Datetime,100034981 (Weseler Straße),101034981 (Weseler Straße stadteinwärts),102034981 (Weseler Straße stadtauswärts),100034981-status,101034981-status,102034981-status
2019-07-01 00:00,5,0,5,0,0,0
2019-07-01 00:15,7,2,5,0,0,0
2019-07-01 00:30,3,2,1,0,0,0
2019-07-01 00:45,2,1,1,0,0,0
2019-07-01 01:00,2,0,2,0,0,0
2019-07-01 01:15,5,1,4,0,0,0
2019-07-01 01:30,0,0,0,0,0,0
2019-07-01 01:45,0,0,0,0,0,0
2019-07-01 02:00,0,0,0,0,0,0
2019-07-01 02:15,1,0,1,0,0,0
2019-07-01 02:30,2,2,0,0,0,0
2019-07-01 02:45,3,0,3,0,0,0
2019-07-01 03:00,0,0,0,0,0,0
2019-07-01 03:15,1,0,1,0,0,0
2019-07-01 03:30,5,2,3,0,0,0
2019-07-01 03:45,0,0,0,0,0,0
2019-07-01 04:00,0,0,0,0,0,0
2019-07-01 04:15,0,0,0,0,0,0
2019-07-01 04:30,2,2,0,0,0,0
2019-07-01 04:45,2,2,0,0,0,0
2019-07-01 05:00,6,2,4,0,0,0
2019-07-01 05:15,7,4,3,0,0,0
2019-07-01 05:30,12,4,8,0,0,0
2019-07-01 05:45,16,9,7,0,0,0
2019-07-01 06:00,12,8,4,0,0,0
2019-07-01 06:15,27,14,13,0,0,0
2019-07-01 06:30,46,18,28,0,0,0
2019-07-01 06:45,59,23,36,0,0,0
2019-07-01 07:00,61,26,35,0,0,0
2019-07-01 07:15,80,50,30,0,0,0
2019-07-01 07:30,134,75,59,0,0,0
2019-07-01 07:45,128,89,39,0,0,0
2019-07-01 08:00,111,75,36,0,0,0
2019-07-01 08:15,83,48,35,0,0,0
2019-07-01 08:30,86,47,39,0,0,0
2019-07-01 08:45,99,66,33,0,0,0
2019-07-01 09:00,59,39,20,0,0,0
2019-07-01 09:15,59,42,17,0,0,0
2019-07-01 09:30,58,41,17,0,0,0
2019-07-01 09:45,76,47,29,0,0,0
2019-07-01 10:00,65,46,19,0,0,0
2019-07-01 10:15,50,32,18,0,0,0
2019-07-01 10:30,51,39,12,0,0,0
2019-07-01 10:45,46,28,18,0,0,0
2019-07-01 11:00,53,43,10,0,0,0
2019-07-01 11:15,57,42,15,0,0,0
2019-07-01 11:30,37,22,15,0,0,0
2019-07-01 11:45,60,37,23,0,0,0
2019-07-01 12:00,61,35,26,0,0,0
2019-07-01 12:15,66,33,33,0,0,0
2019-07-01 12:30,65,34,31,0,0,0
2019-07-01 12:45,64,44,20,0,0,0
2019-07-01 13:00,62,26,36,0,0,0
2019-07-01 13:15,47,21,26,0,0,0
2019-07-01 13:30,60,34,26,0,0,0
2019-07-01 13:45,74,46,28,0,0,0
2019-07-01 14:00,68,47,21,0,0,0
2019-07-01 14:15,63,38,25,0,0,0
2019-07-01 14:30,66,44,22,0,0,0
2019-07-01 14:45,60,35,25,0,0,0
2019-07-01 15:00,82,42,40,0,0,0
2019-07-01 15:15,74,48,26,0,0,0
2019-07-01 15:30,91,62,29,0,0,0
2019-07-01 15:45,106,68,38,0,0,0
2019-07-01 16:00,93,54,39,0,0,0
2019-07-01 16:15,107,73,34,0,0,0
2019-07-01 16:30,135,87,48,0,0,0
2019-07-01 16:45,89,58,31,0,0,0
2019-07-01 17:00,91,55,36,0,0,0
2019-07-01 17:15,108,64,44,0,0,0
2019-07-01 17:30,111,72,39,0,0,0
2019-07-01 17:45,106,60,46,0,0,0
2019-07-01 18:00,101,48,53,0,0,0
2019-07-01 18:15,95,53,42,0,0,0
2019-07-01 18:30,109,52,57,0,0,0
2019-07-01 18:45,89,57,32,0,0,0
2019-07-01 19:00,81,43,38,0,0,0
2019-07-01 19:15,70,35,35,0,0,0
2019-07-01 19:30,48,26,22,0,0,0
2019-07-01 19:45,71,30,41,0,0,0
2019-07-01 20:00,75,36,39,0,0,0
2019-07-01 20:15,55,29,26,0,0,0
2019-07-01 20:30,39,18,21,0,0,0
2019-07-01 20:45,33,25,8,0,0,0
2019-07-01 21:00,37,18,19,0,0,0
2019-07-01 21:15,53,32,21,0,0,0
2019-07-01 21:30,44,23,21,0,0,0
2019-07-01 21:45,32,18,14,0,0,0
2019-07-01 22:00,42,20,22,0,0,0
2019-07-01 22:15,25,8,17,0,0,0
2019-07-01 22:30,29,11,18,0,0,0
2019-07-01 22:45,17,5,12,0,0,0
2019-07-01 23:00,13,4,9,0,0,0
2019-07-01 23:15,16,4,12,0,0,0
2019-07-01 23:30,9,3,6,0,0,0
2019-07-01 23:45,9,4,5,0,0,0
2019-07-02 00:00,5,2,3,0,0,0
2019-07-02 00:15,6,1,5,0,0,0
2019-07-02 00:30,2,1,1,0,0,0
2019-07-02 00:45,3,2,1,0,0,0
2019-07-02 01:00,3,1,2,0,0,0
2019-07-02 01:15,3,1,2,0,0,0
2019-07-02 01:30,3,1,2,0,0,0
2019-07-02 01:45,2,1,1,0,0,0
2019-07-02 02:00,2,2,0,0,0,0
2019-07-02 02:15,1,0,1,0,0,0
2019-07-02 02:30,3,0,3,0,0,0
2019-07-02 02:45,1,1,0,0,0,0
2019-07-02 03:00,1,1,0,0,0,0
2019-07-02 03:15,1,0,1,0,0,0
2019-07-02 03:30,2,1,1,0,0,0
2019-07-02 03:45,0,0,0,0,0,0
2019-07-02 04:00,0,0,0,0,0,0
2019-07-02 04:15,4,2,2,0,0,0
2019-07-02 04:30,1,0,1,0,0,0
2019-07-02 04:45,2,2,0,0,0,0
2019-07-02 05:00,5,2,3,0,0,0
2019-07-02 05:15,3,1,2,0,0,0
2019-07-02 05:30,9,7,2,0,0,0
2019-07-02 05:45,11,6,5,0,0,0
2019-07-02 06:00,6,4,2,0,0,0
2019-07-02 06:15,26,17,9,0,0,0
2019-07-02 06:30,43,12,31,0,0,0
2019-07-02 06:45,67,32,35,0,0,0
2019-07-02 07:00,59,27,32,0,0,0
2019-07-02 07:15,92,56,36,0,0,0
2019-07-02 07:30,134,81,53,0,0,0
2019-07-02 07:45,124,81,43,0,0,0
2019-07-02 08:00,128,89,39,0,0,0
2019-07-02 08:15,91,64,27,0,0,0
2019-07-02 08:30,84,51,33,0,0,0
2019-07-02 08:45,87,58,29,0,0,0
2019-07-02 09:00,60,42,18,0,0,0
2019-07-02 09:15,61,40,21,0,0,0
2019-07-02 09:30,51,44,7,0,0,0
2019-07-02 09:45,76,57,19,0,0,0
2019-07-02 10:00,57,48,9,0,0,0
2019-07-02 10:15,52,31,21,0,0,0
2019-07-02 10:30,31,27,4,0,0,0
2019-07-02 10:45,50,41,9,0,0,0
2019-07-02 11:00,46,27,19,0,0,0
2019-07-02 11:15,49,31,18,0,0,0
2019-07-02 11:30,39,24,15,0,0,0
2019-07-02 11:45,66,35,31,0,0,0
2019-07-02 12:00,53,22,31,0,0,0
2019-07-02 12:15,54,36,18,0,0,0
2019-07-02 12:30,63,29,34,0,0,0
2019-07-02 12:45,55,33,22,0,0,0
2019-07-02 13:00,52,25,27,0,0,0
2019-07-02 13:15,56,28,28,0,0,0
2019-07-02 13:30,58,28,30,0,0,0
2019-07-02 13:45,85,54,31,0,0,0
2019-07-02 14:00,70,34,36,0,0,0
2019-07-02 14:15,57,36,21,0,0,0
2019-07-02 14:30,64,49,15,0,0,0
2019-07-02 14:45,76,48,28,0,0,0
2019-07-02 15:00,61,34,27,0,0,0
2019-07-02 15:15,70,57,13,0,0,0
2019-07-02 15:30,71,44,27,0,0,0
2019-07-02 15:45,99,64,35,0,0,0
2019-07-02 16:00,97,69,28,0,0,0
2019-07-02 16:15,92,56,36,0,0,0
2019-07-02 16:30,88,57,31,0,0,0
2019-07-02 16:45,91,68,23,0,0,0
2019-07-02 17:00,113,72,41,0,0,0
2019-07-02 17:15,103,62,41,0,0,0
2019-07-02 17:30,119,68,51,0,0,0
2019-07-02 17:45,129,72,57,0,0,0
2019-07-02 18:00,96,55,41,0,0,0
2019-07-02 18:15,99,62,37,0,0,0
2019-07-02 18:30,76,38,38,0,0,0
2019-07-02 18:45,85,42,43,0,0,0
2019-07-02 19:00,73,34,39,0,0,0
2019-07-02 19:15,58,33,25,0,0,0
2019-07-02 19:30,77,41,36,0,0,0
2019-07-02 19:45,85,41,44,0,0,0
2019-07-02 20:00,62,27,35,0,0,0
2019-07-02 20:15,78,36,42,0,0,0
2019-07-02 20:30,50,26,24,0,0,0
2019-07-02 20:45,29,18,11,0,0,0
2019-07-02 21:00,46,18,28,0,0,0
2019-07-02 21:15,47,19,28,0,0,0
2019-07-02 21:30,40,19,21,0,0,0
2019-07-02 21:45,32,9,23,0,0,0
2019-07-02 22:00,34,12,22,0,0,0
2019-07-02 22:15,36,17,19,0,0,0
2019-07-02 22:30,15,4,11,0,0,0
2019-07-02 22:45,31,16,15,0,0,0
2019-07-02 23:00,16,9,7,0,0,0
2019-07-02 23:15,8,4,4,0,0,0
2019-07-02 23:30,15,6,9,0,0,0
2019-07-02 23:45,11,6,5,0,0,0
2019-07-03 00:00,12,8,4,0,0,0
2019-07-03 00:15,6,3,3,0,0,0
2019-07-03 00:30,10,4,6,0,0,0
2019-07-03 00:45,7,1,6,0,0,0
2019-07-03 01:00,11,4,7,0,0,0
2019-07-03 01:15,3,1,2,0,0,0
2019-07-03 01:30,2,0,2,0,0,0
2019-07-03 01:45,1,0,1,0,0,0
2019-07-03 02:00,4,0,4,0,0,0
2019-07-03 02:15,1,0,1,0,0,0
2019-07-03 02:30,1,0,1,0,0,0
2019-07-03 02:45,6,1,5,0,0,0
2019-07-03 03:00,0,0,0,0,0,0
2019-07-03 03:15,1,0,1,0,0,0
2019-07-03 03:30,4,1,3,0,0,0
2019-07-03 03:45,2,0,2,0,0,0
2019-07-03 04:00,1,0,1,0,0,0
2019-07-03 04:15,4,3,1,0,0,0
2019-07-03 04:30,1,0,1,0,0,0
2019-07-03 04:45,4,3,1,0,0,0
2019-07-03 05:00,3,2,1,0,0,0
2019-07-03 05:15,5,1,4,0,0,0
2019-07-03 05:30,11,6,5,0,0,0
2019-07-03 05:45,19,11,8,0,0,0
2019-07-03 06:00,10,7,3,0,0,0
2019-07-03 06:15,19,13,6,0,0,0
2019-07-03 06:30,44,20,24,0,0,0
2019-07-03 06:45,68,34,34,0,0,0
2019-07-03 07:00,53,22,31,0,0,0
2019-07-03 07:15,97,64,33,0,0,0
2019-07-03 07:30,149,91,58,0,0,0
2019-07-03 07:45,143,98,45,0,0,0
2019-07-03 08:00,117,79,38,0,0,0
2019-07-03 08:15,107,62,45,0,0,0
2019-07-03 08:30,101,58,43,0,0,0
2019-07-03 08:45,108,80,28,0,0,0
2019-07-03 09:00,57,35,22,0,0,0
2019-07-03 09:15,48,33,15,0,0,0
2019-07-03 09:30,55,45,10,0,0,0
2019-07-03 09:45,75,46,29,0,0,0
2019-07-03 10:00,76,54,22,0,0,0
2019-07-03 10:15,51,34,17,0,0,0
2019-07-03 10:30,37,26,11,0,0,0
2019-07-03 10:45,48,37,11,0,0,0
2019-07-03 11:00,38,27,11,0,0,0
2019-07-03 11:15,58,45,13,0,0,0
2019-07-03 11:30,41,28,13,0,0,0
2019-07-03 11:45,58,39,19,0,0,0
2019-07-03 12:00,59,38,21,0,0,0
2019-07-03 12:15,58,22,36,0,0,0
2019-07-03 12:30,50,26,24,0,0,0
2019-07-03 12:45,53,35,18,0,0,0
2019-07-03 13:00,91,55,36,0,0,0
2019-07-03 13:15,51,30,21,0,0,0
2019-07-03 13:30,68,32,36,0,0,0
2019-07-03 13:45,76,36,40,0,0,0
2019-07-03 14:00,77,38,39,0,0,0
2019-07-03 14:15,64,36,28,0,0,0
2019-07-03 14:30,70,42,28,0,0,0
2019-07-03 14:45,68,33,35,0,0,0
2019-07-03 15:00,84,48,36,0,0,0
2019-07-03 15:15,89,45,44,0,0,0
2019-07-03 15:30,92,53,39,0,0,0
2019-07-03 15:45,99,58,41,0,0,0
2019-07-03 16:00,105,69,36,0,0,0
2019-07-03 16:15,98,66,32,0,0,0
2019-07-03 16:30,80,56,24,0,0,0
2019-07-03 16:45,115,81,34,0,0,0
2019-07-03 17:00,92,58,34,0,0,0
2019-07-03 17:15,81,53,28,0,0,0
2019-07-03 17:30,111,65,46,0,0,0
2019-07-03 17:45,120,70,50,0,0,0
2019-07-03 18:00,115,72,43,0,0,0
2019-07-03 18:15,93,45,48,0,0,0
2019-07-03 18:30,85,47,38,0,0,0
2019-07-03 18:45,67,39,28,0,0,0
2019-07-03 19:00,72,48,24,0,0,0
2019-07-03 19:15,78,45,33,0,0,0
2019-07-03 19:30,57,31,26,0,0,0
2019-07-03 19:45,65,34,31,0,0,0
2019-07-03 20:00,41,24,17,0,0,0
2019-07-03 20:15,65,30,35,0,0,0
2019-07-03 20:30,48,30,18,0,0,0
2019-07-03 20:45,57,28,29,0,0,0
2019-07-03 21:00,39,16,23,0,0,0
2019-07-03 21:15,45,25,20,0,0,0
2019-07-03 21:30,33,16,17,0,0,0
2019-07-03 21:45,44,16,28,0,0,0
2019-07-03 22:00,36,18,18,0,0,0
2019-07-03 22:15,21,7,14,0,0,0
2019-07-03 22:30,21,8,13,0,0,0
2019-07-03 22:45,35,9,26,0,0,0
2019-07-03 23:00,28,12,16,0,0,0
2019-07-03 23:15,14,5,9,0,0,0
2019-07-03 23:30,21,9,12,0,0,0
2019-07-03 23:45,5,1,4,0,0,0
2019-07-04 00:00,8,5,3,0,0,0
2019-07-04 00:15,7,0,7,0,0,0
2019-07-04 00:30,10,7,3,0,0,0
2019-07-04 00:45,15,6,9,0,0,0
2019-07-04 01:00,12,6,6,0,0,0
2019-07-04 01:15,6,1,5,0,0,0
2019-07-04 01:30,0,0,0,0,0,0
2019-07-04 01:45,7,1,6,0,0,0
2019-07-04 02:00,5,2,3,0,0,0
2019-07-04 02:15,2,0,2,0,0,0
2019-07-04 02:30,1,0,1,0,0,0
2019-07-04 02:45,4,1,3,0,0,0
2019-07-04 03:00,1,0,1,0,0,0
2019-07-04 03:15,2,1,1,0,0,0
2019-07-04 03:30,1,1,0,0,0,0
2019-07-04 03:45,1,0,1,0,0,0
2019-07-04 04:00,1,0,1,0,0,0
2019-07-04 04:15,2,2,0,0,0,0
2019-07-04 04:30,2,1,1,0,0,0
2019-07-04 04:45,9,6,3,0,0,0
2019-07-04 05:00,2,2,0,0,0,0
2019-07-04 05:15,6,2,4,0,0,0
2019-07-04 05:30,13,10,3,0,0,0
2019-07-04 05:45,12,7,5,0,0,0
2019-07-04 06:00,11,7,4,0,0,0
2019-07-04 06:15,17,12,5,0,0,0
2019-07-04 06:30,55,30,25,0,0,0
2019-07-04 06:45,61,21,40,0,0,0
2019-07-04 07:00,43,22,21,0,0,0
2019-07-04 07:15,83,40,43,0,0,0
2019-07-04 07:30,139,91,48,0,0,0
2019-07-04 07:45,144,86,58,0,0,0
2019-07-04 08:00,112,66,46,0,0,0
2019-07-04 08:15,88,65,23,0,0,0
2019-07-04 08:30,94,59,35,0,0,0
2019-07-04 08:45,93,59,34,0,0,0
2019-07-04 09:00,61,44,17,0,0,0
2019-07-04 09:15,52,37,15,0,0,0
2019-07-04 09:30,58,37,21,0,0,0
2019-07-04 09:45,72,50,22,0,0,0
2019-07-04 10:00,67,54,13,0,0,0
2019-07-04 10:15,29,21,8,0,0,0
2019-07-04 10:30,53,39,14,0,0,0
2019-07-04 10:45,38,34,4,0,0,0
2019-07-04 11:00,42,27,15,0,0,0
2019-07-04 11:15,25,16,9,0,0,0
2019-07-04 11:30,47,28,19,0,0,0
2019-07-04 11:45,66,47,19,0,0,0
2019-07-04 12:00,72,38,34,0,0,0
2019-07-04 12:15,65,34,31,0,0,0
2019-07-04 12:30,64,36,28,0,0,0
2019-07-04 12:45,71,43,28,0,0,0
2019-07-04 13:00,49,29,20,0,0,0
2019-07-04 13:15,53,22,31,0,0,0
2019-07-04 13:30,56,30,26,0,0,0
2019-07-04 13:45,59,39,20,0,0,0
2019-07-04 14:00,60,34,26,0,0,0
2019-07-04 14:15,51,30,21,0,0,0
2019-07-04 14:30,66,41,25,0,0,0
2019-07-04 14:45,83,47,36,0,0,0
2019-07-04 15:00,83,45,38,0,0,0
2019-07-04 15:15,70,46,24,0,0,0
2019-07-04 15:30,75,41,34,0,0,0
2019-07-04 15:45,119,67,52,0,0,0
2019-07-04 16:00,104,60,44,0,0,0
2019-07-04 16:15,109,71,38,0,0,0
2019-07-04 16:30,110,76,34,0,0,0
2019-07-04 16:45,93,60,33,0,0,0
2019-07-04 17:00,92,63,29,0,0,0
2019-07-04 17:15,92,54,38,0,0,0
2019-07-04 17:30,121,84,37,0,0,0
2019-07-04 17:45,121,77,44,0,0,0
2019-07-04 18:00,97,59,38,0,0,0
2019-07-04 18:15,105,66,39,0,0,0
2019-07-04 18:30,68,37,31,0,0,0
2019-07-04 18:45,99,65,34,0,0,0
2019-07-04 19:00,67,45,22,0,0,0
2019-07-04 19:15,73,38,35,0,0,0
2019-07-04 19:30,82,45,37,0,0,0
2019-07-04 19:45,84,51,33,0,0,0
2019-07-04 20:00,56,26,30,0,0,0
2019-07-04 20:15,50,28,22,0,0,0
2019-07-04 20:30,44,24,20,0,0,0
2019-07-04 20:45,36,19,17,0,0,0
2019-07-04 21:00,50,21,29,0,0,0
2019-07-04 21:15,41,16,25,0,0,0
2019-07-04 21:30,37,20,17,0,0,0
2019-07-04 21:45,20,10,10,0,0,0
2019-07-04 22:00,37,16,21,0,0,0
2019-07-04 22:15,26,8,18,0,0,0
2019-07-04 22:30,33,7,26,0,0,0
2019-07-04 22:45,21,7,14,0,0,0
2019-07-04 23:00,29,7,22,0,0,0
2019-07-04 23:15,14,7,7,0,0,0
2019-07-04 23:30,12,1,11,0,0,0
2019-07-04 23:45,8,4,4,0,0,0
2019-07-05 00:00,17,7,10,0,0,0
2019-07-05 00:15,7,2,5,0,0,0
2019-07-05 00:30,14,6,8,0,0,0
2019-07-05 00:45,3,0,3,0,0,0
2019-07-05 01:00,4,2,2,0,0,0
2019-07-05 01:15,4,0,4,0,0,0
2019-07-05 01:30,2,0,2,0,0,0
2019-07-05 01:45,2,0,2,0,0,0
2019-07-05 02:00,5,1,4,0,0,0
2019-07-05 02:15,1,1,0,0,0,0
2019-07-05 02:30,1,0,1,0,0,0
2019-07-05 02:45,6,1,5,0,0,0
2019-07-05 03:00,2,0,2,0,0,0
2019-07-05 03:15,0,0,0,0,0,0
2019-07-05 03:30,1,1,0,0,0,0
2019-07-05 03:45,0,0,0,0,0,0
2019-07-05 04:00,0,0,0,0,0,0
2019-07-05 04:15,3,3,0,0,0,0
2019-07-05 04:30,0,0,0,0,0,0
2019-07-05 04:45,3,2,1,0,0,0
2019-07-05 05:00,2,1,1,0,0,0
2019-07-05 05:15,9,4,5,0,0,0
2019-07-05 05:30,11,8,3,0,0,0
2019-07-05 05:45,14,7,7,0,0,0
2019-07-05 06:00,8,6,2,0,0,0
2019-07-05 06:15,22,16,6,0,0,0
2019-07-05 06:30,26,11,15,0,0,0
2019-07-05 06:45,59,25,34,0,0,0
2019-07-05 07:00,58,33,25,0,0,0
2019-07-05 07:15,64,33,31,0,0,0
2019-07-05 07:30,136,78,58,0,0,0
2019-07-05 07:45,126,74,52,0,0,0
2019-07-05 08:00,107,68,39,0,0,0
2019-07-05 08:15,100,65,35,0,0,0
2019-07-05 08:30,60,33,27,0,0,0
2019-07-05 08:45,90,67,23,0,0,0
2019-07-05 09:00,53,37,16,0,0,0
2019-07-05 09:15,41,28,13,0,0,0
2019-07-05 09:30,62,42,20,0,0,0
2019-07-05 09:45,67,48,19,0,0,0
2019-07-05 10:00,52,38,14,0,0,0
2019-07-05 10:15,42,33,9,0,0,0
2019-07-05 10:30,44,28,16,0,0,0
2019-07-05 10:45,43,29,14,0,0,0
2019-07-05 11:00,54,31,23,0,0,0
2019-07-05 11:15,50,32,18,0,0,0
2019-07-05 11:30,55,37,18,0,0,0
2019-07-05 11:45,66,37,29,0,0,0
2019-07-05 12:00,53,24,29,0,0,0
2019-07-05 12:15,60,30,30,0,0,0
2019-07-05 12:30,60,33,27,0,0,0
2019-07-05 12:45,61,40,21,0,0,0
2019-07-05 13:00,78,39,39,0,0,0
2019-07-05 13:15,67,37,30,0,0,0
2019-07-05 13:30,96,55,41,0,0,0
2019-07-05 13:45,105,57,48,0,0,0
2019-07-05 14:00,76,39,37,0,0,0
2019-07-05 14:15,78,45,33,0,0,0
2019-07-05 14:30,88,63,25,0,0,0
2019-07-05 14:45,89,60,29,0,0,0
2019-07-05 15:00,78,44,34,0,0,0
2019-07-05 15:15,65,39,26,0,0,0
2019-07-05 15:30,77,45,32,0,0,0
2019-07-05 15:45,92,57,35,0,0,0
2019-07-05 16:00,86,61,25,0,0,0
2019-07-05 16:15,75,46,29,0,0,0
2019-07-05 16:30,71,42,29,0,0,0
2019-07-05 16:45,73,37,36,0,0,0
2019-07-05 17:00,64,43,21,0,0,0
2019-07-05 17:15,91,48,43,0,0,0
2019-07-05 17:30,80,57,23,0,0,0
2019-07-05 17:45,114,43,71,0,0,0
2019-07-05 18:00,81,22,59,0,0,0
2019-07-05 18:15,72,30,42,0,0,0
2019-07-05 18:30,72,45,27,0,0,0
2019-07-05 18:45,91,63,28,0,0,0
2019-07-05 19:00,57,35,22,0,0,0
2019-07-05 19:15,73,58,15,0,0,0
2019-07-05 19:30,72,47,25,0,0,0
2019-07-05 19:45,66,41,25,0,0,0
2019-07-05 20:00,46,30,16,0,0,0
2019-07-05 20:15,58,31,27,0,0,0
2019-07-05 20:30,48,27,21,0,0,0
2019-07-05 20:45,52,37,15,0,0,0
2019-07-05 21:00,28,14,14,0,0,0
2019-07-05 21:15,26,11,15,0,0,0
2019-07-05 21:30,43,27,16,0,0,0
2019-07-05 21:45,36,16,20,0,0,0
2019-07-05 22:00,61,30,31,0,0,0
2019-07-05 22:15,56,14,42,0,0,0
2019-07-05 22:30,44,16,28,0,0,0
2019-07-05 22:45,56,17,39,0,0,0
2019-07-05 23:00,30,12,18,0,0,0
2019-07-05 23:15,59,18,41,0,0,0
2019-07-05 23:30,54,33,21,0,0,0
2019-07-05 23:45,42,24,18,0,0,0
2019-07-06 00:00,25,14,11,0,0,0
2019-07-06 00:15,34,12,22,0,0,0
2019-07-06 00:30,23,7,16,0,0,0
2019-07-06 00:45,21,13,8,0,0,0
2019-07-06 01:00,29,15,14,0,0,0
2019-07-06 01:15,31,15,16,0,0,0
2019-07-06 01:30,19,14,5,0,0,0
2019-07-06 01:45,14,9,5,0,0,0
2019-07-06 02:00,17,6,11,0,0,0
2019-07-06 02:15,11,8,3,0,0,0
2019-07-06 02:30,11,5,6,0,0,0
2019-07-06 02:45,13,7,6,0,0,0
2019-07-06 03:00,19,10,9,0,0,0
2019-07-06 03:15,9,5,4,0,0,0
2019-07-06 03:30,5,4,1,0,0,0
2019-07-06 03:45,6,1,5,0,0,0
2019-07-06 04:00,6,4,2,0,0,0
2019-07-06 04:15,5,1,4,0,0,0
2019-07-06 04:30,0,0,0,0,0,0
2019-07-06 04:45,8,2,6,0,0,0
2019-07-06 05:00,5,3,2,0,0,0
2019-07-06 05:15,4,2,2,0,0,0
2019-07-06 05:30,8,3,5,0,0,0
2019-07-06 05:45,3,2,1,0,0,0
2019-07-06 06:00,2,2,0,0,0,0
2019-07-06 06:15,5,5,0,0,0,0
2019-07-06 06:30,8,4,4,0,0,0
2019-07-06 06:45,3,2,1,0,0,0
2019-07-06 07:00,2,1,1,0,0,0
2019-07-06 07:15,11,6,5,0,0,0
2019-07-06 07:30,21,13,8,0,0,0
2019-07-06 07:45,27,18,9,0,0,0
2019-07-06 08:00,22,14,8,0,0,0
2019-07-06 08:15,23,17,6,0,0,0
2019-07-06 08:30,25,16,9,0,0,0
2019-07-06 08:45,41,33,8,0,0,0
2019-07-06 09:00,21,15,6,0,0,0
2019-07-06 09:15,47,37,10,0,0,0
2019-07-06 09:30,51,40,11,0,0,0
2019-07-06 09:45,48,34,14,0,0,0
2019-07-06 10:00,64,44,20,0,0,0
2019-07-06 10:15,35,23,12,0,0,0
2019-07-06 10:30,36,28,8,0,0,0
2019-07-06 10:45,75,51,24,0,0,0
2019-07-06 11:00,55,41,14,0,0,0
2019-07-06 11:15,58,42,16,0,0,0
2019-07-06 11:30,65,54,11,0,0,0
2019-07-06 11:45,68,46,22,0,0,0
2019-07-06 12:00,56,40,16,0,0,0
2019-07-06 12:15,61,35,26,0,0,0
2019-07-06 12:30,54,28,26,0,0,0
2019-07-06 12:45,46,36,10,0,0,0
2019-07-06 13:00,51,37,14,0,0,0
2019-07-06 13:15,58,42,16,0,0,0
2019-07-06 13:30,70,47,23,0,0,0
2019-07-06 13:45,66,50,16,0,0,0
2019-07-06 14:00,61,39,22,0,0,0
2019-07-06 14:15,55,38,17,0,0,0
2019-07-06 14:30,57,43,14,0,0,0
2019-07-06 14:45,58,30,28,0,0,0
2019-07-06 15:00,50,31,19,0,0,0
2019-07-06 15:15,36,21,15,0,0,0
2019-07-06 15:30,58,32,26,0,0,0
2019-07-06 15:45,67,39,28,0,0,0
2019-07-06 16:00,56,30,26,0,0,0
2019-07-06 16:15,57,29,28,0,0,0
2019-07-06 16:30,51,24,27,0,0,0
2019-07-06 16:45,59,33,26,0,0,0
2019-07-06 17:00,36,15,21,0,0,0
2019-07-06 17:15,47,24,23,0,0,0
2019-07-06 17:30,48,22,26,0,0,0
2019-07-06 17:45,40,22,18,0,0,0
2019-07-06 18:00,35,16,19,0,0,0
2019-07-06 18:15,34,18,16,0,0,0
2019-07-06 18:30,39,21,18,0,0,0
2019-07-06 18:45,28,17,11,0,0,0
2019-07-06 19:00,20,9,11,0,0,0
2019-07-06 19:15,33,13,20,0,0,0
2019-07-06 19:30,25,13,12,0,0,0
2019-07-06 19:45,24,15,9,0,0,0
2019-07-06 20:00,30,16,14,0,0,0
2019-07-06 20:15,29,13,16,0,0,0
2019-07-06 20:30,21,15,6,0,0,0
2019-07-06 20:45,18,10,8,0,0,0
2019-07-06 21:00,27,15,12,0,0,0
2019-07-06 21:15,26,11,15,0,0,0
2019-07-06 21:30,17,9,8,0,0,0
2019-07-06 21:45,11,2,9,0,0,0
2019-07-06 22:00,19,11,8,0,0,0
2019-07-06 22:15,17,6,11,0,0,0
2019-07-06 22:30,8,6,2,0,0,0
2019-07-06 22:45,21,12,9,0,0,0
2019-07-06 23:00,29,12,17,0,0,0
2019-07-06 23:15,11,4,7,0,0,0
2019-07-06 23:30,9,5,4,0,0,0
2019-07-06 23:45,10,4,6,0,0,0
2019-07-07 00:00,6,5,1,0,0,0
2019-07-07 00:15,14,4,10,0,0,0
2019-07-07 00:30,16,9,7,0,0,0
2019-07-07 00:45,20,9,11,0,0,0
2019-07-07 01:00,11,2,9,0,0,0
2019-07-07 01:15,7,6,1,0,0,0
2019-07-07 01:30,4,2,2,0,0,0
2019-07-07 01:45,10,6,4,0,0,0
2019-07-07 02:00,8,6,2,0,0,0
2019-07-07 02:15,6,6,0,0,0,0
2019-07-07 02:30,5,4,1,0,0,0
2019-07-07 02:45,3,0,3,0,0,0
2019-07-07 03:00,5,0,5,0,0,0
2019-07-07 03:15,0,0,0,0,0,0
2019-07-07 03:30,3,1,2,0,0,0
2019-07-07 03:45,0,0,0,0,0,0
2019-07-07 04:00,5,0,5,0,0,0
2019-07-07 04:15,2,1,1,0,0,0
2019-07-07 04:30,3,2,1,0,0,0
2019-07-07 04:45,2,2,0,0,0,0
2019-07-07 05:00,1,1,0,0,0,0
2019-07-07 05:15,1,1,0,0,0,0
2019-07-07 05:30,4,0,4,0,0,0
2019-07-07 05:45,3,3,0,0,0,0
2019-07-07 06:00,4,2,2,0,0,0
2019-07-07 06:15,3,3,0,0,0,0
2019-07-07 06:30,4,2,2,0,0,0
2019-07-07 06:45,3,3,0,0,0,0
2019-07-07 07:00,0,0,0,0,0,0
2019-07-07 07:15,2,1,1,0,0,0
2019-07-07 07:30,5,3,2,0,0,0
2019-07-07 07:45,10,9,1,0,0,0
2019-07-07 08:00,11,9,2,0,0,0
2019-07-07 08:15,11,8,3,0,0,0
2019-07-07 08:30,10,7,3,0,0,0
2019-07-07 08:45,11,8,3,0,0,0
2019-07-07 09:00,10,7,3,0,0,0
2019-07-07 09:15,12,10,2,0,0,0
2019-07-07 09:30,20,16,4,0,0,0
2019-07-07 09:45,39,35,4,0,0,0
2019-07-07 10:00,19,11,8,0,0,0
2019-07-07 10:15,18,13,5,0,0,0
2019-07-07 10:30,30,23,7,0,0,0
2019-07-07 10:45,28,24,4,0,0,0
2019-07-07 11:00,21,9,12,0,0,0
2019-07-07 11:15,27,15,12,0,0,0
2019-07-07 11:30,18,13,5,0,0,0
2019-07-07 11:45,27,16,11,0,0,0
2019-07-07 12:00,19,9,10,0,0,0
2019-07-07 12:15,41,13,28,0,0,0
2019-07-07 12:30,37,19,18,0,0,0
2019-07-07 12:45,20,13,7,0,0,0
2019-07-07 13:00,40,29,11,0,0,0
2019-07-07 13:15,45,33,12,0,0,0
2019-07-07 13:30,47,30,17,0,0,0
2019-07-07 13:45,44,31,13,0,0,0
2019-07-07 14:00,24,13,11,0,0,0
2019-07-07 14:15,32,18,14,0,0,0
2019-07-07 14:30,47,24,23,0,0,0
2019-07-07 14:45,42,22,20,0,0,0
2019-07-07 15:00,38,23,15,0,0,0
2019-07-07 15:15,54,29,25,0,0,0
2019-07-07 15:30,30,9,21,0,0,0
2019-07-07 15:45,58,29,29,0,0,0
2019-07-07 16:00,56,39,17,0,0,0
2019-07-07 16:15,56,50,6,0,0,0
2019-07-07 16:30,58,37,21,0,0,0
2019-07-07 16:45,51,30,21,0,0,0
2019-07-07 17:00,45,26,19,0,0,0
2019-07-07 17:15,51,29,22,0,0,0
2019-07-07 17:30,34,14,20,0,0,0
2019-07-07 17:45,53,20,33,0,0,0
2019-07-07 18:00,57,21,36,0,0,0
2019-07-07 18:15,49,33,16,0,0,0
2019-07-07 18:30,39,21,18,0,0,0
2019-07-07 18:45,45,23,22,0,0,0
2019-07-07 19:00,26,13,13,0,0,0
2019-07-07 19:15,57,28,29,0,0,0
2019-07-07 19:30,37,15,22,0,0,0
2019-07-07 19:45,32,14,18,0,0,0
2019-07-07 20:00,43,20,23,0,0,0
2019-07-07 20:15,42,14,28,0,0,0
2019-07-07 20:30,34,19,15,0,0,0
2019-07-07 20:45,26,9,17,0,0,0
2019-07-07 21:00,20,4,16,0,0,0
2019-07-07 21:15,29,12,17,0,0,0
2019-07-07 21:30,20,8,12,0,0,0
2019-07-07 21:45,22,10,12,0,0,0
2019-07-07 22:00,18,5,13,0,0,0
2019-07-07 22:15,25,3,22,0,0,0
2019-07-07 22:30,10,3,7,0,0,0
2019-07-07 22:45,8,6,2,0,0,0
2019-07-07 23:00,12,4,8,0,0,0
2019-07-07 23:15,6,1,5,0,0,0
2019-07-07 23:30,5,0,5,0,0,0
2019-07-07 23:45,6,2,4,0,0,0
2019-07-08 00:00,0,0,0,0,0,0
2019-07-08 00:15,1,0,1,0,0,0
2019-07-08 00:30,2,1,1,0,0,0
2019-07-08 00:45,4,0,4,0,0,0
2019-07-08 01:00,2,1,1,0,0,0
2019-07-08 01:15,6,1,5,0,0,0
2019-07-08 01:30,1,0,1,0,0,0
2019-07-08 01:45,0,0,0,0,0,0
2019-07-08 02:00,1,0,1,0,0,0
2019-07-08 02:15,0,0,0,0,0,0
2019-07-08 02:30,3,1,2,0,0,0
2019-07-08 02:45,3,2,1,0,0,0
2019-07-08 03:00,0,0,0,0,0,0
2019-07-08 03:15,0,0,0,0,0,0
2019-07-08 03:30,0,0,0,0,0,0
2019-07-08 03:45,0,0,0,0,0,0
2019-07-08 04:00,0,0,0,0,0,0
2019-07-08 04:15,1,0,1,0,0,0
2019-07-08 04:30,1,0,1,0,0,0
2019-07-08 04:45,6,3,3,0,0,0
2019-07-08 05:00,3,2,1,0,0,0
2019-07-08 05:15,5,2,3,0,0,0
2019-07-08 05:30,18,12,6,0,0,0
2019-07-08 05:45,11,8,3,0,0,0
2019-07-08 06:00,8,5,3,0,0,0
2019-07-08 06:15,21,12,9,0,0,0
2019-07-08 06:30,33,15,18,0,0,0
2019-07-08 06:45,55,25,30,0,0,0
2019-07-08 07:00,49,22,27,0,0,0
2019-07-08 07:15,103,55,48,0,0,0
2019-07-08 07:30,173,117,56,0,0,0
2019-07-08 07:45,135,95,40,0,0,0
2019-07-08 08:00,75,50,25,0,0,0
2019-07-08 08:15,86,52,34,0,0,0
2019-07-08 08:30,76,48,28,0,0,0
2019-07-08 08:45,80,53,27,0,0,0
2019-07-08 09:00,60,52,8,0,0,0
2019-07-08 09:15,56,37,19,0,0,0
2019-07-08 09:30,52,39,13,0,0,0
2019-07-08 09:45,65,48,17,0,0,0
2019-07-08 10:00,40,28,12,0,0,0
2019-07-08 10:15,42,24,18,0,0,0
2019-07-08 10:30,27,17,10,0,0,0
2019-07-08 10:45,46,33,13,0,0,0
2019-07-08 11:00,45,30,15,0,0,0
2019-07-08 11:15,58,41,17,0,0,0
2019-07-08 11:30,38,26,12,0,0,0
2019-07-08 11:45,60,34,26,0,0,0
2019-07-08 12:00,49,30,19,0,0,0
2019-07-08 12:15,43,27,16,0,0,0
2019-07-08 12:30,50,27,23,0,0,0
2019-07-08 12:45,53,24,29,0,0,0
2019-07-08 13:00,79,36,43,0,0,0
2019-07-08 13:15,47,28,19,0,0,0
2019-07-08 13:30,56,28,28,0,0,0
2019-07-08 13:45,56,37,19,0,0,0
2019-07-08 14:00,64,35,29,0,0,0
2019-07-08 14:15,46,31,15,0,0,0
2019-07-08 14:30,59,33,26,0,0,0
2019-07-08 14:45,67,38,29,0,0,0
2019-07-08 15:00,67,29,38,0,0,0
2019-07-08 15:15,66,41,25,0,0,0
2019-07-08 15:30,98,63,35,0,0,0
2019-07-08 15:45,88,67,21,0,0,0
2019-07-08 16:00,72,38,34,0,0,0
2019-07-08 16:15,89,60,29,0,0,0
2019-07-08 16:30,86,46,40,0,0,0
2019-07-08 16:45,75,53,22,0,0,0
2019-07-08 17:00,87,57,30,0,0,0
2019-07-08 17:15,73,43,30,0,0,0
2019-07-08 17:30,90,51,39,0,0,0
2019-07-08 17:45,116,56,60,0,0,0
2019-07-08 18:00,75,44,31,0,0,0
2019-07-08 18:15,85,49,36,0,0,0
2019-07-08 18:30,48,27,21,0,0,0
2019-07-08 18:45,67,39,28,0,0,0
2019-07-08 19:00,48,27,21,0,0,0
2019-07-08 19:15,67,32,35,0,0,0
2019-07-08 19:30,53,23,30,0,0,0
2019-07-08 19:45,51,21,30,0,0,0
2019-07-08 20:00,46,19,27,0,0,0
2019-07-08 20:15,41,17,24,0,0,0
2019-07-08 20:30,34,25,9,0,0,0
2019-07-08 20:45,29,17,12,0,0,0
2019-07-08 21:00,23,10,13,0,0,0
2019-07-08 21:15,38,21,17,0,0,0
2019-07-08 21:30,22,13,9,0,0,0
2019-07-08 21:45,18,12,6,0,0,0
2019-07-08 22:00,21,4,17,0,0,0
2019-07-08 22:15,14,5,9,0,0,0
2019-07-08 22:30,14,7,7,0,0,0
2019-07-08 22:45,19,9,10,0,0,0
2019-07-08 23:00,15,3,12,0,0,0
2019-07-08 23:15,6,1,5,0,0,0
2019-07-08 23:30,1,1,0,0,0,0
2019-07-08 23:45,10,6,4,0,0,0
2019-07-09 00:00,4,1,3,0,0,0
2019-07-09 00:15,4,2,2,0,0,0
2019-07-09 00:30,4,3,1,0,0,0
2019-07-09 00:45,1,1,0,0,0,0
2019-07-09 01:00,2,0,2,0,0,0
2019-07-09 01:15,1,0,1,0,0,0
2019-07-09 01:30,5,1,4,0,0,0
2019-07-09 01:45,2,0,2,0,0,0
2019-07-09 02:00,2,0,2,0,0,0
2019-07-09 02:15,2,1,1,0,0,0
2019-07-09 02:30,0,0,0,0,0,0
2019-07-09 02:45,5,4,1,0,0,0
2019-07-09 03:00,0,0,0,0,0,0
2019-07-09 03:15,0,0,0,0,0,0
2019-07-09 03:30,4,0,4,0,0,0
2019-07-09 03:45,2,2,0,0,0,0
2019-07-09 04:00,0,0,0,0,0,0
2019-07-09 04:15,2,1,1,0,0,0
2019-07-09 04:30,2,0,2,0,0,0
2019-07-09 04:45,4,3,1,0,0,0
2019-07-09 05:00,0,0,0,0,0,0
2019-07-09 05:15,5,3,2,0,0,0
2019-07-09 05:30,20,10,10,0,0,0
2019-07-09 05:45,10,8,2,0,0,0
2019-07-09 06:00,7,5,2,0,0,0
2019-07-09 06:15,17,13,4,0,0,0
2019-07-09 06:30,37,16,21,0,0,0
2019-07-09 06:45,54,19,35,0,0,0
2019-07-09 07:00,58,34,24,0,0,0
2019-07-09 07:15,84,43,41,0,0,0
2019-07-09 07:30,151,102,49,0,0,0
2019-07-09 07:45,134,92,42,0,0,0
2019-07-09 08:00,115,75,40,0,0,0
2019-07-09 08:15,91,57,34,0,0,0
2019-07-09 08:30,89,52,37,0,0,0
2019-07-09 08:45,84,49,35,0,0,0
2019-07-09 09:00,53,40,13,0,0,0
2019-07-09 09:15,56,40,16,0,0,0
2019-07-09 09:30,55,40,15,0,0,0
2019-07-09 09:45,65,44,21,0,0,0
2019-07-09 10:00,46,36,10,0,0,0
2019-07-09 10:15,46,30,16,0,0,0
2019-07-09 10:30,39,22,17,0,0,0
2019-07-09 10:45,36,23,13,0,0,0
2019-07-09 11:00,33,17,16,0,0,0
2019-07-09 11:15,40,32,8,0,0,0
2019-07-09 11:30,58,38,20,0,0,0
2019-07-09 11:45,48,29,19,0,0,0
2019-07-09 12:00,62,23,39,0,0,0
2019-07-09 12:15,57,39,18,0,0,0
2019-07-09 12:30,37,21,16,0,0,0
2019-07-09 12:45,61,29,32,0,0,0
2019-07-09 13:00,68,34,34,0,0,0
2019-07-09 13:15,56,30,26,0,0,0
2019-07-09 13:30,67,39,28,0,0,0
2019-07-09 13:45,59,36,23,0,0,0
2019-07-09 14:00,64,32,32,0,0,0
2019-07-09 14:15,60,33,27,0,0,0
2019-07-09 14:30,53,33,20,0,0,0
2019-07-09 14:45,74,44,30,0,0,0
2019-07-09 15:00,75,43,32,0,0,0
2019-07-09 15:15,59,36,23,0,0,0
2019-07-09 15:30,76,40,36,0,0,0
2019-07-09 15:45,108,61,47,0,0,0
2019-07-09 16:00,96,63,33,0,0,0
2019-07-09 16:15,90,62,28,0,0,0
2019-07-09 16:30,94,58,36,0,0,0
2019-07-09 16:45,92,61,31,0,0,0
2019-07-09 17:00,78,48,30,0,0,0
2019-07-09 17:15,97,55,42,0,0,0
2019-07-09 17:30,117,73,44,0,0,0
2019-07-09 17:45,120,85,35,0,0,0
2019-07-09 18:00,107,52,55,0,0,0
2019-07-09 18:15,84,42,42,0,0,0
2019-07-09 18:30,87,42,45,0,0,0
2019-07-09 18:45,88,56,32,0,0,0
2019-07-09 19:00,79,41,38,0,0,0
2019-07-09 19:15,81,57,24,0,0,0
2019-07-09 19:30,70,43,27,0,0,0
2019-07-09 19:45,42,22,20,0,0,0
2019-07-09 20:00,46,21,25,0,0,0
2019-07-09 20:15,53,27,26,0,0,0
2019-07-09 20:30,50,31,19,0,0,0
2019-07-09 20:45,49,22,27,0,0,0
2019-07-09 21:00,45,23,22,0,0,0
2019-07-09 21:15,35,18,17,0,0,0
2019-07-09 21:30,23,10,13,0,0,0
2019-07-09 21:45,22,12,10,0,0,0
2019-07-09 22:00,38,19,19,0,0,0
2019-07-09 22:15,29,10,19,0,0,0
2019-07-09 22:30,18,5,13,0,0,0
2019-07-09 22:45,18,2,16,0,0,0
2019-07-09 23:00,18,6,12,0,0,0
2019-07-09 23:15,13,3,10,0,0,0
2019-07-09 23:30,18,7,11,0,0,0
2019-07-09 23:45,7,3,4,0,0,0
2019-07-10 00:00,8,3,5,0,0,0
2019-07-10 00:15,4,1,3,0,0,0
2019-07-10 00:30,10,5,5,0,0,0
2019-07-10 00:45,5,1,4,0,0,0
2019-07-10 01:00,2,2,0,0,0,0
2019-07-10 01:15,4,2,2,0,0,0
2019-07-10 01:30,6,2,4,0,0,0
2019-07-10 01:45,4,1,3,0,0,0
2019-07-10 02:00,5,1,4,0,0,0
2019-07-10 02:15,2,0,2,0,0,0
2019-07-10 02:30,2,1,1,0,0,0
2019-07-10 02:45,0,0,0,0,0,0
2019-07-10 03:00,0,0,0,0,0,0
2019-07-10 03:15,0,0,0,0,0,0
2019-07-10 03:30,4,0,4,0,0,0
2019-07-10 03:45,0,0,0,0,0,0
2019-07-10 04:00,2,1,1,0,0,0
2019-07-10 04:15,5,3,2,0,0,0
2019-07-10 04:30,1,0,1,0,0,0
2019-07-10 04:45,4,2,2,0,0,0
2019-07-10 05:00,2,1,1,0,0,0
2019-07-10 05:15,5,4,1,0,0,0
2019-07-10 05:30,7,3,4,0,0,0
2019-07-10 05:45,13,10,3,0,0,0
2019-07-10 06:00,8,5,3,0,0,0
2019-07-10 06:15,16,11,5,0,0,0
2019-07-10 06:30,41,18,23,0,0,0
2019-07-10 06:45,49,17,32,0,0,0
2019-07-10 07:00,52,24,28,0,0,0
2019-07-10 07:15,97,62,35,0,0,0
2019-07-10 07:30,156,111,45,0,0,0
2019-07-10 07:45,156,101,55,0,0,0
2019-07-10 08:00,99,57,42,0,0,0
2019-07-10 08:15,106,71,35,0,0,0
2019-07-10 08:30,89,49,40,0,0,0
2019-07-10 08:45,94,61,33,0,0,0
2019-07-10 09:00,91,39,52,0,0,0
2019-07-10 09:15,65,45,20,0,0,0
2019-07-10 09:30,60,38,22,0,0,0
2019-07-10 09:45,74,53,21,0,0,0
2019-07-10 10:00,46,31,15,0,0,0
2019-07-10 10:15,46,31,15,0,0,0
2019-07-10 10:30,43,23,20,0,0,0
2019-07-10 10:45,62,39,23,0,0,0
2019-07-10 11:00,41,24,17,0,0,0
2019-07-10 11:15,58,36,22,0,0,0
2019-07-10 11:30,47,35,12,0,0,0
2019-07-10 11:45,56,38,18,0,0,0
2019-07-10 12:00,64,36,28,0,0,0
2019-07-10 12:15,70,43,27,0,0,0
2019-07-10 12:30,74,39,35,0,0,0
2019-07-10 12:45,71,42,29,0,0,0
2019-07-10 13:00,102,72,30,0,0,0
2019-07-10 13:15,47,20,27,0,0,0
2019-07-10 13:30,55,32,23,0,0,0
2019-07-10 13:45,85,45,40,0,0,0
2019-07-10 14:00,64,33,31,0,0,0
2019-07-10 14:15,59,39,20,0,0,0
2019-07-10 14:30,59,29,30,0,0,0
2019-07-10 14:45,66,45,21,0,0,0
2019-07-10 15:00,64,41,23,0,0,0
2019-07-10 15:15,74,39,35,0,0,0
2019-07-10 15:30,82,50,32,0,0,0
2019-07-10 15:45,94,66,28,0,0,0
2019-07-10 16:00,90,73,17,0,0,0
2019-07-10 16:15,105,69,36,0,0,0
2019-07-10 16:30,97,61,36,0,0,0
2019-07-10 16:45,99,73,26,0,0,0
2019-07-10 17:00,86,45,41,0,0,0
2019-07-10 17:15,95,60,35,0,0,0
2019-07-10 17:30,105,71,34,0,0,0
2019-07-10 17:45,118,70,48,0,0,0
2019-07-10 18:00,84,40,44,0,0,0
2019-07-10 18:15,78,40,38,0,0,0
2019-07-10 18:30,69,41,28,0,0,0
2019-07-10 18:45,79,49,30,0,0,0
2019-07-10 19:00,75,37,38,0,0,0
2019-07-10 19:15,74,36,38,0,0,0
2019-07-10 19:30,64,31,33,0,0,0
2019-07-10 19:45,62,38,24,0,0,0
2019-07-10 20:00,49,27,22,0,0,0
2019-07-10 20:15,54,29,25,0,0,0
2019-07-10 20:30,38,23,15,0,0,0
2019-07-10 20:45,35,25,10,0,0,0
2019-07-10 21:00,27,13,14,0,0,0
2019-07-10 21:15,45,25,20,0,0,0
2019-07-10 21:30,37,19,18,0,0,0
2019-07-10 21:45,30,18,12,0,0,0
2019-07-10 22:00,31,15,16,0,0,0
2019-07-10 22:15,16,6,10,0,0,0
2019-07-10 22:30,21,16,5,0,0,0
2019-07-10 22:45,26,6,20,0,0,0
2019-07-10 23:00,24,10,14,0,0,0
2019-07-10 23:15,20,8,12,0,0,0
2019-07-10 23:30,16,5,11,0,0,0
2019-07-10 23:45,6,1,5,0,0,0
2019-07-11 00:00,9,5,4,0,0,0
2019-07-11 00:15,12,8,4,0,0,0
2019-07-11 00:30,12,6,6,0,0,0
2019-07-11 00:45,5,1,4,0,0,0
2019-07-11 01:00,2,0,2,0,0,0
2019-07-11 01:15,8,3,5,0,0,0
2019-07-11 01:30,1,0,1,0,0,0
2019-07-11 01:45,10,1,9,0,0,0
2019-07-11 02:00,3,0,3,0,0,0
2019-07-11 02:15,4,0,4,0,0,0
2019-07-11 02:30,1,0,1,0,0,0
2019-07-11 02:45,6,1,5,0,0,0
2019-07-11 03:00,6,1,5,0,0,0
2019-07-11 03:15,3,0,3,0,0,0
2019-07-11 03:30,4,0,4,0,0,0
2019-07-11 03:45,1,0,1,0,0,0
2019-07-11 04:00,4,2,2,0,0,0
2019-07-11 04:15,4,1,3,0,0,0
2019-07-11 04:30,2,2,0,0,0,0
2019-07-11 04:45,3,2,1,0,0,0
2019-07-11 05:00,2,1,1,0,0,0
2019-07-11 05:15,7,4,3,0,0,0
2019-07-11 05:30,13,7,6,0,0,0
2019-07-11 05:45,12,7,5,0,0,0
2019-07-11 06:00,13,9,4,0,0,0
2019-07-11 06:15,23,15,8,0,0,0
2019-07-11 06:30,28,7,21,0,0,0
2019-07-11 06:45,51,27,24,0,0,0
2019-07-11 07:00,40,20,20,0,0,0
2019-07-11 07:15,54,31,23,0,0,0
2019-07-11 07:30,74,44,30,0,0,0
2019-07-11 07:45,99,66,33,0,0,0
2019-07-11 08:00,75,53,22,0,0,0
2019-07-11 08:15,73,48,25,0,0,0
2019-07-11 08:30,65,44,21,0,0,0
2019-07-11 08:45,81,55,26,0,0,0
2019-07-11 09:00,55,35,20,0,0,0
2019-07-11 09:15,43,25,18,0,0,0
2019-07-11 09:30,40,30,10,0,0,0
2019-07-11 09:45,37,29,8,0,0,0
2019-07-11 10:00,28,23,5,0,0,0
2019-07-11 10:15,26,17,9,0,0,0
2019-07-11 10:30,26,20,6,0,0,0
2019-07-11 10:45,33,23,10,0,0,0
2019-07-11 11:00,23,14,9,0,0,0
2019-07-11 11:15,24,12,12,0,0,0
2019-07-11 11:30,25,19,6,0,0,0
2019-07-11 11:45,46,34,12,0,0,0
2019-07-11 12:00,49,28,21,0,0,0
2019-07-11 12:15,39,28,11,0,0,0
2019-07-11 12:30,35,26,9,0,0,0
2019-07-11 12:45,42,29,13,0,0,0
2019-07-11 13:00,33,21,12,0,0,0
2019-07-11 13:15,32,19,13,0,0,0
2019-07-11 13:30,44,17,27,0,0,0
2019-07-11 13:45,51,28,23,0,0,0
2019-07-11 14:00,57,31,26,0,0,0
2019-07-11 14:15,56,31,25,0,0,0
2019-07-11 14:30,45,27,18,0,0,0
2019-07-11 14:45,71,48,23,0,0,0
2019-07-11 15:00,57,27,30,0,0,0
2019-07-11 15:15,65,40,25,0,0,0
2019-07-11 15:30,63,45,18,0,0,0
2019-07-11 15:45,73,53,20,0,0,0
2019-07-11 16:00,100,60,40,0,0,0
2019-07-11 16:15,82,53,29,0,0,0
2019-07-11 16:30,90,57,33,0,0,0
2019-07-11 16:45,67,47,20,0,0,0
2019-07-11 17:00,84,56,28,0,0,0
2019-07-11 17:15,64,46,18,0,0,0
2019-07-11 17:30,104,69,35,0,0,0
2019-07-11 17:45,72,36,36,0,0,0
2019-07-11 18:00,26,14,12,0,0,0
2019-07-11 18:15,28,13,15,0,0,0
2019-07-11 18:30,38,23,15,0,0,0
2019-07-11 18:45,35,22,13,0,0,0
2019-07-11 19:00,55,39,16,0,0,0
2019-07-11 19:15,37,31,6,0,0,0
2019-07-11 19:30,44,31,13,0,0,0
2019-07-11 19:45,44,28,16,0,0,0
2019-07-11 20:00,33,17,16,0,0,0
2019-07-11 20:15,40,28,12,0,0,0
2019-07-11 20:30,31,21,10,0,0,0
2019-07-11 20:45,28,22,6,0,0,0
2019-07-11 21:00,23,12,11,0,0,0
2019-07-11 21:15,26,15,11,0,0,0
2019-07-11 21:30,11,8,3,0,0,0
2019-07-11 21:45,11,4,7,0,0,0
2019-07-11 22:00,25,10,15,0,0,0
2019-07-11 22:15,25,15,10,0,0,0
2019-07-11 22:30,18,8,10,0,0,0
2019-07-11 22:45,21,6,15,0,0,0
2019-07-11 23:00,17,5,12,0,0,0
2019-07-11 23:15,14,7,7,0,0,0
2019-07-11 23:30,15,6,9,0,0,0
2019-07-11 23:45,7,3,4,0,0,0
2019-07-12 00:00,15,9,6,0,0,0
2019-07-12 00:15,5,4,1,0,0,0
2019-07-12 00:30,8,5,3,0,0,0
2019-07-12 00:45,5,2,3,0,0,0
2019-07-12 01:00,10,6,4,0,0,0
2019-07-12 01:15,3,1,2,0,0,0
2019-07-12 01:30,2,1,1,0,0,0
2019-07-12 01:45,2,0,2,0,0,0
2019-07-12 02:00,6,3,3,0,0,0
2019-07-12 02:15,9,2,7,0,0,0
2019-07-12 02:30,7,5,2,0,0,0
2019-07-12 02:45,1,1,0,0,0,0
2019-07-12 03:00,3,0,3,0,0,0
2019-07-12 03:15,0,0,0,0,0,0
2019-07-12 03:30,1,0,1,0,0,0
2019-07-12 03:45,0,0,0,0,0,0
2019-07-12 04:00,1,0,1,0,0,0
2019-07-12 04:15,1,1,0,0,0,0
2019-07-12 04:30,2,2,0,0,0,0
2019-07-12 04:45,2,2,0,0,0,0
2019-07-12 05:00,1,0,1,0,0,0
2019-07-12 05:15,4,2,2,0,0,0
2019-07-12 05:30,8,5,3,0,0,0
2019-07-12 05:45,12,7,5,0,0,0
2019-07-12 06:00,10,5,5,0,0,0
2019-07-12 06:15,16,10,6,0,0,0
2019-07-12 06:30,27,11,16,0,0,0
2019-07-12 06:45,47,21,26,0,0,0
2019-07-12 07:00,44,27,17,0,0,0
2019-07-12 07:15,62,39,23,0,0,0
2019-07-12 07:30,100,60,40,0,0,0
2019-07-12 07:45,127,75,52,0,0,0
2019-07-12 08:00,91,58,33,0,0,0
2019-07-12 08:15,74,52,22,0,0,0
2019-07-12 08:30,77,56,21,0,0,0
2019-07-12 08:45,82,58,24,0,0,0
2019-07-12 09:00,51,31,20,0,0,0
2019-07-12 09:15,40,29,11,0,0,0
2019-07-12 09:30,31,22,9,0,0,0
2019-07-12 09:45,35,29,6,0,0,0
2019-07-12 10:00,31,24,7,0,0,0
2019-07-12 10:15,28,15,13,0,0,0
2019-07-12 10:30,41,22,19,0,0,0
2019-07-12 10:45,40,28,12,0,0,0
2019-07-12 11:00,41,34,7,0,0,0
2019-07-12 11:15,24,22,2,0,0,0
2019-07-12 11:30,37,27,10,0,0,0
2019-07-12 11:45,52,43,9,0,0,0
2019-07-12 12:00,41,22,19,0,0,0
2019-07-12 12:15,39,29,10,0,0,0
2019-07-12 12:30,51,36,15,0,0,0
2019-07-12 12:45,48,36,12,0,0,0
2019-07-12 13:00,40,30,10,0,0,0
2019-07-12 13:15,50,33,17,0,0,0
2019-07-12 13:30,63,39,24,0,0,0
2019-07-12 13:45,66,43,23,0,0,0
2019-07-12 14:00,54,40,14,0,0,0
2019-07-12 14:15,66,54,12,0,0,0
2019-07-12 14:30,64,38,26,0,0,0
2019-07-12 14:45,61,40,21,0,0,0
2019-07-12 15:00,80,37,43,0,0,0
2019-07-12 15:15,60,38,22,0,0,0
2019-07-12 15:30,70,50,20,0,0,0
2019-07-12 15:45,59,30,29,0,0,0
2019-07-12 16:00,32,22,10,0,0,0
2019-07-12 16:15,37,22,15,0,0,0
2019-07-12 16:30,47,26,21,0,0,0
2019-07-12 16:45,61,38,23,0,0,0
2019-07-12 17:00,68,44,24,0,0,0
2019-07-12 17:15,43,22,21,0,0,0
2019-07-12 17:30,62,44,18,0,0,0
2019-07-12 17:45,85,44,41,0,0,0
2019-07-12 18:00,43,30,13,0,0,0
2019-07-12 18:15,50,23,27,0,0,0
2019-07-12 18:30,33,14,19,0,0,0
2019-07-12 18:45,41,32,9,0,0,0
2019-07-12 19:00,40,30,10,0,0,0
2019-07-12 19:15,51,30,21,0,0,0
2019-07-12 19:30,42,30,12,0,0,0
2019-07-12 19:45,43,26,17,0,0,0
2019-07-12 20:00,52,30,22,0,0,0
2019-07-12 20:15,34,18,16,0,0,0
2019-07-12 20:30,30,16,14,0,0,0
2019-07-12 20:45,25,12,13,0,0,0
2019-07-12 21:00,32,21,11,0,0,0
2019-07-12 21:15,35,19,16,0,0,0
2019-07-12 21:30,26,12,14,0,0,0
2019-07-12 21:45,25,14,11,0,0,0
2019-07-12 22:00,28,13,15,0,0,0
2019-07-12 22:15,16,10,6,0,0,0
2019-07-12 22:30,17,6,11,0,0,0
2019-07-12 22:45,18,3,15,0,0,0
2019-07-12 23:00,20,5,15,0,0,0
2019-07-12 23:15,13,3,10,0,0,0
2019-07-12 23:30,16,5,11,0,0,0
2019-07-12 23:45,26,8,18,0,0,0
2019-07-13 00:00,25,17,8,0,0,0
2019-07-13 00:15,16,7,9,0,0,0
2019-07-13 00:30,21,11,10,0,0,0
2019-07-13 00:45,25,17,8,0,0,0
2019-07-13 01:00,9,2,7,0,0,0
2019-07-13 01:15,15,1,14,0,0,0
2019-07-13 01:30,19,8,11,0,0,0
2019-07-13 01:45,5,0,5,0,0,0
2019-07-13 02:00,5,2,3,0,0,0
2019-07-13 02:15,11,4,7,0,0,0
2019-07-13 02:30,6,6,0,0,0,0
2019-07-13 02:45,6,3,3,0,0,0
2019-07-13 03:00,6,1,5,0,0,0
2019-07-13 03:15,7,2,5,0,0,0
2019-07-13 03:30,6,1,5,0,0,0
2019-07-13 03:45,12,2,10,0,0,0
2019-07-13 04:00,7,2,5,0,0,0
2019-07-13 04:15,3,0,3,0,0,0
2019-07-13 04:30,2,2,0,0,0,0
2019-07-13 04:45,4,1,3,0,0,0
2019-07-13 05:00,5,4,1,0,0,0
2019-07-13 05:15,7,3,4,0,0,0
2019-07-13 05:30,3,2,1,0,0,0
2019-07-13 05:45,4,2,2,0,0,0
2019-07-13 06:00,9,6,3,0,0,0
2019-07-13 06:15,3,3,0,0,0,0
2019-07-13 06:30,8,7,1,0,0,0
2019-07-13 06:45,8,7,1,0,0,0
2019-07-13 07:00,11,11,0,0,0,0
2019-07-13 07:15,19,17,2,0,0,0
2019-07-13 07:30,28,21,7,0,0,0
2019-07-13 07:45,25,21,4,0,0,0
2019-07-13 08:00,21,13,8,0,0,0
2019-07-13 08:15,20,13,7,0,0,0
2019-07-13 08:30,21,14,7,0,0,0
2019-07-13 08:45,50,45,5,0,0,0
2019-07-13 09:00,20,12,8,0,0,0
2019-07-13 09:15,32,20,12,0,0,0
2019-07-13 09:30,33,26,7,0,0,0
2019-07-13 09:45,32,25,7,0,0,0
2019-07-13 10:00,30,17,13,0,0,0
2019-07-13 10:15,31,22,9,0,0,0
2019-07-13 10:30,33,25,8,0,0,0
2019-07-13 10:45,47,36,11,0,0,0
2019-07-13 11:00,43,30,13,0,0,0
2019-07-13 11:15,49,36,13,0,0,0
2019-07-13 11:30,52,39,13,0,0,0
2019-07-13 11:45,48,32,16,0,0,0
2019-07-13 12:00,64,42,22,0,0,0
2019-07-13 12:15,40,23,17,0,0,0
2019-07-13 12:30,51,29,22,0,0,0
2019-07-13 12:45,55,40,15,0,0,0
2019-07-13 13:00,35,14,21,0,0,0
2019-07-13 13:15,45,32,13,0,0,0
2019-07-13 13:30,57,41,16,0,0,0
2019-07-13 13:45,64,47,17,0,0,0
2019-07-13 14:00,58,33,25,0,0,0
2019-07-13 14:15,48,34,14,0,0,0
2019-07-13 14:30,45,30,15,0,0,0
2019-07-13 14:45,81,48,33,0,0,0
2019-07-13 15:00,43,24,19,0,0,0
2019-07-13 15:15,34,22,12,0,0,0
2019-07-13 15:30,46,26,20,0,0,0
2019-07-13 15:45,34,25,9,0,0,0
2019-07-13 16:00,48,31,17,0,0,0
2019-07-13 16:15,63,32,31,0,0,0
2019-07-13 16:30,59,38,21,0,0,0
2019-07-13 16:45,51,24,27,0,0,0
2019-07-13 17:00,31,18,13,0,0,0
2019-07-13 17:15,37,21,16,0,0,0
2019-07-13 17:30,51,27,24,0,0,0
2019-07-13 17:45,64,42,22,0,0,0
2019-07-13 18:00,72,21,51,0,0,0
2019-07-13 18:15,56,34,22,0,0,0
2019-07-13 18:30,56,26,30,0,0,0
2019-07-13 18:45,45,30,15,0,0,0
2019-07-13 19:00,57,37,20,0,0,0
2019-07-13 19:15,38,21,17,0,0,0
2019-07-13 19:30,40,23,17,0,0,0
2019-07-13 19:45,35,23,12,0,0,0
2019-07-13 20:00,52,33,19,0,0,0
2019-07-13 20:15,37,12,25,0,0,0
2019-07-13 20:30,27,18,9,0,0,0
2019-07-13 20:45,24,14,10,0,0,0
2019-07-13 21:00,33,23,10,0,0,0
2019-07-13 21:15,45,29,16,0,0,0
2019-07-13 21:30,30,15,15,0,0,0
2019-07-13 21:45,30,11,19,0,0,0
2019-07-13 22:00,11,3,8,0,0,0
2019-07-13 22:15,16,13,3,0,0,0
2019-07-13 22:30,30,12,18,0,0,0
2019-07-13 22:45,14,8,6,0,0,0
2019-07-13 23:00,25,5,20,0,0,0
2019-07-13 23:15,27,13,14,0,0,0
2019-07-13 23:30,14,6,8,0,0,0
2019-07-13 23:45,23,8,15,0,0,0
2019-07-14 00:00,24,12,12,0,0,0
2019-07-14 00:15,10,7,3,0,0,0
2019-07-14 00:30,9,4,5,0,0,0
2019-07-14 00:45,12,8,4,0,0,0
2019-07-14 01:00,19,10,9,0,0,0
2019-07-14 01:15,14,7,7,0,0,0
2019-07-14 01:30,16,8,8,0,0,0
2019-07-14 01:45,22,14,8,0,0,0
2019-07-14 02:00,5,2,3,0,0,0
2019-07-14 02:15,6,3,3,0,0,0
2019-07-14 02:30,5,2,3,0,0,0
2019-07-14 02:45,3,0,3,0,0,0
2019-07-14 03:00,6,2,4,0,0,0
2019-07-14 03:15,15,9,6,0,0,0
2019-07-14 03:30,8,6,2,0,0,0
2019-07-14 03:45,13,11,2,0,0,0
2019-07-14 04:00,4,2,2,0,0,0
2019-07-14 04:15,5,0,5,0,0,0
2019-07-14 04:30,2,0,2,0,0,0
2019-07-14 04:45,2,1,1,0,0,0
2019-07-14 05:00,0,0,0,0,0,0
2019-07-14 05:15,5,2,3,0,0,0
2019-07-14 05:30,2,1,1,0,0,0
2019-07-14 05:45,3,2,1,0,0,0
2019-07-14 06:00,1,0,1,0,0,0
2019-07-14 06:15,7,5,2,0,0,0
2019-07-14 06:30,6,3,3,0,0,0
2019-07-14 06:45,6,4,2,0,0,0
2019-07-14 07:00,3,2,1,0,0,0
2019-07-14 07:15,2,1,1,0,0,0
2019-07-14 07:30,2,2,0,0,0,0
2019-07-14 07:45,17,15,2,0,0,0
2019-07-14 08:00,5,3,2,0,0,0
2019-07-14 08:15,7,3,4,0,0,0
2019-07-14 08:30,3,1,2,0,0,0
2019-07-14 08:45,8,6,2,0,0,0
2019-07-14 09:00,8,7,1,0,0,0
2019-07-14 09:15,14,11,3,0,0,0
2019-07-14 09:30,24,15,9,0,0,0
2019-07-14 09:45,41,37,4,0,0,0
2019-07-14 10:00,26,21,5,0,0,0
2019-07-14 10:15,30,22,8,0,0,0
2019-07-14 10:30,34,29,5,0,0,0
2019-07-14 10:45,24,19,5,0,0,0
2019-07-14 11:00,22,20,2,0,0,0
2019-07-14 11:15,22,12,10,0,0,0
2019-07-14 11:30,39,21,18,0,0,0
2019-07-14 11:45,28,17,11,0,0,0
2019-07-14 12:00,14,7,7,0,0,0
2019-07-14 12:15,22,13,9,0,0,0
2019-07-14 12:30,23,17,6,0,0,0
2019-07-14 12:45,23,14,9,0,0,0
2019-07-14 13:00,30,15,15,0,0,0
2019-07-14 13:15,22,13,9,0,0,0
2019-07-14 13:30,29,15,14,0,0,0
2019-07-14 13:45,24,8,16,0,0,0
2019-07-14 14:00,27,8,19,0,0,0
2019-07-14 14:15,16,10,6,0,0,0
2019-07-14 14:30,37,26,11,0,0,0
2019-07-14 14:45,54,36,18,0,0,0
2019-07-14 15:00,31,15,16,0,0,0
2019-07-14 15:15,19,12,7,0,0,0
2019-07-14 15:30,42,24,18,0,0,0
2019-07-14 15:45,46,25,21,0,0,0
2019-07-14 16:00,37,30,7,0,0,0
2019-07-14 16:15,22,14,8,0,0,0
2019-07-14 16:30,31,19,12,0,0,0
2019-07-14 16:45,33,18,15,0,0,0
2019-07-14 17:00,32,19,13,0,0,0
2019-07-14 17:15,42,17,25,0,0,0
2019-07-14 17:30,29,17,12,0,0,0
2019-07-14 17:45,51,30,21,0,0,0
2019-07-14 18:00,31,17,14,0,0,0
2019-07-14 18:15,34,25,9,0,0,0
2019-07-14 18:30,31,14,17,0,0,0
2019-07-14 18:45,34,25,9,0,0,0
2019-07-14 19:00,31,17,14,0,0,0
2019-07-14 19:15,29,18,11,0,0,0
2019-07-14 19:30,25,9,16,0,0,0
2019-07-14 19:45,35,21,14,0,0,0
2019-07-14 20:00,26,11,15,0,0,0
2019-07-14 20:15,26,13,13,0,0,0
2019-07-14 20:30,25,12,13,0,0,0
2019-07-14 20:45,8,3,5,0,0,0
2019-07-14 21:00,15,4,11,0,0,0
2019-07-14 21:15,17,9,8,0,0,0
2019-07-14 21:30,12,4,8,0,0,0
2019-07-14 21:45,8,4,4,0,0,0
2019-07-14 22:00,26,6,20,0,0,0
2019-07-14 22:15,8,3,5,0,0,0
2019-07-14 22:30,10,2,8,0,0,0
2019-07-14 22:45,11,4,7,0,0,0
2019-07-14 23:00,10,1,9,0,0,0
2019-07-14 23:15,10,5,5,0,0,0
2019-07-14 23:30,7,4,3,0,0,0
2019-07-14 23:45,7,6,1,0,0,0
2019-07-15 00:00,6,1,5,0,0,0
2019-07-15 00:15,4,1,3,0,0,0
2019-07-15 00:30,1,0,1,0,0,0
2019-07-15 00:45,6,2,4,0,0,0
2019-07-15 01:00,6,1,5,0,0,0
2019-07-15 01:15,1,1,0,0,0,0
2019-07-15 01:30,0,0,0,0,0,0
2019-07-15 01:45,4,0,4,0,0,0
2019-07-15 02:00,3,1,2,0,0,0
2019-07-15 02:15,3,2,1,0,0,0
2019-07-15 02:30,0,0,0,0,0,0
2019-07-15 02:45,0,0,0,0,0,0
2019-07-15 03:00,0,0,0,0,0,0
2019-07-15 03:15,1,0,1,0,0,0
2019-07-15 03:30,4,4,0,0,0,0
2019-07-15 03:45,0,0,0,0,0,0
2019-07-15 04:00,0,0,0,0,0,0
2019-07-15 04:15,0,0,0,0,0,0
2019-07-15 04:30,3,3,0,0,0,0
2019-07-15 04:45,3,2,1,0,0,0
2019-07-15 05:00,0,0,0,0,0,0
2019-07-15 05:15,7,4,3,0,0,0
2019-07-15 05:30,13,7,6,0,0,0
2019-07-15 05:45,12,9,3,0,0,0
2019-07-15 06:00,11,7,4,0,0,0
2019-07-15 06:15,19,12,7,0,0,0
2019-07-15 06:30,40,16,24,0,0,0
2019-07-15 06:45,52,26,26,0,0,0
2019-07-15 07:00,50,24,26,0,0,0
2019-07-15 07:15,62,32,30,0,0,0
2019-07-15 07:30,78,42,36,0,0,0
2019-07-15 07:45,108,71,37,0,0,0
2019-07-15 08:00,63,28,35,0,0,0
2019-07-15 08:15,79,45,34,0,0,0
2019-07-15 08:30,70,44,26,0,0,0
2019-07-15 08:45,81,52,29,0,0,0
2019-07-15 09:00,49,31,18,0,0,0
2019-07-15 09:15,43,29,14,0,0,0
2019-07-15 09:30,57,44,13,0,0,0
2019-07-15 09:45,60,47,13,0,0,0
2019-07-15 10:00,37,27,10,0,0,0
2019-07-15 10:15,35,23,12,0,0,0
2019-07-15 10:30,32,27,5,0,0,0
2019-07-15 10:45,46,39,7,0,0,0
2019-07-15 11:00,49,34,15,0,0,0
2019-07-15 11:15,46,32,14,0,0,0
2019-07-15 11:30,37,27,10,0,0,0
2019-07-15 11:45,45,28,17,0,0,0
2019-07-15 12:00,55,27,28,0,0,0
2019-07-15 12:15,49,34,15,0,0,0
2019-07-15 12:30,40,17,23,0,0,0
2019-07-15 12:45,47,27,20,0,0,0
2019-07-15 13:00,43,30,13,0,0,0
2019-07-15 13:15,43,26,17,0,0,0
2019-07-15 13:30,50,30,20,0,0,0
2019-07-15 13:45,48,31,17,0,0,0
2019-07-15 14:00,67,33,34,0,0,0
2019-07-15 14:15,40,21,19,0,0,0
2019-07-15 14:30,63,43,20,0,0,0
2019-07-15 14:45,65,39,26,0,0,0
2019-07-15 15:00,57,35,22,0,0,0
2019-07-15 15:15,55,33,22,0,0,0
2019-07-15 15:30,57,36,21,0,0,0
2019-07-15 15:45,86,55,31,0,0,0
2019-07-15 16:00,81,46,35,0,0,0
2019-07-15 16:15,93,65,28,0,0,0
2019-07-15 16:30,76,46,30,0,0,0
2019-07-15 16:45,71,43,28,0,0,0
2019-07-15 17:00,103,75,28,0,0,0
2019-07-15 17:15,86,50,36,0,0,0
2019-07-15 17:30,99,51,48,0,0,0
2019-07-15 17:45,91,54,37,0,0,0
2019-07-15 18:00,67,29,38,0,0,0
2019-07-15 18:15,64,40,24,0,0,0
2019-07-15 18:30,58,36,22,0,0,0
2019-07-15 18:45,82,50,32,0,0,0
2019-07-15 19:00,53,23,30,0,0,0
2019-07-15 19:15,55,29,26,0,0,0
2019-07-15 19:30,36,19,17,0,0,0
2019-07-15 19:45,57,29,28,0,0,0
2019-07-15 20:00,43,22,21,0,0,0
2019-07-15 20:15,48,22,26,0,0,0
2019-07-15 20:30,39,29,10,0,0,0
2019-07-15 20:45,33,18,15,0,0,0
2019-07-15 21:00,26,15,11,0,0,0
2019-07-15 21:15,38,23,15,0,0,0
2019-07-15 21:30,22,8,14,0,0,0
2019-07-15 21:45,28,14,14,0,0,0
2019-07-15 22:00,26,15,11,0,0,0
2019-07-15 22:15,18,8,10,0,0,0
2019-07-15 22:30,16,9,7,0,0,0
2019-07-15 22:45,18,8,10,0,0,0
2019-07-15 23:00,19,11,8,0,0,0
2019-07-15 23:15,16,5,11,0,0,0
2019-07-15 23:30,11,5,6,0,0,0
2019-07-15 23:45,6,2,4,0,0,0
2019-07-16 00:00,12,3,9,0,0,0
2019-07-16 00:15,5,2,3,0,0,0
2019-07-16 00:30,4,2,2,0,0,0
2019-07-16 00:45,11,3,8,0,0,0
2019-07-16 01:00,7,1,6,0,0,0
2019-07-16 01:15,5,3,2,0,0,0
2019-07-16 01:30,0,0,0,0,0,0
2019-07-16 01:45,2,0,2,0,0,0
2019-07-16 02:00,3,1,2,0,0,0
2019-07-16 02:15,0,0,0,0,0,0
2019-07-16 02:30,1,1,0,0,0,0
2019-07-16 02:45,0,0,0,0,0,0
2019-07-16 03:00,2,1,1,0,0,0
2019-07-16 03:15,1,0,1,0,0,0
2019-07-16 03:30,0,0,0,0,0,0
2019-07-16 03:45,0,0,0,0,0,0
2019-07-16 04:00,1,0,1,0,0,0
2019-07-16 04:15,1,1,0,0,0,0
2019-07-16 04:30,3,2,1,0,0,0
2019-07-16 04:45,1,1,0,0,0,0
2019-07-16 05:00,1,0,1,0,0,0
2019-07-16 05:15,7,4,3,0,0,0
2019-07-16 05:30,9,7,2,0,0,0
2019-07-16 05:45,12,7,5,0,0,0
2019-07-16 06:00,10,7,3,0,0,0
2019-07-16 06:15,6,4,2,0,0,0
2019-07-16 06:30,37,19,18,0,0,0
2019-07-16 06:45,54,27,27,0,0,0
2019-07-16 07:00,45,22,23,0,0,0
2019-07-16 07:15,56,25,31,0,0,0
2019-07-16 07:30,92,57,35,0,0,0
2019-07-16 07:45,98,59,39,0,0,0
2019-07-16 08:00,69,45,24,0,0,0
2019-07-16 08:15,88,50,38,0,0,0
2019-07-16 08:30,73,41,32,0,0,0
2019-07-16 08:45,85,53,32,0,0,0
2019-07-16 09:00,48,25,23,0,0,0
2019-07-16 09:15,52,33,19,0,0,0
2019-07-16 09:30,39,33,6,0,0,0
2019-07-16 09:45,43,30,13,0,0,0
2019-07-16 10:00,38,23,15,0,0,0
2019-07-16 10:15,43,33,10,0,0,0
2019-07-16 10:30,31,17,14,0,0,0
2019-07-16 10:45,44,37,7,0,0,0
2019-07-16 11:00,44,31,13,0,0,0
2019-07-16 11:15,41,26,15,0,0,0
2019-07-16 11:30,36,21,15,0,0,0
2019-07-16 11:45,51,32,19,0,0,0
2019-07-16 12:00,39,19,20,0,0,0
2019-07-16 12:15,46,24,22,0,0,0
2019-07-16 12:30,46,25,21,0,0,0
2019-07-16 12:45,44,28,16,0,0,0
2019-07-16 13:00,47,26,21,0,0,0
2019-07-16 13:15,39,17,22,0,0,0
2019-07-16 13:30,37,20,17,0,0,0
2019-07-16 13:45,39,27,12,0,0,0
2019-07-16 14:00,50,34,16,0,0,0
2019-07-16 14:15,49,30,19,0,0,0
2019-07-16 14:30,53,30,23,0,0,0
2019-07-16 14:45,63,34,29,0,0,0
2019-07-16 15:00,70,38,32,0,0,0
2019-07-16 15:15,53,29,24,0,0,0
2019-07-16 15:30,74,52,22,0,0,0
2019-07-16 15:45,86,54,32,0,0,0
2019-07-16 16:00,73,49,24,0,0,0
2019-07-16 16:15,74,45,29,0,0,0
2019-07-16 16:30,72,43,29,0,0,0
2019-07-16 16:45,73,43,30,0,0,0
2019-07-16 17:00,92,66,26,0,0,0
2019-07-16 17:15,75,43,32,0,0,0
2019-07-16 17:30,91,58,33,0,0,0
2019-07-16 17:45,89,48,41,0,0,0
2019-07-16 18:00,85,53,32,0,0,0
2019-07-16 18:15,71,56,15,0,0,0
2019-07-16 18:30,84,44,40,0,0,0
2019-07-16 18:45,66,31,35,0,0,0
2019-07-16 19:00,54,27,27,0,0,0
2019-07-16 19:15,53,35,18,0,0,0
2019-07-16 19:30,41,21,20,0,0,0
2019-07-16 19:45,44,21,23,0,0,0
2019-07-16 20:00,43,21,22,0,0,0
2019-07-16 20:15,39,24,15,0,0,0
2019-07-16 20:30,51,29,22,0,0,0
2019-07-16 20:45,27,15,12,0,0,0
2019-07-16 21:00,22,11,11,0,0,0
2019-07-16 21:15,38,17,21,0,0,0
2019-07-16 21:30,25,12,13,0,0,0
2019-07-16 21:45,23,10,13,0,0,0
2019-07-16 22:00,21,7,14,0,0,0
2019-07-16 22:15,18,5,13,0,0,0
2019-07-16 22:30,20,8,12,0,0,0
2019-07-16 22:45,7,2,5,0,0,0
2019-07-16 23:00,13,4,9,0,0,0
2019-07-16 23:15,9,2,7,0,0,0
2019-07-16 23:30,9,7,2,0,0,0
2019-07-16 23:45,12,7,5,0,0,0
2019-07-17 00:00,1,1,0,0,0,0
2019-07-17 00:15,8,3,5,0,0,0
2019-07-17 00:30,7,2,5,0,0,0
2019-07-17 00:45,6,0,6,0,0,0
2019-07-17 01:00,2,1,1,0,0,0
2019-07-17 01:15,8,4,4,0,0,0
2019-07-17 01:30,2,1,1,0,0,0
2019-07-17 01:45,3,0,3,0,0,0
2019-07-17 02:00,2,0,2,0,0,0
2019-07-17 02:15,2,1,1,0,0,0
2019-07-17 02:30,3,1,2,0,0,0
2019-07-17 02:45,2,0,2,0,0,0
2019-07-17 03:00,0,0,0,0,0,0
2019-07-17 03:15,3,3,0,0,0,0
2019-07-17 03:30,1,0,1,0,0,0
2019-07-17 03:45,1,1,0,0,0,0
2019-07-17 04:00,4,0,4,0,0,0
2019-07-17 04:15,3,3,0,0,0,0
2019-07-17 04:30,2,1,1,0,0,0
2019-07-17 04:45,4,4,0,0,0,0
2019-07-17 05:00,3,2,1,0,0,0
2019-07-17 05:15,7,4,3,0,0,0
2019-07-17 05:30,6,3,3,0,0,0
2019-07-17 05:45,8,4,4,0,0,0
2019-07-17 06:00,10,7,3,0,0,0
2019-07-17 06:15,14,10,4,0,0,0
2019-07-17 06:30,39,20,19,0,0,0
2019-07-17 06:45,55,25,30,0,0,0
2019-07-17 07:00,50,23,27,0,0,0
2019-07-17 07:15,54,28,26,0,0,0
2019-07-17 07:30,60,30,30,0,0,0
2019-07-17 07:45,101,66,35,0,0,0
2019-07-17 08:00,77,51,26,0,0,0
2019-07-17 08:15,87,50,37,0,0,0
2019-07-17 08:30,77,50,27,0,0,0
2019-07-17 08:45,95,61,34,0,0,0
2019-07-17 09:00,53,32,21,0,0,0
2019-07-17 09:15,54,36,18,0,0,0
2019-07-17 09:30,48,41,7,0,0,0
2019-07-17 09:45,50,39,11,0,0,0
2019-07-17 10:00,45,32,13,0,0,0
2019-07-17 10:15,44,34,10,0,0,0
2019-07-17 10:30,52,31,21,0,0,0
2019-07-17 10:45,59,43,16,0,0,0
2019-07-17 11:00,35,25,10,0,0,0
2019-07-17 11:15,53,36,17,0,0,0
2019-07-17 11:30,41,31,10,0,0,0
2019-07-17 11:45,53,37,16,0,0,0
2019-07-17 12:00,45,29,16,0,0,0
2019-07-17 12:15,55,33,22,0,0,0
2019-07-17 12:30,56,36,20,0,0,0
2019-07-17 12:45,41,24,17,0,0,0
2019-07-17 13:00,46,25,21,0,0,0
2019-07-17 13:15,50,28,22,0,0,0
2019-07-17 13:30,44,29,15,0,0,0
2019-07-17 13:45,31,22,9,0,0,0
2019-07-17 14:00,44,24,20,0,0,0
2019-07-17 14:15,55,29,26,0,0,0
2019-07-17 14:30,50,28,22,0,0,0
2019-07-17 14:45,71,41,30,0,0,0
2019-07-17 15:00,49,30,19,0,0,0
2019-07-17 15:15,63,47,16,0,0,0
2019-07-17 15:30,84,54,30,0,0,0
2019-07-17 15:45,78,49,29,0,0,0
2019-07-17 16:00,97,57,40,0,0,0
2019-07-17 16:15,76,39,37,0,0,0
2019-07-17 16:30,99,69,30,0,0,0
2019-07-17 16:45,69,43,26,0,0,0
2019-07-17 17:00,73,46,27,0,0,0
2019-07-17 17:15,69,40,29,0,0,0
2019-07-17 17:30,96,57,39,0,0,0
2019-07-17 17:45,82,58,24,0,0,0
2019-07-17 18:00,87,54,33,0,0,0
2019-07-17 18:15,73,47,26,0,0,0
2019-07-17 18:30,86,60,26,0,0,0
2019-07-17 18:45,51,30,21,0,0,0
2019-07-17 19:00,57,34,23,0,0,0
2019-07-17 19:15,62,36,26,0,0,0
2019-07-17 19:30,56,30,26,0,0,0
2019-07-17 19:45,58,35,23,0,0,0
2019-07-17 20:00,65,37,28,0,0,0
2019-07-17 20:15,32,19,13,0,0,0
2019-07-17 20:30,36,17,19,0,0,0
2019-07-17 20:45,34,19,15,0,0,0
2019-07-17 21:00,41,27,14,0,0,0
2019-07-17 21:15,44,30,14,0,0,0
2019-07-17 21:30,37,20,17,0,0,0
2019-07-17 21:45,26,14,12,0,0,0
2019-07-17 22:00,40,15,25,0,0,0
2019-07-17 22:15,21,9,12,0,0,0
2019-07-17 22:30,27,14,13,0,0,0
2019-07-17 22:45,30,14,16,0,0,0
2019-07-17 23:00,24,16,8,0,0,0
2019-07-17 23:15,13,4,9,0,0,0
2019-07-17 23:30,15,5,10,0,0,0
2019-07-17 23:45,13,2,11,0,0,0
2019-07-18 00:00,10,8,2,0,0,0
2019-07-18 00:15,8,3,5,0,0,0
2019-07-18 00:30,12,7,5,0,0,0
2019-07-18 00:45,5,2,3,0,0,0
2019-07-18 01:00,8,3,5,0,0,0
2019-07-18 01:15,11,1,10,0,0,0
2019-07-18 01:30,5,3,2,0,0,0
2019-07-18 01:45,2,0,2,0,0,0
2019-07-18 02:00,4,0,4,0,0,0
2019-07-18 02:15,3,1,2,0,0,0
2019-07-18 02:30,1,0,1,0,0,0
2019-07-18 02:45,3,1,2,0,0,0
2019-07-18 03:00,5,0,5,0,0,0
2019-07-18 03:15,5,1,4,0,0,0
2019-07-18 03:30,3,0,3,0,0,0
2019-07-18 03:45,1,0,1,0,0,0
2019-07-18 04:00,2,0,2,0,0,0
2019-07-18 04:15,5,4,1,0,0,0
2019-07-18 04:30,5,3,2,0,0,0
2019-07-18 04:45,4,1,3,0,0,0
2019-07-18 05:00,3,1,2,0,0,0
2019-07-18 05:15,6,4,2,0,0,0
2019-07-18 05:30,13,6,7,0,0,0
2019-07-18 05:45,12,5,7,0,0,0
2019-07-18 06:00,13,7,6,0,0,0
2019-07-18 06:15,7,3,4,0,0,0
2019-07-18 06:30,32,14,18,0,0,0
2019-07-18 06:45,46,20,26,0,0,0
2019-07-18 07:00,51,25,26,0,0,0
2019-07-18 07:15,54,28,26,0,0,0
2019-07-18 07:30,75,39,36,0,0,0
2019-07-18 07:45,80,48,32,0,0,0
2019-07-18 08:00,76,46,30,0,0,0
2019-07-18 08:15,77,45,32,0,0,0
2019-07-18 08:30,82,47,35,0,0,0
2019-07-18 08:45,87,58,29,0,0,0
2019-07-18 09:00,55,30,25,0,0,0
2019-07-18 09:15,48,36,12,0,0,0
2019-07-18 09:30,43,29,14,0,0,0
2019-07-18 09:45,52,42,10,0,0,0
2019-07-18 10:00,39,29,10,0,0,0
2019-07-18 10:15,34,20,14,0,0,0
2019-07-18 10:30,36,29,7,0,0,0
2019-07-18 10:45,34,20,14,0,0,0
2019-07-18 11:00,39,26,13,0,0,0
2019-07-18 11:15,53,39,14,0,0,0
2019-07-18 11:30,42,32,10,0,0,0
2019-07-18 11:45,57,40,17,0,0,0
2019-07-18 12:00,42,25,17,0,0,0
2019-07-18 12:15,48,28,20,0,0,0
2019-07-18 12:30,53,31,22,0,0,0
2019-07-18 12:45,38,25,13,0,0,0
2019-07-18 13:00,39,20,19,0,0,0
2019-07-18 13:15,43,34,9,0,0,0
2019-07-18 13:30,45,22,23,0,0,0
2019-07-18 13:45,45,31,14,0,0,0
2019-07-18 14:00,49,34,15,0,0,0
2019-07-18 14:15,59,41,18,0,0,0
2019-07-18 14:30,52,29,23,0,0,0
2019-07-18 14:45,86,61,25,0,0,0
2019-07-18 15:00,74,37,37,0,0,0
2019-07-18 15:15,62,39,23,0,0,0
2019-07-18 15:30,123,76,47,0,0,0
2019-07-18 15:45,76,51,25,0,0,0
2019-07-18 16:00,73,49,24,0,0,0
2019-07-18 16:15,86,55,31,0,0,0
2019-07-18 16:30,81,53,28,0,0,0
2019-07-18 16:45,84,53,31,0,0,0
2019-07-18 17:00,91,62,29,0,0,0
2019-07-18 17:15,109,66,43,0,0,0
2019-07-18 17:30,68,36,32,0,0,0
2019-07-18 17:45,83,57,26,0,0,0
2019-07-18 18:00,93,56,37,0,0,0
2019-07-18 18:15,91,44,47,0,0,0
2019-07-18 18:30,58,34,24,0,0,0
2019-07-18 18:45,62,23,39,0,0,0
2019-07-18 19:00,72,43,29,0,0,0
2019-07-18 19:15,37,16,21,0,0,0
2019-07-18 19:30,64,33,31,0,0,0
2019-07-18 19:45,62,31,31,0,0,0
2019-07-18 20:00,40,21,19,0,0,0
2019-07-18 20:15,57,28,29,0,0,0
2019-07-18 20:30,34,19,15,0,0,0
2019-07-18 20:45,57,42,15,0,0,0
2019-07-18 21:00,40,15,25,0,0,0
2019-07-18 21:15,38,12,26,0,0,0
2019-07-18 21:30,29,11,18,0,0,0
2019-07-18 21:45,31,17,14,0,0,0
2019-07-18 22:00,34,15,19,0,0,0
2019-07-18 22:15,29,11,18,0,0,0
2019-07-18 22:30,14,6,8,0,0,0
2019-07-18 22:45,19,4,15,0,0,0
2019-07-18 23:00,15,5,10,0,0,0
2019-07-18 23:15,21,6,15,0,0,0
2019-07-18 23:30,17,6,11,0,0,0
2019-07-18 23:45,12,6,6,0,0,0
2019-07-19 00:00,9,1,8,0,0,0
2019-07-19 00:15,16,6,10,0,0,0
2019-07-19 00:30,4,0,4,0,0,0
2019-07-19 00:45,8,5,3,0,0,0
2019-07-19 01:00,3,2,1,0,0,0
2019-07-19 01:15,1,0,1,0,0,0
2019-07-19 01:30,6,3,3,0,0,0
2019-07-19 01:45,9,6,3,0,0,0
2019-07-19 02:00,3,2,1,0,0,0
2019-07-19 02:15,3,1,2,0,0,0
2019-07-19 02:30,3,1,2,0,0,0
2019-07-19 02:45,2,0,2,0,0,0
2019-07-19 03:00,8,2,6,0,0,0
2019-07-19 03:15,3,0,3,0,0,0
2019-07-19 03:30,4,1,3,0,0,0
2019-07-19 03:45,0,0,0,0,0,0
2019-07-19 04:00,2,2,0,0,0,0
2019-07-19 04:15,2,2,0,0,0,0
2019-07-19 04:30,6,2,4,0,0,0
2019-07-19 04:45,1,1,0,0,0,0
2019-07-19 05:00,2,2,0,0,0,0
2019-07-19 05:15,6,4,2,0,0,0
2019-07-19 05:30,7,4,3,0,0,0
2019-07-19 05:45,12,10,2,0,0,0
2019-07-19 06:00,10,7,3,0,0,0
2019-07-19 06:15,14,10,4,0,0,0
2019-07-19 06:30,29,15,14,0,0,0
2019-07-19 06:45,66,25,41,0,0,0
2019-07-19 07:00,38,17,21,0,0,0
2019-07-19 07:15,42,25,17,0,0,0
2019-07-19 07:30,72,36,36,0,0,0
2019-07-19 07:45,81,42,39,0,0,0
2019-07-19 08:00,76,37,39,0,0,0
2019-07-19 08:15,59,38,21,0,0,0
2019-07-19 08:30,75,47,28,0,0,0
2019-07-19 08:45,69,46,23,0,0,0
2019-07-19 09:00,47,28,19,0,0,0
2019-07-19 09:15,49,31,18,0,0,0
2019-07-19 09:30,39,32,7,0,0,0
2019-07-19 09:45,46,38,8,0,0,0
2019-07-19 10:00,41,29,12,0,0,0
2019-07-19 10:15,30,17,13,0,0,0
2019-07-19 10:30,29,24,5,0,0,0
2019-07-19 10:45,40,31,9,0,0,0
2019-07-19 11:00,54,41,13,0,0,0
2019-07-19 11:15,32,21,11,0,0,0
2019-07-19 11:30,42,30,12,0,0,0
2019-07-19 11:45,54,39,15,0,0,0
2019-07-19 12:00,53,34,19,0,0,0
2019-07-19 12:15,45,26,19,0,0,0
2019-07-19 12:30,54,30,24,0,0,0
2019-07-19 12:45,61,36,25,0,0,0
2019-07-19 13:00,47,36,11,0,0,0
2019-07-19 13:15,59,42,17,0,0,0
2019-07-19 13:30,58,40,18,0,0,0
2019-07-19 13:45,48,24,24,0,0,0
2019-07-19 14:00,75,47,28,0,0,0
2019-07-19 14:15,66,53,13,0,0,0
2019-07-19 14:30,69,48,21,0,0,0
2019-07-19 14:45,74,47,27,0,0,0
2019-07-19 15:00,82,61,21,0,0,0
2019-07-19 15:15,46,33,13,0,0,0
2019-07-19 15:30,108,56,52,0,0,0
2019-07-19 15:45,68,49,19,0,0,0
2019-07-19 16:00,71,55,16,0,0,0
2019-07-19 16:15,73,40,33,0,0,0
2019-07-19 16:30,76,45,31,0,0,0
2019-07-19 16:45,69,51,18,0,0,0
2019-07-19 17:00,66,38,28,0,0,0
2019-07-19 17:15,50,31,19,0,0,0
2019-07-19 17:30,75,43,32,0,0,0
2019-07-19 17:45,72,42,30,0,0,0
2019-07-19 18:00,72,42,30,0,0,0
2019-07-19 18:15,82,41,41,0,0,0
2019-07-19 18:30,57,35,22,0,0,0
2019-07-19 18:45,67,53,14,0,0,0
2019-07-19 19:00,60,42,18,0,0,0
2019-07-19 19:15,54,30,24,0,0,0
2019-07-19 19:30,58,33,25,0,0,0
2019-07-19 19:45,59,32,27,0,0,0
2019-07-19 20:00,58,33,25,0,0,0
2019-07-19 20:15,53,29,24,0,0,0
2019-07-19 20:30,38,30,8,0,0,0
2019-07-19 20:45,35,16,19,0,0,0
2019-07-19 21:00,23,15,8,0,0,0
2019-07-19 21:15,25,13,12,0,0,0
2019-07-19 21:30,27,12,15,0,0,0
2019-07-19 21:45,36,20,16,0,0,0
2019-07-19 22:00,36,20,16,0,0,0
2019-07-19 22:15,24,8,16,0,0,0
2019-07-19 22:30,40,15,25,0,0,0
2019-07-19 22:45,34,18,16,0,0,0
2019-07-19 23:00,36,13,23,0,0,0
2019-07-19 23:15,23,7,16,0,0,0
2019-07-19 23:30,20,9,11,0,0,0
2019-07-19 23:45,17,4,13,0,0,0
2019-07-20 00:00,15,4,11,0,0,0
2019-07-20 00:15,25,10,15,0,0,0
2019-07-20 00:30,23,10,13,0,0,0
2019-07-20 00:45,14,4,10,0,0,0
2019-07-20 01:00,13,5,8,0,0,0
2019-07-20 01:15,15,3,12,0,0,0
2019-07-20 01:30,9,3,6,0,0,0
2019-07-20 01:45,17,5,12,0,0,0
2019-07-20 02:00,3,3,0,0,0,0
2019-07-20 02:15,4,0,4,0,0,0
2019-07-20 02:30,6,0,6,0,0,0
2019-07-20 02:45,4,1,3,0,0,0
2019-07-20 03:00,5,1,4,0,0,0
2019-07-20 03:15,6,0,6,0,0,0
2019-07-20 03:30,3,2,1,0,0,0
2019-07-20 03:45,6,2,4,0,0,0
2019-07-20 04:00,3,0,3,0,0,0
2019-07-20 04:15,4,1,3,0,0,0
2019-07-20 04:30,1,0,1,0,0,0
2019-07-20 04:45,2,2,0,0,0,0
2019-07-20 05:00,0,0,0,0,0,0
2019-07-20 05:15,8,1,7,0,0,0
2019-07-20 05:30,3,0,3,0,0,0
2019-07-20 05:45,7,4,3,0,0,0
2019-07-20 06:00,2,2,0,0,0,0
2019-07-20 06:15,6,3,3,0,0,0
2019-07-20 06:30,8,4,4,0,0,0
2019-07-20 06:45,4,4,0,0,0,0
2019-07-20 07:00,5,4,1,0,0,0
2019-07-20 07:15,5,1,4,0,0,0
2019-07-20 07:30,21,12,9,0,0,0
2019-07-20 07:45,12,6,6,0,0,0
2019-07-20 08:00,11,8,3,0,0,0
2019-07-20 08:15,14,8,6,0,0,0
2019-07-20 08:30,25,17,8,0,0,0
2019-07-20 08:45,18,9,9,0,0,0
2019-07-20 09:00,28,19,9,0,0,0
2019-07-20 09:15,27,20,7,0,0,0
2019-07-20 09:30,28,23,5,0,0,0
2019-07-20 09:45,45,36,9,0,0,0
2019-07-20 10:00,54,42,12,0,0,0
2019-07-20 10:15,46,39,7,0,0,0
2019-07-20 10:30,50,30,20,0,0,0
2019-07-20 10:45,45,35,10,0,0,0
2019-07-20 11:00,53,38,15,0,0,0
2019-07-20 11:15,37,22,15,0,0,0
2019-07-20 11:30,38,22,16,0,0,0
2019-07-20 11:45,55,43,12,0,0,0
2019-07-20 12:00,51,34,17,0,0,0
2019-07-20 12:15,54,37,17,0,0,0
2019-07-20 12:30,41,25,16,0,0,0
2019-07-20 12:45,43,33,10,0,0,0
2019-07-20 13:00,37,27,10,0,0,0
2019-07-20 13:15,33,20,13,0,0,0
2019-07-20 13:30,45,29,16,0,0,0
2019-07-20 13:45,38,20,18,0,0,0
2019-07-20 14:00,9,4,5,0,0,0
2019-07-20 14:15,31,16,15,0,0,0
2019-07-20 14:30,29,17,12,0,0,0
2019-07-20 14:45,36,29,7,0,0,0
2019-07-20 15:00,41,21,20,0,0,0
2019-07-20 15:15,22,16,6,0,0,0
2019-07-20 15:30,31,25,6,0,0,0
2019-07-20 15:45,34,17,17,0,0,0
2019-07-20 16:00,23,19,4,0,0,0
2019-07-20 16:15,24,15,9,0,0,0
2019-07-20 16:30,34,20,14,0,0,0
2019-07-20 16:45,23,11,12,0,0,0
2019-07-20 17:00,18,9,9,0,0,0
2019-07-20 17:15,25,16,9,0,0,0
2019-07-20 17:30,38,22,16,0,0,0
2019-07-20 17:45,30,18,12,0,0,0
2019-07-20 18:00,13,8,5,0,0,0
2019-07-20 18:15,24,10,14,0,0,0
2019-07-20 18:30,37,23,14,0,0,0
2019-07-20 18:45,24,17,7,0,0,0
2019-07-20 19:00,25,18,7,0,0,0
2019-07-20 19:15,37,26,11,0,0,0
2019-07-20 19:30,29,15,14,0,0,0
2019-07-20 19:45,45,32,13,0,0,0
2019-07-20 20:00,19,16,3,0,0,0
2019-07-20 20:15,23,18,5,0,0,0
2019-07-20 20:30,19,14,5,0,0,0
2019-07-20 20:45,21,15,6,0,0,0
2019-07-20 21:00,33,17,16,0,0,0
2019-07-20 21:15,19,9,10,0,0,0
2019-07-20 21:30,15,9,6,0,0,0
2019-07-20 21:45,26,13,13,0,0,0
2019-07-20 22:00,20,9,11,0,0,0
2019-07-20 22:15,18,10,8,0,0,0
2019-07-20 22:30,28,18,10,0,0,0
2019-07-20 22:45,16,6,10,0,0,0
2019-07-20 23:00,5,4,1,0,0,0
2019-07-20 23:15,17,7,10,0,0,0
2019-07-20 23:30,11,5,6,0,0,0
2019-07-20 23:45,9,3,6,0,0,0
2019-07-21 00:00,16,8,8,0,0,0
2019-07-21 00:15,13,8,5,0,0,0
2019-07-21 00:30,10,7,3,0,0,0
2019-07-21 00:45,18,11,7,0,0,0
2019-07-21 01:00,8,5,3,0,0,0
2019-07-21 01:15,10,0,10,0,0,0
2019-07-21 01:30,10,5,5,0,0,0
2019-07-21 01:45,12,0,12,0,0,0
2019-07-21 02:00,4,3,1,0,0,0
2019-07-21 02:15,6,5,1,0,0,0
2019-07-21 02:30,10,5,5,0,0,0
2019-07-21 02:45,5,4,1,0,0,0
2019-07-21 03:00,2,0,2,0,0,0
2019-07-21 03:15,1,0,1,0,0,0
2019-07-21 03:30,4,0,4,0,0,0
2019-07-21 03:45,4,2,2,0,0,0
2019-07-21 04:00,6,2,4,0,0,0
2019-07-21 04:15,2,0,2,0,0,0
2019-07-21 04:30,4,0,4,0,0,0
2019-07-21 04:45,3,1,2,0,0,0
2019-07-21 05:00,1,1,0,0,0,0
2019-07-21 05:15,1,0,1,0,0,0
2019-07-21 05:30,6,3,3,0,0,0
2019-07-21 05:45,3,3,0,0,0,0
2019-07-21 06:00,4,3,1,0,0,0
2019-07-21 06:15,4,3,1,0,0,0
2019-07-21 06:30,3,2,1,0,0,0
2019-07-21 06:45,2,1,1,0,0,0
2019-07-21 07:00,3,1,2,0,0,0
2019-07-21 07:15,3,1,2,0,0,0
2019-07-21 07:30,6,4,2,0,0,0
2019-07-21 07:45,11,7,4,0,0,0
2019-07-21 08:00,10,8,2,0,0,0
2019-07-21 08:15,4,3,1,0,0,0
2019-07-21 08:30,10,4,6,0,0,0
2019-07-21 08:45,9,4,5,0,0,0
2019-07-21 09:00,5,3,2,0,0,0
2019-07-21 09:15,11,10,1,0,0,0
2019-07-21 09:30,18,10,8,0,0,0
2019-07-21 09:45,27,23,4,0,0,0
2019-07-21 10:00,20,15,5,0,0,0
2019-07-21 10:15,28,18,10,0,0,0
2019-07-21 10:30,33,27,6,0,0,0
2019-07-21 10:45,29,21,8,0,0,0
2019-07-21 11:00,33,27,6,0,0,0
2019-07-21 11:15,34,27,7,0,0,0
2019-07-21 11:30,31,20,11,0,0,0
2019-07-21 11:45,28,20,8,0,0,0
2019-07-21 12:00,38,19,19,0,0,0
2019-07-21 12:15,39,21,18,0,0,0
2019-07-21 12:30,20,14,6,0,0,0
2019-07-21 12:45,46,25,21,0,0,0
2019-07-21 13:00,40,23,17,0,0,0
2019-07-21 13:15,18,13,5,0,0,0
2019-07-21 13:30,48,22,26,0,0,0
2019-07-21 13:45,48,38,10,0,0,0
2019-07-21 14:00,43,23,20,0,0,0
2019-07-21 14:15,53,27,26,0,0,0
2019-07-21 14:30,46,24,22,0,0,0
2019-07-21 14:45,39,25,14,0,0,0
2019-07-21 15:00,51,36,15,0,0,0
2019-07-21 15:15,53,36,17,0,0,0
2019-07-21 15:30,42,19,23,0,0,0
2019-07-21 15:45,37,21,16,0,0,0
2019-07-21 16:00,50,28,22,0,0,0
2019-07-21 16:15,56,27,29,0,0,0
2019-07-21 16:30,41,29,12,0,0,0
2019-07-21 16:45,42,31,11,0,0,0
2019-07-21 17:00,46,22,24,0,0,0
2019-07-21 17:15,48,28,20,0,0,0
2019-07-21 17:30,45,26,19,0,0,0
2019-07-21 17:45,43,23,20,0,0,0
2019-07-21 18:00,38,19,19,0,0,0
2019-07-21 18:15,55,28,27,0,0,0
2019-07-21 18:30,53,28,25,0,0,0
2019-07-21 18:45,60,39,21,0,0,0
2019-07-21 19:00,46,24,22,0,0,0
2019-07-21 19:15,47,21,26,0,0,0
2019-07-21 19:30,36,17,19,0,0,0
2019-07-21 19:45,48,29,19,0,0,0
2019-07-21 20:00,39,27,12,0,0,0
2019-07-21 20:15,20,15,5,0,0,0
2019-07-21 20:30,39,25,14,0,0,0
2019-07-21 20:45,23,17,6,0,0,0
2019-07-21 21:00,25,10,15,0,0,0
2019-07-21 21:15,38,21,17,0,0,0
2019-07-21 21:30,21,11,10,0,0,0
2019-07-21 21:45,37,18,19,0,0,0
2019-07-21 22:00,29,15,14,0,0,0
2019-07-21 22:15,18,8,10,0,0,0
2019-07-21 22:30,11,2,9,0,0,0
2019-07-21 22:45,32,6,26,0,0,0
2019-07-21 23:00,25,4,21,0,0,0
2019-07-21 23:15,24,6,18,0,0,0
2019-07-21 23:30,10,1,9,0,0,0
2019-07-21 23:45,13,6,7,0,0,0
2019-07-22 00:00,8,1,7,0,0,0
2019-07-22 00:15,9,4,5,0,0,0
2019-07-22 00:30,3,0,3,0,0,0
2019-07-22 00:45,5,3,2,0,0,0
2019-07-22 01:00,4,0,4,0,0,0
2019-07-22 01:15,3,1,2,0,0,0
2019-07-22 01:30,1,1,0,0,0,0
2019-07-22 01:45,0,0,0,0,0,0
2019-07-22 02:00,0,0,0,0,0,0
2019-07-22 02:15,3,2,1,0,0,0
2019-07-22 02:30,2,0,2,0,0,0
2019-07-22 02:45,1,0,1,0,0,0
2019-07-22 03:00,3,2,1,0,0,0
2019-07-22 03:15,2,0,2,0,0,0
2019-07-22 03:30,0,0,0,0,0,0
2019-07-22 03:45,0,0,0,0,0,0
2019-07-22 04:00,0,0,0,0,0,0
2019-07-22 04:15,1,1,0,0,0,0
2019-07-22 04:30,3,2,1,0,0,0
2019-07-22 04:45,1,1,0,0,0,0
2019-07-22 05:00,2,1,1,0,0,0
2019-07-22 05:15,4,2,2,0,0,0
2019-07-22 05:30,14,9,5,0,0,0
2019-07-22 05:45,12,7,5,0,0,0
2019-07-22 06:00,14,8,6,0,0,0
2019-07-22 06:15,14,11,3,0,0,0
2019-07-22 06:30,37,19,18,0,0,0
2019-07-22 06:45,49,23,26,0,0,0
2019-07-22 07:00,57,20,37,0,0,0
2019-07-22 07:15,56,28,28,0,0,0
2019-07-22 07:30,78,38,40,0,0,0
2019-07-22 07:45,82,56,26,0,0,0
2019-07-22 08:00,78,41,37,0,0,0
2019-07-22 08:15,69,45,24,0,0,0
2019-07-22 08:30,69,40,29,0,0,0
2019-07-22 08:45,70,31,39,0,0,0
2019-07-22 09:00,71,45,26,0,0,0
2019-07-22 09:15,48,28,20,0,0,0
2019-07-22 09:30,47,36,11,0,0,0
2019-07-22 09:45,53,42,11,0,0,0
2019-07-22 10:00,46,33,13,0,0,0
2019-07-22 10:15,57,41,16,0,0,0
2019-07-22 10:30,58,37,21,0,0,0
2019-07-22 10:45,44,29,15,0,0,0
2019-07-22 11:00,31,19,12,0,0,0
2019-07-22 11:15,44,26,18,0,0,0
2019-07-22 11:30,44,32,12,0,0,0
2019-07-22 11:45,48,33,15,0,0,0
2019-07-22 12:00,53,32,21,0,0,0
2019-07-22 12:15,44,24,20,0,0,0
2019-07-22 12:30,44,31,13,0,0,0
2019-07-22 12:45,36,24,12,0,0,0
2019-07-22 13:00,41,25,16,0,0,0
2019-07-22 13:15,48,33,15,0,0,0
2019-07-22 13:30,48,35,13,0,0,0
2019-07-22 13:45,43,25,18,0,0,0
2019-07-22 14:00,59,45,14,0,0,0
2019-07-22 14:15,50,35,15,0,0,0
2019-07-22 14:30,62,38,24,0,0,0
2019-07-22 14:45,45,33,12,0,0,0
2019-07-22 15:00,58,38,20,0,0,0
2019-07-22 15:15,70,41,29,0,0,0
2019-07-22 15:30,73,46,27,0,0,0
2019-07-22 15:45,100,68,32,0,0,0
2019-07-22 16:00,77,45,32,0,0,0
2019-07-22 16:15,102,66,36,0,0,0
2019-07-22 16:30,92,53,39,0,0,0
2019-07-22 16:45,95,67,28,0,0,0
2019-07-22 17:00,98,64,34,0,0,0
2019-07-22 17:15,98,59,39,0,0,0
2019-07-22 17:30,93,62,31,0,0,0
2019-07-22 17:45,97,61,36,0,0,0
2019-07-22 18:00,88,54,34,0,0,0
2019-07-22 18:15,81,56,25,0,0,0
2019-07-22 18:30,73,35,38,0,0,0
2019-07-22 18:45,60,36,24,0,0,0
2019-07-22 19:00,63,29,34,0,0,0
2019-07-22 19:15,66,36,30,0,0,0
2019-07-22 19:30,49,29,20,0,0,0
2019-07-22 19:45,65,40,25,0,0,0
2019-07-22 20:00,51,32,19,0,0,0
2019-07-22 20:15,50,19,31,0,0,0
2019-07-22 20:30,40,19,21,0,0,0
2019-07-22 20:45,35,15,20,0,0,0
2019-07-22 21:00,47,28,19,0,0,0
2019-07-22 21:15,52,31,21,0,0,0
2019-07-22 21:30,36,19,17,0,0,0
2019-07-22 21:45,23,6,17,0,0,0
2019-07-22 22:00,27,12,15,0,0,0
2019-07-22 22:15,15,5,10,0,0,0
2019-07-22 22:30,18,5,13,0,0,0
2019-07-22 22:45,22,9,13,0,0,0
2019-07-22 23:00,13,5,8,0,0,0
2019-07-22 23:15,13,6,7,0,0,0
2019-07-22 23:30,16,6,10,0,0,0
2019-07-22 23:45,5,2,3,0,0,0
2019-07-23 00:00,18,7,11,0,0,0
2019-07-23 00:15,7,2,5,0,0,0
2019-07-23 00:30,9,4,5,0,0,0
2019-07-23 00:45,4,3,1,0,0,0
2019-07-23 01:00,7,3,4,0,0,0
2019-07-23 01:15,5,2,3,0,0,0
2019-07-23 01:30,3,2,1,0,0,0
2019-07-23 01:45,2,0,2,0,0,0
2019-07-23 02:00,1,0,1,0,0,0
2019-07-23 02:15,2,0,2,0,0,0
2019-07-23 02:30,0,0,0,0,0,0
2019-07-23 02:45,2,2,0,0,0,0
2019-07-23 03:00,2,0,2,0,0,0
2019-07-23 03:15,1,0,1,0,0,0
2019-07-23 03:30,1,0,1,0,0,0
2019-07-23 03:45,0,0,0,0,0,0
2019-07-23 04:00,0,0,0,0,0,0
2019-07-23 04:15,4,1,3,0,0,0
2019-07-23 04:30,2,1,1,0,0,0
2019-07-23 04:45,2,2,0,0,0,0
2019-07-23 05:00,1,1,0,0,0,0
2019-07-23 05:15,5,1,4,0,0,0
2019-07-23 05:30,17,11,6,0,0,0
2019-07-23 05:45,16,9,7,0,0,0
2019-07-23 06:00,14,10,4,0,0,0
2019-07-23 06:15,25,13,12,0,0,0
2019-07-23 06:30,46,18,28,0,0,0
2019-07-23 06:45,51,17,34,0,0,0
2019-07-23 07:00,55,24,31,0,0,0
2019-07-23 07:15,52,24,28,0,0,0
2019-07-23 07:30,72,34,38,0,0,0
2019-07-23 07:45,77,42,35,0,0,0
2019-07-23 08:00,83,48,35,0,0,0
2019-07-23 08:15,85,55,30,0,0,0
2019-07-23 08:30,71,39,32,0,0,0
2019-07-23 08:45,75,44,31,0,0,0
2019-07-23 09:00,56,35,21,0,0,0
2019-07-23 09:15,42,34,8,0,0,0
2019-07-23 09:30,42,31,11,0,0,0
2019-07-23 09:45,60,49,11,0,0,0
2019-07-23 10:00,39,25,14,0,0,0
2019-07-23 10:15,26,16,10,0,0,0
2019-07-23 10:30,44,28,16,0,0,0
2019-07-23 10:45,34,22,12,0,0,0
2019-07-23 11:00,36,29,7,0,0,0
2019-07-23 11:15,35,23,12,0,0,0
2019-07-23 11:30,42,28,14,0,0,0
2019-07-23 11:45,50,31,19,0,0,0
2019-07-23 12:00,56,31,25,0,0,0
2019-07-23 12:15,38,30,8,0,0,0
2019-07-23 12:30,38,19,19,0,0,0
2019-07-23 12:45,38,27,11,0,0,0
2019-07-23 13:00,38,19,19,0,0,0
2019-07-23 13:15,38,20,18,0,0,0
2019-07-23 13:30,56,33,23,0,0,0
2019-07-23 13:45,46,28,18,0,0,0
2019-07-23 14:00,51,38,13,0,0,0
2019-07-23 14:15,57,39,18,0,0,0
2019-07-23 14:30,57,42,15,0,0,0
2019-07-23 14:45,62,46,16,0,0,0
2019-07-23 15:00,67,41,26,0,0,0
2019-07-23 15:15,66,36,30,0,0,0
2019-07-23 15:30,66,47,19,0,0,0
2019-07-23 15:45,66,45,21,0,0,0
2019-07-23 16:00,77,51,26,0,0,0
2019-07-23 16:15,80,51,29,0,0,0
2019-07-23 16:30,84,44,40,0,0,0
2019-07-23 16:45,94,60,34,0,0,0
2019-07-23 17:00,87,61,26,0,0,0
2019-07-23 17:15,81,46,35,0,0,0
2019-07-23 17:30,65,38,27,0,0,0
2019-07-23 17:45,91,51,40,0,0,0
2019-07-23 18:00,94,50,44,0,0,0
2019-07-23 18:15,44,33,11,0,0,0
2019-07-23 18:30,66,42,24,0,0,0
2019-07-23 18:45,78,60,18,0,0,0
2019-07-23 19:00,72,36,36,0,0,0
2019-07-23 19:15,41,26,15,0,0,0
2019-07-23 19:30,51,27,24,0,0,0
2019-07-23 19:45,46,23,23,0,0,0
2019-07-23 20:00,40,18,22,0,0,0
2019-07-23 20:15,45,26,19,0,0,0
2019-07-23 20:30,31,23,8,0,0,0
2019-07-23 20:45,23,14,9,0,0,0
2019-07-23 21:00,24,15,9,0,0,0
2019-07-23 21:15,42,19,23,0,0,0
2019-07-23 21:30,29,14,15,0,0,0
2019-07-23 21:45,31,11,20,0,0,0
2019-07-23 22:00,23,8,15,0,0,0
2019-07-23 22:15,18,6,12,0,0,0
2019-07-23 22:30,27,13,14,0,0,0
2019-07-23 22:45,17,7,10,0,0,0
2019-07-23 23:00,15,5,10,0,0,0
2019-07-23 23:15,30,10,20,0,0,0
2019-07-23 23:30,13,1,12,0,0,0
2019-07-23 23:45,9,7,2,0,0,0
2019-07-24 00:00,6,2,4,0,0,0
2019-07-24 00:15,9,4,5,0,0,0
2019-07-24 00:30,5,0,5,0,0,0
2019-07-24 00:45,3,3,0,0,0,0
2019-07-24 01:00,4,2,2,0,0,0
2019-07-24 01:15,5,3,2,0,0,0
2019-07-24 01:30,2,0,2,0,0,0
2019-07-24 01:45,2,1,1,0,0,0
2019-07-24 02:00,4,0,4,0,0,0
2019-07-24 02:15,9,8,1,0,0,0
2019-07-24 02:30,2,1,1,0,0,0
2019-07-24 02:45,2,0,2,0,0,0
2019-07-24 03:00,0,0,0,0,0,0
2019-07-24 03:15,2,0,2,0,0,0
2019-07-24 03:30,1,1,0,0,0,0
2019-07-24 03:45,1,0,1,0,0,0
2019-07-24 04:00,0,0,0,0,0,0
2019-07-24 04:15,0,0,0,0,0,0
2019-07-24 04:30,2,0,2,0,0,0
2019-07-24 04:45,3,3,0,0,0,0
2019-07-24 05:00,1,1,0,0,0,0
2019-07-24 05:15,5,3,2,0,0,0
2019-07-24 05:30,13,6,7,0,0,0
2019-07-24 05:45,19,10,9,0,0,0
2019-07-24 06:00,13,6,7,0,0,0
2019-07-24 06:15,26,16,10,0,0,0
2019-07-24 06:30,49,24,25,0,0,0
2019-07-24 06:45,58,25,33,0,0,0
2019-07-24 07:00,42,19,23,0,0,0
2019-07-24 07:15,60,26,34,0,0,0
2019-07-24 07:30,83,41,42,0,0,0
2019-07-24 07:45,91,54,37,0,0,0
2019-07-24 08:00,67,40,27,0,0,0
2019-07-24 08:15,68,39,29,0,0,0
2019-07-24 08:30,73,38,35,0,0,0
2019-07-24 08:45,74,47,27,0,0,0
2019-07-24 09:00,66,48,18,0,0,0
2019-07-24 09:15,42,29,13,0,0,0
2019-07-24 09:30,57,45,12,0,0,0
2019-07-24 09:45,51,39,12,0,0,0
2019-07-24 10:00,47,33,14,0,0,0
2019-07-24 10:15,42,30,12,0,0,0
2019-07-24 10:30,44,35,9,0,0,0
2019-07-24 10:45,45,30,15,0,0,0
2019-07-24 11:00,37,26,11,0,0,0
2019-07-24 11:15,33,22,11,0,0,0
2019-07-24 11:30,50,33,17,0,0,0
2019-07-24 11:45,47,29,18,0,0,0
2019-07-24 12:00,47,23,24,0,0,0
2019-07-24 12:15,40,17,23,0,0,0
2019-07-24 12:30,34,23,11,0,0,0
2019-07-24 12:45,43,19,24,0,0,0
2019-07-24 13:00,43,27,16,0,0,0
2019-07-24 13:15,36,25,11,0,0,0
2019-07-24 13:30,39,21,18,0,0,0
2019-07-24 13:45,41,28,13,0,0,0
2019-07-24 14:00,45,22,23,0,0,0
2019-07-24 14:15,37,22,15,0,0,0
2019-07-24 14:30,60,44,16,0,0,0
2019-07-24 14:45,51,34,17,0,0,0
2019-07-24 15:00,81,42,39,0,0,0
2019-07-24 15:15,59,43,16,0,0,0
2019-07-24 15:30,60,46,14,0,0,0
2019-07-24 15:45,64,48,16,0,0,0
2019-07-24 16:00,76,47,29,0,0,0
2019-07-24 16:15,75,48,27,0,0,0
2019-07-24 16:30,67,49,18,0,0,0
2019-07-24 16:45,62,40,22,0,0,0
2019-07-24 17:00,70,39,31,0,0,0
2019-07-24 17:15,65,48,17,0,0,0
2019-07-24 17:30,84,55,29,0,0,0
2019-07-24 17:45,76,45,31,0,0,0
2019-07-24 18:00,71,44,27,0,0,0
2019-07-24 18:15,47,22,25,0,0,0
2019-07-24 18:30,50,30,20,0,0,0
2019-07-24 18:45,62,43,19,0,0,0
2019-07-24 19:00,45,26,19,0,0,0
2019-07-24 19:15,52,18,34,0,0,0
2019-07-24 19:30,54,30,24,0,0,0
2019-07-24 19:45,31,17,14,0,0,0
2019-07-24 20:00,51,22,29,0,0,0
2019-07-24 20:15,30,15,15,0,0,0
2019-07-24 20:30,36,20,16,0,0,0
2019-07-24 20:45,34,17,17,0,0,0
2019-07-24 21:00,27,15,12,0,0,0
2019-07-24 21:15,28,10,18,0,0,0
2019-07-24 21:30,25,17,8,0,0,0
2019-07-24 21:45,28,10,18,0,0,0
2019-07-24 22:00,39,20,19,0,0,0
2019-07-24 22:15,22,14,8,0,0,0
2019-07-24 22:30,27,15,12,0,0,0
2019-07-24 22:45,29,16,13,0,0,0
2019-07-24 23:00,23,12,11,0,0,0
2019-07-24 23:15,26,16,10,0,0,0
2019-07-24 23:30,16,5,11,0,0,0
2019-07-24 23:45,12,4,8,0,0,0
2019-07-25 00:00,5,3,2,0,0,0
2019-07-25 00:15,10,3,7,0,0,0
2019-07-25 00:30,19,11,8,0,0,0
2019-07-25 00:45,10,5,5,0,0,0
2019-07-25 01:00,5,2,3,0,0,0
2019-07-25 01:15,3,0,3,0,0,0
2019-07-25 01:30,4,2,2,0,0,0
2019-07-25 01:45,5,1,4,0,0,0
2019-07-25 02:00,7,1,6,0,0,0
2019-07-25 02:15,3,0,3,0,0,0
2019-07-25 02:30,5,0,5,0,0,0
2019-07-25 02:45,5,1,4,0,0,0
2019-07-25 03:00,1,0,1,0,0,0
2019-07-25 03:15,4,0,4,0,0,0
2019-07-25 03:30,3,1,2,0,0,0
2019-07-25 03:45,1,1,0,0,0,0
2019-07-25 04:00,2,0,2,0,0,0
2019-07-25 04:15,2,1,1,0,0,0
2019-07-25 04:30,3,1,2,0,0,0
2019-07-25 04:45,2,2,0,0,0,0
2019-07-25 05:00,3,2,1,0,0,0
2019-07-25 05:15,4,2,2,0,0,0
2019-07-25 05:30,13,4,9,0,0,0
2019-07-25 05:45,19,11,8,0,0,0
2019-07-25 06:00,14,10,4,0,0,0
2019-07-25 06:15,16,9,7,0,0,0
2019-07-25 06:30,43,17,26,0,0,0
2019-07-25 06:45,56,23,33,0,0,0
2019-07-25 07:00,42,17,25,0,0,0
2019-07-25 07:15,60,29,31,0,0,0
2019-07-25 07:30,74,37,37,0,0,0
2019-07-25 07:45,86,55,31,0,0,0
2019-07-25 08:00,61,35,26,0,0,0
2019-07-25 08:15,67,40,27,0,0,0
2019-07-25 08:30,71,47,24,0,0,0
2019-07-25 08:45,89,61,28,0,0,0
2019-07-25 09:00,57,29,28,0,0,0
2019-07-25 09:15,52,35,17,0,0,0
2019-07-25 09:30,50,39,11,0,0,0
2019-07-25 09:45,41,31,10,0,0,0
2019-07-25 10:00,37,25,12,0,0,0
2019-07-25 10:15,34,24,10,0,0,0
2019-07-25 10:30,26,18,8,0,0,0
2019-07-25 10:45,39,23,16,0,0,0
2019-07-25 11:00,39,29,10,0,0,0
2019-07-25 11:15,40,23,17,0,0,0
2019-07-25 11:30,41,28,13,0,0,0
2019-07-25 11:45,34,22,12,0,0,0
2019-07-25 12:00,35,23,12,0,0,0
2019-07-25 12:15,37,20,17,0,0,0
2019-07-25 12:30,42,28,14,0,0,0
2019-07-25 12:45,44,23,21,0,0,0
2019-07-25 13:00,24,11,13,0,0,0
2019-07-25 13:15,26,14,12,0,0,0
2019-07-25 13:30,33,19,14,0,0,0
2019-07-25 13:45,38,27,11,0,0,0
2019-07-25 14:00,26,18,8,0,0,0
2019-07-25 14:15,35,16,19,0,0,0
2019-07-25 14:30,41,29,12,0,0,0
2019-07-25 14:45,51,28,23,0,0,0
2019-07-25 15:00,50,26,24,0,0,0
2019-07-25 15:15,59,37,22,0,0,0
2019-07-25 15:30,49,35,14,0,0,0
2019-07-25 15:45,55,36,19,0,0,0
2019-07-25 16:00,62,39,23,0,0,0
2019-07-25 16:15,77,57,20,0,0,0
2019-07-25 16:30,58,41,17,0,0,0
2019-07-25 16:45,60,39,21,0,0,0
2019-07-25 17:00,57,37,20,0,0,0
2019-07-25 17:15,45,30,15,0,0,0
2019-07-25 17:30,70,47,23,0,0,0
2019-07-25 17:45,54,38,16,0,0,0
2019-07-25 18:00,57,40,17,0,0,0
2019-07-25 18:15,41,24,17,0,0,0
2019-07-25 18:30,43,27,16,0,0,0
2019-07-25 18:45,40,19,21,0,0,0
2019-07-25 19:00,39,21,18,0,0,0
2019-07-25 19:15,34,19,15,0,0,0
2019-07-25 19:30,32,11,21,0,0,0
2019-07-25 19:45,31,18,13,0,0,0
2019-07-25 20:00,29,17,12,0,0,0
2019-07-25 20:15,46,29,17,0,0,0
2019-07-25 20:30,23,13,10,0,0,0
2019-07-25 20:45,18,11,7,0,0,0
2019-07-25 21:00,31,13,18,0,0,0
2019-07-25 21:15,29,18,11,0,0,0
2019-07-25 21:30,24,14,10,0,0,0
2019-07-25 21:45,18,9,9,0,0,0
2019-07-25 22:00,26,14,12,0,0,0
2019-07-25 22:15,15,3,12,0,0,0
2019-07-25 22:30,18,7,11,0,0,0
2019-07-25 22:45,26,14,12,0,0,0
2019-07-25 23:00,14,3,11,0,0,0
2019-07-25 23:15,13,4,9,0,0,0
2019-07-25 23:30,14,2,12,0,0,0
2019-07-25 23:45,9,3,6,0,0,0
2019-07-26 00:00,10,3,7,0,0,0
2019-07-26 00:15,15,5,10,0,0,0
2019-07-26 00:30,5,2,3,0,0,0
2019-07-26 00:45,6,2,4,0,0,0
2019-07-26 01:00,5,2,3,0,0,0
2019-07-26 01:15,8,3,5,0,0,0
2019-07-26 01:30,3,2,1,0,0,0
2019-07-26 01:45,0,0,0,0,0,0
2019-07-26 02:00,1,1,0,0,0,0
2019-07-26 02:15,4,1,3,0,0,0
2019-07-26 02:30,4,2,2,0,0,0
2019-07-26 02:45,0,0,0,0,0,0
2019-07-26 03:00,3,1,2,0,0,0
2019-07-26 03:15,0,0,0,0,0,0
2019-07-26 03:30,0,0,0,0,0,0
2019-07-26 03:45,2,0,2,0,0,0
2019-07-26 04:00,0,0,0,0,0,0
2019-07-26 04:15,2,0,2,0,0,0
2019-07-26 04:30,2,0,2,0,0,0
2019-07-26 04:45,5,3,2,0,0,0
2019-07-26 05:00,2,2,0,0,0,0
2019-07-26 05:15,3,0,3,0,0,0
2019-07-26 05:30,6,2,4,0,0,0
2019-07-26 05:45,15,9,6,0,0,0
2019-07-26 06:00,10,8,2,0,0,0
2019-07-26 06:15,22,9,13,0,0,0
2019-07-26 06:30,38,19,19,0,0,0
2019-07-26 06:45,32,15,17,0,0,0
2019-07-26 07:00,36,15,21,0,0,0
2019-07-26 07:15,48,26,22,0,0,0
2019-07-26 07:30,67,30,37,0,0,0
2019-07-26 07:45,66,38,28,0,0,0
2019-07-26 08:00,66,37,29,0,0,0
2019-07-26 08:15,65,41,24,0,0,0
2019-07-26 08:30,60,39,21,0,0,0
2019-07-26 08:45,61,41,20,0,0,0
2019-07-26 09:00,47,34,13,0,0,0
2019-07-26 09:15,45,36,9,0,0,0
2019-07-26 09:30,45,33,12,0,0,0
2019-07-26 09:45,40,28,12,0,0,0
2019-07-26 10:00,39,28,11,0,0,0
2019-07-26 10:15,37,25,12,0,0,0
2019-07-26 10:30,33,25,8,0,0,0
2019-07-26 10:45,44,28,16,0,0,0
2019-07-26 11:00,40,26,14,0,0,0
2019-07-26 11:15,41,28,13,0,0,0
2019-07-26 11:30,39,21,18,0,0,0
2019-07-26 11:45,35,26,9,0,0,0
2019-07-26 12:00,41,24,17,0,0,0
2019-07-26 12:15,42,23,19,0,0,0
2019-07-26 12:30,45,28,17,0,0,0
2019-07-26 12:45,39,24,15,0,0,0
2019-07-26 13:00,48,30,18,0,0,0
2019-07-26 13:15,32,21,11,0,0,0
2019-07-26 13:30,44,28,16,0,0,0
2019-07-26 13:45,49,29,20,0,0,0
2019-07-26 14:00,66,47,19,0,0,0
2019-07-26 14:15,49,31,18,0,0,0
2019-07-26 14:30,46,30,16,0,0,0
2019-07-26 14:45,60,48,12,0,0,0
2019-07-26 15:00,59,39,20,0,0,0
2019-07-26 15:15,52,29,23,0,0,0
2019-07-26 15:30,53,39,14,0,0,0
2019-07-26 15:45,45,25,20,0,0,0
2019-07-26 16:00,52,35,17,0,0,0
2019-07-26 16:15,41,28,13,0,0,0
2019-07-26 16:30,39,27,12,0,0,0
2019-07-26 16:45,46,27,19,0,0,0
2019-07-26 17:00,37,23,14,0,0,0
2019-07-26 17:15,41,19,22,0,0,0
2019-07-26 17:30,70,54,16,0,0,0
2019-07-26 17:45,52,37,15,0,0,0
2019-07-26 18:00,39,26,13,0,0,0
2019-07-26 18:15,38,23,15,0,0,0
2019-07-26 18:30,45,28,17,0,0,0
2019-07-26 18:45,54,40,14,0,0,0
2019-07-26 19:00,28,16,12,0,0,0
2019-07-26 19:15,40,25,15,0,0,0
2019-07-26 19:30,33,17,16,0,0,0
2019-07-26 19:45,37,27,10,0,0,0
2019-07-26 20:00,21,14,7,0,0,0
2019-07-26 20:15,39,26,13,0,0,0
2019-07-26 20:30,30,20,10,0,0,0
2019-07-26 20:45,27,16,11,0,0,0
2019-07-26 21:00,28,13,15,0,0,0
2019-07-26 21:15,22,16,6,0,0,0
2019-07-26 21:30,36,18,18,0,0,0
2019-07-26 21:45,29,20,9,0,0,0
2019-07-26 22:00,24,9,15,0,0,0
2019-07-26 22:15,28,12,16,0,0,0
2019-07-26 22:30,17,7,10,0,0,0
2019-07-26 22:45,17,3,14,0,0,0
2019-07-26 23:00,16,5,11,0,0,0
2019-07-26 23:15,14,10,4,0,0,0
2019-07-26 23:30,17,6,11,0,0,0
2019-07-26 23:45,14,5,9,0,0,0
2019-07-27 00:00,20,5,15,0,0,0
2019-07-27 00:15,18,4,14,0,0,0
2019-07-27 00:30,10,6,4,0,0,0
2019-07-27 00:45,18,6,12,0,0,0
2019-07-27 01:00,14,4,10,0,0,0
2019-07-27 01:15,7,3,4,0,0,0
2019-07-27 01:30,3,2,1,0,0,0
2019-07-27 01:45,4,0,4,0,0,0
2019-07-27 02:00,9,1,8,0,0,0
2019-07-27 02:15,11,8,3,0,0,0
2019-07-27 02:30,1,0,1,0,0,0
2019-07-27 02:45,6,4,2,0,0,0
2019-07-27 03:00,4,1,3,0,0,0
2019-07-27 03:15,7,4,3,0,0,0
2019-07-27 03:30,4,3,1,0,0,0
2019-07-27 03:45,9,5,4,0,0,0
2019-07-27 04:00,5,0,5,0,0,0
2019-07-27 04:15,3,1,2,0,0,0
2019-07-27 04:30,6,1,5,0,0,0
2019-07-27 04:45,4,2,2,0,0,0
2019-07-27 05:00,3,1,2,0,0,0
2019-07-27 05:15,6,6,0,0,0,0
2019-07-27 05:30,7,3,4,0,0,0
2019-07-27 05:45,7,4,3,0,0,0
2019-07-27 06:00,4,2,2,0,0,0
2019-07-27 06:15,5,2,3,0,0,0
2019-07-27 06:30,8,7,1,0,0,0
2019-07-27 06:45,10,7,3,0,0,0
2019-07-27 07:00,4,1,3,0,0,0
2019-07-27 07:15,5,2,3,0,0,0
2019-07-27 07:30,11,6,5,0,0,0
2019-07-27 07:45,16,8,8,0,0,0
2019-07-27 08:00,17,12,5,0,0,0
2019-07-27 08:15,13,12,1,0,0,0
2019-07-27 08:30,25,18,7,0,0,0
2019-07-27 08:45,30,23,7,0,0,0
2019-07-27 09:00,24,19,5,0,0,0
2019-07-27 09:15,29,19,10,0,0,0
2019-07-27 09:30,32,20,12,0,0,0
2019-07-27 09:45,61,46,15,0,0,0
2019-07-27 10:00,57,47,10,0,0,0
2019-07-27 10:15,49,37,12,0,0,0
2019-07-27 10:30,48,30,18,0,0,0
2019-07-27 10:45,52,37,15,0,0,0
2019-07-27 11:00,56,47,9,0,0,0
2019-07-27 11:15,36,29,7,0,0,0
2019-07-27 11:30,46,33,13,0,0,0
2019-07-27 11:45,61,49,12,0,0,0
2019-07-27 12:00,43,27,16,0,0,0
2019-07-27 12:15,29,17,12,0,0,0
2019-07-27 12:30,41,25,16,0,0,0
2019-07-27 12:45,33,19,14,0,0,0
2019-07-27 13:00,33,17,16,0,0,0
2019-07-27 13:15,44,23,21,0,0,0
2019-07-27 13:30,38,20,18,0,0,0
2019-07-27 13:45,36,19,17,0,0,0
2019-07-27 14:00,35,19,16,0,0,0
2019-07-27 14:15,27,17,10,0,0,0
2019-07-27 14:30,26,15,11,0,0,0
2019-07-27 14:45,31,13,18,0,0,0
2019-07-27 15:00,28,15,13,0,0,0
2019-07-27 15:15,20,14,6,0,0,0
2019-07-27 15:30,24,15,9,0,0,0
2019-07-27 15:45,49,34,15,0,0,0
2019-07-27 16:00,37,19,18,0,0,0
2019-07-27 16:15,40,23,17,0,0,0
2019-07-27 16:30,28,16,12,0,0,0
2019-07-27 16:45,25,14,11,0,0,0
2019-07-27 17:00,36,25,11,0,0,0
2019-07-27 17:15,39,23,16,0,0,0
2019-07-27 17:30,33,21,12,0,0,0
2019-07-27 17:45,39,15,24,0,0,0
2019-07-27 18:00,42,32,10,0,0,0
2019-07-27 18:15,39,31,8,0,0,0
2019-07-27 18:30,27,16,11,0,0,0
2019-07-27 18:45,42,30,12,0,0,0
2019-07-27 19:00,36,25,11,0,0,0
2019-07-27 19:15,39,22,17,0,0,0
2019-07-27 19:30,34,22,12,0,0,0
2019-07-27 19:45,48,27,21,0,0,0
2019-07-27 20:00,32,19,13,0,0,0
2019-07-27 20:15,36,18,18,0,0,0
2019-07-27 20:30,30,25,5,0,0,0
2019-07-27 20:45,26,15,11,0,0,0
2019-07-27 21:00,24,14,10,0,0,0
2019-07-27 21:15,30,12,18,0,0,0
2019-07-27 21:30,19,9,10,0,0,0
2019-07-27 21:45,26,17,9,0,0,0
2019-07-27 22:00,31,11,20,0,0,0
2019-07-27 22:15,19,11,8,0,0,0
2019-07-27 22:30,13,8,5,0,0,0
2019-07-27 22:45,27,17,10,0,0,0
2019-07-27 23:00,9,6,3,0,0,0
2019-07-27 23:15,10,5,5,0,0,0
2019-07-27 23:30,27,7,20,0,0,0
2019-07-27 23:45,17,10,7,0,0,0
2019-07-28 00:00,15,10,5,0,0,0
2019-07-28 00:15,13,8,5,0,0,0
2019-07-28 00:30,19,8,11,0,0,0
2019-07-28 00:45,14,3,11,0,0,0
2019-07-28 01:00,7,4,3,0,0,0
2019-07-28 01:15,10,5,5,0,0,0
2019-07-28 01:30,9,3,6,0,0,0
2019-07-28 01:45,15,4,11,0,0,0
2019-07-28 02:00,8,3,5,0,0,0
2019-07-28 02:15,3,2,1,0,0,0
2019-07-28 02:30,5,3,2,0,0,0
2019-07-28 02:45,4,1,3,0,0,0
2019-07-28 03:00,9,2,7,0,0,0
2019-07-28 03:15,6,0,6,0,0,0
2019-07-28 03:30,6,1,5,0,0,0
2019-07-28 03:45,5,1,4,0,0,0
2019-07-28 04:00,7,0,7,0,0,0
2019-07-28 04:15,8,3,5,0,0,0
2019-07-28 04:30,4,1,3,0,0,0
2019-07-28 04:45,3,2,1,0,0,0
2019-07-28 05:00,1,1,0,0,0,0
2019-07-28 05:15,6,3,3,0,0,0
2019-07-28 05:30,2,1,1,0,0,0
2019-07-28 05:45,5,3,2,0,0,0
2019-07-28 06:00,3,0,3,0,0,0
2019-07-28 06:15,1,1,0,0,0,0
2019-07-28 06:30,6,3,3,0,0,0
2019-07-28 06:45,3,3,0,0,0,0
2019-07-28 07:00,2,1,1,0,0,0
2019-07-28 07:15,3,3,0,0,0,0
2019-07-28 07:30,11,6,5,0,0,0
2019-07-28 07:45,3,0,3,0,0,0
2019-07-28 08:00,4,4,0,0,0,0
2019-07-28 08:15,6,4,2,0,0,0
2019-07-28 08:30,9,7,2,0,0,0
2019-07-28 08:45,9,6,3,0,0,0
2019-07-28 09:00,5,3,2,0,0,0
2019-07-28 09:15,10,7,3,0,0,0
2019-07-28 09:30,12,5,7,0,0,0
2019-07-28 09:45,36,30,6,0,0,0
2019-07-28 10:00,24,18,6,0,0,0
2019-07-28 10:15,22,19,3,0,0,0
2019-07-28 10:30,36,28,8,0,0,0
2019-07-28 10:45,36,26,10,0,0,0
2019-07-28 11:00,16,10,6,0,0,0
2019-07-28 11:15,22,16,6,0,0,0
2019-07-28 11:30,26,16,10,0,0,0
2019-07-28 11:45,28,21,7,0,0,0
2019-07-28 12:00,27,11,16,0,0,0
2019-07-28 12:15,24,12,12,0,0,0
2019-07-28 12:30,26,12,14,0,0,0
2019-07-28 12:45,31,23,8,0,0,0
2019-07-28 13:00,28,15,13,0,0,0
2019-07-28 13:15,34,23,11,0,0,0
2019-07-28 13:30,34,18,16,0,0,0
2019-07-28 13:45,30,20,10,0,0,0
2019-07-28 14:00,33,25,8,0,0,0
2019-07-28 14:15,13,2,11,0,0,0
2019-07-28 14:30,29,22,7,0,0,0
2019-07-28 14:45,31,16,15,0,0,0
2019-07-28 15:00,18,13,5,0,0,0
2019-07-28 15:15,23,16,7,0,0,0
2019-07-28 15:30,37,24,13,0,0,0
2019-07-28 15:45,25,16,9,0,0,0
2019-07-28 16:00,31,20,11,0,0,0
2019-07-28 16:15,31,9,22,0,0,0
2019-07-28 16:30,39,17,22,0,0,0
2019-07-28 16:45,29,15,14,0,0,0
2019-07-28 17:00,29,20,9,0,0,0
2019-07-28 17:15,27,13,14,0,0,0
2019-07-28 17:30,28,16,12,0,0,0
2019-07-28 17:45,26,16,10,0,0,0
2019-07-28 18:00,34,17,17,0,0,0
2019-07-28 18:15,30,12,18,0,0,0
2019-07-28 18:30,31,17,14,0,0,0
2019-07-28 18:45,36,16,20,0,0,0
2019-07-28 19:00,24,14,10,0,0,0
2019-07-28 19:15,24,13,11,0,0,0
2019-07-28 19:30,27,17,10,0,0,0
2019-07-28 19:45,33,21,12,0,0,0
2019-07-28 20:00,21,13,8,0,0,0
2019-07-28 20:15,21,9,12,0,0,0
2019-07-28 20:30,18,10,8,0,0,0
2019-07-28 20:45,29,12,17,0,0,0
2019-07-28 21:00,18,7,11,0,0,0
2019-07-28 21:15,15,8,7,0,0,0
2019-07-28 21:30,11,6,5,0,0,0
2019-07-28 21:45,6,2,4,0,0,0
2019-07-28 22:00,9,5,4,0,0,0
2019-07-28 22:15,19,8,11,0,0,0
2019-07-28 22:30,5,2,3,0,0,0
2019-07-28 22:45,7,2,5,0,0,0
2019-07-28 23:00,9,3,6,0,0,0
2019-07-28 23:15,7,5,2,0,0,0
2019-07-28 23:30,8,1,7,0,0,0
2019-07-28 23:45,6,3,3,0,0,0
2019-07-29 00:00,2,2,0,0,0,0
2019-07-29 00:15,6,2,4,0,0,0
2019-07-29 00:30,12,4,8,0,0,0
2019-07-29 00:45,2,2,0,0,0,0
2019-07-29 01:00,2,2,0,0,0,0
2019-07-29 01:15,2,1,1,0,0,0
2019-07-29 01:30,0,0,0,0,0,0
2019-07-29 01:45,0,0,0,0,0,0
2019-07-29 02:00,0,0,0,0,0,0
2019-07-29 02:15,1,0,1,0,0,0
2019-07-29 02:30,1,1,0,0,0,0
2019-07-29 02:45,0,0,0,0,0,0
2019-07-29 03:00,0,0,0,0,0,0
2019-07-29 03:15,0,0,0,0,0,0
2019-07-29 03:30,1,1,0,0,0,0
2019-07-29 03:45,4,3,1,0,0,0
2019-07-29 04:00,3,3,0,0,0,0
2019-07-29 04:15,3,0,3,0,0,0
2019-07-29 04:30,4,4,0,0,0,0
2019-07-29 04:45,3,1,2,0,0,0
2019-07-29 05:00,0,0,0,0,0,0
2019-07-29 05:15,6,3,3,0,0,0
2019-07-29 05:30,14,6,8,0,0,0
2019-07-29 05:45,9,6,3,0,0,0
2019-07-29 06:00,14,9,5,0,0,0
2019-07-29 06:15,11,8,3,0,0,0
2019-07-29 06:30,33,10,23,0,0,0
2019-07-29 06:45,52,22,30,0,0,0
2019-07-29 07:00,48,22,26,0,0,0
2019-07-29 07:15,64,29,35,0,0,0
2019-07-29 07:30,78,45,33,0,0,0
2019-07-29 07:45,78,40,38,0,0,0
2019-07-29 08:00,56,30,26,0,0,0
2019-07-29 08:15,68,46,22,0,0,0
2019-07-29 08:30,65,31,34,0,0,0
2019-07-29 08:45,76,46,30,0,0,0
2019-07-29 09:00,49,34,15,0,0,0
2019-07-29 09:15,44,31,13,0,0,0
2019-07-29 09:30,49,38,11,0,0,0
2019-07-29 09:45,39,26,13,0,0,0
2019-07-29 10:00,37,24,13,0,0,0
2019-07-29 10:15,33,20,13,0,0,0
2019-07-29 10:30,54,39,15,0,0,0
2019-07-29 10:45,54,37,17,0,0,0
2019-07-29 11:00,48,30,18,0,0,0
2019-07-29 11:15,45,34,11,0,0,0
2019-07-29 11:30,46,29,17,0,0,0
2019-07-29 11:45,42,29,13,0,0,0
2019-07-29 12:00,59,43,16,0,0,0
2019-07-29 12:15,52,31,21,0,0,0
2019-07-29 12:30,52,28,24,0,0,0
2019-07-29 12:45,51,33,18,0,0,0
2019-07-29 13:00,28,16,12,0,0,0
2019-07-29 13:15,49,35,14,0,0,0
2019-07-29 13:30,56,38,18,0,0,0
2019-07-29 13:45,39,23,16,0,0,0
2019-07-29 14:00,51,22,29,0,0,0
2019-07-29 14:15,58,41,17,0,0,0
2019-07-29 14:30,43,25,18,0,0,0
2019-07-29 14:45,68,46,22,0,0,0
2019-07-29 15:00,87,51,36,0,0,0
2019-07-29 15:15,58,40,18,0,0,0
2019-07-29 15:30,62,38,24,0,0,0
2019-07-29 15:45,71,49,22,0,0,0
2019-07-29 16:00,65,40,25,0,0,0
2019-07-29 16:15,80,53,27,0,0,0
2019-07-29 16:30,65,40,25,0,0,0
2019-07-29 16:45,84,54,30,0,0,0
2019-07-29 17:00,101,65,36,0,0,0
2019-07-29 17:15,99,63,36,0,0,0
2019-07-29 17:30,83,58,25,0,0,0
2019-07-29 17:45,83,45,38,0,0,0
2019-07-29 18:00,71,36,35,0,0,0
2019-07-29 18:15,73,38,35,0,0,0
2019-07-29 18:30,56,29,27,0,0,0
2019-07-29 18:45,60,39,21,0,0,0
2019-07-29 19:00,52,28,24,0,0,0
2019-07-29 19:15,74,43,31,0,0,0
2019-07-29 19:30,44,18,26,0,0,0
2019-07-29 19:45,55,28,27,0,0,0
2019-07-29 20:00,49,26,23,0,0,0
2019-07-29 20:15,27,14,13,0,0,0
2019-07-29 20:30,29,19,10,0,0,0
2019-07-29 20:45,42,18,24,0,0,0
2019-07-29 21:00,37,25,12,0,0,0
2019-07-29 21:15,42,24,18,0,0,0
2019-07-29 21:30,39,29,10,0,0,0
2019-07-29 21:45,15,8,7,0,0,0
2019-07-29 22:00,31,15,16,0,0,0
2019-07-29 22:15,28,12,16,0,0,0
2019-07-29 22:30,16,4,12,0,0,0
2019-07-29 22:45,19,10,9,0,0,0
2019-07-29 23:00,18,12,6,0,0,0
2019-07-29 23:15,15,8,7,0,0,0
2019-07-29 23:30,17,6,11,0,0,0
2019-07-29 23:45,10,5,5,0,0,0
2019-07-30 00:00,12,7,5,0,0,0
2019-07-30 00:15,4,2,2,0,0,0
2019-07-30 00:30,9,6,3,0,0,0
2019-07-30 00:45,2,0,2,0,0,0
2019-07-30 01:00,4,1,3,0,0,0
2019-07-30 01:15,9,3,6,0,0,0
2019-07-30 01:30,5,2,3,0,0,0
2019-07-30 01:45,3,2,1,0,0,0
2019-07-30 02:00,4,0,4,0,0,0
2019-07-30 02:15,1,0,1,0,0,0
2019-07-30 02:30,2,1,1,0,0,0
2019-07-30 02:45,0,0,0,0,0,0
2019-07-30 03:00,2,0,2,0,0,0
2019-07-30 03:15,0,0,0,0,0,0
2019-07-30 03:30,1,0,1,0,0,0
2019-07-30 03:45,0,0,0,0,0,0
2019-07-30 04:00,0,0,0,0,0,0
2019-07-30 04:15,1,1,0,0,0,0
2019-07-30 04:30,2,1,1,0,0,0
2019-07-30 04:45,2,1,1,0,0,0
2019-07-30 05:00,0,0,0,0,0,0
2019-07-30 05:15,9,4,5,0,0,0
2019-07-30 05:30,18,9,9,0,0,0
2019-07-30 05:45,11,6,5,0,0,0
2019-07-30 06:00,14,10,4,0,0,0
2019-07-30 06:15,5,4,1,0,0,0
2019-07-30 06:30,33,13,20,0,0,0
2019-07-30 06:45,64,27,37,0,0,0
2019-07-30 07:00,65,25,40,0,0,0
2019-07-30 07:15,61,28,33,0,0,0
2019-07-30 07:30,67,30,37,0,0,0
2019-07-30 07:45,76,49,27,0,0,0
2019-07-30 08:00,64,32,32,0,0,0
2019-07-30 08:15,62,28,34,0,0,0
2019-07-30 08:30,78,47,31,0,0,0
2019-07-30 08:45,66,40,26,0,0,0
2019-07-30 09:00,47,26,21,0,0,0
2019-07-30 09:15,39,27,12,0,0,0
2019-07-30 09:30,58,46,12,0,0,0
2019-07-30 09:45,56,36,20,0,0,0
2019-07-30 10:00,34,22,12,0,0,0
2019-07-30 10:15,46,34,12,0,0,0
2019-07-30 10:30,35,26,9,0,0,0
2019-07-30 10:45,37,25,12,0,0,0
2019-07-30 11:00,31,22,9,0,0,0
2019-07-30 11:15,42,32,10,0,0,0
2019-07-30 11:30,44,33,11,0,0,0
2019-07-30 11:45,50,31,19,0,0,0
2019-07-30 12:00,34,25,9,0,0,0
2019-07-30 12:15,47,30,17,0,0,0
2019-07-30 12:30,33,19,14,0,0,0
2019-07-30 12:45,34,19,15,0,0,0
2019-07-30 13:00,45,30,15,0,0,0
2019-07-30 13:15,55,23,32,0,0,0
2019-07-30 13:30,40,21,19,0,0,0
2019-07-30 13:45,47,29,18,0,0,0
2019-07-30 14:00,52,32,20,0,0,0
2019-07-30 14:15,37,14,23,0,0,0
2019-07-30 14:30,41,29,12,0,0,0
2019-07-30 14:45,45,28,17,0,0,0
2019-07-30 15:00,54,29,25,0,0,0
2019-07-30 15:15,66,51,15,0,0,0
2019-07-30 15:30,45,36,9,0,0,0
2019-07-30 15:45,77,63,14,0,0,0
2019-07-30 16:00,83,62,21,0,0,0
2019-07-30 16:15,98,69,29,0,0,0
2019-07-30 16:30,77,47,30,0,0,0
2019-07-30 16:45,78,56,22,0,0,0
2019-07-30 17:00,77,46,31,0,0,0
2019-07-30 17:15,79,58,21,0,0,0
2019-07-30 17:30,68,47,21,0,0,0
2019-07-30 17:45,81,56,25,0,0,0
2019-07-30 18:00,82,55,27,0,0,0
2019-07-30 18:15,74,37,37,0,0,0
2019-07-30 18:30,53,32,21,0,0,0
2019-07-30 18:45,69,45,24,0,0,0
2019-07-30 19:00,63,29,34,0,0,0
2019-07-30 19:15,58,27,31,0,0,0
2019-07-30 19:30,39,25,14,0,0,0
2019-07-30 19:45,33,23,10,0,0,0
2019-07-30 20:00,39,23,16,0,0,0
2019-07-30 20:15,25,17,8,0,0,0
2019-07-30 20:30,34,25,9,0,0,0
2019-07-30 20:45,30,12,18,0,0,0
2019-07-30 21:00,20,11,9,0,0,0
2019-07-30 21:15,27,15,12,0,0,0
2019-07-30 21:30,33,18,15,0,0,0
2019-07-30 21:45,17,10,7,0,0,0
2019-07-30 22:00,26,18,8,0,0,0
2019-07-30 22:15,22,13,9,0,0,0
2019-07-30 22:30,16,9,7,0,0,0
2019-07-30 22:45,20,2,18,0,0,0
2019-07-30 23:00,11,5,6,0,0,0
2019-07-30 23:15,10,4,6,0,0,0
2019-07-30 23:30,20,4,16,0,0,0
2019-07-30 23:45,9,9,0,0,0,0
2019-07-31 00:00,17,5,12,0,0,0
2019-07-31 00:15,12,5,7,0,0,0
2019-07-31 00:30,7,4,3,0,0,0
2019-07-31 00:45,8,5,3,0,0,0
2019-07-31 01:00,0,0,0,0,0,0
2019-07-31 01:15,12,9,3,0,0,0
2019-07-31 01:30,3,1,2,0,0,0
2019-07-31 01:45,0,0,0,0,0,0
2019-07-31 02:00,3,0,3,0,0,0
2019-07-31 02:15,4,2,2,0,0,0
2019-07-31 02:30,2,0,2,0,0,0
2019-07-31 02:45,2,0,2,0,0,0
2019-07-31 03:00,2,2,0,0,0,0
2019-07-31 03:15,2,0,2,0,0,0
2019-07-31 03:30,3,1,2,0,0,0
2019-07-31 03:45,1,0,1,0,0,0
2019-07-31 04:00,0,0,0,0,0,0
2019-07-31 04:15,3,1,2,0,0,0
2019-07-31 04:30,3,1,2,0,0,0
2019-07-31 04:45,3,1,2,0,0,0
2019-07-31 05:00,1,0,1,0,0,0
2019-07-31 05:15,10,4,6,0,0,0
2019-07-31 05:30,13,4,9,0,0,0
2019-07-31 05:45,7,5,2,0,0,0
2019-07-31 06:00,6,5,1,0,0,0
2019-07-31 06:15,14,11,3,0,0,0
2019-07-31 06:30,31,12,19,0,0,0
2019-07-31 06:45,61,31,30,0,0,0
2019-07-31 07:00,64,16,48,0,0,0
2019-07-31 07:15,61,29,32,0,0,0
2019-07-31 07:30,65,34,31,0,0,0
2019-07-31 07:45,74,43,31,0,0,0
2019-07-31 08:00,55,29,26,0,0,0
2019-07-31 08:15,65,40,25,0,0,0
2019-07-31 08:30,66,34,32,0,0,0
2019-07-31 08:45,54,33,21,0,0,0
2019-07-31 09:00,62,36,26,0,0,0
2019-07-31 09:15,34,20,14,0,0,0
2019-07-31 09:30,57,43,14,0,0,0
2019-07-31 09:45,40,33,7,0,0,0
2019-07-31 10:00,35,30,5,0,0,0
2019-07-31 10:15,35,31,4,0,0,0
2019-07-31 10:30,38,31,7,0,0,0
2019-07-31 10:45,45,29,16,0,0,0
2019-07-31 11:00,43,34,9,0,0,0
2019-07-31 11:15,40,29,11,0,0,0
2019-07-31 11:30,43,30,13,0,0,0
2019-07-31 11:45,57,40,17,0,0,0
2019-07-31 12:00,38,23,15,0,0,0
2019-07-31 12:15,64,47,17,0,0,0
2019-07-31 12:30,48,25,23,0,0,0
2019-07-31 12:45,56,38,18,0,0,0
2019-07-31 13:00,63,31,32,0,0,0
2019-07-31 13:15,42,24,18,0,0,0
2019-07-31 13:30,34,24,10,0,0,0
2019-07-31 13:45,48,30,18,0,0,0
2019-07-31 14:00,48,33,15,0,0,0
2019-07-31 14:15,47,26,21,0,0,0
2019-07-31 14:30,46,33,13,0,0,0
2019-07-31 14:45,52,36,16,0,0,0
2019-07-31 15:00,45,31,14,0,0,0
2019-07-31 15:15,57,35,22,0,0,0
2019-07-31 15:30,55,34,21,0,0,0
2019-07-31 15:45,61,37,24,0,0,0
2019-07-31 16:00,81,50,31,0,0,0
2019-07-31 16:15,90,51,39,0,0,0
2019-07-31 16:30,37,18,19,0,0,0
2019-07-31 16:45,39,22,17,0,0,0
2019-07-31 17:00,71,42,29,0,0,0
2019-07-31 17:15,50,34,16,0,0,0
2019-07-31 17:30,66,42,24,0,0,0
2019-07-31 17:45,82,67,15,0,0,0
2019-07-31 18:00,66,42,24,0,0,0
2019-07-31 18:15,61,35,26,0,0,0
2019-07-31 18:30,45,25,20,0,0,0
2019-07-31 18:45,67,39,28,0,0,0
2019-07-31 19:00,42,24,18,0,0,0
2019-07-31 19:15,43,31,12,0,0,0
2019-07-31 19:30,41,18,23,0,0,0
2019-07-31 19:45,41,22,19,0,0,0
2019-07-31 20:00,36,24,12,0,0,0
2019-07-31 20:15,26,14,12,0,0,0
2019-07-31 20:30,22,11,11,0,0,0
2019-07-31 20:45,26,13,13,0,0,0
2019-07-31 21:00,18,12,6,0,0,0
2019-07-31 21:15,31,19,12,0,0,0
2019-07-31 21:30,21,11,10,0,0,0
2019-07-31 21:45,23,13,10,0,0,0
2019-07-31 22:00,13,5,8,0,0,0
2019-07-31 22:15,18,12,6,0,0,0
2019-07-31 22:30,26,20,6,0,0,0
2019-07-31 22:45,18,5,13,0,0,0
2019-07-31 23:00,8,1,7,0,0,0
2019-07-31 23:15,2,1,1,0,0,0
2019-07-31 23:30,13,4,9,0,0,0
2019-07-31 23:45,11,1,10,0,0,0
