Datetime,100034983 (Warendorfer Straße),101034983 (Warendorfer Straße stadteinwärts),102034983 (Warendorfer Straße stadtauswärts),100034983-status,101034983-status,102034983-status
2019-09-01 00:00,29,17,12,0,0,0
2019-09-01 00:15,23,15,8,0,0,0
2019-09-01 00:30,29,13,16,0,0,0
2019-09-01 00:45,30,9,21,0,0,0
2019-09-01 01:00,32,19,13,0,0,0
2019-09-01 01:15,21,13,8,0,0,0
2019-09-01 01:30,15,5,10,0,0,0
2019-09-01 01:45,17,4,13,0,0,0
2019-09-01 02:00,16,2,14,0,0,0
2019-09-01 02:15,8,1,7,0,0,0
2019-09-01 02:30,15,11,4,0,0,0
2019-09-01 02:45,11,6,5,0,0,0
2019-09-01 03:00,9,2,7,0,0,0
2019-09-01 03:15,6,1,5,0,0,0
2019-09-01 03:30,3,1,2,0,0,0
2019-09-01 03:45,8,3,5,0,0,0
2019-09-01 04:00,4,3,1,0,0,0
2019-09-01 04:15,5,1,4,0,0,0
2019-09-01 04:30,2,0,2,0,0,0
2019-09-01 04:45,6,1,5,0,0,0
2019-09-01 05:00,3,1,2,0,0,0
2019-09-01 05:15,4,2,2,0,0,0
2019-09-01 05:30,8,4,4,0,0,0
2019-09-01 05:45,10,4,6,0,0,0
2019-09-01 06:00,1,1,0,0,0,0
2019-09-01 06:15,6,4,2,0,0,0
2019-09-01 06:30,8,3,5,0,0,0
2019-09-01 06:45,8,5,3,0,0,0
2019-09-01 07:00,3,1,2,0,0,0
2019-09-01 07:15,5,3,2,0,0,0
2019-09-01 07:30,8,4,4,0,0,0
2019-09-01 07:45,8,6,2,0,0,0
2019-09-01 08:00,6,2,4,0,0,0
2019-09-01 08:15,13,8,5,0,0,0
2019-09-01 08:30,9,3,6,0,0,0
2019-09-01 08:45,22,15,7,0,0,0
2019-09-01 09:00,17,13,4,0,0,0
2019-09-01 09:15,22,16,6,0,0,0
2019-09-01 09:30,26,22,4,0,0,0
2019-09-01 09:45,26,22,4,0,0,0
2019-09-01 10:00,46,34,12,0,0,0
2019-09-01 10:15,37,22,15,0,0,0
2019-09-01 10:30,40,26,14,0,0,0
2019-09-01 10:45,53,43,10,0,0,0
2019-09-01 11:00,42,17,25,0,0,0
2019-09-01 11:15,46,34,12,0,0,0
2019-09-01 11:30,41,22,19,0,0,0
2019-09-01 11:45,47,25,22,0,0,0
2019-09-01 12:00,48,31,17,0,0,0
2019-09-01 12:15,33,16,17,0,0,0
2019-09-01 12:30,51,26,25,0,0,0
2019-09-01 12:45,58,28,30,0,0,0
2019-09-01 13:00,66,30,36,0,0,0
2019-09-01 13:15,56,32,24,0,0,0
2019-09-01 13:30,64,40,24,0,0,0
2019-09-01 13:45,54,31,23,0,0,0
2019-09-01 14:00,78,46,32,0,0,0
2019-09-01 14:15,73,52,21,0,0,0
2019-09-01 14:30,61,40,21,0,0,0
2019-09-01 14:45,91,54,37,0,0,0
2019-09-01 15:00,64,44,20,0,0,0
2019-09-01 15:15,80,43,37,0,0,0
2019-09-01 15:30,70,43,27,0,0,0
2019-09-01 15:45,83,57,26,0,0,0
2019-09-01 16:00,96,56,40,0,0,0
2019-09-01 16:15,75,48,27,0,0,0
2019-09-01 16:30,76,51,25,0,0,0
2019-09-01 16:45,80,60,20,0,0,0
2019-09-01 17:00,94,58,36,0,0,0
2019-09-01 17:15,103,70,33,0,0,0
2019-09-01 17:30,98,63,35,0,0,0
2019-09-01 17:45,93,58,35,0,0,0
2019-09-01 18:00,83,37,46,0,0,0
2019-09-01 18:15,83,30,53,0,0,0
2019-09-01 18:30,74,36,38,0,0,0
2019-09-01 18:45,86,50,36,0,0,0
2019-09-01 19:00,65,27,38,0,0,0
2019-09-01 19:15,51,29,22,0,0,0
2019-09-01 19:30,63,25,38,0,0,0
2019-09-01 19:45,67,37,30,0,0,0
2019-09-01 20:00,57,22,35,0,0,0
2019-09-01 20:15,57,30,27,0,0,0
2019-09-01 20:30,43,20,23,0,0,0
2019-09-01 20:45,32,20,12,0,0,0
2019-09-01 21:00,30,8,22,0,0,0
2019-09-01 21:15,22,15,7,0,0,0
2019-09-01 21:30,27,12,15,0,0,0
2019-09-01 21:45,22,12,10,0,0,0
2019-09-01 22:00,25,14,11,0,0,0
2019-09-01 22:15,31,9,22,0,0,0
2019-09-01 22:30,30,13,17,0,0,0
2019-09-01 22:45,19,8,11,0,0,0
2019-09-01 23:00,12,4,8,0,0,0
2019-09-01 23:15,5,2,3,0,0,0
2019-09-01 23:30,11,5,6,0,0,0
2019-09-01 23:45,10,2,8,0,0,0
2019-09-02 00:00,4,2,2,0,0,0
2019-09-02 00:15,4,2,2,0,0,0
2019-09-02 00:30,1,0,1,0,0,0
2019-09-02 00:45,1,0,1,0,0,0
2019-09-02 01:00,1,1,0,0,0,0
2019-09-02 01:15,3,2,1,0,0,0
2019-09-02 01:30,4,3,1,0,0,0
2019-09-02 01:45,4,1,3,0,0,0
2019-09-02 02:00,0,0,0,0,0,0
2019-09-02 02:15,2,0,2,0,0,0
2019-09-02 02:30,2,1,1,0,0,0
2019-09-02 02:45,0,0,0,0,0,0
2019-09-02 03:00,1,0,1,0,0,0
2019-09-02 03:15,1,1,0,0,0,0
2019-09-02 03:30,0,0,0,0,0,0
2019-09-02 03:45,2,1,1,0,0,0
2019-09-02 04:00,0,0,0,0,0,0
2019-09-02 04:15,0,0,0,0,0,0
2019-09-02 04:30,1,0,1,0,0,0
2019-09-02 04:45,1,1,0,0,0,0
2019-09-02 05:00,0,0,0,0,0,0
2019-09-02 05:15,5,3,2,0,0,0
2019-09-02 05:30,18,10,8,0,0,0
2019-09-02 05:45,20,13,7,0,0,0
2019-09-02 06:00,11,6,5,0,0,0
2019-09-02 06:15,26,16,10,0,0,0
2019-09-02 06:30,42,30,12,0,0,0
2019-09-02 06:45,85,56,29,0,0,0
2019-09-02 07:00,113,84,29,0,0,0
2019-09-02 07:15,229,177,52,0,0,0
2019-09-02 07:30,374,303,71,0,0,0
2019-09-02 07:45,214,143,71,0,0,0
2019-09-02 08:00,166,124,42,0,0,0
2019-09-02 08:15,157,118,39,0,0,0
2019-09-02 08:30,164,115,49,0,0,0
2019-09-02 08:45,165,130,35,0,0,0
2019-09-02 09:00,97,74,23,0,0,0
2019-09-02 09:15,94,76,18,0,0,0
2019-09-02 09:30,121,87,34,0,0,0
2019-09-02 09:45,152,124,28,0,0,0
2019-09-02 10:00,82,55,27,0,0,0
2019-09-02 10:15,93,55,38,0,0,0
2019-09-02 10:30,107,73,34,0,0,0
2019-09-02 10:45,105,72,33,0,0,0
2019-09-02 11:00,94,58,36,0,0,0
2019-09-02 11:15,89,44,45,0,0,0
2019-09-02 11:30,108,60,48,0,0,0
2019-09-02 11:45,106,60,46,0,0,0
2019-09-02 12:00,113,68,45,0,0,0
2019-09-02 12:15,118,72,46,0,0,0
2019-09-02 12:30,144,64,80,0,0,0
2019-09-02 12:45,123,69,54,0,0,0
2019-09-02 13:00,156,78,78,0,0,0
2019-09-02 13:15,152,57,95,0,0,0
2019-09-02 13:30,128,71,57,0,0,0
2019-09-02 13:45,147,77,70,0,0,0
2019-09-02 14:00,144,73,71,0,0,0
2019-09-02 14:15,146,70,76,0,0,0
2019-09-02 14:30,147,82,65,0,0,0
2019-09-02 14:45,172,75,97,0,0,0
2019-09-02 15:00,150,89,61,0,0,0
2019-09-02 15:15,167,95,72,0,0,0
2019-09-02 15:30,161,77,84,0,0,0
2019-09-02 15:45,181,91,90,0,0,0
2019-09-02 16:00,175,95,80,0,0,0
2019-09-02 16:15,201,101,100,0,0,0
2019-09-02 16:30,173,97,76,0,0,0
2019-09-02 16:45,210,135,75,0,0,0
2019-09-02 17:00,202,103,99,0,0,0
2019-09-02 17:15,191,98,93,0,0,0
2019-09-02 17:30,189,108,81,0,0,0
2019-09-02 17:45,219,98,121,0,0,0
2019-09-02 18:00,195,97,98,0,0,0
2019-09-02 18:15,172,75,97,0,0,0
2019-09-02 18:30,156,73,83,0,0,0
2019-09-02 18:45,150,63,87,0,0,0
2019-09-02 19:00,130,50,80,0,0,0
2019-09-02 19:15,95,40,55,0,0,0
2019-09-02 19:30,91,40,51,0,0,0
2019-09-02 19:45,106,47,59,0,0,0
2019-09-02 20:00,96,38,58,0,0,0
2019-09-02 20:15,81,40,41,0,0,0
2019-09-02 20:30,49,14,35,0,0,0
2019-09-02 20:45,55,23,32,0,0,0
2019-09-02 21:00,47,16,31,0,0,0
2019-09-02 21:15,44,17,27,0,0,0
2019-09-02 21:30,38,13,25,0,0,0
2019-09-02 21:45,41,21,20,0,0,0
2019-09-02 22:00,50,21,29,0,0,0
2019-09-02 22:15,36,22,14,0,0,0
2019-09-02 22:30,26,11,15,0,0,0
2019-09-02 22:45,21,8,13,0,0,0
2019-09-02 23:00,18,9,9,0,0,0
2019-09-02 23:15,15,10,5,0,0,0
2019-09-02 23:30,24,17,7,0,0,0
2019-09-02 23:45,7,2,5,0,0,0
2019-09-03 00:00,14,8,6,0,0,0
2019-09-03 00:15,6,5,1,0,0,0
2019-09-03 00:30,8,3,5,0,0,0
2019-09-03 00:45,5,3,2,0,0,0
2019-09-03 01:00,3,1,2,0,0,0
2019-09-03 01:15,2,0,2,0,0,0
2019-09-03 01:30,0,0,0,0,0,0
2019-09-03 01:45,3,1,2,0,0,0
2019-09-03 02:00,3,0,3,0,0,0
2019-09-03 02:15,2,1,1,0,0,0
2019-09-03 02:30,0,0,0,0,0,0
2019-09-03 02:45,1,0,1,0,0,0
2019-09-03 03:00,1,1,0,0,0,0
2019-09-03 03:15,0,0,0,0,0,0
2019-09-03 03:30,0,0,0,0,0,0
2019-09-03 03:45,4,2,2,0,0,0
2019-09-03 04:00,0,0,0,0,0,0
2019-09-03 04:15,0,0,0,0,0,0
2019-09-03 04:30,2,1,1,0,0,0
2019-09-03 04:45,1,1,0,0,0,0
2019-09-03 05:00,0,0,0,0,0,0
2019-09-03 05:15,4,1,3,0,0,0
2019-09-03 05:30,14,12,2,0,0,0
2019-09-03 05:45,15,9,6,0,0,0
2019-09-03 06:00,19,11,8,0,0,0
2019-09-03 06:15,29,23,6,0,0,0
2019-09-03 06:30,57,31,26,0,0,0
2019-09-03 06:45,72,45,27,0,0,0
2019-09-03 07:00,110,81,29,0,0,0
2019-09-03 07:15,224,174,50,0,0,0
2019-09-03 07:30,356,287,69,0,0,0
2019-09-03 07:45,233,155,78,0,0,0
2019-09-03 08:00,148,113,35,0,0,0
2019-09-03 08:15,156,114,42,0,0,0
2019-09-03 08:30,160,110,50,0,0,0
2019-09-03 08:45,177,136,41,0,0,0
2019-09-03 09:00,123,86,37,0,0,0
2019-09-03 09:15,108,82,26,0,0,0
2019-09-03 09:30,118,83,35,0,0,0
2019-09-03 09:45,137,101,36,0,0,0
2019-09-03 10:00,102,66,36,0,0,0
2019-09-03 10:15,96,58,38,0,0,0
2019-09-03 10:30,107,73,34,0,0,0
2019-09-03 10:45,115,72,43,0,0,0
2019-09-03 11:00,95,70,25,0,0,0
2019-09-03 11:15,90,46,44,0,0,0
2019-09-03 11:30,93,52,41,0,0,0
2019-09-03 11:45,98,62,36,0,0,0
2019-09-03 12:00,112,70,42,0,0,0
2019-09-03 12:15,123,70,53,0,0,0
2019-09-03 12:30,137,75,62,0,0,0
2019-09-03 12:45,129,67,62,0,0,0
2019-09-03 13:00,152,72,80,0,0,0
2019-09-03 13:15,185,91,94,0,0,0
2019-09-03 13:30,116,56,60,0,0,0
2019-09-03 13:45,144,71,73,0,0,0
2019-09-03 14:00,158,57,101,0,0,0
2019-09-03 14:15,136,70,66,0,0,0
2019-09-03 14:30,151,77,74,0,0,0
2019-09-03 14:45,147,74,73,0,0,0
2019-09-03 15:00,131,68,63,0,0,0
2019-09-03 15:15,156,79,77,0,0,0
2019-09-03 15:30,161,81,80,0,0,0
2019-09-03 15:45,180,88,92,0,0,0
2019-09-03 16:00,119,103,16,0,0,0
2019-09-03 16:15,132,94,38,0,0,0
2019-09-03 16:30,199,90,109,0,0,0
2019-09-03 16:45,201,114,87,0,0,0
2019-09-03 17:00,224,96,128,0,0,0
2019-09-03 17:15,195,93,102,0,0,0
2019-09-03 17:30,204,87,117,0,0,0
2019-09-03 17:45,214,104,110,0,0,0
2019-09-03 18:00,186,85,101,0,0,0
2019-09-03 18:15,174,75,99,0,0,0
2019-09-03 18:30,120,43,77,0,0,0
2019-09-03 18:45,142,64,78,0,0,0
2019-09-03 19:00,101,41,60,0,0,0
2019-09-03 19:15,102,46,56,0,0,0
2019-09-03 19:30,111,54,57,0,0,0
2019-09-03 19:45,91,38,53,0,0,0
2019-09-03 20:00,72,22,50,0,0,0
2019-09-03 20:15,58,24,34,0,0,0
2019-09-03 20:30,66,22,44,0,0,0
2019-09-03 20:45,62,29,33,0,0,0
2019-09-03 21:00,47,26,21,0,0,0
2019-09-03 21:15,65,30,35,0,0,0
2019-09-03 21:30,53,27,26,0,0,0
2019-09-03 21:45,63,33,30,0,0,0
2019-09-03 22:00,46,18,28,0,0,0
2019-09-03 22:15,37,11,26,0,0,0
2019-09-03 22:30,34,16,18,0,0,0
2019-09-03 22:45,29,15,14,0,0,0
2019-09-03 23:00,24,12,12,0,0,0
2019-09-03 23:15,18,8,10,0,0,0
2019-09-03 23:30,20,14,6,0,0,0
2019-09-03 23:45,14,9,5,0,0,0
2019-09-04 00:00,11,4,7,0,0,0
2019-09-04 00:15,8,5,3,0,0,0
2019-09-04 00:30,15,5,10,0,0,0
2019-09-04 00:45,8,4,4,0,0,0
2019-09-04 01:00,5,2,3,0,0,0
2019-09-04 01:15,7,3,4,0,0,0
2019-09-04 01:30,8,5,3,0,0,0
2019-09-04 01:45,3,3,0,0,0,0
2019-09-04 02:00,1,0,1,0,0,0
2019-09-04 02:15,1,0,1,0,0,0
2019-09-04 02:30,0,0,0,0,0,0
2019-09-04 02:45,1,1,0,0,0,0
2019-09-04 03:00,1,1,0,0,0,0
2019-09-04 03:15,0,0,0,0,0,0
2019-09-04 03:30,1,0,1,0,0,0
2019-09-04 03:45,0,0,0,0,0,0
2019-09-04 04:00,1,0,1,0,0,0
2019-09-04 04:15,1,1,0,0,0,0
2019-09-04 04:30,3,3,0,0,0,0
2019-09-04 04:45,2,2,0,0,0,0
2019-09-04 05:00,0,0,0,0,0,0
2019-09-04 05:15,4,3,1,0,0,0
2019-09-04 05:30,15,10,5,0,0,0
2019-09-04 05:45,22,11,11,0,0,0
2019-09-04 06:00,14,12,2,0,0,0
2019-09-04 06:15,30,15,15,0,0,0
2019-09-04 06:30,45,26,19,0,0,0
2019-09-04 06:45,58,39,19,0,0,0
2019-09-04 07:00,111,83,28,0,0,0
2019-09-04 07:15,222,180,42,0,0,0
2019-09-04 07:30,357,283,74,0,0,0
2019-09-04 07:45,227,149,78,0,0,0
2019-09-04 08:00,187,145,42,0,0,0
2019-09-04 08:15,164,117,47,0,0,0
2019-09-04 08:30,140,103,37,0,0,0
2019-09-04 08:45,181,142,39,0,0,0
2019-09-04 09:00,89,69,20,0,0,0
2019-09-04 09:15,152,128,24,0,0,0
2019-09-04 09:30,126,88,38,0,0,0
2019-09-04 09:45,147,110,37,0,0,0
2019-09-04 10:00,127,101,26,0,0,0
2019-09-04 10:15,136,103,33,0,0,0
2019-09-04 10:30,126,91,35,0,0,0
2019-09-04 10:45,130,97,33,0,0,0
2019-09-04 11:00,133,90,43,0,0,0
2019-09-04 11:15,162,96,66,0,0,0
2019-09-04 11:30,128,79,49,0,0,0
2019-09-04 11:45,146,87,59,0,0,0
2019-09-04 12:00,145,90,55,0,0,0
2019-09-04 12:15,129,75,54,0,0,0
2019-09-04 12:30,156,73,83,0,0,0
2019-09-04 12:45,163,85,78,0,0,0
2019-09-04 13:00,178,78,100,0,0,0
2019-09-04 13:15,158,77,81,0,0,0
2019-09-04 13:30,123,63,60,0,0,0
2019-09-04 13:45,189,73,116,0,0,0
2019-09-04 14:00,168,62,106,0,0,0
2019-09-04 14:15,140,60,80,0,0,0
2019-09-04 14:30,134,59,75,0,0,0
2019-09-04 14:45,164,87,77,0,0,0
2019-09-04 15:00,162,85,77,0,0,0
2019-09-04 15:15,133,65,68,0,0,0
2019-09-04 15:30,161,64,97,0,0,0
2019-09-04 15:45,169,87,82,0,0,0
2019-09-04 16:00,199,109,90,0,0,0
2019-09-04 16:15,176,78,98,0,0,0
2019-09-04 16:30,183,96,87,0,0,0
2019-09-04 16:45,194,105,89,0,0,0
2019-09-04 17:00,190,82,108,0,0,0
2019-09-04 17:15,181,73,108,0,0,0
2019-09-04 17:30,161,66,95,0,0,0
2019-09-04 17:45,163,77,86,0,0,0
2019-09-04 18:00,139,57,82,0,0,0
2019-09-04 18:15,111,57,54,0,0,0
2019-09-04 18:30,95,36,59,0,0,0
2019-09-04 18:45,114,57,57,0,0,0
2019-09-04 19:00,119,51,68,0,0,0
2019-09-04 19:15,85,45,40,0,0,0
2019-09-04 19:30,89,38,51,0,0,0
2019-09-04 19:45,73,26,47,0,0,0
2019-09-04 20:00,72,31,41,0,0,0
2019-09-04 20:15,51,15,36,0,0,0
2019-09-04 20:30,37,18,19,0,0,0
2019-09-04 20:45,59,28,31,0,0,0
2019-09-04 21:00,46,21,25,0,0,0
2019-09-04 21:15,51,38,13,0,0,0
2019-09-04 21:30,41,13,28,0,0,0
2019-09-04 21:45,29,10,19,0,0,0
2019-09-04 22:00,54,17,37,0,0,0
2019-09-04 22:15,46,17,29,0,0,0
2019-09-04 22:30,35,16,19,0,0,0
2019-09-04 22:45,33,18,15,0,0,0
2019-09-04 23:00,26,9,17,0,0,0
2019-09-04 23:15,14,7,7,0,0,0
2019-09-04 23:30,25,17,8,0,0,0
2019-09-04 23:45,20,5,15,0,0,0
2019-09-05 00:00,6,2,4,0,0,0
2019-09-05 00:15,10,1,9,0,0,0
2019-09-05 00:30,17,12,5,0,0,0
2019-09-05 00:45,16,12,4,0,0,0
2019-09-05 01:00,7,2,5,0,0,0
2019-09-05 01:15,4,1,3,0,0,0
2019-09-05 01:30,8,5,3,0,0,0
2019-09-05 01:45,4,2,2,0,0,0
2019-09-05 02:00,3,2,1,0,0,0
2019-09-05 02:15,6,2,4,0,0,0
2019-09-05 02:30,7,0,7,0,0,0
2019-09-05 02:45,1,1,0,0,0,0
2019-09-05 03:00,5,1,4,0,0,0
2019-09-05 03:15,2,1,1,0,0,0
2019-09-05 03:30,0,0,0,0,0,0
2019-09-05 03:45,3,1,2,0,0,0
2019-09-05 04:00,5,3,2,0,0,0
2019-09-05 04:15,2,0,2,0,0,0
2019-09-05 04:30,0,0,0,0,0,0
2019-09-05 04:45,3,1,2,0,0,0
2019-09-05 05:00,2,0,2,0,0,0
2019-09-05 05:15,3,2,1,0,0,0
2019-09-05 05:30,13,8,5,0,0,0
2019-09-05 05:45,20,8,12,0,0,0
2019-09-05 06:00,16,11,5,0,0,0
2019-09-05 06:15,25,18,7,0,0,0
2019-09-05 06:30,46,28,18,0,0,0
2019-09-05 06:45,81,49,32,0,0,0
2019-09-05 07:00,85,58,27,0,0,0
2019-09-05 07:15,206,163,43,0,0,0
2019-09-05 07:30,366,290,76,0,0,0
2019-09-05 07:45,209,146,63,0,0,0
2019-09-05 08:00,142,108,34,0,0,0
2019-09-05 08:15,171,131,40,0,0,0
2019-09-05 08:30,182,131,51,0,0,0
2019-09-05 08:45,184,140,44,0,0,0
2019-09-05 09:00,114,84,30,0,0,0
2019-09-05 09:15,108,84,24,0,0,0
2019-09-05 09:30,98,72,26,0,0,0
2019-09-05 09:45,126,96,30,0,0,0
2019-09-05 10:00,101,80,21,0,0,0
2019-09-05 10:15,95,66,29,0,0,0
2019-09-05 10:30,81,54,27,0,0,0
2019-09-05 10:45,92,51,41,0,0,0
2019-09-05 11:00,71,45,26,0,0,0
2019-09-05 11:15,91,59,32,0,0,0
2019-09-05 11:30,92,60,32,0,0,0
2019-09-05 11:45,102,64,38,0,0,0
2019-09-05 12:00,109,67,42,0,0,0
2019-09-05 12:15,115,66,49,0,0,0
2019-09-05 12:30,101,53,48,0,0,0
2019-09-05 12:45,118,75,43,0,0,0
2019-09-05 13:00,131,55,76,0,0,0
2019-09-05 13:15,118,47,71,0,0,0
2019-09-05 13:30,116,60,56,0,0,0
2019-09-05 13:45,134,71,63,0,0,0
2019-09-05 14:00,155,61,94,0,0,0
2019-09-05 14:15,123,63,60,0,0,0
2019-09-05 14:30,110,51,59,0,0,0
2019-09-05 14:45,115,73,42,0,0,0
2019-09-05 15:00,128,64,64,0,0,0
2019-09-05 15:15,125,62,63,0,0,0
2019-09-05 15:30,128,55,73,0,0,0
2019-09-05 15:45,172,89,83,0,0,0
2019-09-05 16:00,161,88,73,0,0,0
2019-09-05 16:15,146,76,70,0,0,0
2019-09-05 16:30,153,71,82,0,0,0
2019-09-05 16:45,177,101,76,0,0,0
2019-09-05 17:00,153,66,87,0,0,0
2019-09-05 17:15,161,73,88,0,0,0
2019-09-05 17:30,188,85,103,0,0,0
2019-09-05 17:45,203,101,102,0,0,0
2019-09-05 18:00,143,64,79,0,0,0
2019-09-05 18:15,153,63,90,0,0,0
2019-09-05 18:30,116,50,66,0,0,0
2019-09-05 18:45,188,104,84,0,0,0
2019-09-05 19:00,127,60,67,0,0,0
2019-09-05 19:15,121,62,59,0,0,0
2019-09-05 19:30,100,52,48,0,0,0
2019-09-05 19:45,71,32,39,0,0,0
2019-09-05 20:00,83,36,47,0,0,0
2019-09-05 20:15,88,40,48,0,0,0
2019-09-05 20:30,68,33,35,0,0,0
2019-09-05 20:45,87,46,41,0,0,0
2019-09-05 21:00,60,20,40,0,0,0
2019-09-05 21:15,55,29,26,0,0,0
2019-09-05 21:30,53,20,33,0,0,0
2019-09-05 21:45,42,28,14,0,0,0
2019-09-05 22:00,55,30,25,0,0,0
2019-09-05 22:15,40,16,24,0,0,0
2019-09-05 22:30,32,14,18,0,0,0
2019-09-05 22:45,29,10,19,0,0,0
2019-09-05 23:00,20,10,10,0,0,0
2019-09-05 23:15,26,10,16,0,0,0
2019-09-05 23:30,35,17,18,0,0,0
2019-09-05 23:45,11,4,7,0,0,0
2019-09-06 00:00,23,8,15,0,0,0
2019-09-06 00:15,8,2,6,0,0,0
2019-09-06 00:30,5,3,2,0,0,0
2019-09-06 00:45,8,6,2,0,0,0
2019-09-06 01:00,5,1,4,0,0,0
2019-09-06 01:15,4,2,2,0,0,0
2019-09-06 01:30,9,2,7,0,0,0
2019-09-06 01:45,3,2,1,0,0,0
2019-09-06 02:00,5,1,4,0,0,0
2019-09-06 02:15,2,0,2,0,0,0
2019-09-06 02:30,0,0,0,0,0,0
2019-09-06 02:45,0,0,0,0,0,0
2019-09-06 03:00,0,0,0,0,0,0
2019-09-06 03:15,1,1,0,0,0,0
2019-09-06 03:30,0,0,0,0,0,0
2019-09-06 03:45,1,0,1,0,0,0
2019-09-06 04:00,0,0,0,0,0,0
2019-09-06 04:15,0,0,0,0,0,0
2019-09-06 04:30,2,0,2,0,0,0
2019-09-06 04:45,1,1,0,0,0,0
2019-09-06 05:00,0,0,0,0,0,0
2019-09-06 05:15,1,0,1,0,0,0
2019-09-06 05:30,9,4,5,0,0,0
2019-09-06 05:45,22,11,11,0,0,0
2019-09-06 06:00,9,7,2,0,0,0
2019-09-06 06:15,28,20,8,0,0,0
2019-09-06 06:30,46,31,15,0,0,0
2019-09-06 06:45,67,46,21,0,0,0
2019-09-06 07:00,77,53,24,0,0,0
2019-09-06 07:15,180,136,44,0,0,0
2019-09-06 07:30,306,259,47,0,0,0
2019-09-06 07:45,201,148,53,0,0,0
2019-09-06 08:00,139,101,38,0,0,0
2019-09-06 08:15,119,78,41,0,0,0
2019-09-06 08:30,125,91,34,0,0,0
2019-09-06 08:45,180,137,43,0,0,0
2019-09-06 09:00,104,84,20,0,0,0
2019-09-06 09:15,107,74,33,0,0,0
2019-09-06 09:30,131,97,34,0,0,0
2019-09-06 09:45,136,107,29,0,0,0
2019-09-06 10:00,104,69,35,0,0,0
2019-09-06 10:15,96,64,32,0,0,0
2019-09-06 10:30,85,58,27,0,0,0
2019-09-06 10:45,137,87,50,0,0,0
2019-09-06 11:00,110,79,31,0,0,0
2019-09-06 11:15,125,73,52,0,0,0
2019-09-06 11:30,94,56,38,0,0,0
2019-09-06 11:45,124,77,47,0,0,0
2019-09-06 12:00,131,68,63,0,0,0
2019-09-06 12:15,144,85,59,0,0,0
2019-09-06 12:30,202,111,91,0,0,0
2019-09-06 12:45,171,86,85,0,0,0
2019-09-06 13:00,127,64,63,0,0,0
2019-09-06 13:15,177,87,90,0,0,0
2019-09-06 13:30,143,80,63,0,0,0
2019-09-06 13:45,166,90,76,0,0,0
2019-09-06 14:00,182,78,104,0,0,0
2019-09-06 14:15,141,72,69,0,0,0
2019-09-06 14:30,179,82,97,0,0,0
2019-09-06 14:45,160,71,89,0,0,0
2019-09-06 15:00,199,98,101,0,0,0
2019-09-06 15:15,198,125,73,0,0,0
2019-09-06 15:30,186,107,79,0,0,0
2019-09-06 15:45,152,86,66,0,0,0
2019-09-06 16:00,180,114,66,0,0,0
2019-09-06 16:15,150,80,70,0,0,0
2019-09-06 16:30,159,84,75,0,0,0
2019-09-06 16:45,182,100,82,0,0,0
2019-09-06 17:00,167,95,72,0,0,0
2019-09-06 17:15,172,88,84,0,0,0
2019-09-06 17:30,148,82,66,0,0,0
2019-09-06 17:45,172,84,88,0,0,0
2019-09-06 18:00,159,72,87,0,0,0
2019-09-06 18:15,141,79,62,0,0,0
2019-09-06 18:30,124,61,63,0,0,0
2019-09-06 18:45,156,79,77,0,0,0
2019-09-06 19:00,130,56,74,0,0,0
2019-09-06 19:15,109,60,49,0,0,0
2019-09-06 19:30,113,53,60,0,0,0
2019-09-06 19:45,110,71,39,0,0,0
2019-09-06 20:00,114,58,56,0,0,0
2019-09-06 20:15,103,55,48,0,0,0
2019-09-06 20:30,81,48,33,0,0,0
2019-09-06 20:45,81,45,36,0,0,0
2019-09-06 21:00,63,36,27,0,0,0
2019-09-06 21:15,67,31,36,0,0,0
2019-09-06 21:30,71,38,33,0,0,0
2019-09-06 21:45,37,15,22,0,0,0
2019-09-06 22:00,50,17,33,0,0,0
2019-09-06 22:15,65,29,36,0,0,0
2019-09-06 22:30,33,15,18,0,0,0
2019-09-06 22:45,55,16,39,0,0,0
2019-09-06 23:00,56,26,30,0,0,0
2019-09-06 23:15,26,14,12,0,0,0
2019-09-06 23:30,48,21,27,0,0,0
2019-09-06 23:45,35,16,19,0,0,0
2019-09-07 00:00,49,21,28,0,0,0
2019-09-07 00:15,34,11,23,0,0,0
2019-09-07 00:30,34,16,18,0,0,0
2019-09-07 00:45,19,9,10,0,0,0
2019-09-07 01:00,21,4,17,0,0,0
2019-09-07 01:15,20,11,9,0,0,0
2019-09-07 01:30,22,11,11,0,0,0
2019-09-07 01:45,13,5,8,0,0,0
2019-09-07 02:00,10,1,9,0,0,0
2019-09-07 02:15,6,1,5,0,0,0
2019-09-07 02:30,9,3,6,0,0,0
2019-09-07 02:45,11,2,9,0,0,0
2019-09-07 03:00,10,4,6,0,0,0
2019-09-07 03:15,10,1,9,0,0,0
2019-09-07 03:30,5,1,4,0,0,0
2019-09-07 03:45,4,2,2,0,0,0
2019-09-07 04:00,4,2,2,0,0,0
2019-09-07 04:15,5,1,4,0,0,0
2019-09-07 04:30,3,0,3,0,0,0
2019-09-07 04:45,2,0,2,0,0,0
2019-09-07 05:00,0,0,0,0,0,0
2019-09-07 05:15,1,0,1,0,0,0
2019-09-07 05:30,6,6,0,0,0,0
2019-09-07 05:45,12,6,6,0,0,0
2019-09-07 06:00,5,4,1,0,0,0
2019-09-07 06:15,9,9,0,0,0,0
2019-09-07 06:30,5,4,1,0,0,0
2019-09-07 06:45,3,3,0,0,0,0
2019-09-07 07:00,11,7,4,0,0,0
2019-09-07 07:15,11,8,3,0,0,0
2019-09-07 07:30,16,8,8,0,0,0
2019-09-07 07:45,33,22,11,0,0,0
2019-09-07 08:00,33,24,9,0,0,0
2019-09-07 08:15,35,21,14,0,0,0
2019-09-07 08:30,34,22,12,0,0,0
2019-09-07 08:45,63,41,22,0,0,0
2019-09-07 09:00,47,36,11,0,0,0
2019-09-07 09:15,55,41,14,0,0,0
2019-09-07 09:30,86,72,14,0,0,0
2019-09-07 09:45,105,84,21,0,0,0
2019-09-07 10:00,81,64,17,0,0,0
2019-09-07 10:15,108,87,21,0,0,0
2019-09-07 10:30,121,102,19,0,0,0
2019-09-07 10:45,163,129,34,0,0,0
2019-09-07 11:00,135,97,38,0,0,0
2019-09-07 11:15,149,92,57,0,0,0
2019-09-07 11:30,160,112,48,0,0,0
2019-09-07 11:45,194,142,52,0,0,0
2019-09-07 12:00,173,118,55,0,0,0
2019-09-07 12:15,183,131,52,0,0,0
2019-09-07 12:30,188,133,55,0,0,0
2019-09-07 12:45,178,119,59,0,0,0
2019-09-07 13:00,156,96,60,0,0,0
2019-09-07 13:15,138,78,60,0,0,0
2019-09-07 13:30,158,98,60,0,0,0
2019-09-07 13:45,174,100,74,0,0,0
2019-09-07 14:00,158,76,82,0,0,0
2019-09-07 14:15,156,79,77,0,0,0
2019-09-07 14:30,140,53,87,0,0,0
2019-09-07 14:45,146,63,83,0,0,0
2019-09-07 15:00,153,70,83,0,0,0
2019-09-07 15:15,133,67,66,0,0,0
2019-09-07 15:30,133,86,47,0,0,0
2019-09-07 15:45,127,66,61,0,0,0
2019-09-07 16:00,101,51,50,0,0,0
2019-09-07 16:15,85,46,39,0,0,0
2019-09-07 16:30,102,57,45,0,0,0
2019-09-07 16:45,130,67,63,0,0,0
2019-09-07 17:00,110,67,43,0,0,0
2019-09-07 17:15,119,56,63,0,0,0
2019-09-07 17:30,90,48,42,0,0,0
2019-09-07 17:45,131,74,57,0,0,0
2019-09-07 18:00,144,78,66,0,0,0
2019-09-07 18:15,125,68,57,0,0,0
2019-09-07 18:30,116,69,47,0,0,0
2019-09-07 18:45,127,79,48,0,0,0
2019-09-07 19:00,144,85,59,0,0,0
2019-09-07 19:15,139,75,64,0,0,0
2019-09-07 19:30,104,54,50,0,0,0
2019-09-07 19:45,117,73,44,0,0,0
2019-09-07 20:00,99,58,41,0,0,0
2019-09-07 20:15,124,81,43,0,0,0
2019-09-07 20:30,83,55,28,0,0,0
2019-09-07 20:45,93,49,44,0,0,0
2019-09-07 21:00,74,28,46,0,0,0
2019-09-07 21:15,78,34,44,0,0,0
2019-09-07 21:30,68,35,33,0,0,0
2019-09-07 21:45,77,27,50,0,0,0
2019-09-07 22:00,64,21,43,0,0,0
2019-09-07 22:15,68,29,39,0,0,0
2019-09-07 22:30,60,13,47,0,0,0
2019-09-07 22:45,44,11,33,0,0,0
2019-09-07 23:00,53,19,34,0,0,0
2019-09-07 23:15,51,19,32,0,0,0
2019-09-07 23:30,65,25,40,0,0,0
2019-09-07 23:45,45,3,42,0,0,0
2019-09-08 00:00,48,13,35,0,0,0
2019-09-08 00:15,41,18,23,0,0,0
2019-09-08 00:30,63,29,34,0,0,0
2019-09-08 00:45,37,18,19,0,0,0
2019-09-08 01:00,34,13,21,0,0,0
2019-09-08 01:15,16,8,8,0,0,0
2019-09-08 01:30,25,13,12,0,0,0
2019-09-08 01:45,12,3,9,0,0,0
2019-09-08 02:00,20,9,11,0,0,0
2019-09-08 02:15,32,14,18,0,0,0
2019-09-08 02:30,18,10,8,0,0,0
2019-09-08 02:45,10,2,8,0,0,0
2019-09-08 03:00,12,3,9,0,0,0
2019-09-08 03:15,6,5,1,0,0,0
2019-09-08 03:30,9,7,2,0,0,0
2019-09-08 03:45,12,3,9,0,0,0
2019-09-08 04:00,10,2,8,0,0,0
2019-09-08 04:15,2,0,2,0,0,0
2019-09-08 04:30,3,2,1,0,0,0
2019-09-08 04:45,1,0,1,0,0,0
2019-09-08 05:00,0,0,0,0,0,0
2019-09-08 05:15,6,2,4,0,0,0
2019-09-08 05:30,4,3,1,0,0,0
2019-09-08 05:45,8,3,5,0,0,0
2019-09-08 06:00,1,1,0,0,0,0
2019-09-08 06:15,5,4,1,0,0,0
2019-09-08 06:30,7,2,5,0,0,0
2019-09-08 06:45,6,6,0,0,0,0
2019-09-08 07:00,5,0,5,0,0,0
2019-09-08 07:15,8,7,1,0,0,0
2019-09-08 07:30,17,10,7,0,0,0
2019-09-08 07:45,30,21,9,0,0,0
2019-09-08 08:00,50,47,3,0,0,0
2019-09-08 08:15,82,78,4,0,0,0
2019-09-08 08:30,78,74,4,0,0,0
2019-09-08 08:45,51,44,7,0,0,0
2019-09-08 09:00,30,26,4,0,0,0
2019-09-08 09:15,60,53,7,0,0,0
2019-09-08 09:30,43,34,9,0,0,0
2019-09-08 09:45,85,69,16,0,0,0
2019-09-08 10:00,43,28,15,0,0,0
2019-09-08 10:15,50,38,12,0,0,0
2019-09-08 10:30,70,34,36,0,0,0
2019-09-08 10:45,75,45,30,0,0,0
2019-09-08 11:00,68,41,27,0,0,0
2019-09-08 11:15,59,43,16,0,0,0
2019-09-08 11:30,68,47,21,0,0,0
2019-09-08 11:45,87,55,32,0,0,0
2019-09-08 12:00,88,55,33,0,0,0
2019-09-08 12:15,102,73,29,0,0,0
2019-09-08 12:30,100,66,34,0,0,0
2019-09-08 12:45,89,54,35,0,0,0
2019-09-08 13:00,76,45,31,0,0,0
2019-09-08 13:15,80,48,32,0,0,0
2019-09-08 13:30,105,51,54,0,0,0
2019-09-08 13:45,97,44,53,0,0,0
2019-09-08 14:00,117,44,73,0,0,0
2019-09-08 14:15,129,53,76,0,0,0
2019-09-08 14:30,123,66,57,0,0,0
2019-09-08 14:45,134,73,61,0,0,0
2019-09-08 15:00,73,34,39,0,0,0
2019-09-08 15:15,64,32,32,0,0,0
2019-09-08 15:30,98,45,53,0,0,0
2019-09-08 15:45,98,48,50,0,0,0
2019-09-08 16:00,60,31,29,0,0,0
2019-09-08 16:15,90,45,45,0,0,0
2019-09-08 16:30,79,34,45,0,0,0
2019-09-08 16:45,65,39,26,0,0,0
2019-09-08 17:00,83,39,44,0,0,0
2019-09-08 17:15,77,52,25,0,0,0
2019-09-08 17:30,87,52,35,0,0,0
2019-09-08 17:45,86,49,37,0,0,0
2019-09-08 18:00,71,27,44,0,0,0
2019-09-08 18:15,35,18,17,0,0,0
2019-09-08 18:30,52,25,27,0,0,0
2019-09-08 18:45,54,26,28,0,0,0
2019-09-08 19:00,46,22,24,0,0,0
2019-09-08 19:15,31,14,17,0,0,0
2019-09-08 19:30,60,29,31,0,0,0
2019-09-08 19:45,41,21,20,0,0,0
2019-09-08 20:00,33,21,12,0,0,0
2019-09-08 20:15,42,25,17,0,0,0
2019-09-08 20:30,27,12,15,0,0,0
2019-09-08 20:45,26,12,14,0,0,0
2019-09-08 21:00,20,12,8,0,0,0
2019-09-08 21:15,35,17,18,0,0,0
2019-09-08 21:30,25,18,7,0,0,0
2019-09-08 21:45,15,4,11,0,0,0
2019-09-08 22:00,15,5,10,0,0,0
2019-09-08 22:15,22,16,6,0,0,0
2019-09-08 22:30,28,16,12,0,0,0
2019-09-08 22:45,15,5,10,0,0,0
2019-09-08 23:00,12,7,5,0,0,0
2019-09-08 23:15,13,6,7,0,0,0
2019-09-08 23:30,7,4,3,0,0,0
2019-09-08 23:45,9,4,5,0,0,0
2019-09-09 00:00,7,6,1,0,0,0
2019-09-09 00:15,1,0,1,0,0,0
2019-09-09 00:30,4,0,4,0,0,0
2019-09-09 00:45,4,2,2,0,0,0
2019-09-09 01:00,0,0,0,0,0,0
2019-09-09 01:15,2,2,0,0,0,0
2019-09-09 01:30,0,0,0,0,0,0
2019-09-09 01:45,6,5,1,0,0,0
2019-09-09 02:00,0,0,0,0,0,0
2019-09-09 02:15,0,0,0,0,0,0
2019-09-09 02:30,1,1,0,0,0,0
2019-09-09 02:45,1,1,0,0,0,0
2019-09-09 03:00,0,0,0,0,0,0
2019-09-09 03:15,1,1,0,0,0,0
2019-09-09 03:30,1,0,1,0,0,0
2019-09-09 03:45,0,0,0,0,0,0
2019-09-09 04:00,1,0,1,0,0,0
2019-09-09 04:15,0,0,0,0,0,0
2019-09-09 04:30,0,0,0,0,0,0
2019-09-09 04:45,4,2,2,0,0,0
2019-09-09 05:00,1,1,0,0,0,0
2019-09-09 05:15,5,2,3,0,0,0
2019-09-09 05:30,15,10,5,0,0,0
2019-09-09 05:45,22,11,11,0,0,0
2019-09-09 06:00,18,15,3,0,0,0
2019-09-09 06:15,24,16,8,0,0,0
2019-09-09 06:30,51,35,16,0,0,0
2019-09-09 06:45,66,43,23,0,0,0
2019-09-09 07:00,89,63,26,0,0,0
2019-09-09 07:15,193,148,45,0,0,0
2019-09-09 07:30,341,278,63,0,0,0
2019-09-09 07:45,234,146,88,0,0,0
2019-09-09 08:00,135,105,30,0,0,0
2019-09-09 08:15,150,101,49,0,0,0
2019-09-09 08:30,148,110,38,0,0,0
2019-09-09 08:45,160,129,31,0,0,0
2019-09-09 09:00,109,88,21,0,0,0
2019-09-09 09:15,113,85,28,0,0,0
2019-09-09 09:30,110,82,28,0,0,0
2019-09-09 09:45,109,85,24,0,0,0
2019-09-09 10:00,98,64,34,0,0,0
2019-09-09 10:15,96,72,24,0,0,0
2019-09-09 10:30,88,60,28,0,0,0
2019-09-09 10:45,87,62,25,0,0,0
2019-09-09 11:00,86,52,34,0,0,0
2019-09-09 11:15,98,56,42,0,0,0
2019-09-09 11:30,111,69,42,0,0,0
2019-09-09 11:45,90,43,47,0,0,0
2019-09-09 12:00,112,71,41,0,0,0
2019-09-09 12:15,109,64,45,0,0,0
2019-09-09 12:30,126,63,63,0,0,0
2019-09-09 12:45,133,73,60,0,0,0
2019-09-09 13:00,166,75,91,0,0,0
2019-09-09 13:15,126,55,71,0,0,0
2019-09-09 13:30,133,76,57,0,0,0
2019-09-09 13:45,102,58,44,0,0,0
2019-09-09 14:00,145,58,87,0,0,0
2019-09-09 14:15,140,77,63,0,0,0
2019-09-09 14:30,114,64,50,0,0,0
2019-09-09 14:45,146,76,70,0,0,0
2019-09-09 15:00,154,72,82,0,0,0
2019-09-09 15:15,169,90,79,0,0,0
2019-09-09 15:30,154,78,76,0,0,0
2019-09-09 15:45,162,84,78,0,0,0
2019-09-09 16:00,192,83,109,0,0,0
2019-09-09 16:15,162,88,74,0,0,0
2019-09-09 16:30,172,85,87,0,0,0
2019-09-09 16:45,186,96,90,0,0,0
2019-09-09 17:00,184,80,104,0,0,0
2019-09-09 17:15,198,92,106,0,0,0
2019-09-09 17:30,184,73,111,0,0,0
2019-09-09 17:45,180,87,93,0,0,0
2019-09-09 18:00,159,79,80,0,0,0
2019-09-09 18:15,157,69,88,0,0,0
2019-09-09 18:30,119,60,59,0,0,0
2019-09-09 18:45,128,61,67,0,0,0
2019-09-09 19:00,107,40,67,0,0,0
2019-09-09 19:15,121,66,55,0,0,0
2019-09-09 19:30,81,31,50,0,0,0
2019-09-09 19:45,90,40,50,0,0,0
2019-09-09 20:00,83,39,44,0,0,0
2019-09-09 20:15,62,31,31,0,0,0
2019-09-09 20:30,71,20,51,0,0,0
2019-09-09 20:45,41,16,25,0,0,0
2019-09-09 21:00,52,28,24,0,0,0
2019-09-09 21:15,57,29,28,0,0,0
2019-09-09 21:30,58,19,39,0,0,0
2019-09-09 21:45,55,22,33,0,0,0
2019-09-09 22:00,35,14,21,0,0,0
2019-09-09 22:15,31,13,18,0,0,0
2019-09-09 22:30,29,14,15,0,0,0
2019-09-09 22:45,30,15,15,0,0,0
2019-09-09 23:00,21,7,14,0,0,0
2019-09-09 23:15,15,9,6,0,0,0
2019-09-09 23:30,33,12,21,0,0,0
2019-09-09 23:45,13,1,12,0,0,0
2019-09-10 00:00,8,3,5,0,0,0
2019-09-10 00:15,5,2,3,0,0,0
2019-09-10 00:30,5,3,2,0,0,0
2019-09-10 00:45,4,2,2,0,0,0
2019-09-10 01:00,6,2,4,0,0,0
2019-09-10 01:15,7,3,4,0,0,0
2019-09-10 01:30,1,1,0,0,0,0
2019-09-10 01:45,1,0,1,0,0,0
2019-09-10 02:00,3,1,2,0,0,0
2019-09-10 02:15,1,0,1,0,0,0
2019-09-10 02:30,0,0,0,0,0,0
2019-09-10 02:45,1,0,1,0,0,0
2019-09-10 03:00,2,1,1,0,0,0
2019-09-10 03:15,1,0,1,0,0,0
2019-09-10 03:30,1,1,0,0,0,0
2019-09-10 03:45,0,0,0,0,0,0
2019-09-10 04:00,0,0,0,0,0,0
2019-09-10 04:15,0,0,0,0,0,0
2019-09-10 04:30,1,1,0,0,0,0
2019-09-10 04:45,0,0,0,0,0,0
2019-09-10 05:00,1,1,0,0,0,0
2019-09-10 05:15,6,4,2,0,0,0
2019-09-10 05:30,11,7,4,0,0,0
2019-09-10 05:45,20,10,10,0,0,0
2019-09-10 06:00,18,13,5,0,0,0
2019-09-10 06:15,28,15,13,0,0,0
2019-09-10 06:30,41,25,16,0,0,0
2019-09-10 06:45,70,54,16,0,0,0
2019-09-10 07:00,84,54,30,0,0,0
2019-09-10 07:15,215,163,52,0,0,0
2019-09-10 07:30,343,293,50,0,0,0
2019-09-10 07:45,217,131,86,0,0,0
2019-09-10 08:00,154,116,38,0,0,0
2019-09-10 08:15,191,134,57,0,0,0
2019-09-10 08:30,146,110,36,0,0,0
2019-09-10 08:45,168,129,39,0,0,0
2019-09-10 09:00,111,85,26,0,0,0
2019-09-10 09:15,118,93,25,0,0,0
2019-09-10 09:30,116,85,31,0,0,0
2019-09-10 09:45,140,106,34,0,0,0
2019-09-10 10:00,71,47,24,0,0,0
2019-09-10 10:15,85,61,24,0,0,0
2019-09-10 10:30,103,76,27,0,0,0
2019-09-10 10:45,121,80,41,0,0,0
2019-09-10 11:00,97,62,35,0,0,0
2019-09-10 11:15,93,56,37,0,0,0
2019-09-10 11:30,96,53,43,0,0,0
2019-09-10 11:45,102,59,43,0,0,0
2019-09-10 12:00,108,61,47,0,0,0
2019-09-10 12:15,107,52,55,0,0,0
2019-09-10 12:30,144,70,74,0,0,0
2019-09-10 12:45,116,79,37,0,0,0
2019-09-10 13:00,129,52,77,0,0,0
2019-09-10 13:15,157,77,80,0,0,0
2019-09-10 13:30,123,69,54,0,0,0
2019-09-10 13:45,150,82,68,0,0,0
2019-09-10 14:00,159,72,87,0,0,0
2019-09-10 14:15,118,59,59,0,0,0
2019-09-10 14:30,126,66,60,0,0,0
2019-09-10 14:45,163,91,72,0,0,0
2019-09-10 15:00,150,77,73,0,0,0
2019-09-10 15:15,148,76,72,0,0,0
2019-09-10 15:30,178,100,78,0,0,0
2019-09-10 15:45,181,100,81,0,0,0
2019-09-10 16:00,162,82,80,0,0,0
2019-09-10 16:15,173,97,76,0,0,0
2019-09-10 16:30,213,102,111,0,0,0
2019-09-10 16:45,207,103,104,0,0,0
2019-09-10 17:00,211,109,102,0,0,0
2019-09-10 17:15,209,94,115,0,0,0
2019-09-10 17:30,198,96,102,0,0,0
2019-09-10 17:45,221,97,124,0,0,0
2019-09-10 18:00,184,103,81,0,0,0
2019-09-10 18:15,184,81,103,0,0,0
2019-09-10 18:30,143,64,79,0,0,0
2019-09-10 18:45,158,78,80,0,0,0
2019-09-10 19:00,130,62,68,0,0,0
2019-09-10 19:15,147,70,77,0,0,0
2019-09-10 19:30,110,61,49,0,0,0
2019-09-10 19:45,122,58,64,0,0,0
2019-09-10 20:00,107,44,63,0,0,0
2019-09-10 20:15,86,41,45,0,0,0
2019-09-10 20:30,40,21,19,0,0,0
2019-09-10 20:45,51,24,27,0,0,0
2019-09-10 21:00,61,30,31,0,0,0
2019-09-10 21:15,58,24,34,0,0,0
2019-09-10 21:30,64,25,39,0,0,0
2019-09-10 21:45,58,29,29,0,0,0
2019-09-10 22:00,55,26,29,0,0,0
2019-09-10 22:15,50,25,25,0,0,0
2019-09-10 22:30,49,19,30,0,0,0
2019-09-10 22:45,39,18,21,0,0,0
2019-09-10 23:00,26,12,14,0,0,0
2019-09-10 23:15,24,9,15,0,0,0
2019-09-10 23:30,10,7,3,0,0,0
2019-09-10 23:45,15,8,7,0,0,0
2019-09-11 00:00,7,2,5,0,0,0
2019-09-11 00:15,6,3,3,0,0,0
2019-09-11 00:30,6,3,3,0,0,0
2019-09-11 00:45,5,1,4,0,0,0
2019-09-11 01:00,5,3,2,0,0,0
2019-09-11 01:15,4,0,4,0,0,0
2019-09-11 01:30,5,4,1,0,0,0
2019-09-11 01:45,5,3,2,0,0,0
2019-09-11 02:00,1,1,0,0,0,0
2019-09-11 02:15,3,0,3,0,0,0
2019-09-11 02:30,2,2,0,0,0,0
2019-09-11 02:45,2,1,1,0,0,0
2019-09-11 03:00,2,0,2,0,0,0
2019-09-11 03:15,1,1,0,0,0,0
2019-09-11 03:30,1,1,0,0,0,0
2019-09-11 03:45,1,1,0,0,0,0
2019-09-11 04:00,1,0,1,0,0,0
2019-09-11 04:15,1,1,0,0,0,0
2019-09-11 04:30,0,0,0,0,0,0
2019-09-11 04:45,2,1,1,0,0,0
2019-09-11 05:00,0,0,0,0,0,0
2019-09-11 05:15,2,1,1,0,0,0
2019-09-11 05:30,8,6,2,0,0,0
2019-09-11 05:45,28,13,15,0,0,0
2019-09-11 06:00,11,8,3,0,0,0
2019-09-11 06:15,33,20,13,0,0,0
2019-09-11 06:30,50,30,20,0,0,0
2019-09-11 06:45,67,35,32,0,0,0
2019-09-11 07:00,96,67,29,0,0,0
2019-09-11 07:15,219,164,55,0,0,0
2019-09-11 07:30,359,293,66,0,0,0
2019-09-11 07:45,225,146,79,0,0,0
2019-09-11 08:00,155,126,29,0,0,0
2019-09-11 08:15,187,132,55,0,0,0
2019-09-11 08:30,147,112,35,0,0,0
2019-09-11 08:45,170,130,40,0,0,0
2019-09-11 09:00,123,101,22,0,0,0
2019-09-11 09:15,139,113,26,0,0,0
2019-09-11 09:30,127,92,35,0,0,0
2019-09-11 09:45,151,111,40,0,0,0
2019-09-11 10:00,143,105,38,0,0,0
2019-09-11 10:15,122,86,36,0,0,0
2019-09-11 10:30,134,92,42,0,0,0
2019-09-11 10:45,115,80,35,0,0,0
2019-09-11 11:00,137,91,46,0,0,0
2019-09-11 11:15,116,71,45,0,0,0
2019-09-11 11:30,149,102,47,0,0,0
2019-09-11 11:45,126,75,51,0,0,0
2019-09-11 12:00,141,81,60,0,0,0
2019-09-11 12:15,179,103,76,0,0,0
2019-09-11 12:30,169,75,94,0,0,0
2019-09-11 12:45,158,80,78,0,0,0
2019-09-11 13:00,202,96,106,0,0,0
2019-09-11 13:15,151,62,89,0,0,0
2019-09-11 13:30,161,70,91,0,0,0
2019-09-11 13:45,168,66,102,0,0,0
2019-09-11 14:00,171,68,103,0,0,0
2019-09-11 14:15,132,61,71,0,0,0
2019-09-11 14:30,120,49,71,0,0,0
2019-09-11 14:45,139,67,72,0,0,0
2019-09-11 15:00,128,74,54,0,0,0
2019-09-11 15:15,108,51,57,0,0,0
2019-09-11 15:30,127,55,72,0,0,0
2019-09-11 15:45,155,79,76,0,0,0
2019-09-11 16:00,129,67,62,0,0,0
2019-09-11 16:15,161,69,92,0,0,0
2019-09-11 16:30,140,71,69,0,0,0
2019-09-11 16:45,163,69,94,0,0,0
2019-09-11 17:00,140,68,72,0,0,0
2019-09-11 17:15,159,74,85,0,0,0
2019-09-11 17:30,156,64,92,0,0,0
2019-09-11 17:45,170,83,87,0,0,0
2019-09-11 18:00,114,46,68,0,0,0
2019-09-11 18:15,127,56,71,0,0,0
2019-09-11 18:30,95,44,51,0,0,0
2019-09-11 18:45,116,49,67,0,0,0
2019-09-11 19:00,82,32,50,0,0,0
2019-09-11 19:15,104,57,47,0,0,0
2019-09-11 19:30,83,42,41,0,0,0
2019-09-11 19:45,77,44,33,0,0,0
2019-09-11 20:00,77,41,36,0,0,0
2019-09-11 20:15,60,23,37,0,0,0
2019-09-11 20:30,48,19,29,0,0,0
2019-09-11 20:45,40,17,23,0,0,0
2019-09-11 21:00,41,13,28,0,0,0
2019-09-11 21:15,46,23,23,0,0,0
2019-09-11 21:30,44,9,35,0,0,0
2019-09-11 21:45,34,15,19,0,0,0
2019-09-11 22:00,34,13,21,0,0,0
2019-09-11 22:15,42,30,12,0,0,0
2019-09-11 22:30,27,8,19,0,0,0
2019-09-11 22:45,30,14,16,0,0,0
2019-09-11 23:00,21,13,8,0,0,0
2019-09-11 23:15,10,4,6,0,0,0
2019-09-11 23:30,16,7,9,0,0,0
2019-09-11 23:45,22,12,10,0,0,0
2019-09-12 00:00,26,14,12,0,0,0
2019-09-12 00:15,13,7,6,0,0,0
2019-09-12 00:30,2,0,2,0,0,0
2019-09-12 00:45,4,1,3,0,0,0
2019-09-12 01:00,4,4,0,0,0,0
2019-09-12 01:15,14,5,9,0,0,0
2019-09-12 01:30,9,3,6,0,0,0
2019-09-12 01:45,6,2,4,0,0,0
2019-09-12 02:00,3,0,3,0,0,0
2019-09-12 02:15,4,0,4,0,0,0
2019-09-12 02:30,2,0,2,0,0,0
2019-09-12 02:45,4,0,4,0,0,0
2019-09-12 03:00,8,2,6,0,0,0
2019-09-12 03:15,3,0,3,0,0,0
2019-09-12 03:30,2,0,2,0,0,0
2019-09-12 03:45,1,1,0,0,0,0
2019-09-12 04:00,1,0,1,0,0,0
2019-09-12 04:15,3,0,3,0,0,0
2019-09-12 04:30,1,0,1,0,0,0
2019-09-12 04:45,3,2,1,0,0,0
2019-09-12 05:00,2,0,2,0,0,0
2019-09-12 05:15,3,1,2,0,0,0
2019-09-12 05:30,11,7,4,0,0,0
2019-09-12 05:45,27,13,14,0,0,0
2019-09-12 06:00,17,14,3,0,0,0
2019-09-12 06:15,29,17,12,0,0,0
2019-09-12 06:30,43,32,11,0,0,0
2019-09-12 06:45,73,53,20,0,0,0
2019-09-12 07:00,75,50,25,0,0,0
2019-09-12 07:15,183,136,47,0,0,0
2019-09-12 07:30,300,248,52,0,0,0
2019-09-12 07:45,206,124,82,0,0,0
2019-09-12 08:00,148,115,33,0,0,0
2019-09-12 08:15,143,98,45,0,0,0
2019-09-12 08:30,151,117,34,0,0,0
2019-09-12 08:45,177,140,37,0,0,0
2019-09-12 09:00,90,62,28,0,0,0
2019-09-12 09:15,98,75,23,0,0,0
2019-09-12 09:30,103,74,29,0,0,0
2019-09-12 09:45,126,99,27,0,0,0
2019-09-12 10:00,76,52,24,0,0,0
2019-09-12 10:15,101,64,37,0,0,0
2019-09-12 10:30,85,62,23,0,0,0
2019-09-12 10:45,120,84,36,0,0,0
2019-09-12 11:00,100,59,41,0,0,0
2019-09-12 11:15,100,60,40,0,0,0
2019-09-12 11:30,85,52,33,0,0,0
2019-09-12 11:45,116,67,49,0,0,0
2019-09-12 12:00,120,74,46,0,0,0
2019-09-12 12:15,112,71,41,0,0,0
2019-09-12 12:30,121,63,58,0,0,0
2019-09-12 12:45,118,55,63,0,0,0
2019-09-12 13:00,141,65,76,0,0,0
2019-09-12 13:15,125,56,69,0,0,0
2019-09-12 13:30,99,53,46,0,0,0
2019-09-12 13:45,148,73,75,0,0,0
2019-09-12 14:00,164,60,104,0,0,0
2019-09-12 14:15,140,68,72,0,0,0
2019-09-12 14:30,115,63,52,0,0,0
2019-09-12 14:45,160,87,73,0,0,0
2019-09-12 15:00,138,70,68,0,0,0
2019-09-12 15:15,158,94,64,0,0,0
2019-09-12 15:30,169,101,68,0,0,0
2019-09-12 15:45,184,105,79,0,0,0
2019-09-12 16:00,183,101,82,0,0,0
2019-09-12 16:15,167,74,93,0,0,0
2019-09-12 16:30,201,110,91,0,0,0
2019-09-12 16:45,191,100,91,0,0,0
2019-09-12 17:00,171,83,88,0,0,0
2019-09-12 17:15,191,82,109,0,0,0
2019-09-12 17:30,205,102,103,0,0,0
2019-09-12 17:45,201,106,95,0,0,0
2019-09-12 18:00,212,107,105,0,0,0
2019-09-12 18:15,155,76,79,0,0,0
2019-09-12 18:30,147,51,96,0,0,0
2019-09-12 18:45,154,69,85,0,0,0
2019-09-12 19:00,176,92,84,0,0,0
2019-09-12 19:15,126,65,61,0,0,0
2019-09-12 19:30,95,44,51,0,0,0
2019-09-12 19:45,100,45,55,0,0,0
2019-09-12 20:00,88,35,53,0,0,0
2019-09-12 20:15,78,30,48,0,0,0
2019-09-12 20:30,66,32,34,0,0,0
2019-09-12 20:45,61,31,30,0,0,0
2019-09-12 21:00,79,35,44,0,0,0
2019-09-12 21:15,61,25,36,0,0,0
2019-09-12 21:30,57,37,20,0,0,0
2019-09-12 21:45,58,28,30,0,0,0
2019-09-12 22:00,70,32,38,0,0,0
2019-09-12 22:15,51,17,34,0,0,0
2019-09-12 22:30,46,18,28,0,0,0
2019-09-12 22:45,33,18,15,0,0,0
2019-09-12 23:00,25,8,17,0,0,0
2019-09-12 23:15,24,14,10,0,0,0
2019-09-12 23:30,19,9,10,0,0,0
2019-09-12 23:45,26,11,15,0,0,0
2019-09-13 00:00,22,10,12,0,0,0
2019-09-13 00:15,8,2,6,0,0,0
2019-09-13 00:30,17,2,15,0,0,0
2019-09-13 00:45,12,7,5,0,0,0
2019-09-13 01:00,2,0,2,0,0,0
2019-09-13 01:15,8,4,4,0,0,0
2019-09-13 01:30,3,2,1,0,0,0
2019-09-13 01:45,4,2,2,0,0,0
2019-09-13 02:00,2,2,0,0,0,0
2019-09-13 02:15,1,1,0,0,0,0
2019-09-13 02:30,0,0,0,0,0,0
2019-09-13 02:45,1,0,1,0,0,0
2019-09-13 03:00,3,1,2,0,0,0
2019-09-13 03:15,2,1,1,0,0,0
2019-09-13 03:30,2,0,2,0,0,0
2019-09-13 03:45,2,1,1,0,0,0
2019-09-13 04:00,0,0,0,0,0,0
2019-09-13 04:15,2,1,1,0,0,0
2019-09-13 04:30,0,0,0,0,0,0
2019-09-13 04:45,5,2,3,0,0,0
2019-09-13 05:00,0,0,0,0,0,0
2019-09-13 05:15,3,0,3,0,0,0
2019-09-13 05:30,10,4,6,0,0,0
2019-09-13 05:45,24,13,11,0,0,0
2019-09-13 06:00,15,12,3,0,0,0
2019-09-13 06:15,17,11,6,0,0,0
2019-09-13 06:30,48,31,17,0,0,0
2019-09-13 06:45,66,40,26,0,0,0
2019-09-13 07:00,66,44,22,0,0,0
2019-09-13 07:15,190,142,48,0,0,0
2019-09-13 07:30,349,275,74,0,0,0
2019-09-13 07:45,214,129,85,0,0,0
2019-09-13 08:00,116,88,28,0,0,0
2019-09-13 08:15,119,87,32,0,0,0
2019-09-13 08:30,138,108,30,0,0,0
2019-09-13 08:45,136,100,36,0,0,0
2019-09-13 09:00,93,67,26,0,0,0
2019-09-13 09:15,106,70,36,0,0,0
2019-09-13 09:30,104,77,27,0,0,0
2019-09-13 09:45,127,95,32,0,0,0
2019-09-13 10:00,58,43,15,0,0,0
2019-09-13 10:15,46,24,22,0,0,0
2019-09-13 10:30,59,30,29,0,0,0
2019-09-13 10:45,70,49,21,0,0,0
2019-09-13 11:00,89,57,32,0,0,0
2019-09-13 11:15,84,43,41,0,0,0
2019-09-13 11:30,82,52,30,0,0,0
2019-09-13 11:45,103,63,40,0,0,0
2019-09-13 12:00,120,85,35,0,0,0
2019-09-13 12:15,120,65,55,0,0,0
2019-09-13 12:30,132,59,73,0,0,0
2019-09-13 12:45,129,67,62,0,0,0
2019-09-13 13:00,160,72,88,0,0,0
2019-09-13 13:15,124,47,77,0,0,0
2019-09-13 13:30,135,72,63,0,0,0
2019-09-13 13:45,156,74,82,0,0,0
2019-09-13 14:00,175,86,89,0,0,0
2019-09-13 14:15,151,79,72,0,0,0
2019-09-13 14:30,164,95,69,0,0,0
2019-09-13 14:45,143,70,73,0,0,0
2019-09-13 15:00,182,93,89,0,0,0
2019-09-13 15:15,156,96,60,0,0,0
2019-09-13 15:30,143,83,60,0,0,0
2019-09-13 15:45,127,64,63,0,0,0
2019-09-13 16:00,187,101,86,0,0,0
2019-09-13 16:15,157,81,76,0,0,0
2019-09-13 16:30,164,93,71,0,0,0
2019-09-13 16:45,167,90,77,0,0,0
2019-09-13 17:00,149,79,70,0,0,0
2019-09-13 17:15,146,72,74,0,0,0
2019-09-13 17:30,146,79,67,0,0,0
2019-09-13 17:45,144,59,85,0,0,0
2019-09-13 18:00,147,65,82,0,0,0
2019-09-13 18:15,151,75,76,0,0,0
2019-09-13 18:30,140,70,70,0,0,0
2019-09-13 18:45,138,73,65,0,0,0
2019-09-13 19:00,136,66,70,0,0,0
2019-09-13 19:15,127,54,73,0,0,0
2019-09-13 19:30,85,41,44,0,0,0
2019-09-13 19:45,93,55,38,0,0,0
2019-09-13 20:00,98,50,48,0,0,0
2019-09-13 20:15,88,38,50,0,0,0
2019-09-13 20:30,74,43,31,0,0,0
2019-09-13 20:45,67,44,23,0,0,0
2019-09-13 21:00,66,34,32,0,0,0
2019-09-13 21:15,68,35,33,0,0,0
2019-09-13 21:30,35,23,12,0,0,0
2019-09-13 21:45,49,25,24,0,0,0
2019-09-13 22:00,67,32,35,0,0,0
2019-09-13 22:15,54,24,30,0,0,0
2019-09-13 22:30,51,24,27,0,0,0
2019-09-13 22:45,35,14,21,0,0,0
2019-09-13 23:00,49,21,28,0,0,0
2019-09-13 23:15,24,6,18,0,0,0
2019-09-13 23:30,37,11,26,0,0,0
2019-09-13 23:45,29,15,14,0,0,0
2019-09-14 00:00,34,14,20,0,0,0
2019-09-14 00:15,31,14,17,0,0,0
2019-09-14 00:30,33,21,12,0,0,0
2019-09-14 00:45,29,11,18,0,0,0
2019-09-14 01:00,22,15,7,0,0,0
2019-09-14 01:15,22,8,14,0,0,0
2019-09-14 01:30,11,5,6,0,0,0
2019-09-14 01:45,14,5,9,0,0,0
2019-09-14 02:00,17,7,10,0,0,0
2019-09-14 02:15,11,1,10,0,0,0
2019-09-14 02:30,4,1,3,0,0,0
2019-09-14 02:45,12,4,8,0,0,0
2019-09-14 03:00,11,3,8,0,0,0
2019-09-14 03:15,6,1,5,0,0,0
2019-09-14 03:30,9,0,9,0,0,0
2019-09-14 03:45,8,2,6,0,0,0
2019-09-14 04:00,3,1,2,0,0,0
2019-09-14 04:15,6,1,5,0,0,0
2019-09-14 04:30,3,3,0,0,0,0
2019-09-14 04:45,10,5,5,0,0,0
2019-09-14 05:00,0,0,0,0,0,0
2019-09-14 05:15,3,3,0,0,0,0
2019-09-14 05:30,6,3,3,0,0,0
2019-09-14 05:45,9,4,5,0,0,0
2019-09-14 06:00,4,3,1,0,0,0
2019-09-14 06:15,7,4,3,0,0,0
2019-09-14 06:30,2,2,0,0,0,0
2019-09-14 06:45,11,9,2,0,0,0
2019-09-14 07:00,18,15,3,0,0,0
2019-09-14 07:15,22,12,10,0,0,0
2019-09-14 07:30,22,15,7,0,0,0
2019-09-14 07:45,35,26,9,0,0,0
2019-09-14 08:00,24,17,7,0,0,0
2019-09-14 08:15,32,24,8,0,0,0
2019-09-14 08:30,56,49,7,0,0,0
2019-09-14 08:45,59,42,17,0,0,0
2019-09-14 09:00,63,47,16,0,0,0
2019-09-14 09:15,87,71,16,0,0,0
2019-09-14 09:30,103,76,27,0,0,0
2019-09-14 09:45,137,108,29,0,0,0
2019-09-14 10:00,109,78,31,0,0,0
2019-09-14 10:15,130,99,31,0,0,0
2019-09-14 10:30,153,123,30,0,0,0
2019-09-14 10:45,182,135,47,0,0,0
2019-09-14 11:00,144,102,42,0,0,0
2019-09-14 11:15,151,117,34,0,0,0
2019-09-14 11:30,177,119,58,0,0,0
2019-09-14 11:45,199,127,72,0,0,0
2019-09-14 12:00,177,126,51,0,0,0
2019-09-14 12:15,223,151,72,0,0,0
2019-09-14 12:30,195,112,83,0,0,0
2019-09-14 12:45,197,114,83,0,0,0
2019-09-14 13:00,193,123,70,0,0,0
2019-09-14 13:15,192,121,71,0,0,0
2019-09-14 13:30,161,93,68,0,0,0
2019-09-14 13:45,163,84,79,0,0,0
2019-09-14 14:00,158,76,82,0,0,0
2019-09-14 14:15,159,82,77,0,0,0
2019-09-14 14:30,142,48,94,0,0,0
2019-09-14 14:45,169,62,107,0,0,0
2019-09-14 15:00,164,66,98,0,0,0
2019-09-14 15:15,151,74,77,0,0,0
2019-09-14 15:30,149,70,79,0,0,0
2019-09-14 15:45,120,76,44,0,0,0
2019-09-14 16:00,136,69,67,0,0,0
2019-09-14 16:15,124,55,69,0,0,0
2019-09-14 16:30,105,60,45,0,0,0
2019-09-14 16:45,117,60,57,0,0,0
2019-09-14 17:00,158,91,67,0,0,0
2019-09-14 17:15,122,63,59,0,0,0
2019-09-14 17:30,132,83,49,0,0,0
2019-09-14 17:45,116,50,66,0,0,0
2019-09-14 18:00,128,58,70,0,0,0
2019-09-14 18:15,108,55,53,0,0,0
2019-09-14 18:30,105,59,46,0,0,0
2019-09-14 18:45,117,64,53,0,0,0
2019-09-14 19:00,110,56,54,0,0,0
2019-09-14 19:15,76,39,37,0,0,0
2019-09-14 19:30,89,44,45,0,0,0
2019-09-14 19:45,85,34,51,0,0,0
2019-09-14 20:00,72,37,35,0,0,0
2019-09-14 20:15,72,36,36,0,0,0
2019-09-14 20:30,53,21,32,0,0,0
2019-09-14 20:45,46,26,20,0,0,0
2019-09-14 21:00,51,30,21,0,0,0
2019-09-14 21:15,70,48,22,0,0,0
2019-09-14 21:30,27,14,13,0,0,0
2019-09-14 21:45,38,16,22,0,0,0
2019-09-14 22:00,41,15,26,0,0,0
2019-09-14 22:15,34,18,16,0,0,0
2019-09-14 22:30,40,14,26,0,0,0
2019-09-14 22:45,29,14,15,0,0,0
2019-09-14 23:00,35,19,16,0,0,0
2019-09-14 23:15,35,15,20,0,0,0
2019-09-14 23:30,41,22,19,0,0,0
2019-09-14 23:45,44,21,23,0,0,0
2019-09-15 00:00,29,13,16,0,0,0
2019-09-15 00:15,31,9,22,0,0,0
2019-09-15 00:30,31,16,15,0,0,0
2019-09-15 00:45,18,7,11,0,0,0
2019-09-15 01:00,35,21,14,0,0,0
2019-09-15 01:15,22,8,14,0,0,0
2019-09-15 01:30,27,12,15,0,0,0
2019-09-15 01:45,15,8,7,0,0,0
2019-09-15 02:00,22,7,15,0,0,0
2019-09-15 02:15,18,6,12,0,0,0
2019-09-15 02:30,17,8,9,0,0,0
2019-09-15 02:45,10,1,9,0,0,0
2019-09-15 03:00,12,4,8,0,0,0
2019-09-15 03:15,7,3,4,0,0,0
2019-09-15 03:30,5,0,5,0,0,0
2019-09-15 03:45,6,1,5,0,0,0
2019-09-15 04:00,11,3,8,0,0,0
2019-09-15 04:15,0,0,0,0,0,0
2019-09-15 04:30,4,2,2,0,0,0
2019-09-15 04:45,10,0,10,0,0,0
2019-09-15 05:00,0,0,0,0,0,0
2019-09-15 05:15,1,0,1,0,0,0
2019-09-15 05:30,8,2,6,0,0,0
2019-09-15 05:45,4,2,2,0,0,0
2019-09-15 06:00,3,1,2,0,0,0
2019-09-15 06:15,8,4,4,0,0,0
2019-09-15 06:30,5,3,2,0,0,0
2019-09-15 06:45,9,6,3,0,0,0
2019-09-15 07:00,4,2,2,0,0,0
2019-09-15 07:15,5,1,4,0,0,0
2019-09-15 07:30,8,8,0,0,0,0
2019-09-15 07:45,10,7,3,0,0,0
2019-09-15 08:00,7,3,4,0,0,0
2019-09-15 08:15,10,7,3,0,0,0
2019-09-15 08:30,15,10,5,0,0,0
2019-09-15 08:45,19,14,5,0,0,0
2019-09-15 09:00,15,10,5,0,0,0
2019-09-15 09:15,38,25,13,0,0,0
2019-09-15 09:30,37,24,13,0,0,0
2019-09-15 09:45,48,35,13,0,0,0
2019-09-15 10:00,53,46,7,0,0,0
2019-09-15 10:15,52,34,18,0,0,0
2019-09-15 10:30,68,52,16,0,0,0
2019-09-15 10:45,76,59,17,0,0,0
2019-09-15 11:00,66,49,17,0,0,0
2019-09-15 11:15,61,45,16,0,0,0
2019-09-15 11:30,78,58,20,0,0,0
2019-09-15 11:45,56,27,29,0,0,0
2019-09-15 12:00,63,36,27,0,0,0
2019-09-15 12:15,67,42,25,0,0,0
2019-09-15 12:30,60,30,30,0,0,0
2019-09-15 12:45,78,48,30,0,0,0
2019-09-15 13:00,65,39,26,0,0,0
2019-09-15 13:15,71,29,42,0,0,0
2019-09-15 13:30,93,51,42,0,0,0
2019-09-15 13:45,113,65,48,0,0,0
2019-09-15 14:00,93,57,36,0,0,0
2019-09-15 14:15,106,50,56,0,0,0
2019-09-15 14:30,103,66,37,0,0,0
2019-09-15 14:45,120,63,57,0,0,0
2019-09-15 15:00,113,73,40,0,0,0
2019-09-15 15:15,109,59,50,0,0,0
2019-09-15 15:30,112,61,51,0,0,0
2019-09-15 15:45,127,79,48,0,0,0
2019-09-15 16:00,122,70,52,0,0,0
2019-09-15 16:15,100,53,47,0,0,0
2019-09-15 16:30,89,41,48,0,0,0
2019-09-15 16:45,101,66,35,0,0,0
2019-09-15 17:00,96,52,44,0,0,0
2019-09-15 17:15,105,55,50,0,0,0
2019-09-15 17:30,127,74,53,0,0,0
2019-09-15 17:45,106,64,42,0,0,0
2019-09-15 18:00,92,41,51,0,0,0
2019-09-15 18:15,110,65,45,0,0,0
2019-09-15 18:30,70,37,33,0,0,0
2019-09-15 18:45,78,44,34,0,0,0
2019-09-15 19:00,62,32,30,0,0,0
2019-09-15 19:15,58,42,16,0,0,0
2019-09-15 19:30,45,20,25,0,0,0
2019-09-15 19:45,74,39,35,0,0,0
2019-09-15 20:00,53,25,28,0,0,0
2019-09-15 20:15,45,18,27,0,0,0
2019-09-15 20:30,34,15,19,0,0,0
2019-09-15 20:45,39,16,23,0,0,0
2019-09-15 21:00,39,10,29,0,0,0
2019-09-15 21:15,21,8,13,0,0,0
2019-09-15 21:30,22,8,14,0,0,0
2019-09-15 21:45,28,14,14,0,0,0
2019-09-15 22:00,26,10,16,0,0,0
2019-09-15 22:15,13,8,5,0,0,0
2019-09-15 22:30,19,5,14,0,0,0
2019-09-15 22:45,20,7,13,0,0,0
2019-09-15 23:00,17,10,7,0,0,0
2019-09-15 23:15,11,8,3,0,0,0
2019-09-15 23:30,5,4,1,0,0,0
2019-09-15 23:45,5,4,1,0,0,0
2019-09-16 00:00,7,4,3,4,4,0
2019-09-16 00:15,5,2,3,4,4,0
2019-09-16 00:30,2,1,1,4,4,0
2019-09-16 00:45,3,2,1,4,4,0
2019-09-16 01:00,2,2,0,4,4,0
2019-09-16 01:15,4,1,3,4,4,0
2019-09-16 01:30,3,2,1,4,4,0
2019-09-16 01:45,3,3,0,4,4,0
2019-09-16 02:00,3,0,3,4,4,0
2019-09-16 02:15,0,0,0,4,4,0
2019-09-16 02:30,1,1,0,4,4,0
2019-09-16 02:45,0,0,0,4,4,0
2019-09-16 03:00,1,0,1,4,4,0
2019-09-16 03:15,1,1,0,4,4,0
2019-09-16 03:30,1,1,0,4,4,0
2019-09-16 03:45,2,1,1,4,4,0
2019-09-16 04:00,1,0,1,4,4,0
2019-09-16 04:15,2,0,2,4,4,0
2019-09-16 04:30,2,1,1,4,4,0
2019-09-16 04:45,2,2,0,4,4,0
2019-09-16 05:00,1,0,1,4,4,0
2019-09-16 05:15,4,3,1,4,4,0
2019-09-16 05:30,13,10,3,4,4,0
2019-09-16 05:45,18,10,8,4,4,0
2019-09-16 06:00,11,10,1,4,4,0
2019-09-16 06:15,22,16,6,4,4,0
2019-09-16 06:30,50,35,15,4,4,0
2019-09-16 06:45,62,44,18,4,4,0
2019-09-16 07:00,87,66,21,4,4,0
2019-09-16 07:15,149,115,34,4,4,0
2019-09-16 07:30,227,184,43,4,4,0
2019-09-16 07:45,193,126,67,4,4,0
2019-09-16 08:00,126,95,31,4,4,0
2019-09-16 08:15,136,104,32,4,4,0
2019-09-16 08:30,131,107,24,4,4,0
2019-09-16 08:45,156,131,25,4,4,0
2019-09-16 09:00,101,82,19,4,4,0
2019-09-16 09:15,95,80,15,4,4,0
2019-09-16 09:30,102,80,22,4,4,0
2019-09-16 09:45,113,99,14,4,4,0
2019-09-16 10:00,77,60,17,4,4,0
2019-09-16 10:15,88,64,24,4,4,0
2019-09-16 10:30,89,69,20,4,4,0
2019-09-16 10:45,80,69,11,4,4,0
2019-09-16 11:00,82,67,15,4,4,0
2019-09-16 11:15,87,61,26,4,4,0
2019-09-16 11:30,82,66,16,4,4,0
2019-09-16 11:45,80,58,22,4,4,0
2019-09-16 12:00,88,65,23,4,4,0
2019-09-16 12:15,88,66,22,4,4,0
2019-09-16 12:30,115,67,48,4,4,0
2019-09-16 12:45,91,64,27,4,4,0
2019-09-16 13:00,124,72,52,4,4,0
2019-09-16 13:15,115,59,56,4,4,0
2019-09-16 13:30,103,65,38,4,4,0
2019-09-16 13:45,112,70,42,4,4,0
2019-09-16 14:00,124,61,63,4,4,0
2019-09-16 14:15,107,72,35,4,4,0
2019-09-16 14:30,104,73,31,4,4,0
2019-09-16 14:45,134,74,60,4,4,0
2019-09-16 15:00,121,72,49,4,4,0
2019-09-16 15:15,135,85,50,4,4,0
2019-09-16 15:30,127,73,54,4,4,0
2019-09-16 15:45,153,89,64,4,4,0
2019-09-16 16:00,155,91,64,4,4,0
2019-09-16 16:15,157,88,69,4,4,0
2019-09-16 16:30,149,84,65,4,4,0
2019-09-16 16:45,157,99,58,4,4,0
2019-09-16 17:00,159,90,69,4,4,0
2019-09-16 17:15,171,97,74,4,4,0
2019-09-16 17:30,155,92,63,4,4,0
2019-09-16 17:45,159,87,72,4,4,0
2019-09-16 18:00,149,82,67,4,4,0
2019-09-16 18:15,132,71,61,4,4,0
2019-09-16 18:30,117,67,50,4,4,0
2019-09-16 18:45,121,72,49,4,4,0
2019-09-16 19:00,106,53,53,4,4,0
2019-09-16 19:15,83,51,32,4,4,0
2019-09-16 19:30,92,44,48,4,4,0
2019-09-16 19:45,77,40,37,4,4,0
2019-09-16 20:00,79,42,37,4,4,0
2019-09-16 20:15,72,37,35,4,4,0
2019-09-16 20:30,56,26,30,4,4,0
2019-09-16 20:45,42,21,21,4,4,0
2019-09-16 21:00,51,26,25,4,4,0
2019-09-16 21:15,42,26,16,4,4,0
2019-09-16 21:30,43,19,24,4,4,0
2019-09-16 21:45,38,16,22,4,4,0
2019-09-16 22:00,35,19,16,4,4,0
2019-09-16 22:15,33,20,13,4,4,0
2019-09-16 22:30,26,14,12,4,4,0
2019-09-16 22:45,20,11,9,4,4,0
2019-09-16 23:00,16,10,6,4,4,0
2019-09-16 23:15,22,11,11,4,4,0
2019-09-16 23:30,15,12,3,4,4,0
2019-09-16 23:45,8,3,5,4,4,0
2019-09-17 00:00,10,5,5,4,4,0
2019-09-17 00:15,10,4,6,4,4,0
2019-09-17 00:30,7,5,2,4,4,0
2019-09-17 00:45,4,3,1,4,4,0
2019-09-17 01:00,2,1,1,4,4,0
2019-09-17 01:15,3,2,1,4,4,0
2019-09-17 01:30,3,2,1,4,4,0
2019-09-17 01:45,5,2,3,4,4,0
2019-09-17 02:00,3,1,2,4,4,0
2019-09-17 02:15,1,1,0,4,4,0
2019-09-17 02:30,1,0,1,4,4,0
2019-09-17 02:45,1,1,0,4,4,0
2019-09-17 03:00,2,1,1,4,4,0
2019-09-17 03:15,1,0,1,4,4,0
2019-09-17 03:30,1,1,0,4,4,0
2019-09-17 03:45,1,1,0,4,4,0
2019-09-17 04:00,0,0,0,4,4,0
2019-09-17 04:15,0,0,0,4,4,0
2019-09-17 04:30,1,1,0,4,4,0
2019-09-17 04:45,1,1,0,4,4,0
2019-09-17 05:00,2,1,1,4,4,0
2019-09-17 05:15,5,3,2,4,4,0
2019-09-17 05:30,15,12,3,4,4,0
2019-09-17 05:45,20,10,10,4,4,0
2019-09-17 06:00,16,10,6,4,4,0
2019-09-17 06:15,34,20,14,4,4,0
2019-09-17 06:30,41,29,12,4,4,0
2019-09-17 06:45,75,50,25,4,4,0
2019-09-17 07:00,92,68,24,4,4,0
2019-09-17 07:15,162,118,44,4,4,0
2019-09-17 07:30,243,188,55,4,4,0
2019-09-17 07:45,200,126,74,4,4,0
2019-09-17 08:00,136,102,34,4,4,0
2019-09-17 08:15,147,113,34,4,4,0
2019-09-17 08:30,143,114,29,4,4,0
2019-09-17 08:45,171,126,45,4,4,0
2019-09-17 09:00,106,81,25,4,4,0
2019-09-17 09:15,104,83,21,4,4,0
2019-09-17 09:30,117,84,33,4,4,0
2019-09-17 09:45,142,104,38,4,4,0
2019-09-17 10:00,89,68,21,4,4,0
2019-09-17 10:15,97,68,29,4,4,0
2019-09-17 10:30,110,76,34,4,4,0
2019-09-17 10:45,114,80,34,4,4,0
2019-09-17 11:00,106,73,33,4,4,0
2019-09-17 11:15,95,54,41,4,4,0
2019-09-17 11:30,101,58,43,4,4,0
2019-09-17 11:45,115,65,50,4,4,0
2019-09-17 12:00,122,63,59,4,4,0
2019-09-17 12:15,130,69,61,4,4,0
2019-09-17 12:30,151,75,76,4,4,0
2019-09-17 12:45,130,73,57,4,4,0
2019-09-17 13:00,131,68,63,4,4,0
2019-09-17 13:15,155,67,88,4,4,0
2019-09-17 13:30,117,72,45,4,4,0
2019-09-17 13:45,147,75,72,4,4,0
2019-09-17 14:00,143,64,79,4,4,0
2019-09-17 14:15,117,59,58,4,4,0
2019-09-17 14:30,135,73,62,4,4,0
2019-09-17 14:45,149,81,68,4,4,0
2019-09-17 15:00,118,68,50,4,4,0
2019-09-17 15:15,130,74,56,4,4,0
2019-09-17 15:30,155,83,72,4,4,0
2019-09-17 15:45,166,93,73,4,4,0
2019-09-17 16:00,185,94,91,4,4,0
2019-09-17 16:15,149,87,62,4,4,0
2019-09-17 16:30,176,95,81,4,4,0
2019-09-17 16:45,183,103,80,4,4,0
2019-09-17 17:00,174,93,81,4,4,0
2019-09-17 17:15,178,86,92,4,4,0
2019-09-17 17:30,180,99,81,4,4,0
2019-09-17 17:45,183,101,82,4,4,0
2019-09-17 18:00,192,87,105,4,4,0
2019-09-17 18:15,147,75,72,4,4,0
2019-09-17 18:30,116,53,63,4,4,0
2019-09-17 18:45,146,63,83,4,4,0
2019-09-17 19:00,132,55,77,4,4,0
2019-09-17 19:15,119,59,60,4,4,0
2019-09-17 19:30,113,54,59,4,4,0
2019-09-17 19:45,104,48,56,4,4,0
2019-09-17 20:00,83,39,44,4,4,0
2019-09-17 20:15,69,30,39,4,4,0
2019-09-17 20:30,49,19,30,4,4,0
2019-09-17 20:45,54,23,31,4,4,0
2019-09-17 21:00,50,27,23,4,4,0
2019-09-17 21:15,47,24,23,4,4,0
2019-09-17 21:30,69,24,45,4,4,0
2019-09-17 21:45,57,26,31,4,4,0
2019-09-17 22:00,45,19,26,4,4,0
2019-09-17 22:15,62,21,41,4,4,0
2019-09-17 22:30,38,16,22,4,4,0
2019-09-17 22:45,33,17,16,4,4,0
2019-09-17 23:00,45,12,33,4,4,0
2019-09-17 23:15,27,8,19,4,4,0
2019-09-17 23:30,22,9,13,4,4,0
2019-09-17 23:45,16,11,5,4,4,0
2019-09-18 00:00,13,6,7,4,4,0
2019-09-18 00:15,14,5,9,4,4,0
2019-09-18 00:30,8,4,4,4,4,0
2019-09-18 00:45,5,2,3,4,4,0
2019-09-18 01:00,4,3,1,4,4,0
2019-09-18 01:15,2,1,1,4,4,0
2019-09-18 01:30,7,4,3,4,4,0
2019-09-18 01:45,3,3,0,4,4,0
2019-09-18 02:00,4,1,3,4,4,0
2019-09-18 02:15,2,1,1,4,4,0
2019-09-18 02:30,1,1,0,4,4,0
2019-09-18 02:45,3,2,1,4,4,0
2019-09-18 03:00,2,1,1,4,4,0
2019-09-18 03:15,1,1,0,4,4,0
2019-09-18 03:30,1,1,0,4,4,0
2019-09-18 03:45,2,1,1,4,4,0
2019-09-18 04:00,0,0,0,4,4,0
2019-09-18 04:15,1,1,0,4,4,0
2019-09-18 04:30,1,1,0,4,4,0
2019-09-18 04:45,2,2,0,4,4,0
2019-09-18 05:00,1,1,0,4,4,0
2019-09-18 05:15,5,3,2,4,4,0
2019-09-18 05:30,12,8,4,4,4,0
2019-09-18 05:45,20,11,9,4,4,0
2019-09-18 06:00,15,11,4,4,4,0
2019-09-18 06:15,28,16,12,4,4,0
2019-09-18 06:30,54,30,24,4,4,0
2019-09-18 06:45,61,40,21,4,4,0
2019-09-18 07:00,96,69,27,4,4,0
2019-09-18 07:15,165,122,43,4,4,0
2019-09-18 07:30,250,181,69,4,4,0
2019-09-18 07:45,189,121,68,4,4,0
2019-09-18 08:00,145,113,32,4,4,0
2019-09-18 08:15,156,113,43,4,4,0
2019-09-18 08:30,139,103,36,4,4,0
2019-09-18 08:45,164,130,34,4,4,0
2019-09-18 09:00,109,87,22,4,4,0
2019-09-18 09:15,136,109,27,4,4,0
2019-09-18 09:30,121,94,27,4,4,0
2019-09-18 09:45,141,111,30,4,4,0
2019-09-18 10:00,106,90,16,4,4,0
2019-09-18 10:15,117,91,26,4,4,0
2019-09-18 10:30,126,93,33,4,4,0
2019-09-18 10:45,142,94,48,4,4,0
2019-09-18 11:00,134,89,45,4,4,0
2019-09-18 11:15,136,95,41,4,4,0
2019-09-18 11:30,139,90,49,4,4,0
2019-09-18 11:45,139,96,43,4,4,0
2019-09-18 12:00,130,88,42,4,4,0
2019-09-18 12:15,150,91,59,4,4,0
2019-09-18 12:30,158,75,83,4,4,0
2019-09-18 12:45,158,83,75,4,4,0
2019-09-18 13:00,178,84,94,4,4,0
2019-09-18 13:15,149,70,79,4,4,0
2019-09-18 13:30,139,71,68,4,4,0
2019-09-18 13:45,137,71,66,4,4,0
2019-09-18 14:00,156,65,91,4,4,0
2019-09-18 14:15,109,62,47,4,4,0
2019-09-18 14:30,131,59,72,4,4,0
2019-09-18 14:45,157,82,75,4,4,0
2019-09-18 15:00,150,71,79,4,4,0
2019-09-18 15:15,158,63,95,4,4,0
2019-09-18 15:30,160,66,94,4,4,0
2019-09-18 15:45,167,85,82,4,4,0
2019-09-18 16:00,174,83,91,4,4,0
2019-09-18 16:15,151,74,77,4,4,0
2019-09-18 16:30,178,92,86,4,4,0
2019-09-18 16:45,197,91,106,4,4,0
2019-09-18 17:00,168,84,84,4,4,0
2019-09-18 17:15,167,81,86,4,4,0
2019-09-18 17:30,155,78,77,4,4,0
2019-09-18 17:45,176,92,84,4,4,0
2019-09-18 18:00,152,62,90,4,4,0
2019-09-18 18:15,157,67,90,4,4,0
2019-09-18 18:30,129,56,73,4,4,0
2019-09-18 18:45,138,62,76,4,4,0
2019-09-18 19:00,121,50,71,4,4,0
2019-09-18 19:15,127,52,75,4,4,0
2019-09-18 19:30,98,43,55,4,4,0
2019-09-18 19:45,86,41,45,4,4,0
2019-09-18 20:00,97,39,58,4,4,0
2019-09-18 20:15,58,25,33,4,4,0
2019-09-18 20:30,48,23,25,4,4,0
2019-09-18 20:45,57,28,29,4,4,0
2019-09-18 21:00,58,24,34,4,4,0
2019-09-18 21:15,51,26,25,4,4,0
2019-09-18 21:30,37,16,21,4,4,0
2019-09-18 21:45,47,20,27,4,4,0
2019-09-18 22:00,50,22,28,4,4,0
2019-09-18 22:15,50,27,23,4,4,0
2019-09-18 22:30,52,21,31,4,4,0
2019-09-18 22:45,44,16,28,4,4,0
2019-09-18 23:00,43,16,27,4,4,0
2019-09-18 23:15,25,11,14,4,4,0
2019-09-18 23:30,23,14,9,4,4,0
2019-09-18 23:45,19,10,9,4,4,0
2019-09-19 00:00,19,7,12,4,4,0
2019-09-19 00:15,13,4,9,4,4,0
2019-09-19 00:30,10,5,5,4,4,0
2019-09-19 00:45,12,7,5,4,4,0
2019-09-19 01:00,8,4,4,4,4,0
2019-09-19 01:15,7,3,4,4,4,0
2019-09-19 01:30,8,5,3,4,4,0
2019-09-19 01:45,10,3,7,4,4,0
2019-09-19 02:00,7,1,6,4,4,0
2019-09-19 02:15,2,1,1,4,4,0
2019-09-19 02:30,4,0,4,4,4,0
2019-09-19 02:45,3,1,2,4,4,0
2019-09-19 03:00,7,1,6,4,4,0
2019-09-19 03:15,5,0,5,4,4,0
2019-09-19 03:30,1,0,1,4,4,0
2019-09-19 03:45,4,1,3,4,4,0
2019-09-19 04:00,2,1,1,4,4,0
2019-09-19 04:15,3,0,3,4,4,0
2019-09-19 04:30,2,0,2,4,4,0
2019-09-19 04:45,2,1,1,4,4,0
2019-09-19 05:00,3,0,3,4,4,0
2019-09-19 05:15,2,1,1,4,4,0
2019-09-19 05:30,15,9,6,4,4,0
2019-09-19 05:45,17,10,7,4,4,0
2019-09-19 06:00,16,13,3,4,4,0
2019-09-19 06:15,27,16,11,4,4,0
2019-09-19 06:30,50,30,20,4,4,0
2019-09-19 06:45,70,47,23,4,4,0
2019-09-19 07:00,72,56,16,4,4,0
2019-09-19 07:15,170,126,44,4,4,0
2019-09-19 07:30,248,200,48,4,4,0
2019-09-19 07:45,207,127,80,4,4,0
2019-09-19 08:00,131,101,30,4,4,0
2019-09-19 08:15,149,107,42,4,4,0
2019-09-19 08:30,152,117,35,4,4,0
2019-09-19 08:45,173,134,39,4,4,0
2019-09-19 09:00,98,80,18,4,4,0
2019-09-19 09:15,105,81,24,4,4,0
2019-09-19 09:30,108,80,28,4,4,0
2019-09-19 09:45,126,94,32,4,4,0
2019-09-19 10:00,91,66,25,4,4,0
2019-09-19 10:15,86,68,18,4,4,0
2019-09-19 10:30,89,59,30,4,4,0
2019-09-19 10:45,110,78,32,4,4,0
2019-09-19 11:00,100,61,39,4,4,0
2019-09-19 11:15,108,61,47,4,4,0
2019-09-19 11:30,104,64,40,4,4,0
2019-09-19 11:45,111,70,41,4,4,0
2019-09-19 12:00,116,68,48,4,4,0
2019-09-19 12:15,111,66,45,4,4,0
2019-09-19 12:30,123,64,59,4,4,0
2019-09-19 12:45,120,67,53,4,4,0
2019-09-19 13:00,137,64,73,4,4,0
2019-09-19 13:15,122,53,69,4,4,0
2019-09-19 13:30,106,60,46,4,4,0
2019-09-19 13:45,136,75,61,4,4,0
2019-09-19 14:00,141,62,79,4,4,0
2019-09-19 14:15,129,64,65,4,4,0
2019-09-19 14:30,111,59,52,4,4,0
2019-09-19 14:45,144,82,62,4,4,0
2019-09-19 15:00,143,68,75,4,4,0
2019-09-19 15:15,148,80,68,4,4,0
2019-09-19 15:30,160,77,83,4,4,0
2019-09-19 15:45,181,98,83,4,4,0
2019-09-19 16:00,174,96,78,4,4,0
2019-09-19 16:15,162,81,81,4,4,0
2019-09-19 16:30,181,93,88,4,4,0
2019-09-19 16:45,186,101,85,4,4,0
2019-09-19 17:00,161,80,81,4,4,0
2019-09-19 17:15,165,87,78,4,4,0
2019-09-19 17:30,188,95,93,4,4,0
2019-09-19 17:45,184,98,86,4,4,0
2019-09-19 18:00,179,84,95,4,4,0
2019-09-19 18:15,160,76,84,4,4,0
2019-09-19 18:30,137,69,68,4,4,0
2019-09-19 18:45,159,93,66,4,4,0
2019-09-19 19:00,135,71,64,4,4,0
2019-09-19 19:15,128,68,60,4,4,0
2019-09-19 19:30,110,56,54,4,4,0
2019-09-19 19:45,98,47,51,4,4,0
2019-09-19 20:00,96,40,56,4,4,0
2019-09-19 20:15,83,37,46,4,4,0
2019-09-19 20:30,69,32,37,4,4,0
2019-09-19 20:45,67,40,27,4,4,0
2019-09-19 21:00,57,28,29,4,4,0
2019-09-19 21:15,59,27,32,4,4,0
2019-09-19 21:30,53,28,25,4,4,0
2019-09-19 21:45,52,25,27,4,4,0
2019-09-19 22:00,48,27,21,4,4,0
2019-09-19 22:15,57,19,38,4,4,0
2019-09-19 22:30,50,20,30,4,4,0
2019-09-19 22:45,40,14,26,4,4,0
2019-09-19 23:00,40,11,29,4,4,0
2019-09-19 23:15,26,11,15,4,4,0
2019-09-19 23:30,28,11,17,4,4,0
2019-09-19 23:45,16,8,8,4,4,0
2019-09-20 00:00,17,10,7,4,4,0
2019-09-20 00:15,11,3,8,4,4,0
2019-09-20 00:30,5,2,3,4,4,0
2019-09-20 00:45,8,4,4,4,4,0
2019-09-20 01:00,5,1,4,4,4,0
2019-09-20 01:15,11,3,8,4,4,0
2019-09-20 01:30,5,1,4,4,4,0
2019-09-20 01:45,6,3,3,4,4,0
2019-09-20 02:00,3,1,2,4,4,0
2019-09-20 02:15,2,0,2,4,4,0
2019-09-20 02:30,1,1,0,4,4,0
2019-09-20 02:45,2,0,2,4,4,0
2019-09-20 03:00,2,0,2,4,4,0
2019-09-20 03:15,3,1,2,4,4,0
2019-09-20 03:30,2,0,2,4,4,0
2019-09-20 03:45,1,1,0,4,4,0
2019-09-20 04:00,1,1,0,4,4,0
2019-09-20 04:15,3,0,3,4,4,0
2019-09-20 04:30,0,0,0,4,4,0
2019-09-20 04:45,2,2,0,4,4,0
2019-09-20 05:00,1,1,0,4,4,0
2019-09-20 05:15,4,1,3,4,4,0
2019-09-20 05:30,7,4,3,4,4,0
2019-09-20 05:45,22,13,9,4,4,0
2019-09-20 06:00,16,13,3,4,4,0
2019-09-20 06:15,24,16,8,4,4,0
2019-09-20 06:30,48,31,17,4,4,0
2019-09-20 06:45,61,46,15,4,4,0
2019-09-20 07:00,78,54,24,4,4,0
2019-09-20 07:15,172,129,43,4,4,0
2019-09-20 07:30,277,225,52,4,4,0
2019-09-20 07:45,193,132,61,4,4,0
2019-09-20 08:00,127,97,30,4,4,0
2019-09-20 08:15,121,90,31,4,4,0
2019-09-20 08:30,135,100,35,4,4,0
2019-09-20 08:45,150,113,37,4,4,0
2019-09-20 09:00,106,82,24,4,4,0
2019-09-20 09:15,108,75,33,4,4,0
2019-09-20 09:30,107,79,28,4,4,0
2019-09-20 09:45,136,105,31,4,4,0
2019-09-20 10:00,88,63,25,4,4,0
2019-09-20 10:15,83,53,30,4,4,0
2019-09-20 10:30,94,58,36,4,4,0
2019-09-20 10:45,128,82,46,4,4,0
2019-09-20 11:00,120,66,54,4,4,0
2019-09-20 11:15,138,66,72,4,4,0
2019-09-20 11:30,128,65,63,4,4,0
2019-09-20 11:45,143,77,66,4,4,0
2019-09-20 12:00,142,72,70,4,4,0
2019-09-20 12:15,136,77,59,4,4,0
2019-09-20 12:30,170,85,85,4,4,0
2019-09-20 12:45,180,78,102,4,4,0
2019-09-20 13:00,204,75,129,4,4,0
2019-09-20 13:15,221,67,154,4,4,0
2019-09-20 13:30,201,77,124,4,4,0
2019-09-20 13:45,186,80,106,4,4,0
2019-09-20 14:00,212,84,128,4,4,0
2019-09-20 14:15,157,72,85,4,4,0
2019-09-20 14:30,172,84,88,4,4,0
2019-09-20 14:45,171,76,95,4,4,0
2019-09-20 15:00,170,87,83,4,4,0
2019-09-20 15:15,183,100,83,4,4,0
2019-09-20 15:30,189,93,96,4,4,0
2019-09-20 15:45,159,82,77,4,4,0
2019-09-20 16:00,164,96,68,4,4,0
2019-09-20 16:15,147,80,67,4,4,0
2019-09-20 16:30,161,87,74,4,4,0
2019-09-20 16:45,172,89,83,4,4,0
2019-09-20 17:00,148,84,64,4,4,0
2019-09-20 17:15,169,86,83,4,4,0
2019-09-20 17:30,151,84,67,4,4,0
2019-09-20 17:45,154,79,75,4,4,0
2019-09-20 18:00,144,89,55,4,4,0
2019-09-20 18:15,166,97,69,4,4,0
2019-09-20 18:30,124,66,58,4,4,0
2019-09-20 18:45,163,82,81,4,4,0
2019-09-20 19:00,142,71,71,4,4,0
2019-09-20 19:15,129,70,59,4,4,0
2019-09-20 19:30,105,52,53,4,4,0
2019-09-20 19:45,100,68,32,4,4,0
2019-09-20 20:00,103,58,45,4,4,0
2019-09-20 20:15,90,46,44,4,4,0
2019-09-20 20:30,75,42,33,4,4,0
2019-09-20 20:45,76,42,34,4,4,0
2019-09-20 21:00,67,36,31,4,4,0
2019-09-20 21:15,60,32,28,4,4,0
2019-09-20 21:30,71,32,39,4,4,0
2019-09-20 21:45,49,24,25,4,4,0
2019-09-20 22:00,45,26,19,4,4,0
2019-09-20 22:15,38,22,16,4,4,0
2019-09-20 22:30,45,20,25,4,4,0
2019-09-20 22:45,52,20,32,4,4,0
2019-09-20 23:00,42,21,21,4,4,0
2019-09-20 23:15,34,15,19,4,4,0
2019-09-20 23:30,35,19,16,4,4,0
2019-09-20 23:45,35,21,14,4,4,0
2019-09-21 00:00,32,15,17,4,4,0
2019-09-21 00:15,24,12,12,4,4,0
2019-09-21 00:30,24,14,10,4,4,0
2019-09-21 00:45,23,12,11,4,4,0
2019-09-21 01:00,22,9,13,4,4,0
2019-09-21 01:15,17,11,6,4,4,0
2019-09-21 01:30,23,8,15,4,4,0
2019-09-21 01:45,21,7,14,4,4,0
2019-09-21 02:00,14,4,10,4,4,0
2019-09-21 02:15,6,3,3,4,4,0
2019-09-21 02:30,10,2,8,4,4,0
2019-09-21 02:45,11,5,6,4,4,0
2019-09-21 03:00,8,4,4,4,4,0
2019-09-21 03:15,6,1,5,4,4,0
2019-09-21 03:30,3,1,2,4,4,0
2019-09-21 03:45,7,2,5,4,4,0
2019-09-21 04:00,9,2,7,4,4,0
2019-09-21 04:15,2,1,1,4,4,0
2019-09-21 04:30,6,2,4,4,4,0
2019-09-21 04:45,9,3,6,4,4,0
2019-09-21 05:00,1,1,0,4,4,0
2019-09-21 05:15,5,2,3,4,4,0
2019-09-21 05:30,8,5,3,4,4,0
2019-09-21 05:45,9,5,4,4,4,0
2019-09-21 06:00,8,5,3,4,4,0
2019-09-21 06:15,8,7,1,4,4,0
2019-09-21 06:30,4,3,1,4,4,0
2019-09-21 06:45,10,9,1,4,4,0
2019-09-21 07:00,11,9,2,4,4,0
2019-09-21 07:15,16,9,7,4,4,0
2019-09-21 07:30,21,14,7,4,4,0
2019-09-21 07:45,29,20,9,4,4,0
2019-09-21 08:00,26,21,5,4,4,0
2019-09-21 08:15,40,27,13,4,4,0
2019-09-21 08:30,50,39,11,4,4,0
2019-09-21 08:45,60,48,12,4,4,0
2019-09-21 09:00,58,41,17,4,4,0
2019-09-21 09:15,79,63,16,4,4,0
2019-09-21 09:30,96,73,23,4,4,0
2019-09-21 09:45,119,98,21,4,4,0
2019-09-21 10:00,118,86,32,4,4,0
2019-09-21 10:15,122,100,22,4,4,0
2019-09-21 10:30,134,108,26,4,4,0
2019-09-21 10:45,163,124,39,4,4,0
2019-09-21 11:00,138,101,37,4,4,0
2019-09-21 11:15,155,116,39,4,4,0
2019-09-21 11:30,195,126,69,4,4,0
2019-09-21 11:45,198,127,71,4,4,0
2019-09-21 12:00,173,114,59,4,4,0
2019-09-21 12:15,181,124,57,4,4,0
2019-09-21 12:30,183,108,75,4,4,0
2019-09-21 12:45,211,119,92,4,4,0
2019-09-21 13:00,189,107,82,4,4,0
2019-09-21 13:15,206,103,103,4,4,0
2019-09-21 13:30,170,92,78,4,4,0
2019-09-21 13:45,186,94,92,4,4,0
2019-09-21 14:00,163,87,76,4,4,0
2019-09-21 14:15,153,77,76,4,4,0
2019-09-21 14:30,141,54,87,4,4,0
2019-09-21 14:45,183,67,116,4,4,0
2019-09-21 15:00,170,65,105,4,4,0
2019-09-21 15:15,164,65,99,4,4,0
2019-09-21 15:30,165,74,91,4,4,0
2019-09-21 15:45,150,70,80,4,4,0
2019-09-21 16:00,127,64,63,4,4,0
2019-09-21 16:15,126,57,69,4,4,0
2019-09-21 16:30,117,62,55,4,4,0
2019-09-21 16:45,139,71,68,4,4,0
2019-09-21 17:00,130,68,62,4,4,0
2019-09-21 17:15,134,63,71,4,4,0
2019-09-21 17:30,134,66,68,4,4,0
2019-09-21 17:45,137,79,58,4,4,0
2019-09-21 18:00,155,81,74,4,4,0
2019-09-21 18:15,123,62,61,4,4,0
2019-09-21 18:30,127,66,61,4,4,0
2019-09-21 18:45,146,78,68,4,4,0
2019-09-21 19:00,125,73,52,4,4,0
2019-09-21 19:15,124,65,59,4,4,0
2019-09-21 19:30,99,55,44,4,4,0
2019-09-21 19:45,101,64,37,4,4,0
2019-09-21 20:00,104,61,43,4,4,0
2019-09-21 20:15,97,59,38,4,4,0
2019-09-21 20:30,78,49,29,4,4,0
2019-09-21 20:45,72,53,19,4,4,0
2019-09-21 21:00,66,36,30,4,4,0
2019-09-21 21:15,62,40,22,4,4,0
2019-09-21 21:30,45,25,20,4,4,0
2019-09-21 21:45,40,24,16,4,4,0
2019-09-21 22:00,30,17,13,4,4,0
2019-09-21 22:15,47,20,27,4,4,0
2019-09-21 22:30,29,11,18,4,4,0
2019-09-21 22:45,38,15,23,4,4,0
2019-09-21 23:00,38,16,22,4,4,0
2019-09-21 23:15,37,18,19,4,4,0
2019-09-21 23:30,30,19,11,4,4,0
2019-09-21 23:45,37,12,25,4,4,0
2019-09-22 00:00,21,14,7,4,4,0
2019-09-22 00:15,30,14,16,4,4,0
2019-09-22 00:30,33,16,17,4,4,0
2019-09-22 00:45,22,11,11,4,4,0
2019-09-22 01:00,27,16,11,4,4,0
2019-09-22 01:15,20,9,11,4,4,0
2019-09-22 01:30,23,11,12,4,4,0
2019-09-22 01:45,18,8,10,4,4,0
2019-09-22 02:00,15,5,10,4,4,0
2019-09-22 02:15,16,6,10,4,4,0
2019-09-22 02:30,12,8,4,4,4,0
2019-09-22 02:45,21,4,17,4,4,0
2019-09-22 03:00,13,4,9,4,4,0
2019-09-22 03:15,8,3,5,4,4,0
2019-09-22 03:30,7,3,4,4,4,0
2019-09-22 03:45,8,2,6,4,4,0
2019-09-22 04:00,7,3,4,4,4,0
2019-09-22 04:15,4,1,3,4,4,0
2019-09-22 04:30,1,1,0,4,4,0
2019-09-22 04:45,3,1,2,4,4,0
2019-09-22 05:00,0,0,0,4,4,0
2019-09-22 05:15,1,1,0,4,4,0
2019-09-22 05:30,5,3,2,4,4,0
2019-09-22 05:45,6,4,2,4,4,0
2019-09-22 06:00,3,1,2,4,4,0
2019-09-22 06:15,6,5,1,4,4,0
2019-09-22 06:30,4,3,1,4,4,0
2019-09-22 06:45,5,5,0,4,4,0
2019-09-22 07:00,1,1,0,4,4,0
2019-09-22 07:15,6,4,2,4,4,0
2019-09-22 07:30,15,9,6,4,4,0
2019-09-22 07:45,13,10,3,4,4,0
2019-09-22 08:00,17,15,2,4,4,0
2019-09-22 08:15,29,26,3,4,4,0
2019-09-22 08:30,29,25,4,4,4,0
2019-09-22 08:45,29,21,8,4,4,0
2019-09-22 09:00,21,16,5,4,4,0
2019-09-22 09:15,36,28,8,4,4,0
2019-09-22 09:30,35,25,10,4,4,0
2019-09-22 09:45,62,44,18,4,4,0
2019-09-22 10:00,48,36,12,4,4,0
2019-09-22 10:15,46,32,14,4,4,0
2019-09-22 10:30,57,36,21,4,4,0
2019-09-22 10:45,71,48,23,4,4,0
2019-09-22 11:00,68,36,32,4,4,0
2019-09-22 11:15,58,41,17,4,4,0
2019-09-22 11:30,63,42,21,4,4,0
2019-09-22 11:45,69,41,28,4,4,0
2019-09-22 12:00,53,39,14,4,4,0
2019-09-22 12:15,68,42,26,4,4,0
2019-09-22 12:30,74,40,34,4,4,0
2019-09-22 12:45,87,44,43,4,4,0
2019-09-22 13:00,69,40,29,4,4,0
2019-09-22 13:15,71,40,31,4,4,0
2019-09-22 13:30,94,47,47,4,4,0
2019-09-22 13:45,84,47,37,4,4,0
2019-09-22 14:00,103,51,52,4,4,0
2019-09-22 14:15,106,48,58,4,4,0
2019-09-22 14:30,94,56,38,4,4,0
2019-09-22 14:45,120,60,60,4,4,0
2019-09-22 15:00,93,48,45,4,4,0
2019-09-22 15:15,102,45,57,4,4,0
2019-09-22 15:30,86,51,35,4,4,0
2019-09-22 15:45,105,59,46,4,4,0
2019-09-22 16:00,94,54,40,4,4,0
2019-09-22 16:15,87,53,34,4,4,0
2019-09-22 16:30,90,51,39,4,4,0
2019-09-22 16:45,111,55,56,4,4,0
2019-09-22 17:00,111,51,60,4,4,0
2019-09-22 17:15,102,60,42,4,4,0
2019-09-22 17:30,118,67,51,4,4,0
2019-09-22 17:45,113,58,55,4,4,0
2019-09-22 18:00,89,43,46,4,4,0
2019-09-22 18:15,79,49,30,4,4,0
2019-09-22 18:30,78,45,33,4,4,0
2019-09-22 18:45,87,47,40,4,4,0
2019-09-22 19:00,61,32,29,4,4,0
2019-09-22 19:15,66,33,33,4,4,0
2019-09-22 19:30,65,31,34,4,4,0
2019-09-22 19:45,64,34,30,4,4,0
2019-09-22 20:00,63,23,40,4,4,0
2019-09-22 20:15,53,24,29,4,4,0
2019-09-22 20:30,51,21,30,4,4,0
2019-09-22 20:45,44,18,26,4,4,0
2019-09-22 21:00,36,12,24,4,4,0
2019-09-22 21:15,35,20,15,4,4,0
2019-09-22 21:30,33,18,15,4,4,0
2019-09-22 21:45,29,14,15,4,4,0
2019-09-22 22:00,28,12,16,4,4,0
2019-09-22 22:15,23,11,12,4,4,0
2019-09-22 22:30,20,11,9,4,4,0
2019-09-22 22:45,16,6,10,4,4,0
2019-09-22 23:00,17,8,9,4,4,0
2019-09-22 23:15,11,5,6,4,4,0
2019-09-22 23:30,9,5,4,4,4,0
2019-09-22 23:45,6,3,3,4,4,0
2019-09-23 00:00,6,4,2,4,4,0
2019-09-23 00:15,2,2,0,4,4,0
2019-09-23 00:30,3,0,3,4,4,0
2019-09-23 00:45,2,2,0,4,4,0
2019-09-23 01:00,2,2,0,4,4,0
2019-09-23 01:15,2,1,1,4,4,0
2019-09-23 01:30,2,2,0,4,4,0
2019-09-23 01:45,4,3,1,4,4,0
2019-09-23 02:00,0,0,0,4,4,0
2019-09-23 02:15,0,0,0,4,4,0
2019-09-23 02:30,1,1,0,4,4,0
2019-09-23 02:45,0,0,0,4,4,0
2019-09-23 03:00,0,0,0,4,4,0
2019-09-23 03:15,1,1,0,4,4,0
2019-09-23 03:30,0,0,0,4,4,0
2019-09-23 03:45,1,1,0,4,4,0
2019-09-23 04:00,2,0,2,4,4,0
2019-09-23 04:15,0,0,0,4,4,0
2019-09-23 04:30,2,1,1,4,4,0
2019-09-23 04:45,2,2,0,4,4,0
2019-09-23 05:00,2,0,2,4,4,0
2019-09-23 05:15,4,3,1,4,4,0
2019-09-23 05:30,10,10,0,4,4,0
2019-09-23 05:45,19,11,8,4,4,0
2019-09-23 06:00,15,10,5,4,4,0
2019-09-23 06:15,24,17,7,4,4,0
2019-09-23 06:30,51,34,17,4,4,0
2019-09-23 06:45,62,48,14,4,4,0
2019-09-23 07:00,92,70,22,4,4,0
2019-09-23 07:15,161,128,33,4,4,0
2019-09-23 07:30,256,212,44,4,4,0
2019-09-23 07:45,192,131,61,4,4,0
2019-09-23 08:00,123,101,22,4,4,0
2019-09-23 08:15,136,108,28,4,4,0
2019-09-23 08:30,144,112,32,4,4,0
2019-09-23 08:45,158,134,24,4,4,0
2019-09-23 09:00,99,84,15,4,4,0
2019-09-23 09:15,99,85,14,4,4,0
2019-09-23 09:30,105,81,24,4,4,0
2019-09-23 09:45,131,104,27,4,4,0
2019-09-23 10:00,80,59,21,4,4,0
2019-09-23 10:15,76,65,11,4,4,0
2019-09-23 10:30,97,68,29,4,4,0
2019-09-23 10:45,95,70,25,4,4,0
2019-09-23 11:00,89,65,24,4,4,0
2019-09-23 11:15,94,58,36,4,4,0
2019-09-23 11:30,88,66,22,4,4,0
2019-09-23 11:45,88,55,33,4,4,0
2019-09-23 12:00,101,66,35,4,4,0
2019-09-23 12:15,105,64,41,4,4,0
2019-09-23 12:30,118,66,52,4,4,0
2019-09-23 12:45,103,65,38,4,4,0
2019-09-23 13:00,129,72,57,4,4,0
2019-09-23 13:15,119,58,61,4,4,0
2019-09-23 13:30,118,67,51,4,4,0
2019-09-23 13:45,119,67,52,4,4,0
2019-09-23 14:00,130,64,66,4,4,0
2019-09-23 14:15,114,71,43,4,4,0
2019-09-23 14:30,118,75,43,4,4,0
2019-09-23 14:45,117,75,42,4,4,0
2019-09-23 15:00,151,75,76,4,4,0
2019-09-23 15:15,142,90,52,4,4,0
2019-09-23 15:30,151,77,74,4,4,0
2019-09-23 15:45,166,88,78,4,4,0
2019-09-23 16:00,158,92,66,4,4,0
2019-09-23 16:15,167,92,75,4,4,0
2019-09-23 16:30,157,85,72,4,4,0
2019-09-23 16:45,191,104,87,4,4,0
2019-09-23 17:00,168,91,77,4,4,0
2019-09-23 17:15,174,96,78,4,4,0
2019-09-23 17:30,176,91,85,4,4,0
2019-09-23 17:45,163,89,74,4,4,0
2019-09-23 18:00,157,83,74,4,4,0
2019-09-23 18:15,149,70,79,4,4,0
2019-09-23 18:30,120,68,52,4,4,0
2019-09-23 18:45,133,74,59,4,4,0
2019-09-23 19:00,112,56,56,4,4,0
2019-09-23 19:15,105,51,54,4,4,0
2019-09-23 19:30,84,47,37,4,4,0
2019-09-23 19:45,99,43,56,4,4,0
2019-09-23 20:00,89,42,47,4,4,0
2019-09-23 20:15,76,39,37,4,4,0
2019-09-23 20:30,56,25,31,4,4,0
2019-09-23 20:45,36,21,15,4,4,0
2019-09-23 21:00,54,28,26,4,4,0
2019-09-23 21:15,61,28,33,4,4,0
2019-09-23 21:30,42,17,25,4,4,0
2019-09-23 21:45,36,16,20,4,4,0
2019-09-23 22:00,43,20,23,4,4,0
2019-09-23 22:15,37,20,17,4,4,0
2019-09-23 22:30,34,15,19,4,4,0
2019-09-23 22:45,25,10,15,4,4,0
2019-09-23 23:00,17,9,8,4,4,0
2019-09-23 23:15,19,10,9,4,4,0
2019-09-23 23:30,23,13,10,4,4,0
2019-09-23 23:45,7,2,5,4,4,0
2019-09-24 00:00,7,5,2,4,4,0
2019-09-24 00:15,3,3,0,4,4,0
2019-09-24 00:30,7,4,3,4,4,0
2019-09-24 00:45,6,3,3,4,4,0
2019-09-24 01:00,2,1,1,4,4,0
2019-09-24 01:15,6,2,4,4,4,0
2019-09-24 01:30,4,2,2,4,4,0
2019-09-24 01:45,4,1,3,4,4,0
2019-09-24 02:00,2,1,1,4,4,0
2019-09-24 02:15,4,1,3,4,4,0
2019-09-24 02:30,1,0,1,4,4,0
2019-09-24 02:45,1,1,0,4,4,0
2019-09-24 03:00,1,1,0,4,4,0
2019-09-24 03:15,0,0,0,4,4,0
2019-09-24 03:30,1,1,0,4,4,0
2019-09-24 03:45,1,1,0,4,4,0
2019-09-24 04:00,0,0,0,4,4,0
2019-09-24 04:15,3,0,3,4,4,0
2019-09-24 04:30,1,1,0,4,4,0
2019-09-24 04:45,3,1,2,4,4,0
2019-09-24 05:00,1,1,0,4,4,0
2019-09-24 05:15,4,3,1,4,4,0
2019-09-24 05:30,17,12,5,4,4,0
2019-09-24 05:45,19,10,9,4,4,0
2019-09-24 06:00,17,11,6,4,4,0
2019-09-24 06:15,29,21,8,4,4,0
2019-09-24 06:30,50,29,21,4,4,0
2019-09-24 06:45,71,52,19,4,4,0
2019-09-24 07:00,91,67,24,4,4,0
2019-09-24 07:15,182,131,51,4,4,0
2019-09-24 07:30,268,215,53,4,4,0
2019-09-24 07:45,211,133,78,4,4,0
2019-09-24 08:00,144,105,39,4,4,0
2019-09-24 08:15,163,119,44,4,4,0
2019-09-24 08:30,153,117,36,4,4,0
2019-09-24 08:45,166,135,31,4,4,0
2019-09-24 09:00,116,83,33,4,4,0
2019-09-24 09:15,118,81,37,4,4,0
2019-09-24 09:30,117,87,30,4,4,0
2019-09-24 09:45,112,106,6,4,4,0
2019-09-24 10:00,90,65,25,4,4,0
2019-09-24 10:15,95,65,30,4,4,0
2019-09-24 10:30,101,79,22,4,4,0
2019-09-24 10:45,109,80,29,4,4,0
2019-09-24 11:00,106,74,32,4,4,0
2019-09-24 11:15,100,54,46,4,4,0
2019-09-24 11:30,98,55,43,4,4,0
2019-09-24 11:45,104,65,39,4,4,0
2019-09-24 12:00,113,65,48,4,4,0
2019-09-24 12:15,110,68,42,4,4,0
2019-09-24 12:30,139,74,65,4,4,0
2019-09-24 12:45,137,72,65,4,4,0
2019-09-24 13:00,135,65,70,4,4,0
2019-09-24 13:15,151,72,79,4,4,0
2019-09-24 13:30,130,70,60,4,4,0
2019-09-24 13:45,139,72,67,4,4,0
2019-09-24 14:00,155,65,90,4,4,0
2019-09-24 14:15,100,60,40,4,4,0
2019-09-24 14:30,136,71,65,4,4,0
2019-09-24 14:45,146,79,67,4,4,0
2019-09-24 15:00,149,68,81,4,4,0
2019-09-24 15:15,164,75,89,4,4,0
2019-09-24 15:30,183,88,95,4,4,0
2019-09-24 15:45,189,92,97,4,4,0
2019-09-24 16:00,173,94,79,4,4,0
2019-09-24 16:15,185,88,97,4,4,0
2019-09-24 16:30,205,94,111,4,4,0
2019-09-24 16:45,199,103,96,4,4,0
2019-09-24 17:00,191,96,95,4,4,0
2019-09-24 17:15,195,86,109,4,4,0
2019-09-24 17:30,183,93,90,4,4,0
2019-09-24 17:45,224,103,121,4,4,0
2019-09-24 18:00,179,90,89,4,4,0
2019-09-24 18:15,149,78,71,4,4,0
2019-09-24 18:30,132,55,77,4,4,0
2019-09-24 18:45,138,59,79,4,4,0
2019-09-24 19:00,136,52,84,4,4,0
2019-09-24 19:15,112,62,50,4,4,0
2019-09-24 19:30,100,56,44,4,4,0
2019-09-24 19:45,92,49,43,4,4,0
2019-09-24 20:00,79,42,37,4,4,0
2019-09-24 20:15,71,32,39,4,4,0
2019-09-24 20:30,48,20,28,4,4,0
2019-09-24 20:45,57,25,32,4,4,0
2019-09-24 21:00,51,27,24,4,4,0
2019-09-24 21:15,56,26,30,4,4,0
2019-09-24 21:30,58,25,33,4,4,0
2019-09-24 21:45,52,27,25,4,4,0
2019-09-24 22:00,47,20,27,4,4,0
2019-09-24 22:15,45,19,26,4,4,0
2019-09-24 22:30,39,16,23,4,4,0
2019-09-24 22:45,34,16,18,4,4,0
2019-09-24 23:00,25,13,12,4,4,0
2019-09-24 23:15,17,7,10,4,4,0
2019-09-24 23:30,26,10,16,4,4,0
2019-09-24 23:45,16,10,6,4,4,0
2019-09-25 00:00,12,5,7,4,4,0
2019-09-25 00:15,9,5,4,4,4,0
2019-09-25 00:30,8,5,3,4,4,0
2019-09-25 00:45,6,2,4,4,4,0
2019-09-25 01:00,6,3,3,4,4,0
2019-09-25 01:15,4,1,3,4,4,0
2019-09-25 01:30,10,4,6,4,4,0
2019-09-25 01:45,5,3,2,4,4,0
2019-09-25 02:00,1,1,0,4,4,0
2019-09-25 02:15,1,1,0,4,4,0
2019-09-25 02:30,2,1,1,4,4,0
2019-09-25 02:45,2,2,0,4,4,0
2019-09-25 03:00,1,1,0,4,4,0
2019-09-25 03:15,4,1,3,4,4,0
2019-09-25 03:30,1,1,0,4,4,0
2019-09-25 03:45,1,1,0,4,4,0
2019-09-25 04:00,0,0,0,4,4,0
2019-09-25 04:15,1,1,0,4,4,0
2019-09-25 04:30,1,1,0,4,4,0
2019-09-25 04:45,3,2,1,4,4,0
2019-09-25 05:00,1,1,0,4,4,0
2019-09-25 05:15,4,3,1,4,4,0
2019-09-25 05:30,10,8,2,4,4,0
2019-09-25 05:45,24,11,13,4,4,0
2019-09-25 06:00,12,11,1,4,4,0
2019-09-25 06:15,24,16,8,4,4,0
2019-09-25 06:30,48,30,18,4,4,0
2019-09-25 06:45,57,39,18,4,4,0
2019-09-25 07:00,94,70,24,4,4,0
2019-09-25 07:15,165,133,32,4,4,0
2019-09-25 07:30,269,207,62,4,4,0
2019-09-25 07:45,213,127,86,4,4,0
2019-09-25 08:00,156,117,39,4,4,0
2019-09-25 08:15,153,115,38,4,4,0
2019-09-25 08:30,145,102,43,4,4,0
2019-09-25 08:45,159,129,30,4,4,0
2019-09-25 09:00,117,84,33,4,4,0
2019-09-25 09:15,144,109,35,4,4,0
2019-09-25 09:30,117,92,25,4,4,0
2019-09-25 09:45,139,109,30,4,4,0
2019-09-25 10:00,126,94,32,4,4,0
2019-09-25 10:15,131,91,40,4,4,0
2019-09-25 10:30,117,91,26,4,4,0
2019-09-25 10:45,133,92,41,4,4,0
2019-09-25 11:00,135,88,47,4,4,0
2019-09-25 11:15,127,91,36,4,4,0
2019-09-25 11:30,149,91,58,4,4,0
2019-09-25 11:45,137,91,46,4,4,0
2019-09-25 12:00,136,87,49,4,4,0
2019-09-25 12:15,141,89,52,4,4,0
2019-09-25 12:30,145,75,70,4,4,0
2019-09-25 12:45,155,82,73,4,4,0
2019-09-25 13:00,169,86,83,4,4,0
2019-09-25 13:15,157,70,87,4,4,0
2019-09-25 13:30,114,68,46,4,4,0
2019-09-25 13:45,131,70,61,4,4,0
2019-09-25 14:00,152,64,88,4,4,0
2019-09-25 14:15,122,62,60,4,4,0
2019-09-25 14:30,125,57,68,4,4,0
2019-09-25 14:45,147,77,70,4,4,0
2019-09-25 15:00,153,72,81,4,4,0
2019-09-25 15:15,154,60,94,4,4,0
2019-09-25 15:30,158,64,94,4,4,0
2019-09-25 15:45,194,85,109,4,4,0
2019-09-25 16:00,169,85,84,4,4,0
2019-09-25 16:15,167,72,95,4,4,0
2019-09-25 16:30,175,86,89,4,4,0
2019-09-25 16:45,177,86,91,4,4,0
2019-09-25 17:00,176,78,98,4,4,0
2019-09-25 17:15,145,76,69,4,4,0
2019-09-25 17:30,166,74,92,4,4,0
2019-09-25 17:45,189,87,102,4,4,0
2019-09-25 18:00,147,60,87,4,4,0
2019-09-25 18:15,146,65,81,4,4,0
2019-09-25 18:30,141,49,92,4,4,0
2019-09-25 18:45,143,59,84,4,4,0
2019-09-25 19:00,130,48,82,4,4,0
2019-09-25 19:15,134,50,84,4,4,0
2019-09-25 19:30,105,43,62,4,4,0
2019-09-25 19:45,89,39,50,4,4,0
2019-09-25 20:00,74,37,37,4,4,0
2019-09-25 20:15,60,23,37,4,4,0
2019-09-25 20:30,40,22,18,4,4,0
2019-09-25 20:45,57,25,32,4,4,0
2019-09-25 21:00,59,22,37,4,4,0
2019-09-25 21:15,76,27,49,4,4,0
2019-09-25 21:30,40,14,26,4,4,0
2019-09-25 21:45,45,20,25,4,4,0
2019-09-25 22:00,50,21,29,4,4,0
2019-09-25 22:15,51,26,25,4,4,0
2019-09-25 22:30,30,17,13,4,4,0
2019-09-25 22:45,34,16,18,4,4,0
2019-09-25 23:00,36,14,22,4,4,0
2019-09-25 23:15,22,9,13,4,4,0
2019-09-25 23:30,30,13,17,4,4,0
2019-09-25 23:45,14,9,5,4,4,0
2019-09-26 00:00,21,8,13,4,4,0
2019-09-26 00:15,12,4,8,4,4,0
2019-09-26 00:30,16,6,10,4,4,0
2019-09-26 00:45,13,7,6,4,4,0
2019-09-26 01:00,13,3,10,4,4,0
2019-09-26 01:15,14,3,11,4,4,0
2019-09-26 01:30,7,4,3,4,4,0
2019-09-26 01:45,5,2,3,4,4,0
2019-09-26 02:00,3,1,2,4,4,0
2019-09-26 02:15,5,1,4,4,4,0
2019-09-26 02:30,2,0,2,4,4,0
2019-09-26 02:45,2,1,1,4,4,0
2019-09-26 03:00,4,1,3,4,4,0
2019-09-26 03:15,1,0,1,4,4,0
2019-09-26 03:30,4,0,4,4,4,0
2019-09-26 03:45,3,1,2,4,4,0
2019-09-26 04:00,3,1,2,4,4,0
2019-09-26 04:15,4,0,4,4,4,0
2019-09-26 04:30,1,0,1,4,4,0
2019-09-26 04:45,3,1,2,4,4,0
2019-09-26 05:00,1,0,1,4,4,0
2019-09-26 05:15,2,1,1,4,4,0
2019-09-26 05:30,13,8,5,4,4,0
2019-09-26 05:45,22,10,12,4,4,0
2019-09-26 06:00,16,13,3,4,4,0
2019-09-26 06:15,25,17,8,4,4,0
2019-09-26 06:30,47,30,17,4,4,0
2019-09-26 06:45,65,50,15,4,4,0
2019-09-26 07:00,83,55,28,4,4,0
2019-09-26 07:15,182,142,40,4,4,0
2019-09-26 07:30,303,246,57,4,4,0
2019-09-26 07:45,209,132,77,4,4,0
2019-09-26 08:00,150,108,42,4,4,0
2019-09-26 08:15,154,112,42,4,4,0
2019-09-26 08:30,168,122,46,4,4,0
2019-09-26 08:45,173,138,35,4,4,0
2019-09-26 09:00,94,75,19,4,4,0
2019-09-26 09:15,113,80,33,4,4,0
2019-09-26 09:30,109,75,34,4,4,0
2019-09-26 09:45,140,96,44,4,4,0
2019-09-26 10:00,89,66,23,4,4,0
2019-09-26 10:15,102,66,36,4,4,0
2019-09-26 10:30,80,58,22,4,4,0
2019-09-26 10:45,108,71,37,4,4,0
2019-09-26 11:00,79,55,24,4,4,0
2019-09-26 11:15,103,60,43,4,4,0
2019-09-26 11:30,91,59,32,4,4,0
2019-09-26 11:45,109,67,42,4,4,0
2019-09-26 12:00,104,70,34,4,4,0
2019-09-26 12:15,115,68,47,4,4,0
2019-09-26 12:30,114,60,54,4,4,0
2019-09-26 12:45,124,66,58,4,4,0
2019-09-26 13:00,108,61,47,4,4,0
2019-09-26 13:15,112,52,60,4,4,0
2019-09-26 13:30,95,58,37,4,4,0
2019-09-26 13:45,121,73,48,4,4,0
2019-09-26 14:00,142,61,81,4,4,0
2019-09-26 14:15,108,65,43,4,4,0
2019-09-26 14:30,88,58,30,4,4,0
2019-09-26 14:45,141,81,60,4,4,0
2019-09-26 15:00,109,67,42,4,4,0
2019-09-26 15:15,117,79,38,4,4,0
2019-09-26 15:30,139,78,61,4,4,0
2019-09-26 15:45,171,97,74,4,4,0
2019-09-26 16:00,156,95,61,4,4,0
2019-09-26 16:15,154,80,74,4,4,0
2019-09-26 16:30,166,94,72,4,4,0
2019-09-26 16:45,183,103,80,4,4,0
2019-09-26 17:00,152,77,75,4,4,0
2019-09-26 17:15,157,82,75,4,4,0
2019-09-26 17:30,148,92,56,4,4,0
2019-09-26 17:45,186,100,86,4,4,0
2019-09-26 18:00,160,81,79,4,4,0
2019-09-26 18:15,127,71,56,4,4,0
2019-09-26 18:30,130,64,66,4,4,0
2019-09-26 18:45,147,89,58,4,4,0
2019-09-26 19:00,137,73,64,4,4,0
2019-09-26 19:15,107,67,40,4,4,0
2019-09-26 19:30,95,55,40,4,4,0
2019-09-26 19:45,87,45,42,4,4,0
2019-09-26 20:00,84,38,46,4,4,0
2019-09-26 20:15,75,36,39,4,4,0
2019-09-26 20:30,54,32,22,4,4,0
2019-09-26 20:45,64,39,25,4,4,0
2019-09-26 21:00,66,27,39,4,4,0
2019-09-26 21:15,63,27,36,4,4,0
2019-09-26 21:30,50,28,22,4,4,0
2019-09-26 21:45,56,26,30,4,4,0
2019-09-26 22:00,49,29,20,4,4,0
2019-09-26 22:15,46,20,26,4,4,0
2019-09-26 22:30,43,18,25,4,4,0
2019-09-26 22:45,35,13,22,4,4,0
2019-09-26 23:00,30,11,19,4,4,0
2019-09-26 23:15,25,12,13,4,4,0
2019-09-26 23:30,20,12,8,4,4,0
2019-09-26 23:45,18,8,10,4,4,0
2019-09-27 00:00,17,8,9,4,4,0
2019-09-27 00:15,8,2,6,4,4,0
2019-09-27 00:30,5,2,3,4,4,0
2019-09-27 00:45,8,5,3,4,4,0
2019-09-27 01:00,2,1,1,4,4,0
2019-09-27 01:15,5,4,1,4,4,0
2019-09-27 01:30,10,1,9,4,4,0
2019-09-27 01:45,6,3,3,4,4,0
2019-09-27 02:00,2,1,1,4,4,0
2019-09-27 02:15,2,0,2,4,4,0
2019-09-27 02:30,2,1,1,4,4,0
2019-09-27 02:45,0,0,0,4,4,0
2019-09-27 03:00,0,0,0,4,4,0
2019-09-27 03:15,1,1,0,4,4,0
2019-09-27 03:30,0,0,0,4,4,0
2019-09-27 03:45,1,1,0,4,4,0
2019-09-27 04:00,0,0,0,4,4,0
2019-09-27 04:15,3,0,3,4,4,0
2019-09-27 04:30,2,0,2,4,4,0
2019-09-27 04:45,3,1,2,4,4,0
2019-09-27 05:00,1,1,0,4,4,0
2019-09-27 05:15,1,1,0,4,4,0
2019-09-27 05:30,6,4,2,4,4,0
2019-09-27 05:45,20,13,7,4,4,0
2019-09-27 06:00,17,13,4,4,4,0
2019-09-27 06:15,22,16,6,4,4,0
2019-09-27 06:30,44,30,14,4,4,0
2019-09-27 06:45,67,46,21,4,4,0
2019-09-27 07:00,73,54,19,4,4,0
2019-09-27 07:15,189,146,43,4,4,0
2019-09-27 07:30,310,260,50,4,4,0
2019-09-27 07:45,204,137,67,4,4,0
2019-09-27 08:00,129,101,28,4,4,0
2019-09-27 08:15,135,92,43,4,4,0
2019-09-27 08:30,136,100,36,4,4,0
2019-09-27 08:45,157,116,41,4,4,0
2019-09-27 09:00,96,81,15,4,4,0
2019-09-27 09:15,94,73,21,4,4,0
2019-09-27 09:30,108,81,27,4,4,0
2019-09-27 09:45,130,104,26,4,4,0
2019-09-27 10:00,100,60,40,4,4,0
2019-09-27 10:15,83,51,32,4,4,0
2019-09-27 10:30,86,54,32,4,4,0
2019-09-27 10:45,129,77,52,4,4,0
2019-09-27 11:00,109,68,41,4,4,0
2019-09-27 11:15,122,64,58,4,4,0
2019-09-27 11:30,113,62,51,4,4,0
2019-09-27 11:45,123,75,48,4,4,0
2019-09-27 12:00,127,75,52,4,4,0
2019-09-27 12:15,139,76,63,4,4,0
2019-09-27 12:30,186,87,99,4,4,0
2019-09-27 12:45,154,79,75,4,4,0
2019-09-27 13:00,166,71,95,4,4,0
2019-09-27 13:15,139,69,70,4,4,0
2019-09-27 13:30,150,77,73,4,4,0
2019-09-27 13:45,140,79,61,4,4,0
2019-09-27 14:00,203,83,120,4,4,0
2019-09-27 14:15,120,74,46,4,4,0
2019-09-27 14:30,157,85,72,4,4,0
2019-09-27 14:45,141,78,63,4,4,0
2019-09-27 15:00,167,90,77,4,4,0
2019-09-27 15:15,181,101,80,4,4,0
2019-09-27 15:30,164,94,70,4,4,0
2019-09-27 15:45,173,85,88,4,4,0
2019-09-27 16:00,169,100,69,4,4,0
2019-09-27 16:15,154,80,74,4,4,0
2019-09-27 16:30,139,89,50,4,4,0
2019-09-27 16:45,169,91,78,4,4,0
2019-09-27 17:00,139,87,52,4,4,0
2019-09-27 17:15,151,84,67,4,4,0
2019-09-27 17:30,167,84,83,4,4,0
2019-09-27 17:45,153,75,78,4,4,0
2019-09-27 18:00,162,82,80,4,4,0
2019-09-27 18:15,176,90,86,4,4,0
2019-09-27 18:30,137,67,70,4,4,0
2019-09-27 18:45,142,80,62,4,4,0
2019-09-27 19:00,120,67,53,4,4,0
2019-09-27 19:15,120,69,51,4,4,0
2019-09-27 19:30,104,53,51,4,4,0
2019-09-27 19:45,123,66,57,4,4,0
2019-09-27 20:00,111,57,54,4,4,0
2019-09-27 20:15,80,47,33,4,4,0
2019-09-27 20:30,71,42,29,4,4,0
2019-09-27 20:45,72,41,31,4,4,0
2019-09-27 21:00,65,37,28,4,4,0
2019-09-27 21:15,66,33,33,4,4,0
2019-09-27 21:30,59,32,27,4,4,0
2019-09-27 21:45,41,23,18,4,4,0
2019-09-27 22:00,60,24,36,4,4,0
2019-09-27 22:15,45,23,22,4,4,0
2019-09-27 22:30,40,21,19,4,4,0
2019-09-27 22:45,42,19,23,4,4,0
2019-09-27 23:00,50,22,28,4,4,0
2019-09-27 23:15,38,16,22,4,4,0
2019-09-27 23:30,28,19,9,4,4,0
2019-09-27 23:45,33,19,14,4,4,0
2019-09-28 00:00,40,17,23,4,4,0
2019-09-28 00:15,24,13,11,4,4,0
2019-09-28 00:30,31,15,16,4,4,0
2019-09-28 00:45,25,14,11,4,4,0
2019-09-28 01:00,19,9,10,4,4,0
2019-09-28 01:15,23,11,12,4,4,0
2019-09-28 01:30,27,8,19,4,4,0
2019-09-28 01:45,19,8,11,4,4,0
2019-09-28 02:00,14,4,10,4,4,0
2019-09-28 02:15,9,2,7,4,4,0
2019-09-28 02:30,6,2,4,4,4,0
2019-09-28 02:45,14,5,9,4,4,0
2019-09-28 03:00,12,3,9,4,4,0
2019-09-28 03:15,6,2,4,4,4,0
2019-09-28 03:30,6,1,5,4,4,0
2019-09-28 03:45,10,2,8,4,4,0
2019-09-28 04:00,4,2,2,4,4,0
2019-09-28 04:15,7,1,6,4,4,0
2019-09-28 04:30,2,2,0,4,4,0
2019-09-28 04:45,4,3,1,4,4,0
2019-09-28 05:00,0,0,0,4,4,0
2019-09-28 05:15,5,2,3,4,4,0
2019-09-28 05:30,7,5,2,4,4,0
2019-09-28 05:45,8,5,3,4,4,0
2019-09-28 06:00,5,4,1,4,4,0
2019-09-28 06:15,8,6,2,4,4,0
2019-09-28 06:30,7,3,4,4,4,0
2019-09-28 06:45,13,9,4,4,4,0
2019-09-28 07:00,15,9,6,4,4,0
2019-09-28 07:15,13,9,4,4,4,0
2019-09-28 07:30,26,14,12,4,4,0
2019-09-28 07:45,27,19,8,4,4,0
2019-09-28 08:00,35,22,13,4,4,0
2019-09-28 08:15,40,27,13,4,4,0
2019-09-28 08:30,47,36,11,4,4,0
2019-09-28 08:45,57,49,8,4,4,0
2019-09-28 09:00,53,41,12,4,4,0
2019-09-28 09:15,81,63,18,4,4,0
2019-09-28 09:30,92,78,14,4,4,0
2019-09-28 09:45,110,97,13,4,4,0
2019-09-28 10:00,97,82,15,4,4,0
2019-09-28 10:15,111,96,15,4,4,0
2019-09-28 10:30,136,112,24,4,4,0
2019-09-28 10:45,156,130,26,4,4,0
2019-09-28 11:00,131,102,29,4,4,0
2019-09-28 11:15,140,116,24,4,4,0
2019-09-28 11:30,169,125,44,4,4,0
2019-09-28 11:45,164,128,36,4,4,0
2019-09-28 12:00,178,117,61,4,4,0
2019-09-28 12:15,188,130,58,4,4,0
2019-09-28 12:30,168,112,56,4,4,0
2019-09-28 12:45,175,118,57,4,4,0
2019-09-28 13:00,161,106,55,4,4,0
2019-09-28 13:15,165,102,63,4,4,0
2019-09-28 13:30,152,89,63,4,4,0
2019-09-28 13:45,126,93,33,4,4,0
2019-09-28 14:00,150,82,68,4,4,0
2019-09-28 14:15,145,73,72,4,4,0
2019-09-28 14:30,107,53,54,4,4,0
2019-09-28 14:45,131,67,64,4,4,0
2019-09-28 15:00,121,65,56,4,4,0
2019-09-28 15:15,129,64,65,4,4,0
2019-09-28 15:30,114,72,42,4,4,0
2019-09-28 15:45,120,70,50,4,4,0
2019-09-28 16:00,102,58,44,4,4,0
2019-09-28 16:15,99,51,48,4,4,0
2019-09-28 16:30,114,62,52,4,4,0
2019-09-28 16:45,114,64,50,4,4,0
2019-09-28 17:00,113,72,41,4,4,0
2019-09-28 17:15,114,63,51,4,4,0
2019-09-28 17:30,112,66,46,4,4,0
2019-09-28 17:45,121,73,48,4,4,0
2019-09-28 18:00,128,75,53,4,4,0
2019-09-28 18:15,113,61,52,4,4,0
2019-09-28 18:30,96,60,36,4,4,0
2019-09-28 18:45,113,78,35,4,4,0
2019-09-28 19:00,105,68,37,4,4,0
2019-09-28 19:15,89,57,32,4,4,0
2019-09-28 19:30,78,49,29,4,4,0
2019-09-28 19:45,86,59,27,4,4,0
2019-09-28 20:00,80,55,25,4,4,0
2019-09-28 20:15,94,62,32,4,4,0
2019-09-28 20:30,70,43,27,4,4,0
2019-09-28 20:45,72,44,28,4,4,0
2019-09-28 21:00,51,31,20,4,4,0
2019-09-28 21:15,44,37,7,4,4,0
2019-09-28 21:30,36,25,11,4,4,0
2019-09-28 21:45,35,23,12,4,4,0
2019-09-28 22:00,34,17,17,4,4,0
2019-09-28 22:15,39,22,17,4,4,0
2019-09-28 22:30,27,11,16,4,4,0
2019-09-28 22:45,17,13,4,4,4,0
2019-09-28 23:00,36,15,21,4,4,0
2019-09-28 23:15,38,19,19,4,4,0
2019-09-28 23:30,39,21,18,4,4,0
2019-09-28 23:45,25,11,14,4,4,0
2019-09-29 00:00,29,14,15,4,4,0
2019-09-29 00:15,30,14,16,4,4,0
2019-09-29 00:30,28,19,9,4,4,0
2019-09-29 00:45,22,11,11,4,4,0
2019-09-29 01:00,28,17,11,4,4,0
2019-09-29 01:15,25,10,15,4,4,0
2019-09-29 01:30,22,10,12,4,4,0
2019-09-29 01:45,15,6,9,4,4,0
2019-09-29 02:00,15,6,9,4,4,0
2019-09-29 02:15,21,7,14,4,4,0
2019-09-29 02:30,17,9,8,4,4,0
2019-09-29 02:45,5,3,2,4,4,0
2019-09-29 03:00,7,3,4,4,4,0
2019-09-29 03:15,8,3,5,4,4,0
2019-09-29 03:30,12,3,9,4,4,0
2019-09-29 03:45,8,2,6,4,4,0
2019-09-29 04:00,3,3,0,4,4,0
2019-09-29 04:15,3,1,2,4,4,0
2019-09-29 04:30,5,1,4,4,4,0
2019-09-29 04:45,3,1,2,4,4,0
2019-09-29 05:00,0,0,0,4,4,0
2019-09-29 05:15,5,1,4,4,4,0
2019-09-29 05:30,6,3,3,4,4,0
2019-09-29 05:45,8,3,5,4,4,0
2019-09-29 06:00,2,1,1,4,4,0
2019-09-29 06:15,5,4,1,4,4,0
2019-09-29 06:30,7,3,4,4,4,0
2019-09-29 06:45,7,6,1,4,4,0
2019-09-29 07:00,1,1,0,4,4,0
2019-09-29 07:15,6,4,2,4,4,0
2019-09-29 07:30,8,8,0,4,4,0
2019-09-29 07:45,17,11,6,4,4,0
2019-09-29 08:00,22,17,5,4,4,0
2019-09-29 08:15,32,30,2,4,4,0
2019-09-29 08:30,31,28,3,4,4,0
2019-09-29 08:45,29,24,5,4,4,0
2019-09-29 09:00,21,16,5,4,4,0
2019-09-29 09:15,43,31,12,4,4,0
2019-09-29 09:30,32,26,6,4,4,0
2019-09-29 09:45,59,43,16,4,4,0
2019-09-29 10:00,54,36,18,4,4,0
2019-09-29 10:15,45,32,13,4,4,0
2019-09-29 10:30,45,37,8,4,4,0
2019-09-29 10:45,64,49,15,4,4,0
2019-09-29 11:00,45,36,9,4,4,0
2019-09-29 11:15,48,41,7,4,4,0
2019-09-29 11:30,51,42,9,4,4,0
2019-09-29 11:45,39,37,2,4,4,0
2019-09-29 12:00,54,40,14,4,4,0
2019-09-29 12:15,54,43,11,4,4,0
2019-09-29 12:30,57,41,16,4,4,0
2019-09-29 12:45,63,44,19,4,4,0
2019-09-29 13:00,56,39,17,4,4,0
2019-09-29 13:15,56,37,19,4,4,0
2019-09-29 13:30,61,47,14,4,4,0
2019-09-29 13:45,68,47,21,4,4,0
2019-09-29 14:00,64,50,14,4,4,0
2019-09-29 14:15,66,51,15,4,4,0
2019-09-29 14:30,73,57,16,4,4,0
2019-09-29 14:45,76,63,13,4,4,0
2019-09-29 15:00,63,50,13,4,4,0
2019-09-29 15:15,58,45,13,4,4,0
2019-09-29 15:30,60,50,10,4,4,0
2019-09-29 15:45,75,61,14,4,4,0
2019-09-29 16:00,68,53,15,4,4,0
2019-09-29 16:15,69,50,19,4,4,0
2019-09-29 16:30,58,44,14,4,4,0
2019-09-29 16:45,64,55,9,4,4,0
2019-09-29 17:00,57,50,7,4,4,0
2019-09-29 17:15,75,59,16,4,4,0
2019-09-29 17:30,76,64,12,4,4,0
2019-09-29 17:45,76,57,19,4,4,0
2019-09-29 18:00,58,37,21,4,4,0
2019-09-29 18:15,62,41,21,4,4,0
2019-09-29 18:30,48,36,12,4,4,0
2019-09-29 18:45,57,42,15,4,4,0
2019-09-29 19:00,47,28,19,4,4,0
2019-09-29 19:15,52,30,22,4,4,0
2019-09-29 19:30,37,26,11,4,4,0
2019-09-29 19:45,39,33,6,4,4,0
2019-09-29 20:00,33,23,10,4,4,0
2019-09-29 20:15,33,24,9,4,4,0
2019-09-29 20:30,28,17,11,4,4,0
2019-09-29 20:45,27,17,10,4,4,0
2019-09-29 21:00,24,11,13,4,4,0
2019-09-29 21:15,25,15,10,4,4,0
2019-09-29 21:30,18,14,4,4,4,0
2019-09-29 21:45,21,11,10,4,4,0
2019-09-29 22:00,14,10,4,4,4,0
2019-09-29 22:15,17,11,6,4,4,0
2019-09-29 22:30,22,11,11,4,4,0
2019-09-29 22:45,9,7,2,4,4,0
2019-09-29 23:00,11,7,4,4,4,0
2019-09-29 23:15,8,5,3,4,4,0
2019-09-29 23:30,5,5,0,4,4,0
2019-09-29 23:45,3,3,0,4,4,0
2019-09-30 00:00,7,4,3,4,4,0
2019-09-30 00:15,4,2,2,4,4,0
2019-09-30 00:30,1,0,1,4,4,0
2019-09-30 00:45,2,2,0,4,4,0
2019-09-30 01:00,3,1,2,4,4,0
2019-09-30 01:15,3,2,1,4,4,0
2019-09-30 01:30,4,2,2,4,4,0
2019-09-30 01:45,6,3,3,4,4,0
2019-09-30 02:00,0,0,0,4,4,0
2019-09-30 02:15,0,0,0,4,4,0
2019-09-30 02:30,1,1,0,4,4,0
2019-09-30 02:45,0,0,0,4,4,0
2019-09-30 03:00,0,0,0,4,4,0
2019-09-30 03:15,1,1,0,4,4,0
2019-09-30 03:30,0,0,0,4,4,0
2019-09-30 03:45,1,1,0,4,4,0
2019-09-30 04:00,0,0,0,4,4,0
2019-09-30 04:15,1,0,1,4,4,0
2019-09-30 04:30,1,1,0,4,4,0
2019-09-30 04:45,2,2,0,4,4,0
2019-09-30 05:00,1,0,1,4,4,0
2019-09-30 05:15,4,3,1,4,4,0
2019-09-30 05:30,11,10,1,4,4,0
2019-09-30 05:45,19,11,8,4,4,0
2019-09-30 06:00,13,10,3,4,4,0
2019-09-30 06:15,25,16,9,4,4,0
2019-09-30 06:30,46,34,12,4,4,0
2019-09-30 06:45,71,48,23,4,4,0
2019-09-30 07:00,87,71,16,4,4,0
2019-09-30 07:15,175,142,33,4,4,0
2019-09-30 07:30,305,244,61,4,4,0
2019-09-30 07:45,200,137,63,4,4,0
2019-09-30 08:00,132,106,26,4,4,0
2019-09-30 08:15,142,108,34,4,4,0
2019-09-30 08:30,134,111,23,4,4,0
2019-09-30 08:45,157,131,26,4,4,0
2019-09-30 09:00,99,82,17,4,4,0
2019-09-30 09:15,111,82,29,4,4,0
2019-09-30 09:30,105,83,22,4,4,0
2019-09-30 09:45,130,103,27,4,4,0
2019-09-30 10:00,79,60,19,4,4,0
2019-09-30 10:15,102,64,38,4,4,0
2019-09-30 10:30,99,68,31,4,4,0
2019-09-30 10:45,112,68,44,4,4,0
2019-09-30 11:00,93,61,32,4,4,0
2019-09-30 11:15,91,55,36,4,4,0
2019-09-30 11:30,95,65,30,4,4,0
2019-09-30 11:45,98,54,44,4,4,0
2019-09-30 12:00,112,68,44,4,4,0
2019-09-30 12:15,118,67,51,4,4,0
2019-09-30 12:30,147,65,82,4,4,0
2019-09-30 12:45,122,68,54,4,4,0
2019-09-30 13:00,146,74,72,4,4,0
2019-09-30 13:15,131,57,74,4,4,0
2019-09-30 13:30,124,70,54,4,4,0
2019-09-30 13:45,133,68,65,4,4,0
2019-09-30 14:00,134,64,70,4,4,0
2019-09-30 14:15,116,73,43,4,4,0
2019-09-30 14:30,126,74,52,4,4,0
2019-09-30 14:45,153,75,78,4,4,0
2019-09-30 15:00,145,77,68,4,4,0
2019-09-30 15:15,165,90,75,4,4,0
2019-09-30 15:30,167,76,91,4,4,0
2019-09-30 15:45,170,88,82,4,4,0
2019-09-30 16:00,145,90,55,4,4,0
2019-09-30 16:15,184,92,92,4,4,0
2019-09-30 16:30,160,88,72,4,4,0
2019-09-30 16:45,187,109,78,4,4,0
2019-09-30 17:00,176,91,85,4,4,0
2019-09-30 17:15,183,96,87,4,4,0
2019-09-30 17:30,169,91,78,4,4,0
2019-09-30 17:45,152,90,62,4,4,0
2019-09-30 18:00,174,85,89,4,4,0
2019-09-30 18:15,139,71,68,4,4,0
2019-09-30 18:30,154,67,87,4,4,0
2019-09-30 18:45,141,68,73,4,4,0
2019-09-30 19:00,105,50,55,4,4,0
2019-09-30 19:15,109,52,57,4,4,0
2019-09-30 19:30,90,41,49,4,4,0
2019-09-30 19:45,94,43,51,4,4,0
2019-09-30 20:00,86,40,46,4,4,0
2019-09-30 20:15,69,37,32,4,4,0
2019-09-30 20:30,40,21,19,4,4,0
2019-09-30 20:45,48,20,28,4,4,0
2019-09-30 21:00,43,25,18,4,4,0
2019-09-30 21:15,58,25,33,4,4,0
2019-09-30 21:30,39,17,22,4,4,0
2019-09-30 21:45,36,19,17,4,4,0
2019-09-30 22:00,42,19,23,4,4,0
2019-09-30 22:15,52,19,33,4,4,0
2019-09-30 22:30,33,14,19,4,4,0
2019-09-30 22:45,22,11,11,4,4,0
2019-09-30 23:00,32,9,23,4,4,0
2019-09-30 23:15,25,10,15,4,4,0
2019-09-30 23:30,33,14,19,4,4,0
2019-09-30 23:45,9,2,7,4,4,0
