Datetime,100034983 (Warendorfer Straße),101034983 (Warendorfer Straße stadteinwärts),102034983 (Warendorfer Straße stadtauswärts),100034983-status,101034983-status,102034983-status
2020-08-01 00:00,39,20,19,0,0,0
2020-08-01 00:15,19,6,13,0,0,0
2020-08-01 00:30,34,18,16,0,0,0
2020-08-01 00:45,22,14,8,0,0,0
2020-08-01 01:00,24,12,12,0,0,0
2020-08-01 01:15,13,7,6,0,0,0
2020-08-01 01:30,26,8,18,0,0,0
2020-08-01 01:45,10,2,8,0,0,0
2020-08-01 02:00,16,5,11,0,0,0
2020-08-01 02:15,11,5,6,0,0,0
2020-08-01 02:30,10,4,6,0,0,0
2020-08-01 02:45,10,7,3,0,0,0
2020-08-01 03:00,7,5,2,0,0,0
2020-08-01 03:15,6,1,5,0,0,0
2020-08-01 03:30,11,2,9,0,0,0
2020-08-01 03:45,13,7,6,0,0,0
2020-08-01 04:00,7,4,3,0,0,0
2020-08-01 04:15,2,0,2,0,0,0
2020-08-01 04:30,7,2,5,0,0,0
2020-08-01 04:45,1,1,0,0,0,0
2020-08-01 05:00,0,0,0,0,0,0
2020-08-01 05:15,3,1,2,0,0,0
2020-08-01 05:30,13,6,7,0,0,0
2020-08-01 05:45,9,5,4,0,0,0
2020-08-01 06:00,7,6,1,0,0,0
2020-08-01 06:15,3,0,3,0,0,0
2020-08-01 06:30,3,3,0,0,0,0
2020-08-01 06:45,7,5,2,0,0,0
2020-08-01 07:00,19,14,5,0,0,0
2020-08-01 07:15,19,12,7,0,0,0
2020-08-01 07:30,29,18,11,0,0,0
2020-08-01 07:45,32,22,10,0,0,0
2020-08-01 08:00,29,19,10,0,0,0
2020-08-01 08:15,37,21,16,0,0,0
2020-08-01 08:30,37,29,8,0,0,0
2020-08-01 08:45,61,42,19,0,0,0
2020-08-01 09:00,48,31,17,0,0,0
2020-08-01 09:15,57,41,16,0,0,0
2020-08-01 09:30,74,48,26,0,0,0
2020-08-01 09:45,108,71,37,0,0,0
2020-08-01 10:00,101,76,25,0,0,0
2020-08-01 10:15,96,75,21,0,0,0
2020-08-01 10:30,125,84,41,0,0,0
2020-08-01 10:45,96,64,32,0,0,0
2020-08-01 11:00,81,48,33,0,0,0
2020-08-01 11:15,101,71,30,0,0,0
2020-08-01 11:30,126,79,47,0,0,0
2020-08-01 11:45,127,82,45,0,0,0
2020-08-01 12:00,114,69,45,0,0,0
2020-08-01 12:15,114,75,39,0,0,0
2020-08-01 12:30,143,86,57,0,0,0
2020-08-01 12:45,149,93,56,0,0,0
2020-08-01 13:00,110,57,53,0,0,0
2020-08-01 13:15,102,63,39,0,0,0
2020-08-01 13:30,122,77,45,0,0,0
2020-08-01 13:45,146,92,54,0,0,0
2020-08-01 14:00,116,73,43,0,0,0
2020-08-01 14:15,141,66,75,0,0,0
2020-08-01 14:30,115,64,51,0,0,0
2020-08-01 14:45,128,48,80,0,0,0
2020-08-01 15:00,126,59,67,0,0,0
2020-08-01 15:15,96,45,51,0,0,0
2020-08-01 15:30,107,52,55,0,0,0
2020-08-01 15:45,118,57,61,0,0,0
2020-08-01 16:00,89,44,45,0,0,0
2020-08-01 16:15,83,47,36,0,0,0
2020-08-01 16:30,100,57,43,0,0,0
2020-08-01 16:45,97,55,42,0,0,0
2020-08-01 17:00,97,58,39,0,0,0
2020-08-01 17:15,87,47,40,0,0,0
2020-08-01 17:30,80,42,38,0,0,0
2020-08-01 17:45,102,59,43,0,0,0
2020-08-01 18:00,85,58,27,0,0,0
2020-08-01 18:15,110,69,41,0,0,0
2020-08-01 18:30,90,58,32,0,0,0
2020-08-01 18:45,89,62,27,0,0,0
2020-08-01 19:00,65,41,24,0,0,0
2020-08-01 19:15,91,51,40,0,0,0
2020-08-01 19:30,74,50,24,0,0,0
2020-08-01 19:45,69,49,20,0,0,0
2020-08-01 20:00,62,37,25,0,0,0
2020-08-01 20:15,59,33,26,0,0,0
2020-08-01 20:30,67,44,23,0,0,0
2020-08-01 20:45,42,26,16,0,0,0
2020-08-01 21:00,45,28,17,0,0,0
2020-08-01 21:15,34,18,16,0,0,0
2020-08-01 21:30,41,28,13,0,0,0
2020-08-01 21:45,31,21,10,0,0,0
2020-08-01 22:00,43,19,24,0,0,0
2020-08-01 22:15,36,19,17,0,0,0
2020-08-01 22:30,34,11,23,0,0,0
2020-08-01 22:45,19,11,8,0,0,0
2020-08-01 23:00,29,17,12,0,0,0
2020-08-01 23:15,25,15,10,0,0,0
2020-08-01 23:30,24,10,14,0,0,0
2020-08-01 23:45,38,14,24,0,0,0
2020-08-02 00:00,38,20,18,0,0,0
2020-08-02 00:15,25,12,13,0,0,0
2020-08-02 00:30,21,11,10,0,0,0
2020-08-02 00:45,24,17,7,0,0,0
2020-08-02 01:00,22,10,12,0,0,0
2020-08-02 01:15,38,22,16,0,0,0
2020-08-02 01:30,20,6,14,0,0,0
2020-08-02 01:45,20,10,10,0,0,0
2020-08-02 02:00,6,2,4,0,0,0
2020-08-02 02:15,11,7,4,0,0,0
2020-08-02 02:30,14,5,9,0,0,0
2020-08-02 02:45,11,9,2,0,0,0
2020-08-02 03:00,13,8,5,0,0,0
2020-08-02 03:15,3,3,0,0,0,0
2020-08-02 03:30,5,2,3,0,0,0
2020-08-02 03:45,7,4,3,0,0,0
2020-08-02 04:00,3,2,1,0,0,0
2020-08-02 04:15,9,6,3,0,0,0
2020-08-02 04:30,3,3,0,0,0,0
2020-08-02 04:45,2,2,0,0,0,0
2020-08-02 05:00,4,1,3,0,0,0
2020-08-02 05:15,4,2,2,0,0,0
2020-08-02 05:30,11,9,2,0,0,0
2020-08-02 05:45,5,1,4,0,0,0
2020-08-02 06:00,11,9,2,0,0,0
2020-08-02 06:15,6,1,5,0,0,0
2020-08-02 06:30,6,6,0,0,0,0
2020-08-02 06:45,5,3,2,0,0,0
2020-08-02 07:00,2,2,0,0,0,0
2020-08-02 07:15,5,5,0,0,0,0
2020-08-02 07:30,11,7,4,0,0,0
2020-08-02 07:45,12,6,6,0,0,0
2020-08-02 08:00,5,4,1,0,0,0
2020-08-02 08:15,8,4,4,0,0,0
2020-08-02 08:30,13,8,5,0,0,0
2020-08-02 08:45,12,6,6,0,0,0
2020-08-02 09:00,11,10,1,0,0,0
2020-08-02 09:15,14,6,8,0,0,0
2020-08-02 09:30,26,12,14,0,0,0
2020-08-02 09:45,43,27,16,0,0,0
2020-08-02 10:00,29,19,10,0,0,0
2020-08-02 10:15,33,22,11,0,0,0
2020-08-02 10:30,35,26,9,0,0,0
2020-08-02 10:45,32,19,13,0,0,0
2020-08-02 11:00,35,16,19,0,0,0
2020-08-02 11:15,57,41,16,0,0,0
2020-08-02 11:30,40,22,18,0,0,0
2020-08-02 11:45,54,31,23,0,0,0
2020-08-02 12:00,47,32,15,0,0,0
2020-08-02 12:15,44,26,18,0,0,0
2020-08-02 12:30,58,36,22,0,0,0
2020-08-02 12:45,51,30,21,0,0,0
2020-08-02 13:00,65,40,25,0,0,0
2020-08-02 13:15,53,35,18,0,0,0
2020-08-02 13:30,51,32,19,0,0,0
2020-08-02 13:45,58,26,32,0,0,0
2020-08-02 14:00,79,43,36,0,0,0
2020-08-02 14:15,83,45,38,0,0,0
2020-08-02 14:30,67,37,30,0,0,0
2020-08-02 14:45,84,49,35,0,0,0
2020-08-02 15:00,78,40,38,0,0,0
2020-08-02 15:15,107,70,37,0,0,0
2020-08-02 15:30,93,54,39,0,0,0
2020-08-02 15:45,105,67,38,0,0,0
2020-08-02 16:00,88,58,30,0,0,0
2020-08-02 16:15,63,42,21,0,0,0
2020-08-02 16:30,56,33,23,0,0,0
2020-08-02 16:45,88,61,27,0,0,0
2020-08-02 17:00,78,45,33,0,0,0
2020-08-02 17:15,81,46,35,0,0,0
2020-08-02 17:30,63,38,25,0,0,0
2020-08-02 17:45,83,61,22,0,0,0
2020-08-02 18:00,80,48,32,0,0,0
2020-08-02 18:15,74,48,26,0,0,0
2020-08-02 18:30,60,36,24,0,0,0
2020-08-02 18:45,83,51,32,0,0,0
2020-08-02 19:00,64,40,24,0,0,0
2020-08-02 19:15,46,24,22,0,0,0
2020-08-02 19:30,48,32,16,0,0,0
2020-08-02 19:45,63,39,24,0,0,0
2020-08-02 20:00,47,24,23,0,0,0
2020-08-02 20:15,50,31,19,0,0,0
2020-08-02 20:30,42,23,19,0,0,0
2020-08-02 20:45,43,23,20,0,0,0
2020-08-02 21:00,55,31,24,0,0,0
2020-08-02 21:15,35,22,13,0,0,0
2020-08-02 21:30,19,8,11,0,0,0
2020-08-02 21:45,24,13,11,0,0,0
2020-08-02 22:00,22,9,13,0,0,0
2020-08-02 22:15,20,13,7,0,0,0
2020-08-02 22:30,8,3,5,0,0,0
2020-08-02 22:45,19,12,7,0,0,0
2020-08-02 23:00,13,3,10,0,0,0
2020-08-02 23:15,12,6,6,0,0,0
2020-08-02 23:30,11,4,7,0,0,0
2020-08-02 23:45,11,6,5,0,0,0
2020-08-03 00:00,10,2,8,0,0,0
2020-08-03 00:15,8,3,5,0,0,0
2020-08-03 00:30,2,1,1,0,0,0
2020-08-03 00:45,3,2,1,0,0,0
2020-08-03 01:00,1,0,1,0,0,0
2020-08-03 01:15,5,2,3,0,0,0
2020-08-03 01:30,3,0,3,0,0,0
2020-08-03 01:45,3,2,1,0,0,0
2020-08-03 02:00,2,1,1,0,0,0
2020-08-03 02:15,1,0,1,0,0,0
2020-08-03 02:30,1,1,0,0,0,0
2020-08-03 02:45,2,0,2,0,0,0
2020-08-03 03:00,0,0,0,0,0,0
2020-08-03 03:15,1,1,0,0,0,0
2020-08-03 03:30,1,1,0,0,0,0
2020-08-03 03:45,0,0,0,0,0,0
2020-08-03 04:00,0,0,0,0,0,0
2020-08-03 04:15,1,0,1,0,0,0
2020-08-03 04:30,1,1,0,0,0,0
2020-08-03 04:45,0,0,0,0,0,0
2020-08-03 05:00,0,0,0,0,0,0
2020-08-03 05:15,5,2,3,0,0,0
2020-08-03 05:30,12,7,5,0,0,0
2020-08-03 05:45,19,10,9,0,0,0
2020-08-03 06:00,22,10,12,0,0,0
2020-08-03 06:15,26,16,10,0,0,0
2020-08-03 06:30,40,20,20,0,0,0
2020-08-03 06:45,57,43,14,0,0,0
2020-08-03 07:00,68,46,22,0,0,0
2020-08-03 07:15,93,60,33,0,0,0
2020-08-03 07:30,88,64,24,0,0,0
2020-08-03 07:45,137,76,61,0,0,0
2020-08-03 08:00,107,76,31,0,0,0
2020-08-03 08:15,95,71,24,0,0,0
2020-08-03 08:30,98,75,23,0,0,0
2020-08-03 08:45,137,92,45,0,0,0
2020-08-03 09:00,93,63,30,0,0,0
2020-08-03 09:15,101,72,29,0,0,0
2020-08-03 09:30,98,67,31,0,0,0
2020-08-03 09:45,114,85,29,0,0,0
2020-08-03 10:00,87,66,21,0,0,0
2020-08-03 10:15,104,79,25,0,0,0
2020-08-03 10:30,107,75,32,0,0,0
2020-08-03 10:45,126,90,36,0,0,0
2020-08-03 11:00,114,73,41,0,0,0
2020-08-03 11:15,112,69,43,0,0,0
2020-08-03 11:30,101,62,39,0,0,0
2020-08-03 11:45,122,92,30,0,0,0
2020-08-03 12:00,97,53,44,0,0,0
2020-08-03 12:15,90,52,38,0,0,0
2020-08-03 12:30,111,74,37,0,0,0
2020-08-03 12:45,113,62,51,0,0,0
2020-08-03 13:00,139,79,60,0,0,0
2020-08-03 13:15,113,64,49,0,0,0
2020-08-03 13:30,112,58,54,0,0,0
2020-08-03 13:45,131,76,55,0,0,0
2020-08-03 14:00,105,60,45,0,0,0
2020-08-03 14:15,122,72,50,0,0,0
2020-08-03 14:30,156,98,58,0,0,0
2020-08-03 14:45,148,91,57,0,0,0
2020-08-03 15:00,126,67,59,0,0,0
2020-08-03 15:15,124,74,50,0,0,0
2020-08-03 15:30,132,76,56,0,0,0
2020-08-03 15:45,161,89,72,0,0,0
2020-08-03 16:00,178,98,80,0,0,0
2020-08-03 16:15,197,106,91,0,0,0
2020-08-03 16:30,190,110,80,0,0,0
2020-08-03 16:45,170,85,85,0,0,0
2020-08-03 17:00,175,88,87,0,0,0
2020-08-03 17:15,150,76,74,0,0,0
2020-08-03 17:30,165,92,73,0,0,0
2020-08-03 17:45,167,90,77,0,0,0
2020-08-03 18:00,161,73,88,0,0,0
2020-08-03 18:15,130,72,58,0,0,0
2020-08-03 18:30,126,60,66,0,0,0
2020-08-03 18:45,112,56,56,0,0,0
2020-08-03 19:00,115,47,68,0,0,0
2020-08-03 19:15,92,38,54,0,0,0
2020-08-03 19:30,85,46,39,0,0,0
2020-08-03 19:45,78,42,36,0,0,0
2020-08-03 20:00,79,31,48,0,0,0
2020-08-03 20:15,75,44,31,0,0,0
2020-08-03 20:30,71,35,36,0,0,0
2020-08-03 20:45,37,20,17,0,0,0
2020-08-03 21:00,43,23,20,0,0,0
2020-08-03 21:15,31,17,14,0,0,0
2020-08-03 21:30,42,21,21,0,0,0
2020-08-03 21:45,42,29,13,0,0,0
2020-08-03 22:00,34,23,11,0,0,0
2020-08-03 22:15,31,18,13,0,0,0
2020-08-03 22:30,39,13,26,0,0,0
2020-08-03 22:45,31,23,8,0,0,0
2020-08-03 23:00,18,8,10,0,0,0
2020-08-03 23:15,21,14,7,0,0,0
2020-08-03 23:30,15,9,6,0,0,0
2020-08-03 23:45,16,4,12,0,0,0
2020-08-04 00:00,12,2,10,0,0,0
2020-08-04 00:15,12,8,4,0,0,0
2020-08-04 00:30,6,0,6,0,0,0
2020-08-04 00:45,3,0,3,0,0,0
2020-08-04 01:00,5,0,5,0,0,0
2020-08-04 01:15,3,1,2,0,0,0
2020-08-04 01:30,4,4,0,0,0,0
2020-08-04 01:45,8,4,4,0,0,0
2020-08-04 02:00,0,0,0,0,0,0
2020-08-04 02:15,1,1,0,0,0,0
2020-08-04 02:30,3,0,3,0,0,0
2020-08-04 02:45,1,1,0,0,0,0
2020-08-04 03:00,0,0,0,0,0,0
2020-08-04 03:15,3,3,0,0,0,0
2020-08-04 03:30,2,0,2,0,0,0
2020-08-04 03:45,1,1,0,0,0,0
2020-08-04 04:00,1,0,1,0,0,0
2020-08-04 04:15,2,0,2,0,0,0
2020-08-04 04:30,1,1,0,0,0,0
2020-08-04 04:45,0,0,0,0,0,0
2020-08-04 05:00,1,1,0,0,0,0
2020-08-04 05:15,6,1,5,0,0,0
2020-08-04 05:30,16,7,9,0,0,0
2020-08-04 05:45,22,9,13,0,0,0
2020-08-04 06:00,22,16,6,0,0,0
2020-08-04 06:15,24,17,7,0,0,0
2020-08-04 06:30,45,24,21,0,0,0
2020-08-04 06:45,56,39,17,0,0,0
2020-08-04 07:00,85,53,32,0,0,0
2020-08-04 07:15,107,63,44,0,0,0
2020-08-04 07:30,103,73,30,0,0,0
2020-08-04 07:45,142,78,64,0,0,0
2020-08-04 08:00,106,79,27,0,0,0
2020-08-04 08:15,94,60,34,0,0,0
2020-08-04 08:30,119,87,32,0,0,0
2020-08-04 08:45,141,103,38,0,0,0
2020-08-04 09:00,101,66,35,0,0,0
2020-08-04 09:15,116,84,32,0,0,0
2020-08-04 09:30,93,64,29,0,0,0
2020-08-04 09:45,131,93,38,0,0,0
2020-08-04 10:00,86,56,30,0,0,0
2020-08-04 10:15,102,61,41,0,0,0
2020-08-04 10:30,106,69,37,0,0,0
2020-08-04 10:45,111,81,30,0,0,0
2020-08-04 11:00,94,68,26,0,0,0
2020-08-04 11:15,98,69,29,0,0,0
2020-08-04 11:30,87,48,39,0,0,0
2020-08-04 11:45,109,67,42,0,0,0
2020-08-04 12:00,109,56,53,0,0,0
2020-08-04 12:15,107,46,61,0,0,0
2020-08-04 12:30,124,76,48,0,0,0
2020-08-04 12:45,126,70,56,0,0,0
2020-08-04 13:00,111,57,54,0,0,0
2020-08-04 13:15,120,68,52,0,0,0
2020-08-04 13:30,127,77,50,0,0,0
2020-08-04 13:45,132,88,44,0,0,0
2020-08-04 14:00,113,63,50,0,0,0
2020-08-04 14:15,116,61,55,0,0,0
2020-08-04 14:30,141,83,58,0,0,0
2020-08-04 14:45,129,80,49,0,0,0
2020-08-04 15:00,143,79,64,0,0,0
2020-08-04 15:15,135,81,54,0,0,0
2020-08-04 15:30,119,63,56,0,0,0
2020-08-04 15:45,174,91,83,0,0,0
2020-08-04 16:00,165,85,80,0,0,0
2020-08-04 16:15,156,92,64,0,0,0
2020-08-04 16:30,169,103,66,0,0,0
2020-08-04 16:45,192,117,75,0,0,0
2020-08-04 17:00,166,87,79,0,0,0
2020-08-04 17:15,168,88,80,0,0,0
2020-08-04 17:30,156,83,73,0,0,0
2020-08-04 17:45,167,93,74,0,0,0
2020-08-04 18:00,151,68,83,0,0,0
2020-08-04 18:15,138,73,65,0,0,0
2020-08-04 18:30,160,86,74,0,0,0
2020-08-04 18:45,142,87,55,0,0,0
2020-08-04 19:00,100,50,50,0,0,0
2020-08-04 19:15,97,38,59,0,0,0
2020-08-04 19:30,73,38,35,0,0,0
2020-08-04 19:45,100,56,44,0,0,0
2020-08-04 20:00,106,53,53,0,0,0
2020-08-04 20:15,79,51,28,0,0,0
2020-08-04 20:30,63,29,34,0,0,0
2020-08-04 20:45,51,26,25,0,0,0
2020-08-04 21:00,56,29,27,0,0,0
2020-08-04 21:15,50,27,23,0,0,0
2020-08-04 21:30,60,31,29,0,0,0
2020-08-04 21:45,29,18,11,0,0,0
2020-08-04 22:00,34,16,18,0,0,0
2020-08-04 22:15,51,23,28,0,0,0
2020-08-04 22:30,37,17,20,0,0,0
2020-08-04 22:45,20,11,9,0,0,0
2020-08-04 23:00,22,15,7,0,0,0
2020-08-04 23:15,22,11,11,0,0,0
2020-08-04 23:30,19,9,10,0,0,0
2020-08-04 23:45,16,10,6,0,0,0
2020-08-05 00:00,22,3,19,0,0,0
2020-08-05 00:15,10,5,5,0,0,0
2020-08-05 00:30,8,2,6,0,0,0
2020-08-05 00:45,12,6,6,0,0,0
2020-08-05 01:00,1,0,1,0,0,0
2020-08-05 01:15,6,0,6,0,0,0
2020-08-05 01:30,1,1,0,0,0,0
2020-08-05 01:45,8,3,5,0,0,0
2020-08-05 02:00,5,3,2,0,0,0
2020-08-05 02:15,5,1,4,0,0,0
2020-08-05 02:30,3,2,1,0,0,0
2020-08-05 02:45,1,0,1,0,0,0
2020-08-05 03:00,2,0,2,0,0,0
2020-08-05 03:15,1,0,1,0,0,0
2020-08-05 03:30,3,1,2,0,0,0
2020-08-05 03:45,1,1,0,0,0,0
2020-08-05 04:00,2,0,2,0,0,0
2020-08-05 04:15,3,2,1,0,0,0
2020-08-05 04:30,1,1,0,0,0,0
2020-08-05 04:45,0,0,0,0,0,0
2020-08-05 05:00,1,0,1,0,0,0
2020-08-05 05:15,6,2,4,0,0,0
2020-08-05 05:30,17,12,5,0,0,0
2020-08-05 05:45,17,4,13,0,0,0
2020-08-05 06:00,24,13,11,0,0,0
2020-08-05 06:15,30,22,8,0,0,0
2020-08-05 06:30,51,34,17,0,0,0
2020-08-05 06:45,67,46,21,0,0,0
2020-08-05 07:00,79,53,26,0,0,0
2020-08-05 07:15,103,66,37,0,0,0
2020-08-05 07:30,120,77,43,0,0,0
2020-08-05 07:45,145,95,50,0,0,0
2020-08-05 08:00,111,75,36,0,0,0
2020-08-05 08:15,125,88,37,0,0,0
2020-08-05 08:30,119,86,33,0,0,0
2020-08-05 08:45,172,127,45,0,0,0
2020-08-05 09:00,105,64,41,0,0,0
2020-08-05 09:15,115,84,31,0,0,0
2020-08-05 09:30,111,88,23,0,0,0
2020-08-05 09:45,131,101,30,0,0,0
2020-08-05 10:00,85,67,18,0,0,0
2020-08-05 10:15,141,96,45,0,0,0
2020-08-05 10:30,120,88,32,0,0,0
2020-08-05 10:45,175,116,59,0,0,0
2020-08-05 11:00,146,86,60,0,0,0
2020-08-05 11:15,123,82,41,0,0,0
2020-08-05 11:30,141,95,46,0,0,0
2020-08-05 11:45,177,103,74,0,0,0
2020-08-05 12:00,132,73,59,0,0,0
2020-08-05 12:15,154,97,57,0,0,0
2020-08-05 12:30,154,88,66,0,0,0
2020-08-05 12:45,163,91,72,0,0,0
2020-08-05 13:00,142,60,82,0,0,0
2020-08-05 13:15,149,80,69,0,0,0
2020-08-05 13:30,150,67,83,0,0,0
2020-08-05 13:45,146,78,68,0,0,0
2020-08-05 14:00,124,66,58,0,0,0
2020-08-05 14:15,134,63,71,0,0,0
2020-08-05 14:30,141,73,68,0,0,0
2020-08-05 14:45,158,62,96,0,0,0
2020-08-05 15:00,123,62,61,0,0,0
2020-08-05 15:15,134,69,65,0,0,0
2020-08-05 15:30,143,69,74,0,0,0
2020-08-05 15:45,169,84,85,0,0,0
2020-08-05 16:00,166,85,81,0,0,0
2020-08-05 16:15,169,77,92,0,0,0
2020-08-05 16:30,171,81,90,0,0,0
2020-08-05 16:45,139,68,71,0,0,0
2020-08-05 17:00,139,68,71,0,0,0
2020-08-05 17:15,163,80,83,0,0,0
2020-08-05 17:30,156,88,68,0,0,0
2020-08-05 17:45,150,73,77,0,0,0
2020-08-05 18:00,192,110,82,0,0,0
2020-08-05 18:15,170,103,67,0,0,0
2020-08-05 18:30,150,80,70,0,0,0
2020-08-05 18:45,142,75,67,0,0,0
2020-08-05 19:00,129,59,70,0,0,0
2020-08-05 19:15,101,59,42,0,0,0
2020-08-05 19:30,112,69,43,0,0,0
2020-08-05 19:45,113,73,40,0,0,0
2020-08-05 20:00,103,54,49,0,0,0
2020-08-05 20:15,86,52,34,0,0,0
2020-08-05 20:30,81,50,31,0,0,0
2020-08-05 20:45,88,47,41,0,0,0
2020-08-05 21:00,61,36,25,0,0,0
2020-08-05 21:15,84,51,33,0,0,0
2020-08-05 21:30,73,46,27,0,0,0
2020-08-05 21:45,71,42,29,0,0,0
2020-08-05 22:00,47,24,23,0,0,0
2020-08-05 22:15,50,26,24,0,0,0
2020-08-05 22:30,68,47,21,0,0,0
2020-08-05 22:45,45,30,15,0,0,0
2020-08-05 23:00,33,23,10,0,0,0
2020-08-05 23:15,29,15,14,0,0,0
2020-08-05 23:30,32,13,19,0,0,0
2020-08-05 23:45,32,18,14,0,0,0
2020-08-06 00:00,16,10,6,0,0,0
2020-08-06 00:15,12,4,8,0,0,0
2020-08-06 00:30,15,14,1,0,0,0
2020-08-06 00:45,14,12,2,0,0,0
2020-08-06 01:00,11,5,6,0,0,0
2020-08-06 01:15,3,1,2,0,0,0
2020-08-06 01:30,7,5,2,0,0,0
2020-08-06 01:45,8,4,4,0,0,0
2020-08-06 02:00,4,1,3,0,0,0
2020-08-06 02:15,4,1,3,0,0,0
2020-08-06 02:30,0,0,0,0,0,0
2020-08-06 02:45,3,1,2,0,0,0
2020-08-06 03:00,2,1,1,0,0,0
2020-08-06 03:15,2,1,1,0,0,0
2020-08-06 03:30,6,4,2,0,0,0
2020-08-06 03:45,2,1,1,0,0,0
2020-08-06 04:00,2,1,1,0,0,0
2020-08-06 04:15,6,4,2,0,0,0
2020-08-06 04:30,4,3,1,0,0,0
2020-08-06 04:45,3,2,1,0,0,0
2020-08-06 05:00,1,1,0,0,0,0
2020-08-06 05:15,5,3,2,0,0,0
2020-08-06 05:30,17,10,7,0,0,0
2020-08-06 05:45,25,9,16,0,0,0
2020-08-06 06:00,19,12,7,0,0,0
2020-08-06 06:15,34,26,8,0,0,0
2020-08-06 06:30,50,28,22,0,0,0
2020-08-06 06:45,71,45,26,0,0,0
2020-08-06 07:00,77,49,28,0,0,0
2020-08-06 07:15,104,55,49,0,0,0
2020-08-06 07:30,89,58,31,0,0,0
2020-08-06 07:45,139,101,38,0,0,0
2020-08-06 08:00,101,68,33,0,0,0
2020-08-06 08:15,110,79,31,0,0,0
2020-08-06 08:30,116,92,24,0,0,0
2020-08-06 08:45,149,102,47,0,0,0
2020-08-06 09:00,85,55,30,0,0,0
2020-08-06 09:15,99,64,35,0,0,0
2020-08-06 09:30,103,73,30,0,0,0
2020-08-06 09:45,128,93,35,0,0,0
2020-08-06 10:00,102,74,28,0,0,0
2020-08-06 10:15,92,52,40,0,0,0
2020-08-06 10:30,95,66,29,0,0,0
2020-08-06 10:45,100,59,41,0,0,0
2020-08-06 11:00,96,63,33,0,0,0
2020-08-06 11:15,98,56,42,0,0,0
2020-08-06 11:30,88,48,40,0,0,0
2020-08-06 11:45,117,70,47,0,0,0
2020-08-06 12:00,111,60,51,0,0,0
2020-08-06 12:15,102,58,44,0,0,0
2020-08-06 12:30,124,64,60,0,0,0
2020-08-06 12:45,138,73,65,0,0,0
2020-08-06 13:00,125,74,51,0,0,0
2020-08-06 13:15,106,43,63,0,0,0
2020-08-06 13:30,127,67,60,0,0,0
2020-08-06 13:45,150,71,79,0,0,0
2020-08-06 14:00,109,56,53,0,0,0
2020-08-06 14:15,120,63,57,0,0,0
2020-08-06 14:30,127,64,63,0,0,0
2020-08-06 14:45,150,71,79,0,0,0
2020-08-06 15:00,125,67,58,0,0,0
2020-08-06 15:15,150,63,87,0,0,0
2020-08-06 15:30,139,87,52,0,0,0
2020-08-06 15:45,144,73,71,0,0,0
2020-08-06 16:00,137,64,73,0,0,0
2020-08-06 16:15,225,122,103,0,0,0
2020-08-06 16:30,162,80,82,0,0,0
2020-08-06 16:45,178,96,82,0,0,0
2020-08-06 17:00,176,94,82,0,0,0
2020-08-06 17:15,162,86,76,0,0,0
2020-08-06 17:30,158,84,74,0,0,0
2020-08-06 17:45,169,101,68,0,0,0
2020-08-06 18:00,158,67,91,0,0,0
2020-08-06 18:15,165,89,76,0,0,0
2020-08-06 18:30,137,65,72,0,0,0
2020-08-06 18:45,152,90,62,0,0,0
2020-08-06 19:00,133,71,62,0,0,0
2020-08-06 19:15,112,68,44,0,0,0
2020-08-06 19:30,131,98,33,0,0,0
2020-08-06 19:45,130,79,51,0,0,0
2020-08-06 20:00,111,60,51,0,0,0
2020-08-06 20:15,95,51,44,0,0,0
2020-08-06 20:30,80,50,30,0,0,0
2020-08-06 20:45,84,53,31,0,0,0
2020-08-06 21:00,67,39,28,0,0,0
2020-08-06 21:15,67,39,28,0,0,0
2020-08-06 21:30,79,44,35,0,0,0
2020-08-06 21:45,47,28,19,0,0,0
2020-08-06 22:00,53,31,22,0,0,0
2020-08-06 22:15,63,44,19,0,0,0
2020-08-06 22:30,56,37,19,0,0,0
2020-08-06 22:45,50,23,27,0,0,0
2020-08-06 23:00,53,32,21,0,0,0
2020-08-06 23:15,28,20,8,0,0,0
2020-08-06 23:30,30,20,10,0,0,0
2020-08-06 23:45,34,20,14,0,0,0
2020-08-07 00:00,12,5,7,0,0,0
2020-08-07 00:15,23,8,15,0,0,0
2020-08-07 00:30,7,3,4,0,0,0
2020-08-07 00:45,16,9,7,0,0,0
2020-08-07 01:00,5,0,5,0,0,0
2020-08-07 01:15,9,5,4,0,0,0
2020-08-07 01:30,8,2,6,0,0,0
2020-08-07 01:45,6,4,2,0,0,0
2020-08-07 02:00,7,5,2,0,0,0
2020-08-07 02:15,3,0,3,0,0,0
2020-08-07 02:30,2,1,1,0,0,0
2020-08-07 02:45,4,3,1,0,0,0
2020-08-07 03:00,2,0,2,0,0,0
2020-08-07 03:15,1,0,1,0,0,0
2020-08-07 03:30,1,0,1,0,0,0
2020-08-07 03:45,0,0,0,0,0,0
2020-08-07 04:00,3,2,1,0,0,0
2020-08-07 04:15,6,2,4,0,0,0
2020-08-07 04:30,3,2,1,0,0,0
2020-08-07 04:45,1,1,0,0,0,0
2020-08-07 05:00,0,0,0,0,0,0
2020-08-07 05:15,5,4,1,0,0,0
2020-08-07 05:30,15,11,4,0,0,0
2020-08-07 05:45,20,8,12,0,0,0
2020-08-07 06:00,21,13,8,0,0,0
2020-08-07 06:15,28,19,9,0,0,0
2020-08-07 06:30,38,21,17,0,0,0
2020-08-07 06:45,56,37,19,0,0,0
2020-08-07 07:00,65,44,21,0,0,0
2020-08-07 07:15,70,45,25,0,0,0
2020-08-07 07:30,89,59,30,0,0,0
2020-08-07 07:45,134,88,46,0,0,0
2020-08-07 08:00,89,61,28,0,0,0
2020-08-07 08:15,101,74,27,0,0,0
2020-08-07 08:30,105,80,25,0,0,0
2020-08-07 08:45,112,79,33,0,0,0
2020-08-07 09:00,81,55,26,0,0,0
2020-08-07 09:15,115,87,28,0,0,0
2020-08-07 09:30,79,60,19,0,0,0
2020-08-07 09:45,114,86,28,0,0,0
2020-08-07 10:00,85,68,17,0,0,0
2020-08-07 10:15,105,68,37,0,0,0
2020-08-07 10:30,95,59,36,0,0,0
2020-08-07 10:45,122,82,40,0,0,0
2020-08-07 11:00,113,58,55,0,0,0
2020-08-07 11:15,111,76,35,0,0,0
2020-08-07 11:30,86,54,32,0,0,0
2020-08-07 11:45,111,61,50,0,0,0
2020-08-07 12:00,108,63,45,0,0,0
2020-08-07 12:15,101,56,45,0,0,0
2020-08-07 12:30,111,61,50,0,0,0
2020-08-07 12:45,123,69,54,0,0,0
2020-08-07 13:00,130,61,69,0,0,0
2020-08-07 13:15,121,59,62,0,0,0
2020-08-07 13:30,128,52,76,0,0,0
2020-08-07 13:45,144,76,68,0,0,0
2020-08-07 14:00,127,63,64,0,0,0
2020-08-07 14:15,150,76,74,0,0,0
2020-08-07 14:30,112,58,54,0,0,0
2020-08-07 14:45,128,68,60,0,0,0
2020-08-07 15:00,138,68,70,0,0,0
2020-08-07 15:15,123,52,71,0,0,0
2020-08-07 15:30,130,74,56,0,0,0
2020-08-07 15:45,117,59,58,0,0,0
2020-08-07 16:00,136,58,78,0,0,0
2020-08-07 16:15,116,69,47,0,0,0
2020-08-07 16:30,118,59,59,0,0,0
2020-08-07 16:45,124,58,66,0,0,0
2020-08-07 17:00,129,70,59,0,0,0
2020-08-07 17:15,127,63,64,0,0,0
2020-08-07 17:30,125,71,54,0,0,0
2020-08-07 17:45,163,101,62,0,0,0
2020-08-07 18:00,127,65,62,0,0,0
2020-08-07 18:15,120,68,52,0,0,0
2020-08-07 18:30,113,57,56,0,0,0
2020-08-07 18:45,135,96,39,0,0,0
2020-08-07 19:00,143,89,54,0,0,0
2020-08-07 19:15,125,77,48,0,0,0
2020-08-07 19:30,139,77,62,0,0,0
2020-08-07 19:45,136,104,32,0,0,0
2020-08-07 20:00,82,43,39,0,0,0
2020-08-07 20:15,84,55,29,0,0,0
2020-08-07 20:30,84,48,36,0,0,0
2020-08-07 20:45,78,50,28,0,0,0
2020-08-07 21:00,71,42,29,0,0,0
2020-08-07 21:15,50,30,20,0,0,0
2020-08-07 21:30,50,30,20,0,0,0
2020-08-07 21:45,67,40,27,0,0,0
2020-08-07 22:00,32,15,17,0,0,0
2020-08-07 22:15,48,20,28,0,0,0
2020-08-07 22:30,57,38,19,0,0,0
2020-08-07 22:45,41,24,17,0,0,0
2020-08-07 23:00,50,25,25,0,0,0
2020-08-07 23:15,37,15,22,0,0,0
2020-08-07 23:30,62,23,39,0,0,0
2020-08-07 23:45,38,25,13,0,0,0
2020-08-08 00:00,35,14,21,0,0,0
2020-08-08 00:15,24,15,9,0,0,0
2020-08-08 00:30,23,14,9,0,0,0
2020-08-08 00:45,28,16,12,0,0,0
2020-08-08 01:00,39,26,13,0,0,0
2020-08-08 01:15,12,3,9,0,0,0
2020-08-08 01:30,18,11,7,0,0,0
2020-08-08 01:45,15,6,9,0,0,0
2020-08-08 02:00,5,3,2,0,0,0
2020-08-08 02:15,21,7,14,0,0,0
2020-08-08 02:30,7,5,2,0,0,0
2020-08-08 02:45,12,6,6,0,0,0
2020-08-08 03:00,4,1,3,0,0,0
2020-08-08 03:15,6,4,2,0,0,0
2020-08-08 03:30,9,1,8,0,0,0
2020-08-08 03:45,5,4,1,0,0,0
2020-08-08 04:00,4,2,2,0,0,0
2020-08-08 04:15,1,0,1,0,0,0
2020-08-08 04:30,7,3,4,0,0,0
2020-08-08 04:45,6,5,1,0,0,0
2020-08-08 05:00,3,1,2,0,0,0
2020-08-08 05:15,6,4,2,0,0,0
2020-08-08 05:30,7,4,3,0,0,0
2020-08-08 05:45,3,1,2,0,0,0
2020-08-08 06:00,9,5,4,0,0,0
2020-08-08 06:15,10,6,4,0,0,0
2020-08-08 06:30,8,7,1,0,0,0
2020-08-08 06:45,22,19,3,0,0,0
2020-08-08 07:00,28,20,8,0,0,0
2020-08-08 07:15,21,12,9,0,0,0
2020-08-08 07:30,41,24,17,0,0,0
2020-08-08 07:45,39,24,15,0,0,0
2020-08-08 08:00,37,24,13,0,0,0
2020-08-08 08:15,61,45,16,0,0,0
2020-08-08 08:30,58,39,19,0,0,0
2020-08-08 08:45,70,46,24,0,0,0
2020-08-08 09:00,83,55,28,0,0,0
2020-08-08 09:15,84,63,21,0,0,0
2020-08-08 09:30,90,61,29,0,0,0
2020-08-08 09:45,140,114,26,0,0,0
2020-08-08 10:00,133,87,46,0,0,0
2020-08-08 10:15,136,104,32,0,0,0
2020-08-08 10:30,123,82,41,0,0,0
2020-08-08 10:45,145,87,58,0,0,0
2020-08-08 11:00,145,92,53,0,0,0
2020-08-08 11:15,127,85,42,0,0,0
2020-08-08 11:30,121,90,31,0,0,0
2020-08-08 11:45,143,75,68,0,0,0
2020-08-08 12:00,139,70,69,0,0,0
2020-08-08 12:15,130,78,52,0,0,0
2020-08-08 12:30,138,69,69,0,0,0
2020-08-08 12:45,140,70,70,0,0,0
2020-08-08 13:00,137,58,79,0,0,0
2020-08-08 13:15,114,53,61,0,0,0
2020-08-08 13:30,118,54,64,0,0,0
2020-08-08 13:45,120,56,64,0,0,0
2020-08-08 14:00,132,70,62,0,0,0
2020-08-08 14:15,123,52,71,0,0,0
2020-08-08 14:30,117,47,70,0,0,0
2020-08-08 14:45,106,41,65,0,0,0
2020-08-08 15:00,123,44,79,0,0,0
2020-08-08 15:15,84,25,59,0,0,0
2020-08-08 15:30,93,43,50,0,0,0
2020-08-08 15:45,124,60,64,0,0,0
2020-08-08 16:00,108,46,62,0,0,0
2020-08-08 16:15,79,35,44,0,0,0
2020-08-08 16:30,87,36,51,0,0,0
2020-08-08 16:45,98,49,49,0,0,0
2020-08-08 17:00,90,51,39,0,0,0
2020-08-08 17:15,88,64,24,0,0,0
2020-08-08 17:30,126,84,42,0,0,0
2020-08-08 17:45,94,56,38,0,0,0
2020-08-08 18:00,89,60,29,0,0,0
2020-08-08 18:15,113,70,43,0,0,0
2020-08-08 18:30,128,85,43,0,0,0
2020-08-08 18:45,108,68,40,0,0,0
2020-08-08 19:00,116,76,40,0,0,0
2020-08-08 19:15,122,90,32,0,0,0
2020-08-08 19:30,90,69,21,0,0,0
2020-08-08 19:45,80,52,28,0,0,0
2020-08-08 20:00,71,48,23,0,0,0
2020-08-08 20:15,91,72,19,0,0,0
2020-08-08 20:30,76,50,26,0,0,0
2020-08-08 20:45,83,64,19,0,0,0
2020-08-08 21:00,57,37,20,0,0,0
2020-08-08 21:15,56,32,24,0,0,0
2020-08-08 21:30,45,26,19,0,0,0
2020-08-08 21:45,30,19,11,0,0,0
2020-08-08 22:00,32,27,5,0,0,0
2020-08-08 22:15,44,30,14,0,0,0
2020-08-08 22:30,25,11,14,0,0,0
2020-08-08 22:45,37,20,17,0,0,0
2020-08-08 23:00,38,20,18,0,0,0
2020-08-08 23:15,35,20,15,0,0,0
2020-08-08 23:30,34,20,14,0,0,0
2020-08-08 23:45,41,23,18,0,0,0
2020-08-09 00:00,53,25,28,0,0,0
2020-08-09 00:15,25,12,13,0,0,0
2020-08-09 00:30,34,23,11,0,0,0
2020-08-09 00:45,26,16,10,0,0,0
2020-08-09 01:00,26,13,13,0,0,0
2020-08-09 01:15,16,9,7,0,0,0
2020-08-09 01:30,29,13,16,0,0,0
2020-08-09 01:45,18,7,11,0,0,0
2020-08-09 02:00,19,10,9,0,0,0
2020-08-09 02:15,17,8,9,0,0,0
2020-08-09 02:30,10,3,7,0,0,0
2020-08-09 02:45,15,7,8,0,0,0
2020-08-09 03:00,13,10,3,0,0,0
2020-08-09 03:15,8,5,3,0,0,0
2020-08-09 03:30,5,1,4,0,0,0
2020-08-09 03:45,6,2,4,0,0,0
2020-08-09 04:00,4,1,3,0,0,0
2020-08-09 04:15,2,1,1,0,0,0
2020-08-09 04:30,4,1,3,0,0,0
2020-08-09 04:45,1,0,1,0,0,0
2020-08-09 05:00,6,5,1,0,0,0
2020-08-09 05:15,10,9,1,0,0,0
2020-08-09 05:30,6,4,2,0,0,0
2020-08-09 05:45,8,4,4,0,0,0
2020-08-09 06:00,1,0,1,0,0,0
2020-08-09 06:15,10,8,2,0,0,0
2020-08-09 06:30,10,6,4,0,0,0
2020-08-09 06:45,8,4,4,0,0,0
2020-08-09 07:00,6,4,2,0,0,0
2020-08-09 07:15,4,2,2,0,0,0
2020-08-09 07:30,14,10,4,0,0,0
2020-08-09 07:45,14,7,7,0,0,0
2020-08-09 08:00,13,8,5,0,0,0
2020-08-09 08:15,15,8,7,0,0,0
2020-08-09 08:30,18,13,5,0,0,0
2020-08-09 08:45,32,18,14,0,0,0
2020-08-09 09:00,31,22,9,0,0,0
2020-08-09 09:15,30,13,17,0,0,0
2020-08-09 09:30,29,17,12,0,0,0
2020-08-09 09:45,40,29,11,0,0,0
2020-08-09 10:00,41,26,15,0,0,0
2020-08-09 10:15,47,25,22,0,0,0
2020-08-09 10:30,35,20,15,0,0,0
2020-08-09 10:45,55,41,14,0,0,0
2020-08-09 11:00,54,29,25,0,0,0
2020-08-09 11:15,50,27,23,0,0,0
2020-08-09 11:30,39,18,21,0,0,0
2020-08-09 11:45,50,30,20,0,0,0
2020-08-09 12:00,48,20,28,0,0,0
2020-08-09 12:15,59,37,22,0,0,0
2020-08-09 12:30,59,25,34,0,0,0
2020-08-09 12:45,65,36,29,0,0,0
2020-08-09 13:00,57,30,27,0,0,0
2020-08-09 13:15,57,37,20,0,0,0
2020-08-09 13:30,44,22,22,0,0,0
2020-08-09 13:45,68,42,26,0,0,0
2020-08-09 14:00,62,35,27,0,0,0
2020-08-09 14:15,77,48,29,0,0,0
2020-08-09 14:30,56,33,23,0,0,0
2020-08-09 14:45,57,31,26,0,0,0
2020-08-09 15:00,59,34,25,0,0,0
2020-08-09 15:15,61,32,29,0,0,0
2020-08-09 15:30,71,39,32,0,0,0
2020-08-09 15:45,58,39,19,0,0,0
2020-08-09 16:00,52,31,21,0,0,0
2020-08-09 16:15,50,29,21,0,0,0
2020-08-09 16:30,61,28,33,0,0,0
2020-08-09 16:45,67,47,20,0,0,0
2020-08-09 17:00,62,41,21,0,0,0
2020-08-09 17:15,56,39,17,0,0,0
2020-08-09 17:30,72,51,21,0,0,0
2020-08-09 17:45,123,91,32,0,0,0
2020-08-09 18:00,133,101,32,0,0,0
2020-08-09 18:15,91,71,20,0,0,0
2020-08-09 18:30,54,32,22,0,0,0
2020-08-09 18:45,9,6,3,0,0,0
2020-08-09 19:00,28,16,12,0,0,0
2020-08-09 19:15,45,35,10,0,0,0
2020-08-09 19:30,44,32,12,0,0,0
2020-08-09 19:45,60,34,26,0,0,0
2020-08-09 20:00,38,26,12,0,0,0
2020-08-09 20:15,43,30,13,0,0,0
2020-08-09 20:30,34,24,10,0,0,0
2020-08-09 20:45,37,27,10,0,0,0
2020-08-09 21:00,35,24,11,0,0,0
2020-08-09 21:15,24,12,12,0,0,0
2020-08-09 21:30,33,22,11,0,0,0
2020-08-09 21:45,25,16,9,0,0,0
2020-08-09 22:00,24,12,12,0,0,0
2020-08-09 22:15,35,24,11,0,0,0
2020-08-09 22:30,8,6,2,0,0,0
2020-08-09 22:45,15,8,7,0,0,0
2020-08-09 23:00,13,10,3,0,0,0
2020-08-09 23:15,21,9,12,0,0,0
2020-08-09 23:30,13,5,8,0,0,0
2020-08-09 23:45,15,6,9,0,0,0
2020-08-10 00:00,11,4,7,0,0,0
2020-08-10 00:15,15,2,13,0,0,0
2020-08-10 00:30,7,5,2,0,0,0
2020-08-10 00:45,7,3,4,0,0,0
2020-08-10 01:00,3,2,1,0,0,0
2020-08-10 01:15,1,1,0,0,0,0
2020-08-10 01:30,4,3,1,0,0,0
2020-08-10 01:45,3,2,1,0,0,0
2020-08-10 02:00,0,0,0,0,0,0
2020-08-10 02:15,0,0,0,0,0,0
2020-08-10 02:30,2,0,2,0,0,0
2020-08-10 02:45,0,0,0,0,0,0
2020-08-10 03:00,1,0,1,0,0,0
2020-08-10 03:15,0,0,0,0,0,0
2020-08-10 03:30,1,1,0,0,0,0
2020-08-10 03:45,1,0,1,0,0,0
2020-08-10 04:00,1,1,0,0,0,0
2020-08-10 04:15,4,1,3,0,0,0
2020-08-10 04:30,3,1,2,0,0,0
2020-08-10 04:45,8,4,4,0,0,0
2020-08-10 05:00,0,0,0,0,0,0
2020-08-10 05:15,10,9,1,0,0,0
2020-08-10 05:30,13,11,2,0,0,0
2020-08-10 05:45,21,10,11,0,0,0
2020-08-10 06:00,26,15,11,0,0,0
2020-08-10 06:15,42,32,10,0,0,0
2020-08-10 06:30,42,22,20,0,0,0
2020-08-10 06:45,66,51,15,0,0,0
2020-08-10 07:00,71,39,32,0,0,0
2020-08-10 07:15,93,58,35,0,0,0
2020-08-10 07:30,109,75,34,0,0,0
2020-08-10 07:45,143,92,51,0,0,0
2020-08-10 08:00,116,85,31,0,0,0
2020-08-10 08:15,106,74,32,0,0,0
2020-08-10 08:30,126,90,36,0,0,0
2020-08-10 08:45,147,110,37,0,0,0
2020-08-10 09:00,86,69,17,0,0,0
2020-08-10 09:15,81,57,24,0,0,0
2020-08-10 09:30,89,66,23,0,0,0
2020-08-10 09:45,116,92,24,0,0,0
2020-08-10 10:00,83,63,20,0,0,0
2020-08-10 10:15,96,65,31,0,0,0
2020-08-10 10:30,149,104,45,0,0,0
2020-08-10 10:45,105,65,40,0,0,0
2020-08-10 11:00,89,53,36,0,0,0
2020-08-10 11:15,98,64,34,0,0,0
2020-08-10 11:30,108,66,42,0,0,0
2020-08-10 11:45,114,71,43,0,0,0
2020-08-10 12:00,92,54,38,0,0,0
2020-08-10 12:15,108,66,42,0,0,0
2020-08-10 12:30,122,67,55,0,0,0
2020-08-10 12:45,102,55,47,0,0,0
2020-08-10 13:00,123,62,61,0,0,0
2020-08-10 13:15,85,47,38,0,0,0
2020-08-10 13:30,110,66,44,0,0,0
2020-08-10 13:45,100,47,53,0,0,0
2020-08-10 14:00,106,63,43,0,0,0
2020-08-10 14:15,115,56,59,0,0,0
2020-08-10 14:30,125,61,64,0,0,0
2020-08-10 14:45,147,93,54,0,0,0
2020-08-10 15:00,112,59,53,0,0,0
2020-08-10 15:15,138,73,65,0,0,0
2020-08-10 15:30,167,78,89,0,0,0
2020-08-10 15:45,169,95,74,0,0,0
2020-08-10 16:00,150,74,76,0,0,0
2020-08-10 16:15,135,64,71,0,0,0
2020-08-10 16:30,163,85,78,0,0,0
2020-08-10 16:45,143,85,58,0,0,0
2020-08-10 17:00,133,62,71,0,0,0
2020-08-10 17:15,161,89,72,0,0,0
2020-08-10 17:30,119,54,65,0,0,0
2020-08-10 17:45,133,78,55,0,0,0
2020-08-10 18:00,134,75,59,0,0,0
2020-08-10 18:15,123,65,58,0,0,0
2020-08-10 18:30,113,60,53,0,0,0
2020-08-10 18:45,112,56,56,0,0,0
2020-08-10 19:00,102,63,39,0,0,0
2020-08-10 19:15,104,61,43,0,0,0
2020-08-10 19:30,77,47,30,0,0,0
2020-08-10 19:45,101,54,47,0,0,0
2020-08-10 20:00,90,48,42,0,0,0
2020-08-10 20:15,72,56,16,0,0,0
2020-08-10 20:30,58,43,15,0,0,0
2020-08-10 20:45,78,55,23,0,0,0
2020-08-10 21:00,66,45,21,0,0,0
2020-08-10 21:15,47,33,14,0,0,0
2020-08-10 21:30,53,42,11,0,0,0
2020-08-10 21:45,50,34,16,0,0,0
2020-08-10 22:00,36,20,16,0,0,0
2020-08-10 22:15,49,28,21,0,0,0
2020-08-10 22:30,37,18,19,0,0,0
2020-08-10 22:45,43,28,15,0,0,0
2020-08-10 23:00,25,10,15,0,0,0
2020-08-10 23:15,26,15,11,0,0,0
2020-08-10 23:30,17,9,8,0,0,0
2020-08-10 23:45,26,13,13,0,0,0
2020-08-11 00:00,15,6,9,0,0,0
2020-08-11 00:15,10,6,4,0,0,0
2020-08-11 00:30,12,8,4,0,0,0
2020-08-11 00:45,11,8,3,0,0,0
2020-08-11 01:00,13,3,10,0,0,0
2020-08-11 01:15,12,5,7,0,0,0
2020-08-11 01:30,3,1,2,0,0,0
2020-08-11 01:45,6,5,1,0,0,0
2020-08-11 02:00,8,5,3,0,0,0
2020-08-11 02:15,2,0,2,0,0,0
2020-08-11 02:30,2,0,2,0,0,0
2020-08-11 02:45,1,0,1,0,0,0
2020-08-11 03:00,1,1,0,0,0,0
2020-08-11 03:15,1,0,1,0,0,0
2020-08-11 03:30,1,0,1,0,0,0
2020-08-11 03:45,2,0,2,0,0,0
2020-08-11 04:00,1,0,1,0,0,0
2020-08-11 04:15,3,2,1,0,0,0
2020-08-11 04:30,3,2,1,0,0,0
2020-08-11 04:45,2,1,1,0,0,0
2020-08-11 05:00,1,1,0,0,0,0
2020-08-11 05:15,9,4,5,0,0,0
2020-08-11 05:30,23,15,8,0,0,0
2020-08-11 05:45,17,5,12,0,0,0
2020-08-11 06:00,29,18,11,0,0,0
2020-08-11 06:15,39,24,15,0,0,0
2020-08-11 06:30,69,42,27,0,0,0
2020-08-11 06:45,77,55,22,0,0,0
2020-08-11 07:00,82,53,29,0,0,0
2020-08-11 07:15,100,65,35,0,0,0
2020-08-11 07:30,98,72,26,0,0,0
2020-08-11 07:45,167,112,55,0,0,0
2020-08-11 08:00,112,79,33,0,0,0
2020-08-11 08:15,131,91,40,0,0,0
2020-08-11 08:30,147,108,39,0,0,0
2020-08-11 08:45,155,114,41,0,0,0
2020-08-11 09:00,100,75,25,0,0,0
2020-08-11 09:15,72,43,29,0,0,0
2020-08-11 09:30,108,76,32,0,0,0
2020-08-11 09:45,122,87,35,0,0,0
2020-08-11 10:00,97,62,35,0,0,0
2020-08-11 10:15,119,78,41,0,0,0
2020-08-11 10:30,122,85,37,0,0,0
2020-08-11 10:45,121,81,40,0,0,0
2020-08-11 11:00,93,55,38,0,0,0
2020-08-11 11:15,105,58,47,0,0,0
2020-08-11 11:30,99,69,30,0,0,0
2020-08-11 11:45,113,56,57,0,0,0
2020-08-11 12:00,116,63,53,0,0,0
2020-08-11 12:15,128,68,60,0,0,0
2020-08-11 12:30,121,62,59,0,0,0
2020-08-11 12:45,153,90,63,0,0,0
2020-08-11 13:00,113,64,49,0,0,0
2020-08-11 13:15,111,49,62,0,0,0
2020-08-11 13:30,99,53,46,0,0,0
2020-08-11 13:45,129,61,68,0,0,0
2020-08-11 14:00,124,54,70,0,0,0
2020-08-11 14:15,120,64,56,0,0,0
2020-08-11 14:30,117,58,59,0,0,0
2020-08-11 14:45,134,49,85,0,0,0
2020-08-11 15:00,141,63,78,0,0,0
2020-08-11 15:15,119,61,58,0,0,0
2020-08-11 15:30,139,76,63,0,0,0
2020-08-11 15:45,153,78,75,0,0,0
2020-08-11 16:00,112,51,61,0,0,0
2020-08-11 16:15,120,59,61,0,0,0
2020-08-11 16:30,150,85,65,0,0,0
2020-08-11 16:45,168,82,86,0,0,0
2020-08-11 17:00,162,84,78,0,0,0
2020-08-11 17:15,136,80,56,0,0,0
2020-08-11 17:30,145,86,59,0,0,0
2020-08-11 17:45,197,106,91,0,0,0
2020-08-11 18:00,159,92,67,0,0,0
2020-08-11 18:15,151,88,63,0,0,0
2020-08-11 18:30,122,68,54,0,0,0
2020-08-11 18:45,125,74,51,0,0,0
2020-08-11 19:00,154,105,49,0,0,0
2020-08-11 19:15,100,64,36,0,0,0
2020-08-11 19:30,91,63,28,0,0,0
2020-08-11 19:45,98,64,34,0,0,0
2020-08-11 20:00,74,37,37,0,0,0
2020-08-11 20:15,72,45,27,0,0,0
2020-08-11 20:30,61,41,20,0,0,0
2020-08-11 20:45,63,47,16,0,0,0
2020-08-11 21:00,47,26,21,0,0,0
2020-08-11 21:15,62,35,27,0,0,0
2020-08-11 21:30,67,40,27,0,0,0
2020-08-11 21:45,39,22,17,0,0,0
2020-08-11 22:00,48,34,14,0,0,0
2020-08-11 22:15,29,13,16,0,0,0
2020-08-11 22:30,31,21,10,0,0,0
2020-08-11 22:45,53,39,14,0,0,0
2020-08-11 23:00,23,16,7,0,0,0
2020-08-11 23:15,20,9,11,0,0,0
2020-08-11 23:30,23,13,10,0,0,0
2020-08-11 23:45,21,8,13,0,0,0
2020-08-12 00:00,13,4,9,0,0,0
2020-08-12 00:15,17,12,5,0,0,0
2020-08-12 00:30,9,7,2,0,0,0
2020-08-12 00:45,5,4,1,0,0,0
2020-08-12 01:00,9,6,3,0,0,0
2020-08-12 01:15,7,5,2,0,0,0
2020-08-12 01:30,4,2,2,0,0,0
2020-08-12 01:45,8,6,2,0,0,0
2020-08-12 02:00,1,1,0,0,0,0
2020-08-12 02:15,4,3,1,0,0,0
2020-08-12 02:30,1,1,0,0,0,0
2020-08-12 02:45,0,0,0,0,0,0
2020-08-12 03:00,2,0,2,0,0,0
2020-08-12 03:15,2,1,1,0,0,0
2020-08-12 03:30,4,0,4,0,0,0
2020-08-12 03:45,0,0,0,0,0,0
2020-08-12 04:00,0,0,0,0,0,0
2020-08-12 04:15,2,1,1,0,0,0
2020-08-12 04:30,5,3,2,0,0,0
2020-08-12 04:45,3,2,1,0,0,0
2020-08-12 05:00,0,0,0,0,0,0
2020-08-12 05:15,7,6,1,0,0,0
2020-08-12 05:30,20,12,8,0,0,0
2020-08-12 05:45,18,12,6,0,0,0
2020-08-12 06:00,25,17,8,0,0,0
2020-08-12 06:15,32,21,11,0,0,0
2020-08-12 06:30,43,24,19,0,0,0
2020-08-12 06:45,70,45,25,0,0,0
2020-08-12 07:00,100,70,30,0,0,0
2020-08-12 07:15,219,166,53,0,0,0
2020-08-12 07:30,258,206,52,0,0,0
2020-08-12 07:45,217,159,58,0,0,0
2020-08-12 08:00,131,80,51,0,0,0
2020-08-12 08:15,137,99,38,0,0,0
2020-08-12 08:30,135,103,32,0,0,0
2020-08-12 08:45,155,109,46,0,0,0
2020-08-12 09:00,149,121,28,0,0,0
2020-08-12 09:15,104,80,24,0,0,0
2020-08-12 09:30,134,100,34,0,0,0
2020-08-12 09:45,132,81,51,0,0,0
2020-08-12 10:00,121,89,32,0,0,0
2020-08-12 10:15,130,90,40,0,0,0
2020-08-12 10:30,134,86,48,0,0,0
2020-08-12 10:45,120,72,48,0,0,0
2020-08-12 11:00,135,81,54,0,0,0
2020-08-12 11:15,149,84,65,0,0,0
2020-08-12 11:30,132,73,59,0,0,0
2020-08-12 11:45,140,85,55,0,0,0
2020-08-12 12:00,114,59,55,0,0,0
2020-08-12 12:15,142,68,74,0,0,0
2020-08-12 12:30,162,86,76,0,0,0
2020-08-12 12:45,180,77,103,0,0,0
2020-08-12 13:00,146,72,74,0,0,0
2020-08-12 13:15,169,74,95,0,0,0
2020-08-12 13:30,122,55,67,0,0,0
2020-08-12 13:45,156,62,94,0,0,0
2020-08-12 14:00,141,56,85,0,0,0
2020-08-12 14:15,154,64,90,0,0,0
2020-08-12 14:30,139,61,78,0,0,0
2020-08-12 14:45,127,69,58,0,0,0
2020-08-12 15:00,92,40,52,0,0,0
2020-08-12 15:15,137,53,84,0,0,0
2020-08-12 15:30,104,60,44,0,0,0
2020-08-12 15:45,129,81,48,0,0,0
2020-08-12 16:00,180,111,69,0,0,0
2020-08-12 16:15,150,79,71,0,0,0
2020-08-12 16:30,163,93,70,0,0,0
2020-08-12 16:45,140,78,62,0,0,0
2020-08-12 17:00,140,79,61,0,0,0
2020-08-12 17:15,126,59,67,0,0,0
2020-08-12 17:30,132,81,51,0,0,0
2020-08-12 17:45,183,101,82,0,0,0
2020-08-12 18:00,123,65,58,0,0,0
2020-08-12 18:15,137,82,55,0,0,0
2020-08-12 18:30,117,65,52,0,0,0
2020-08-12 18:45,166,98,68,0,0,0
2020-08-12 19:00,136,78,58,0,0,0
2020-08-12 19:15,130,77,53,0,0,0
2020-08-12 19:30,81,60,21,0,0,0
2020-08-12 19:45,121,75,46,0,0,0
2020-08-12 20:00,86,53,33,0,0,0
2020-08-12 20:15,83,53,30,0,0,0
2020-08-12 20:30,79,59,20,0,0,0
2020-08-12 20:45,92,66,26,0,0,0
2020-08-12 21:00,73,49,24,0,0,0
2020-08-12 21:15,54,27,27,0,0,0
2020-08-12 21:30,53,31,22,0,0,0
2020-08-12 21:45,55,35,20,0,0,0
2020-08-12 22:00,51,30,21,0,0,0
2020-08-12 22:15,55,33,22,0,0,0
2020-08-12 22:30,52,27,25,0,0,0
2020-08-12 22:45,32,16,16,0,0,0
2020-08-12 23:00,38,22,16,0,0,0
2020-08-12 23:15,26,10,16,0,0,0
2020-08-12 23:30,24,21,3,0,0,0
2020-08-12 23:45,15,9,6,0,0,0
2020-08-13 00:00,22,7,15,0,0,0
2020-08-13 00:15,11,5,6,0,0,0
2020-08-13 00:30,6,2,4,0,0,0
2020-08-13 00:45,12,5,7,0,0,0
2020-08-13 01:00,8,4,4,0,0,0
2020-08-13 01:15,12,4,8,0,0,0
2020-08-13 01:30,6,3,3,0,0,0
2020-08-13 01:45,5,4,1,0,0,0
2020-08-13 02:00,0,0,0,0,0,0
2020-08-13 02:15,2,0,2,0,0,0
2020-08-13 02:30,3,0,3,0,0,0
2020-08-13 02:45,0,0,0,0,0,0
2020-08-13 03:00,1,0,1,0,0,0
2020-08-13 03:15,2,0,2,0,0,0
2020-08-13 03:30,1,0,1,0,0,0
2020-08-13 03:45,2,1,1,0,0,0
2020-08-13 04:00,3,3,0,0,0,0
2020-08-13 04:15,1,0,1,0,0,0
2020-08-13 04:30,4,2,2,0,0,0
2020-08-13 04:45,3,0,3,0,0,0
2020-08-13 05:00,1,0,1,0,0,0
2020-08-13 05:15,8,4,4,0,0,0
2020-08-13 05:30,17,13,4,0,0,0
2020-08-13 05:45,23,11,12,0,0,0
2020-08-13 06:00,16,11,5,0,0,0
2020-08-13 06:15,36,24,12,0,0,0
2020-08-13 06:30,57,37,20,0,0,0
2020-08-13 06:45,67,43,24,0,0,0
2020-08-13 07:00,78,50,28,0,0,0
2020-08-13 07:15,206,163,43,0,0,0
2020-08-13 07:30,265,210,55,0,0,0
2020-08-13 07:45,206,136,70,0,0,0
2020-08-13 08:00,133,104,29,0,0,0
2020-08-13 08:15,106,75,31,0,0,0
2020-08-13 08:30,117,94,23,0,0,0
2020-08-13 08:45,151,123,28,0,0,0
2020-08-13 09:00,87,63,24,0,0,0
2020-08-13 09:15,114,81,33,0,0,0
2020-08-13 09:30,83,52,31,0,0,0
2020-08-13 09:45,108,79,29,0,0,0
2020-08-13 10:00,85,69,16,0,0,0
2020-08-13 10:15,96,60,36,0,0,0
2020-08-13 10:30,97,57,40,0,0,0
2020-08-13 10:45,97,65,32,0,0,0
2020-08-13 11:00,115,80,35,0,0,0
2020-08-13 11:15,97,40,57,0,0,0
2020-08-13 11:30,121,66,55,0,0,0
2020-08-13 11:45,103,61,42,0,0,0
2020-08-13 12:00,102,52,50,0,0,0
2020-08-13 12:15,107,55,52,0,0,0
2020-08-13 12:30,130,60,70,0,0,0
2020-08-13 12:45,123,57,66,0,0,0
2020-08-13 13:00,148,57,91,0,0,0
2020-08-13 13:15,115,61,54,0,0,0
2020-08-13 13:30,95,46,49,0,0,0
2020-08-13 13:45,107,54,53,0,0,0
2020-08-13 14:00,107,60,47,0,0,0
2020-08-13 14:15,125,59,66,0,0,0
2020-08-13 14:30,132,72,60,0,0,0
2020-08-13 14:45,140,74,66,0,0,0
2020-08-13 15:00,141,73,68,0,0,0
2020-08-13 15:15,127,66,61,0,0,0
2020-08-13 15:30,142,76,66,0,0,0
2020-08-13 15:45,153,86,67,0,0,0
2020-08-13 16:00,140,85,55,0,0,0
2020-08-13 16:15,143,76,67,0,0,0
2020-08-13 16:30,160,101,59,0,0,0
2020-08-13 16:45,159,90,69,0,0,0
2020-08-13 17:00,133,84,49,0,0,0
2020-08-13 17:15,146,89,57,0,0,0
2020-08-13 17:30,135,79,56,0,0,0
2020-08-13 17:45,138,68,70,0,0,0
2020-08-13 18:00,114,59,55,0,0,0
2020-08-13 18:15,122,69,53,0,0,0
2020-08-13 18:30,139,66,73,0,0,0
2020-08-13 18:45,141,79,62,0,0,0
2020-08-13 19:00,89,55,34,0,0,0
2020-08-13 19:15,95,58,37,0,0,0
2020-08-13 19:30,68,39,29,0,0,0
2020-08-13 19:45,83,50,33,0,0,0
2020-08-13 20:00,74,44,30,0,0,0
2020-08-13 20:15,59,36,23,0,0,0
2020-08-13 20:30,54,36,18,0,0,0
2020-08-13 20:45,54,26,28,0,0,0
2020-08-13 21:00,61,40,21,0,0,0
2020-08-13 21:15,56,25,31,0,0,0
2020-08-13 21:30,48,22,26,0,0,0
2020-08-13 21:45,39,15,24,0,0,0
2020-08-13 22:00,26,11,15,0,0,0
2020-08-13 22:15,20,4,16,0,0,0
2020-08-13 22:30,20,9,11,0,0,0
2020-08-13 22:45,20,16,4,0,0,0
2020-08-13 23:00,25,14,11,0,0,0
2020-08-13 23:15,23,13,10,0,0,0
2020-08-13 23:30,17,10,7,0,0,0
2020-08-13 23:45,17,8,9,0,0,0
2020-08-14 00:00,19,5,14,0,0,0
2020-08-14 00:15,8,5,3,0,0,0
2020-08-14 00:30,3,2,1,0,0,0
2020-08-14 00:45,7,3,4,0,0,0
2020-08-14 01:00,4,2,2,0,0,0
2020-08-14 01:15,6,2,4,0,0,0
2020-08-14 01:30,1,1,0,0,0,0
2020-08-14 01:45,5,2,3,0,0,0
2020-08-14 02:00,2,1,1,0,0,0
2020-08-14 02:15,4,2,2,0,0,0
2020-08-14 02:30,4,3,1,0,0,0
2020-08-14 02:45,1,0,1,0,0,0
2020-08-14 03:00,0,0,0,0,0,0
2020-08-14 03:15,1,1,0,0,0,0
2020-08-14 03:30,0,0,0,0,0,0
2020-08-14 03:45,0,0,0,0,0,0
2020-08-14 04:00,0,0,0,0,0,0
2020-08-14 04:15,3,1,2,0,0,0
2020-08-14 04:30,1,1,0,0,0,0
2020-08-14 04:45,4,2,2,0,0,0
2020-08-14 05:00,2,2,0,0,0,0
2020-08-14 05:15,3,2,1,0,0,0
2020-08-14 05:30,14,9,5,0,0,0
2020-08-14 05:45,28,13,15,0,0,0
2020-08-14 06:00,14,9,5,0,0,0
2020-08-14 06:15,31,20,11,0,0,0
2020-08-14 06:30,38,27,11,0,0,0
2020-08-14 06:45,52,33,19,0,0,0
2020-08-14 07:00,67,46,21,0,0,0
2020-08-14 07:15,196,156,40,0,0,0
2020-08-14 07:30,300,248,52,0,0,0
2020-08-14 07:45,209,145,64,0,0,0
2020-08-14 08:00,119,88,31,0,0,0
2020-08-14 08:15,98,72,26,0,0,0
2020-08-14 08:30,104,82,22,0,0,0
2020-08-14 08:45,138,102,36,0,0,0
2020-08-14 09:00,87,64,23,0,0,0
2020-08-14 09:15,99,73,26,0,0,0
2020-08-14 09:30,83,54,29,0,0,0
2020-08-14 09:45,91,65,26,0,0,0
2020-08-14 10:00,81,62,19,0,0,0
2020-08-14 10:15,86,56,30,0,0,0
2020-08-14 10:30,102,76,26,0,0,0
2020-08-14 10:45,99,68,31,0,0,0
2020-08-14 11:00,84,51,33,0,0,0
2020-08-14 11:15,119,60,59,0,0,0
2020-08-14 11:30,96,62,34,0,0,0
2020-08-14 11:45,96,52,44,0,0,0
2020-08-14 12:00,112,61,51,0,0,0
2020-08-14 12:15,113,54,59,0,0,0
2020-08-14 12:30,162,92,70,0,0,0
2020-08-14 12:45,133,54,79,0,0,0
2020-08-14 13:00,148,55,93,0,0,0
2020-08-14 13:15,157,64,93,0,0,0
2020-08-14 13:30,140,81,59,0,0,0
2020-08-14 13:45,156,71,85,0,0,0
2020-08-14 14:00,154,90,64,0,0,0
2020-08-14 14:15,122,53,69,0,0,0
2020-08-14 14:30,124,55,69,0,0,0
2020-08-14 14:45,150,70,80,0,0,0
2020-08-14 15:00,138,76,62,0,0,0
2020-08-14 15:15,146,70,76,0,0,0
2020-08-14 15:30,132,77,55,0,0,0
2020-08-14 15:45,137,72,65,0,0,0
2020-08-14 16:00,120,74,46,0,0,0
2020-08-14 16:15,102,61,41,0,0,0
2020-08-14 16:30,105,78,27,0,0,0
2020-08-14 16:45,114,57,57,0,0,0
2020-08-14 17:00,115,65,50,0,0,0
2020-08-14 17:15,122,65,57,0,0,0
2020-08-14 17:30,133,80,53,0,0,0
2020-08-14 17:45,113,59,54,0,0,0
2020-08-14 18:00,119,68,51,0,0,0
2020-08-14 18:15,109,69,40,0,0,0
2020-08-14 18:30,123,75,48,0,0,0
2020-08-14 18:45,120,82,38,0,0,0
2020-08-14 19:00,121,64,57,0,0,0
2020-08-14 19:15,111,59,52,0,0,0
2020-08-14 19:30,77,38,39,0,0,0
2020-08-14 19:45,90,68,22,0,0,0
2020-08-14 20:00,94,57,37,0,0,0
2020-08-14 20:15,59,35,24,0,0,0
2020-08-14 20:30,51,33,18,0,0,0
2020-08-14 20:45,40,25,15,0,0,0
2020-08-14 21:00,65,43,22,0,0,0
2020-08-14 21:15,50,26,24,0,0,0
2020-08-14 21:30,43,24,19,0,0,0
2020-08-14 21:45,24,13,11,0,0,0
2020-08-14 22:00,30,14,16,0,0,0
2020-08-14 22:15,35,16,19,0,0,0
2020-08-14 22:30,33,17,16,0,0,0
2020-08-14 22:45,46,17,29,0,0,0
2020-08-14 23:00,38,20,18,0,0,0
2020-08-14 23:15,21,8,13,0,0,0
2020-08-14 23:30,33,17,16,0,0,0
2020-08-14 23:45,37,15,22,0,0,0
2020-08-15 00:00,34,20,14,0,0,0
2020-08-15 00:15,23,10,13,0,0,0
2020-08-15 00:30,24,12,12,0,0,0
2020-08-15 00:45,20,12,8,0,0,0
2020-08-15 01:00,30,21,9,0,0,0
2020-08-15 01:15,15,6,9,0,0,0
2020-08-15 01:30,15,5,10,0,0,0
2020-08-15 01:45,18,9,9,0,0,0
2020-08-15 02:00,9,5,4,0,0,0
2020-08-15 02:15,10,3,7,0,0,0
2020-08-15 02:30,9,4,5,0,0,0
2020-08-15 02:45,11,5,6,0,0,0
2020-08-15 03:00,1,0,1,0,0,0
2020-08-15 03:15,5,2,3,0,0,0
2020-08-15 03:30,2,1,1,0,0,0
2020-08-15 03:45,4,0,4,0,0,0
2020-08-15 04:00,4,2,2,0,0,0
2020-08-15 04:15,5,2,3,0,0,0
2020-08-15 04:30,5,2,3,0,0,0
2020-08-15 04:45,6,1,5,0,0,0
2020-08-15 05:00,0,0,0,0,0,0
2020-08-15 05:15,3,1,2,0,0,0
2020-08-15 05:30,3,1,2,0,0,0
2020-08-15 05:45,7,7,0,0,0,0
2020-08-15 06:00,3,2,1,0,0,0
2020-08-15 06:15,9,4,5,0,0,0
2020-08-15 06:30,9,7,2,0,0,0
2020-08-15 06:45,10,8,2,0,0,0
2020-08-15 07:00,22,16,6,0,0,0
2020-08-15 07:15,28,19,9,0,0,0
2020-08-15 07:30,21,16,5,0,0,0
2020-08-15 07:45,50,36,14,0,0,0
2020-08-15 08:00,36,21,15,0,0,0
2020-08-15 08:15,35,26,9,0,0,0
2020-08-15 08:30,42,34,8,0,0,0
2020-08-15 08:45,69,45,24,0,0,0
2020-08-15 09:00,57,47,10,0,0,0
2020-08-15 09:15,83,66,17,0,0,0
2020-08-15 09:30,92,69,23,0,0,0
2020-08-15 09:45,117,70,47,0,0,0
2020-08-15 10:00,108,78,30,0,0,0
2020-08-15 10:15,129,87,42,0,0,0
2020-08-15 10:30,130,91,39,0,0,0
2020-08-15 10:45,127,85,42,0,0,0
2020-08-15 11:00,139,104,35,0,0,0
2020-08-15 11:15,155,98,57,0,0,0
2020-08-15 11:30,166,108,58,0,0,0
2020-08-15 11:45,159,105,54,0,0,0
2020-08-15 12:00,143,90,53,0,0,0
2020-08-15 12:15,134,75,59,0,0,0
2020-08-15 12:30,138,80,58,0,0,0
2020-08-15 12:45,116,66,50,0,0,0
2020-08-15 13:00,107,55,52,0,0,0
2020-08-15 13:15,95,58,37,0,0,0
2020-08-15 13:30,140,77,63,0,0,0
2020-08-15 13:45,114,65,49,0,0,0
2020-08-15 14:00,111,66,45,0,0,0
2020-08-15 14:15,117,55,62,0,0,0
2020-08-15 14:30,114,49,65,0,0,0
2020-08-15 14:45,108,63,45,0,0,0
2020-08-15 15:00,114,49,65,0,0,0
2020-08-15 15:15,91,40,51,0,0,0
2020-08-15 15:30,115,67,48,0,0,0
2020-08-15 15:45,148,73,75,0,0,0
2020-08-15 16:00,118,70,48,0,0,0
2020-08-15 16:15,95,54,41,0,0,0
2020-08-15 16:30,75,34,41,0,0,0
2020-08-15 16:45,86,54,32,0,0,0
2020-08-15 17:00,96,50,46,0,0,0
2020-08-15 17:15,111,57,54,0,0,0
2020-08-15 17:30,102,58,44,0,0,0
2020-08-15 17:45,118,77,41,0,0,0
2020-08-15 18:00,104,37,67,0,0,0
2020-08-15 18:15,125,70,55,0,0,0
2020-08-15 18:30,92,49,43,0,0,0
2020-08-15 18:45,104,47,57,0,0,0
2020-08-15 19:00,78,40,38,0,0,0
2020-08-15 19:15,84,45,39,0,0,0
2020-08-15 19:30,79,55,24,0,0,0
2020-08-15 19:45,82,45,37,0,0,0
2020-08-15 20:00,68,38,30,0,0,0
2020-08-15 20:15,67,38,29,0,0,0
2020-08-15 20:30,60,31,29,0,0,0
2020-08-15 20:45,56,37,19,0,0,0
2020-08-15 21:00,54,25,29,0,0,0
2020-08-15 21:15,25,12,13,0,0,0
2020-08-15 21:30,33,22,11,0,0,0
2020-08-15 21:45,24,10,14,0,0,0
2020-08-15 22:00,19,8,11,0,0,0
2020-08-15 22:15,36,23,13,0,0,0
2020-08-15 22:30,37,14,23,0,0,0
2020-08-15 22:45,21,14,7,0,0,0
2020-08-15 23:00,47,25,22,0,0,0
2020-08-15 23:15,29,16,13,0,0,0
2020-08-15 23:30,38,10,28,0,0,0
2020-08-15 23:45,23,7,16,0,0,0
2020-08-16 00:00,39,24,15,0,0,0
2020-08-16 00:15,25,8,17,0,0,0
2020-08-16 00:30,36,20,16,0,0,0
2020-08-16 00:45,28,13,15,0,0,0
2020-08-16 01:00,22,12,10,0,0,0
2020-08-16 01:15,21,8,13,0,0,0
2020-08-16 01:30,14,7,7,0,0,0
2020-08-16 01:45,8,5,3,0,0,0
2020-08-16 02:00,14,4,10,0,0,0
2020-08-16 02:15,18,9,9,0,0,0
2020-08-16 02:30,12,7,5,0,0,0
2020-08-16 02:45,6,4,2,0,0,0
2020-08-16 03:00,11,5,6,0,0,0
2020-08-16 03:15,4,2,2,0,0,0
2020-08-16 03:30,9,2,7,0,0,0
2020-08-16 03:45,10,6,4,0,0,0
2020-08-16 04:00,5,1,4,0,0,0
2020-08-16 04:15,1,1,0,0,0,0
2020-08-16 04:30,0,0,0,0,0,0
2020-08-16 04:45,4,1,3,0,0,0
2020-08-16 05:00,2,0,2,0,0,0
2020-08-16 05:15,10,6,4,0,0,0
2020-08-16 05:30,8,4,4,0,0,0
2020-08-16 05:45,4,2,2,0,0,0
2020-08-16 06:00,5,3,2,0,0,0
2020-08-16 06:15,5,2,3,0,0,0
2020-08-16 06:30,2,1,1,0,0,0
2020-08-16 06:45,5,4,1,0,0,0
2020-08-16 07:00,6,5,1,0,0,0
2020-08-16 07:15,7,6,1,0,0,0
2020-08-16 07:30,9,5,4,0,0,0
2020-08-16 07:45,12,7,5,0,0,0
2020-08-16 08:00,12,8,4,0,0,0
2020-08-16 08:15,17,9,8,0,0,0
2020-08-16 08:30,12,5,7,0,0,0
2020-08-16 08:45,27,17,10,0,0,0
2020-08-16 09:00,20,15,5,0,0,0
2020-08-16 09:15,26,18,8,0,0,0
2020-08-16 09:30,28,20,8,0,0,0
2020-08-16 09:45,40,34,6,0,0,0
2020-08-16 10:00,51,30,21,0,0,0
2020-08-16 10:15,42,22,20,0,0,0
2020-08-16 10:30,44,25,19,0,0,0
2020-08-16 10:45,55,33,22,0,0,0
2020-08-16 11:00,58,37,21,0,0,0
2020-08-16 11:15,58,34,24,0,0,0
2020-08-16 11:30,63,33,30,0,0,0
2020-08-16 11:45,55,32,23,0,0,0
2020-08-16 12:00,58,34,24,0,0,0
2020-08-16 12:15,65,44,21,0,0,0
2020-08-16 12:30,55,32,23,0,0,0
2020-08-16 12:45,70,37,33,0,0,0
2020-08-16 13:00,56,34,22,0,0,0
2020-08-16 13:15,99,51,48,0,0,0
2020-08-16 13:30,80,47,33,0,0,0
2020-08-16 13:45,66,44,22,0,0,0
2020-08-16 14:00,80,48,32,0,0,0
2020-08-16 14:15,107,65,42,0,0,0
2020-08-16 14:30,86,37,49,0,0,0
2020-08-16 14:45,96,54,42,0,0,0
2020-08-16 15:00,78,32,46,0,0,0
2020-08-16 15:15,92,61,31,0,0,0
2020-08-16 15:30,75,43,32,0,0,0
2020-08-16 15:45,101,52,49,0,0,0
2020-08-16 16:00,83,45,38,0,0,0
2020-08-16 16:15,70,48,22,0,0,0
2020-08-16 16:30,73,47,26,0,0,0
2020-08-16 16:45,86,56,30,0,0,0
2020-08-16 17:00,82,55,27,0,0,0
2020-08-16 17:15,90,53,37,0,0,0
2020-08-16 17:30,84,53,31,0,0,0
2020-08-16 17:45,98,69,29,0,0,0
2020-08-16 18:00,97,76,21,0,0,0
2020-08-16 18:15,101,72,29,0,0,0
2020-08-16 18:30,102,72,30,0,0,0
2020-08-16 18:45,109,73,36,0,0,0
2020-08-16 19:00,82,51,31,0,0,0
2020-08-16 19:15,91,66,25,0,0,0
2020-08-16 19:30,65,33,32,0,0,0
2020-08-16 19:45,51,31,20,0,0,0
2020-08-16 20:00,84,59,25,0,0,0
2020-08-16 20:15,76,52,24,0,0,0
2020-08-16 20:30,70,44,26,0,0,0
2020-08-16 20:45,37,25,12,0,0,0
2020-08-16 21:00,28,15,13,0,0,0
2020-08-16 21:15,27,12,15,0,0,0
2020-08-16 21:30,35,14,21,0,0,0
2020-08-16 21:45,15,9,6,0,0,0
2020-08-16 22:00,11,4,7,0,0,0
2020-08-16 22:15,20,6,14,0,0,0
2020-08-16 22:30,11,3,8,0,0,0
2020-08-16 22:45,13,4,9,0,0,0
2020-08-16 23:00,11,4,7,0,0,0
2020-08-16 23:15,12,5,7,0,0,0
2020-08-16 23:30,6,2,4,0,0,0
2020-08-16 23:45,7,2,5,0,0,0
2020-08-17 00:00,6,2,4,0,0,0
2020-08-17 00:15,7,4,3,0,0,0
2020-08-17 00:30,11,8,3,0,0,0
2020-08-17 00:45,2,2,0,0,0,0
2020-08-17 01:00,9,7,2,0,0,0
2020-08-17 01:15,3,0,3,0,0,0
2020-08-17 01:30,3,2,1,0,0,0
2020-08-17 01:45,0,0,0,0,0,0
2020-08-17 02:00,1,1,0,0,0,0
2020-08-17 02:15,2,0,2,0,0,0
2020-08-17 02:30,3,0,3,0,0,0
2020-08-17 02:45,4,1,3,0,0,0
2020-08-17 03:00,1,0,1,0,0,0
2020-08-17 03:15,0,0,0,0,0,0
2020-08-17 03:30,1,1,0,0,0,0
2020-08-17 03:45,0,0,0,0,0,0
2020-08-17 04:00,1,0,1,0,0,0
2020-08-17 04:15,0,0,0,0,0,0
2020-08-17 04:30,2,2,0,0,0,0
2020-08-17 04:45,0,0,0,0,0,0
2020-08-17 05:00,2,2,0,0,0,0
2020-08-17 05:15,3,1,2,0,0,0
2020-08-17 05:30,14,9,5,0,0,0
2020-08-17 05:45,22,12,10,0,0,0
2020-08-17 06:00,13,8,5,0,0,0
2020-08-17 06:15,29,18,11,0,0,0
2020-08-17 06:30,56,36,20,0,0,0
2020-08-17 06:45,58,35,23,0,0,0
2020-08-17 07:00,86,52,34,0,0,0
2020-08-17 07:15,189,156,33,0,0,0
2020-08-17 07:30,277,228,49,0,0,0
2020-08-17 07:45,259,177,82,0,0,0
2020-08-17 08:00,125,92,33,0,0,0
2020-08-17 08:15,120,89,31,0,0,0
2020-08-17 08:30,136,103,33,0,0,0
2020-08-17 08:45,121,94,27,0,0,0
2020-08-17 09:00,77,56,21,0,0,0
2020-08-17 09:15,99,66,33,0,0,0
2020-08-17 09:30,108,69,39,0,0,0
2020-08-17 09:45,86,66,20,0,0,0
2020-08-17 10:00,76,47,29,0,0,0
2020-08-17 10:15,86,54,32,0,0,0
2020-08-17 10:30,82,54,28,0,0,0
2020-08-17 10:45,79,52,27,0,0,0
2020-08-17 11:00,80,49,31,0,0,0
2020-08-17 11:15,102,60,42,0,0,0
2020-08-17 11:30,73,46,27,0,0,0
2020-08-17 11:45,99,66,33,0,0,0
2020-08-17 12:00,90,47,43,0,0,0
2020-08-17 12:15,103,54,49,0,0,0
2020-08-17 12:30,100,46,54,0,0,0
2020-08-17 12:45,123,62,61,0,0,0
2020-08-17 13:00,104,46,58,0,0,0
2020-08-17 13:15,110,49,61,0,0,0
2020-08-17 13:30,119,59,60,0,0,0
2020-08-17 13:45,140,75,65,0,0,0
2020-08-17 14:00,131,55,76,0,0,0
2020-08-17 14:15,90,55,35,0,0,0
2020-08-17 14:30,122,74,48,0,0,0
2020-08-17 14:45,155,88,67,0,0,0
2020-08-17 15:00,151,76,75,0,0,0
2020-08-17 15:15,119,58,61,0,0,0
2020-08-17 15:30,148,76,72,0,0,0
2020-08-17 15:45,147,73,74,0,0,0
2020-08-17 16:00,138,72,66,0,0,0
2020-08-17 16:15,153,75,78,0,0,0
2020-08-17 16:30,172,94,78,0,0,0
2020-08-17 16:45,187,111,76,0,0,0
2020-08-17 17:00,192,105,87,0,0,0
2020-08-17 17:15,180,85,95,0,0,0
2020-08-17 17:30,163,78,85,0,0,0
2020-08-17 17:45,163,85,78,0,0,0
2020-08-17 18:00,155,78,77,0,0,0
2020-08-17 18:15,129,60,69,0,0,0
2020-08-17 18:30,110,46,64,0,0,0
2020-08-17 18:45,128,55,73,0,0,0
2020-08-17 19:00,112,48,64,0,0,0
2020-08-17 19:15,47,14,33,0,0,0
2020-08-17 19:30,46,25,21,0,0,0
2020-08-17 19:45,38,20,18,0,0,0
2020-08-17 20:00,49,26,23,0,0,0
2020-08-17 20:15,63,26,37,0,0,0
2020-08-17 20:30,51,23,28,0,0,0
2020-08-17 20:45,53,16,37,0,0,0
2020-08-17 21:00,55,29,26,0,0,0
2020-08-17 21:15,39,20,19,0,0,0
2020-08-17 21:30,39,30,9,0,0,0
2020-08-17 21:45,26,14,12,0,0,0
2020-08-17 22:00,41,30,11,0,0,0
2020-08-17 22:15,21,10,11,0,0,0
2020-08-17 22:30,25,14,11,0,0,0
2020-08-17 22:45,29,15,14,0,0,0
2020-08-17 23:00,29,14,15,0,0,0
2020-08-17 23:15,12,7,5,0,0,0
2020-08-17 23:30,21,7,14,0,0,0
2020-08-17 23:45,13,5,8,0,0,0
2020-08-18 00:00,5,2,3,0,0,0
2020-08-18 00:15,5,4,1,0,0,0
2020-08-18 00:30,1,0,1,0,0,0
2020-08-18 00:45,8,6,2,0,0,0
2020-08-18 01:00,5,2,3,0,0,0
2020-08-18 01:15,2,1,1,0,0,0
2020-08-18 01:30,3,3,0,0,0,0
2020-08-18 01:45,4,4,0,0,0,0
2020-08-18 02:00,3,0,3,0,0,0
2020-08-18 02:15,3,2,1,0,0,0
2020-08-18 02:30,1,0,1,0,0,0
2020-08-18 02:45,1,0,1,0,0,0
2020-08-18 03:00,0,0,0,0,0,0
2020-08-18 03:15,1,0,1,0,0,0
2020-08-18 03:30,1,0,1,0,0,0
2020-08-18 03:45,3,0,3,0,0,0
2020-08-18 04:00,0,0,0,0,0,0
2020-08-18 04:15,0,0,0,0,0,0
2020-08-18 04:30,1,1,0,0,0,0
2020-08-18 04:45,0,0,0,0,0,0
2020-08-18 05:00,1,1,0,0,0,0
2020-08-18 05:15,5,2,3,0,0,0
2020-08-18 05:30,13,7,6,0,0,0
2020-08-18 05:45,19,8,11,0,0,0
2020-08-18 06:00,22,13,9,0,0,0
2020-08-18 06:15,30,19,11,0,0,0
2020-08-18 06:30,58,33,25,0,0,0
2020-08-18 06:45,66,51,15,0,0,0
2020-08-18 07:00,71,52,19,0,0,0
2020-08-18 07:15,210,170,40,0,0,0
2020-08-18 07:30,257,203,54,0,0,0
2020-08-18 07:45,248,179,69,0,0,0
2020-08-18 08:00,126,91,35,0,0,0
2020-08-18 08:15,120,84,36,0,0,0
2020-08-18 08:30,121,94,27,0,0,0
2020-08-18 08:45,121,94,27,0,0,0
2020-08-18 09:00,116,81,35,0,0,0
2020-08-18 09:15,104,67,37,0,0,0
2020-08-18 09:30,102,74,28,0,0,0
2020-08-18 09:45,103,73,30,0,0,0
2020-08-18 10:00,74,47,27,0,0,0
2020-08-18 10:15,87,56,31,0,0,0
2020-08-18 10:30,84,47,37,0,0,0
2020-08-18 10:45,103,69,34,0,0,0
2020-08-18 11:00,107,62,45,0,0,0
2020-08-18 11:15,97,60,37,0,0,0
2020-08-18 11:30,93,60,33,0,0,0
2020-08-18 11:45,93,63,30,0,0,0
2020-08-18 12:00,103,61,42,0,0,0
2020-08-18 12:15,94,59,35,0,0,0
2020-08-18 12:30,126,68,58,0,0,0
2020-08-18 12:45,129,63,66,0,0,0
2020-08-18 13:00,147,71,76,0,0,0
2020-08-18 13:15,146,58,88,0,0,0
2020-08-18 13:30,129,71,58,0,0,0
2020-08-18 13:45,130,63,67,0,0,0
2020-08-18 14:00,156,62,94,0,0,0
2020-08-18 14:15,144,79,65,0,0,0
2020-08-18 14:30,143,87,56,0,0,0
2020-08-18 14:45,162,91,71,0,0,0
2020-08-18 15:00,148,75,73,0,0,0
2020-08-18 15:15,166,80,86,0,0,0
2020-08-18 15:30,143,77,66,0,0,0
2020-08-18 15:45,200,115,85,0,0,0
2020-08-18 16:00,157,79,78,0,0,0
2020-08-18 16:15,137,73,64,0,0,0
2020-08-18 16:30,174,113,61,0,0,0
2020-08-18 16:45,197,114,83,0,0,0
2020-08-18 17:00,196,103,93,0,0,0
2020-08-18 17:15,150,81,69,0,0,0
2020-08-18 17:30,170,90,80,0,0,0
2020-08-18 17:45,173,80,93,0,0,0
2020-08-18 18:00,181,85,96,0,0,0
2020-08-18 18:15,158,85,73,0,0,0
2020-08-18 18:30,142,66,76,0,0,0
2020-08-18 18:45,141,68,73,0,0,0
2020-08-18 19:00,109,51,58,0,0,0
2020-08-18 19:15,112,58,54,0,0,0
2020-08-18 19:30,96,50,46,0,0,0
2020-08-18 19:45,100,55,45,0,0,0
2020-08-18 20:00,63,28,35,0,0,0
2020-08-18 20:15,74,38,36,0,0,0
2020-08-18 20:30,53,24,29,0,0,0
2020-08-18 20:45,71,36,35,0,0,0
2020-08-18 21:00,86,52,34,0,0,0
2020-08-18 21:15,57,27,30,0,0,0
2020-08-18 21:30,46,26,20,0,0,0
2020-08-18 21:45,43,18,25,0,0,0
2020-08-18 22:00,33,13,20,0,0,0
2020-08-18 22:15,32,17,15,0,0,0
2020-08-18 22:30,37,23,14,0,0,0
2020-08-18 22:45,37,23,14,0,0,0
2020-08-18 23:00,23,12,11,0,0,0
2020-08-18 23:15,26,11,15,0,0,0
2020-08-18 23:30,21,12,9,0,0,0
2020-08-18 23:45,23,9,14,0,0,0
2020-08-19 00:00,14,8,6,0,0,0
2020-08-19 00:15,9,3,6,0,0,0
2020-08-19 00:30,1,1,0,0,0,0
2020-08-19 00:45,6,2,4,0,0,0
2020-08-19 01:00,2,1,1,0,0,0
2020-08-19 01:15,7,4,3,0,0,0
2020-08-19 01:30,3,2,1,0,0,0
2020-08-19 01:45,1,0,1,0,0,0
2020-08-19 02:00,2,0,2,0,0,0
2020-08-19 02:15,6,4,2,0,0,0
2020-08-19 02:30,1,0,1,0,0,0
2020-08-19 02:45,0,0,0,0,0,0
2020-08-19 03:00,1,0,1,0,0,0
2020-08-19 03:15,0,0,0,0,0,0
2020-08-19 03:30,1,1,0,0,0,0
2020-08-19 03:45,1,0,1,0,0,0
2020-08-19 04:00,0,0,0,0,0,0
2020-08-19 04:15,0,0,0,0,0,0
2020-08-19 04:30,2,2,0,0,0,0
2020-08-19 04:45,0,0,0,0,0,0
2020-08-19 05:00,0,0,0,0,0,0
2020-08-19 05:15,6,1,5,0,0,0
2020-08-19 05:30,12,8,4,0,0,0
2020-08-19 05:45,30,18,12,0,0,0
2020-08-19 06:00,12,6,6,0,0,0
2020-08-19 06:15,29,16,13,0,0,0
2020-08-19 06:30,60,36,24,0,0,0
2020-08-19 06:45,68,51,17,0,0,0
2020-08-19 07:00,103,66,37,0,0,0
2020-08-19 07:15,196,154,42,0,0,0
2020-08-19 07:30,297,232,65,0,0,0
2020-08-19 07:45,242,172,70,0,0,0
2020-08-19 08:00,130,96,34,0,0,0
2020-08-19 08:15,144,93,51,0,0,0
2020-08-19 08:30,131,107,24,0,0,0
2020-08-19 08:45,133,101,32,0,0,0
2020-08-19 09:00,107,83,24,0,0,0
2020-08-19 09:15,124,88,36,0,0,0
2020-08-19 09:30,131,98,33,0,0,0
2020-08-19 09:45,120,96,24,0,0,0
2020-08-19 10:00,145,98,47,0,0,0
2020-08-19 10:15,125,90,35,0,0,0
2020-08-19 10:30,124,85,39,0,0,0
2020-08-19 10:45,125,93,32,0,0,0
2020-08-19 11:00,151,100,51,0,0,0
2020-08-19 11:15,148,86,62,0,0,0
2020-08-19 11:30,120,81,39,0,0,0
2020-08-19 11:45,121,55,66,0,0,0
2020-08-19 12:00,121,76,45,0,0,0
2020-08-19 12:15,150,78,72,0,0,0
2020-08-19 12:30,128,66,62,0,0,0
2020-08-19 12:45,130,64,66,0,0,0
2020-08-19 13:00,176,82,94,0,0,0
2020-08-19 13:15,162,91,71,0,0,0
2020-08-19 13:30,147,74,73,0,0,0
2020-08-19 13:45,168,88,80,0,0,0
2020-08-19 14:00,203,98,105,0,0,0
2020-08-19 14:15,134,71,63,0,0,0
2020-08-19 14:30,151,79,72,0,0,0
2020-08-19 14:45,136,72,64,0,0,0
2020-08-19 15:00,157,77,80,0,0,0
2020-08-19 15:15,163,80,83,0,0,0
2020-08-19 15:30,164,84,80,0,0,0
2020-08-19 15:45,182,94,88,0,0,0
2020-08-19 16:00,137,77,60,0,0,0
2020-08-19 16:15,201,101,100,0,0,0
2020-08-19 16:30,195,104,91,0,0,0
2020-08-19 16:45,179,84,95,0,0,0
2020-08-19 17:00,197,93,104,0,0,0
2020-08-19 17:15,184,113,71,0,0,0
2020-08-19 17:30,162,82,80,0,0,0
2020-08-19 17:45,191,105,86,0,0,0
2020-08-19 18:00,162,72,90,0,0,0
2020-08-19 18:15,156,84,72,0,0,0
2020-08-19 18:30,143,73,70,0,0,0
2020-08-19 18:45,131,73,58,0,0,0
2020-08-19 19:00,132,64,68,0,0,0
2020-08-19 19:15,113,53,60,0,0,0
2020-08-19 19:30,101,59,42,0,0,0
2020-08-19 19:45,121,72,49,0,0,0
2020-08-19 20:00,102,53,49,0,0,0
2020-08-19 20:15,75,49,26,0,0,0
2020-08-19 20:30,86,49,37,0,0,0
2020-08-19 20:45,68,32,36,0,0,0
2020-08-19 21:00,83,49,34,0,0,0
2020-08-19 21:15,50,27,23,0,0,0
2020-08-19 21:30,43,24,19,0,0,0
2020-08-19 21:45,44,22,22,0,0,0
2020-08-19 22:00,46,18,28,0,0,0
2020-08-19 22:15,36,22,14,0,0,0
2020-08-19 22:30,36,17,19,0,0,0
2020-08-19 22:45,47,23,24,0,0,0
2020-08-19 23:00,58,24,34,0,0,0
2020-08-19 23:15,36,16,20,0,0,0
2020-08-19 23:30,26,9,17,0,0,0
2020-08-19 23:45,29,13,16,0,0,0
2020-08-20 00:00,38,24,14,0,0,0
2020-08-20 00:15,28,19,9,0,0,0
2020-08-20 00:30,16,11,5,0,0,0
2020-08-20 00:45,3,0,3,0,0,0
2020-08-20 01:00,12,9,3,0,0,0
2020-08-20 01:15,5,2,3,0,0,0
2020-08-20 01:30,5,2,3,0,0,0
2020-08-20 01:45,5,3,2,0,0,0
2020-08-20 02:00,4,1,3,0,0,0
2020-08-20 02:15,3,0,3,0,0,0
2020-08-20 02:30,2,1,1,0,0,0
2020-08-20 02:45,2,2,0,0,0,0
2020-08-20 03:00,2,2,0,0,0,0
2020-08-20 03:15,2,0,2,0,0,0
2020-08-20 03:30,0,0,0,0,0,0
2020-08-20 03:45,0,0,0,0,0,0
2020-08-20 04:00,1,0,1,0,0,0
2020-08-20 04:15,2,2,0,0,0,0
2020-08-20 04:30,1,1,0,0,0,0
2020-08-20 04:45,1,0,1,0,0,0
2020-08-20 05:00,0,0,0,0,0,0
2020-08-20 05:15,5,2,3,0,0,0
2020-08-20 05:30,16,10,6,0,0,0
2020-08-20 05:45,21,9,12,0,0,0
2020-08-20 06:00,15,11,4,0,0,0
2020-08-20 06:15,30,17,13,0,0,0
2020-08-20 06:30,51,32,19,0,0,0
2020-08-20 06:45,54,31,23,0,0,0
2020-08-20 07:00,85,58,27,0,0,0
2020-08-20 07:15,180,138,42,0,0,0
2020-08-20 07:30,283,228,55,0,0,0
2020-08-20 07:45,243,174,69,0,0,0
2020-08-20 08:00,122,92,30,0,0,0
2020-08-20 08:15,115,80,35,0,0,0
2020-08-20 08:30,116,84,32,0,0,0
2020-08-20 08:45,127,90,37,0,0,0
2020-08-20 09:00,109,80,29,0,0,0
2020-08-20 09:15,102,71,31,0,0,0
2020-08-20 09:30,109,79,30,0,0,0
2020-08-20 09:45,116,79,37,0,0,0
2020-08-20 10:00,91,60,31,0,0,0
2020-08-20 10:15,82,56,26,0,0,0
2020-08-20 10:30,96,61,35,0,0,0
2020-08-20 10:45,100,58,42,0,0,0
2020-08-20 11:00,114,66,48,0,0,0
2020-08-20 11:15,82,46,36,0,0,0
2020-08-20 11:30,129,82,47,0,0,0
2020-08-20 11:45,107,64,43,0,0,0
2020-08-20 12:00,110,64,46,0,0,0
2020-08-20 12:15,118,61,57,0,0,0
2020-08-20 12:30,120,51,69,0,0,0
2020-08-20 12:45,131,68,63,0,0,0
2020-08-20 13:00,141,64,77,0,0,0
2020-08-20 13:15,117,48,69,0,0,0
2020-08-20 13:30,108,49,59,0,0,0
2020-08-20 13:45,138,57,81,0,0,0
2020-08-20 14:00,122,50,72,0,0,0
2020-08-20 14:15,132,67,65,0,0,0
2020-08-20 14:30,142,79,63,0,0,0
2020-08-20 14:45,131,75,56,0,0,0
2020-08-20 15:00,117,59,58,0,0,0
2020-08-20 15:15,124,55,69,0,0,0
2020-08-20 15:30,159,82,77,0,0,0
2020-08-20 15:45,173,93,80,0,0,0
2020-08-20 16:00,169,101,68,0,0,0
2020-08-20 16:15,162,88,74,0,0,0
2020-08-20 16:30,215,113,102,0,0,0
2020-08-20 16:45,182,114,68,0,0,0
2020-08-20 17:00,175,115,60,0,0,0
2020-08-20 17:15,164,88,76,0,0,0
2020-08-20 17:30,144,69,75,0,0,0
2020-08-20 17:45,145,81,64,0,0,0
2020-08-20 18:00,144,88,56,0,0,0
2020-08-20 18:15,128,75,53,0,0,0
2020-08-20 18:30,140,90,50,0,0,0
2020-08-20 18:45,103,55,48,0,0,0
2020-08-20 19:00,125,65,60,0,0,0
2020-08-20 19:15,124,67,57,0,0,0
2020-08-20 19:30,96,50,46,0,0,0
2020-08-20 19:45,117,78,39,0,0,0
2020-08-20 20:00,96,38,58,0,0,0
2020-08-20 20:15,91,43,48,0,0,0
2020-08-20 20:30,77,45,32,0,0,0
2020-08-20 20:45,74,45,29,0,0,0
2020-08-20 21:00,48,25,23,0,0,0
2020-08-20 21:15,52,24,28,0,0,0
2020-08-20 21:30,48,19,29,0,0,0
2020-08-20 21:45,40,17,23,0,0,0
2020-08-20 22:00,56,27,29,0,0,0
2020-08-20 22:15,56,33,23,0,0,0
2020-08-20 22:30,35,16,19,0,0,0
2020-08-20 22:45,44,19,25,0,0,0
2020-08-20 23:00,22,14,8,0,0,0
2020-08-20 23:15,26,15,11,0,0,0
2020-08-20 23:30,23,13,10,0,0,0
2020-08-20 23:45,22,6,16,0,0,0
2020-08-21 00:00,25,13,12,0,0,0
2020-08-21 00:15,13,7,6,0,0,0
2020-08-21 00:30,7,4,3,0,0,0
2020-08-21 00:45,2,0,2,0,0,0
2020-08-21 01:00,7,5,2,0,0,0
2020-08-21 01:15,8,1,7,0,0,0
2020-08-21 01:30,1,0,1,0,0,0
2020-08-21 01:45,9,6,3,0,0,0
2020-08-21 02:00,2,0,2,0,0,0
2020-08-21 02:15,2,0,2,0,0,0
2020-08-21 02:30,3,1,2,0,0,0
2020-08-21 02:45,3,0,3,0,0,0
2020-08-21 03:00,3,2,1,0,0,0
2020-08-21 03:15,1,1,0,0,0,0
2020-08-21 03:30,2,1,1,0,0,0
2020-08-21 03:45,2,2,0,0,0,0
2020-08-21 04:00,1,0,1,0,0,0
2020-08-21 04:15,1,1,0,0,0,0
2020-08-21 04:30,1,0,1,0,0,0
2020-08-21 04:45,1,1,0,0,0,0
2020-08-21 05:00,0,0,0,0,0,0
2020-08-21 05:15,6,3,3,0,0,0
2020-08-21 05:30,10,7,3,0,0,0
2020-08-21 05:45,14,6,8,0,0,0
2020-08-21 06:00,11,5,6,0,0,0
2020-08-21 06:15,25,15,10,0,0,0
2020-08-21 06:30,54,34,20,0,0,0
2020-08-21 06:45,43,28,15,0,0,0
2020-08-21 07:00,71,43,28,0,0,0
2020-08-21 07:15,121,92,29,0,0,0
2020-08-21 07:30,179,142,37,0,0,0
2020-08-21 07:45,174,123,51,0,0,0
2020-08-21 08:00,95,71,24,0,0,0
2020-08-21 08:15,95,63,32,0,0,0
2020-08-21 08:30,91,70,21,0,0,0
2020-08-21 08:45,106,80,26,0,0,0
2020-08-21 09:00,76,54,22,0,0,0
2020-08-21 09:15,86,59,27,0,0,0
2020-08-21 09:30,90,67,23,0,0,0
2020-08-21 09:45,86,56,30,0,0,0
2020-08-21 10:00,66,43,23,0,0,0
2020-08-21 10:15,73,51,22,0,0,0
2020-08-21 10:30,93,63,30,0,0,0
2020-08-21 10:45,82,51,31,0,0,0
2020-08-21 11:00,79,43,36,0,0,0
2020-08-21 11:15,97,62,35,0,0,0
2020-08-21 11:30,96,59,37,0,0,0
2020-08-21 11:45,80,57,23,0,0,0
2020-08-21 12:00,97,52,45,0,0,0
2020-08-21 12:15,89,49,40,0,0,0
2020-08-21 12:30,97,40,57,0,0,0
2020-08-21 12:45,134,68,66,0,0,0
2020-08-21 13:00,132,46,86,0,0,0
2020-08-21 13:15,159,76,83,0,0,0
2020-08-21 13:30,112,65,47,0,0,0
2020-08-21 13:45,148,68,80,0,0,0
2020-08-21 14:00,146,69,77,0,0,0
2020-08-21 14:15,147,73,74,0,0,0
2020-08-21 14:30,132,69,63,0,0,0
2020-08-21 14:45,132,66,66,0,0,0
2020-08-21 15:00,152,71,81,0,0,0
2020-08-21 15:15,153,80,73,0,0,0
2020-08-21 15:30,115,48,67,0,0,0
2020-08-21 15:45,148,79,69,0,0,0
2020-08-21 16:00,128,80,48,0,0,0
2020-08-21 16:15,127,62,65,0,0,0
2020-08-21 16:30,118,70,48,0,0,0
2020-08-21 16:45,131,81,50,0,0,0
2020-08-21 17:00,88,41,47,0,0,0
2020-08-21 17:15,50,23,27,0,0,0
2020-08-21 17:30,86,30,56,0,0,0
2020-08-21 17:45,92,42,50,0,0,0
2020-08-21 18:00,128,86,42,0,0,0
2020-08-21 18:15,102,60,42,0,0,0
2020-08-21 18:30,113,72,41,0,0,0
2020-08-21 18:45,90,48,42,0,0,0
2020-08-21 19:00,101,55,46,0,0,0
2020-08-21 19:15,49,25,24,0,0,0
2020-08-21 19:30,68,39,29,0,0,0
2020-08-21 19:45,85,53,32,0,0,0
2020-08-21 20:00,71,35,36,0,0,0
2020-08-21 20:15,56,33,23,0,0,0
2020-08-21 20:30,48,20,28,0,0,0
2020-08-21 20:45,59,38,21,0,0,0
2020-08-21 21:00,37,22,15,0,0,0
2020-08-21 21:15,35,20,15,0,0,0
2020-08-21 21:30,34,14,20,0,0,0
2020-08-21 21:45,27,14,13,0,0,0
2020-08-21 22:00,36,17,19,0,0,0
2020-08-21 22:15,33,18,15,0,0,0
2020-08-21 22:30,36,26,10,0,0,0
2020-08-21 22:45,31,21,10,0,0,0
2020-08-21 23:00,29,19,10,0,0,0
2020-08-21 23:15,39,21,18,0,0,0
2020-08-21 23:30,33,16,17,0,0,0
2020-08-21 23:45,25,17,8,0,0,0
2020-08-22 00:00,20,12,8,0,0,0
2020-08-22 00:15,27,15,12,0,0,0
2020-08-22 00:30,28,17,11,0,0,0
2020-08-22 00:45,26,21,5,0,0,0
2020-08-22 01:00,20,7,13,0,0,0
2020-08-22 01:15,6,3,3,0,0,0
2020-08-22 01:30,18,9,9,0,0,0
2020-08-22 01:45,25,12,13,0,0,0
2020-08-22 02:00,18,10,8,0,0,0
2020-08-22 02:15,15,6,9,0,0,0
2020-08-22 02:30,3,1,2,0,0,0
2020-08-22 02:45,8,4,4,0,0,0
2020-08-22 03:00,5,1,4,0,0,0
2020-08-22 03:15,4,1,3,0,0,0
2020-08-22 03:30,6,4,2,0,0,0
2020-08-22 03:45,5,3,2,0,0,0
2020-08-22 04:00,2,2,0,0,0,0
2020-08-22 04:15,3,2,1,0,0,0
2020-08-22 04:30,4,3,1,0,0,0
2020-08-22 04:45,2,0,2,0,0,0
2020-08-22 05:00,0,0,0,0,0,0
2020-08-22 05:15,7,5,2,0,0,0
2020-08-22 05:30,14,4,10,0,0,0
2020-08-22 05:45,15,6,9,0,0,0
2020-08-22 06:00,8,7,1,0,0,0
2020-08-22 06:15,6,3,3,0,0,0
2020-08-22 06:30,7,4,3,0,0,0
2020-08-22 06:45,11,11,0,0,0,0
2020-08-22 07:00,21,16,5,0,0,0
2020-08-22 07:15,22,15,7,0,0,0
2020-08-22 07:30,38,25,13,0,0,0
2020-08-22 07:45,37,30,7,0,0,0
2020-08-22 08:00,25,14,11,0,0,0
2020-08-22 08:15,44,28,16,0,0,0
2020-08-22 08:30,51,39,12,0,0,0
2020-08-22 08:45,56,40,16,0,0,0
2020-08-22 09:00,51,41,10,0,0,0
2020-08-22 09:15,77,62,15,0,0,0
2020-08-22 09:30,95,74,21,0,0,0
2020-08-22 09:45,113,89,24,0,0,0
2020-08-22 10:00,120,98,22,0,0,0
2020-08-22 10:15,123,87,36,0,0,0
2020-08-22 10:30,161,111,50,0,0,0
2020-08-22 10:45,162,119,43,0,0,0
2020-08-22 11:00,159,113,46,0,0,0
2020-08-22 11:15,152,83,69,0,0,0
2020-08-22 11:30,164,115,49,0,0,0
2020-08-22 11:45,205,129,76,0,0,0
2020-08-22 12:00,149,90,59,0,0,0
2020-08-22 12:15,151,86,65,0,0,0
2020-08-22 12:30,152,88,64,0,0,0
2020-08-22 12:45,177,96,81,0,0,0
2020-08-22 13:00,164,76,88,0,0,0
2020-08-22 13:15,153,85,68,0,0,0
2020-08-22 13:30,145,82,63,0,0,0
2020-08-22 13:45,175,83,92,0,0,0
2020-08-22 14:00,174,91,83,0,0,0
2020-08-22 14:15,162,77,85,0,0,0
2020-08-22 14:30,115,57,58,0,0,0
2020-08-22 14:45,138,75,63,0,0,0
2020-08-22 15:00,126,66,60,0,0,0
2020-08-22 15:15,133,59,74,0,0,0
2020-08-22 15:30,120,55,65,0,0,0
2020-08-22 15:45,113,67,46,0,0,0
2020-08-22 16:00,148,84,64,0,0,0
2020-08-22 16:15,98,55,43,0,0,0
2020-08-22 16:30,106,64,42,0,0,0
2020-08-22 16:45,125,73,52,0,0,0
2020-08-22 17:00,128,87,41,0,0,0
2020-08-22 17:15,121,60,61,0,0,0
2020-08-22 17:30,123,69,54,0,0,0
2020-08-22 17:45,129,68,61,0,0,0
2020-08-22 18:00,116,59,57,0,0,0
2020-08-22 18:15,126,58,68,0,0,0
2020-08-22 18:30,81,42,39,0,0,0
2020-08-22 18:45,61,37,24,0,0,0
2020-08-22 19:00,90,48,42,0,0,0
2020-08-22 19:15,109,53,56,0,0,0
2020-08-22 19:30,76,43,33,0,0,0
2020-08-22 19:45,83,41,42,0,0,0
2020-08-22 20:00,63,34,29,0,0,0
2020-08-22 20:15,60,33,27,0,0,0
2020-08-22 20:30,37,24,13,0,0,0
2020-08-22 20:45,52,39,13,0,0,0
2020-08-22 21:00,39,19,20,0,0,0
2020-08-22 21:15,35,21,14,0,0,0
2020-08-22 21:30,31,17,14,0,0,0
2020-08-22 21:45,33,12,21,0,0,0
2020-08-22 22:00,38,20,18,0,0,0
2020-08-22 22:15,44,25,19,0,0,0
2020-08-22 22:30,20,10,10,0,0,0
2020-08-22 22:45,20,7,13,0,0,0
2020-08-22 23:00,21,11,10,0,0,0
2020-08-22 23:15,30,18,12,0,0,0
2020-08-22 23:30,18,13,5,0,0,0
2020-08-22 23:45,26,10,16,0,0,0
2020-08-23 00:00,40,16,24,0,0,0
2020-08-23 00:15,23,9,14,0,0,0
2020-08-23 00:30,26,13,13,0,0,0
2020-08-23 00:45,26,14,12,0,0,0
2020-08-23 01:00,17,14,3,0,0,0
2020-08-23 01:15,9,1,8,0,0,0
2020-08-23 01:30,18,7,11,0,0,0
2020-08-23 01:45,13,6,7,0,0,0
2020-08-23 02:00,15,5,10,0,0,0
2020-08-23 02:15,18,9,9,0,0,0
2020-08-23 02:30,9,4,5,0,0,0
2020-08-23 02:45,12,5,7,0,0,0
2020-08-23 03:00,7,3,4,0,0,0
2020-08-23 03:15,12,5,7,0,0,0
2020-08-23 03:30,2,2,0,0,0,0
2020-08-23 03:45,5,4,1,0,0,0
2020-08-23 04:00,4,2,2,0,0,0
2020-08-23 04:15,6,4,2,0,0,0
2020-08-23 04:30,0,0,0,0,0,0
2020-08-23 04:45,6,1,5,0,0,0
2020-08-23 05:00,1,0,1,0,0,0
2020-08-23 05:15,3,1,2,0,0,0
2020-08-23 05:30,6,2,4,0,0,0
2020-08-23 05:45,3,2,1,0,0,0
2020-08-23 06:00,4,2,2,0,0,0
2020-08-23 06:15,4,2,2,0,0,0
2020-08-23 06:30,7,7,0,0,0,0
2020-08-23 06:45,4,3,1,0,0,0
2020-08-23 07:00,5,1,4,0,0,0
2020-08-23 07:15,2,2,0,0,0,0
2020-08-23 07:30,4,1,3,0,0,0
2020-08-23 07:45,9,6,3,0,0,0
2020-08-23 08:00,12,6,6,0,0,0
2020-08-23 08:15,10,8,2,0,0,0
2020-08-23 08:30,18,11,7,0,0,0
2020-08-23 08:45,19,15,4,0,0,0
2020-08-23 09:00,23,12,11,0,0,0
2020-08-23 09:15,26,12,14,0,0,0
2020-08-23 09:30,35,23,12,0,0,0
2020-08-23 09:45,49,34,15,0,0,0
2020-08-23 10:00,46,26,20,0,0,0
2020-08-23 10:15,34,21,13,0,0,0
2020-08-23 10:30,64,40,24,0,0,0
2020-08-23 10:45,49,33,16,0,0,0
2020-08-23 11:00,50,28,22,0,0,0
2020-08-23 11:15,56,22,34,0,0,0
2020-08-23 11:30,48,26,22,0,0,0
2020-08-23 11:45,44,24,20,0,0,0
2020-08-23 12:00,56,39,17,0,0,0
2020-08-23 12:15,57,33,24,0,0,0
2020-08-23 12:30,70,28,42,0,0,0
2020-08-23 12:45,58,35,23,0,0,0
2020-08-23 13:00,56,31,25,0,0,0
2020-08-23 13:15,72,54,18,0,0,0
2020-08-23 13:30,40,25,15,0,0,0
2020-08-23 13:45,82,51,31,0,0,0
2020-08-23 14:00,55,35,20,0,0,0
2020-08-23 14:15,76,44,32,0,0,0
2020-08-23 14:30,73,42,31,0,0,0
2020-08-23 14:45,86,68,18,0,0,0
2020-08-23 15:00,78,36,42,0,0,0
2020-08-23 15:15,80,53,27,0,0,0
2020-08-23 15:30,61,30,31,0,0,0
2020-08-23 15:45,87,43,44,0,0,0
2020-08-23 16:00,53,33,20,0,0,0
2020-08-23 16:15,63,24,39,0,0,0
2020-08-23 16:30,93,61,32,0,0,0
2020-08-23 16:45,74,45,29,0,0,0
2020-08-23 17:00,78,46,32,0,0,0
2020-08-23 17:15,78,40,38,0,0,0
2020-08-23 17:30,76,43,33,0,0,0
2020-08-23 17:45,57,31,26,0,0,0
2020-08-23 18:00,61,33,28,0,0,0
2020-08-23 18:15,62,44,18,0,0,0
2020-08-23 18:30,40,28,12,0,0,0
2020-08-23 18:45,46,24,22,0,0,0
2020-08-23 19:00,49,27,22,0,0,0
2020-08-23 19:15,60,30,30,0,0,0
2020-08-23 19:30,43,21,22,0,0,0
2020-08-23 19:45,48,16,32,0,0,0
2020-08-23 20:00,50,29,21,0,0,0
2020-08-23 20:15,56,33,23,0,0,0
2020-08-23 20:30,38,22,16,0,0,0
2020-08-23 20:45,26,17,9,0,0,0
2020-08-23 21:00,26,15,11,0,0,0
2020-08-23 21:15,20,12,8,0,0,0
2020-08-23 21:30,20,10,10,0,0,0
2020-08-23 21:45,27,14,13,0,0,0
2020-08-23 22:00,20,13,7,0,0,0
2020-08-23 22:15,13,4,9,0,0,0
2020-08-23 22:30,9,2,7,0,0,0
2020-08-23 22:45,12,3,9,0,0,0
2020-08-23 23:00,21,5,16,0,0,0
2020-08-23 23:15,32,19,13,0,0,0
2020-08-23 23:30,33,15,18,0,0,0
2020-08-23 23:45,14,7,7,0,0,0
2020-08-24 00:00,10,4,6,0,0,0
2020-08-24 00:15,8,5,3,0,0,0
2020-08-24 00:30,4,4,0,0,0,0
2020-08-24 00:45,5,5,0,0,0,0
2020-08-24 01:00,3,2,1,0,0,0
2020-08-24 01:15,2,0,2,0,0,0
2020-08-24 01:30,2,0,2,0,0,0
2020-08-24 01:45,3,1,2,0,0,0
2020-08-24 02:00,2,2,0,0,0,0
2020-08-24 02:15,0,0,0,0,0,0
2020-08-24 02:30,0,0,0,0,0,0
2020-08-24 02:45,1,0,1,0,0,0
2020-08-24 03:00,3,2,1,0,0,0
2020-08-24 03:15,1,1,0,0,0,0
2020-08-24 03:30,0,0,0,0,0,0
2020-08-24 03:45,1,1,0,0,0,0
2020-08-24 04:00,0,0,0,0,0,0
2020-08-24 04:15,0,0,0,0,0,0
2020-08-24 04:30,1,1,0,0,0,0
2020-08-24 04:45,1,0,1,0,0,0
2020-08-24 05:00,4,1,3,0,0,0
2020-08-24 05:15,3,1,2,0,0,0
2020-08-24 05:30,9,4,5,0,0,0
2020-08-24 05:45,23,13,10,0,0,0
2020-08-24 06:00,15,11,4,0,0,0
2020-08-24 06:15,30,18,12,0,0,0
2020-08-24 06:30,45,30,15,0,0,0
2020-08-24 06:45,47,22,25,0,0,0
2020-08-24 07:00,84,54,30,0,0,0
2020-08-24 07:15,174,129,45,0,0,0
2020-08-24 07:30,270,220,50,0,0,0
2020-08-24 07:45,208,136,72,0,0,0
2020-08-24 08:00,102,73,29,0,0,0
2020-08-24 08:15,108,79,29,0,0,0
2020-08-24 08:30,145,103,42,0,0,0
2020-08-24 08:45,103,77,26,0,0,0
2020-08-24 09:00,89,61,28,0,0,0
2020-08-24 09:15,81,54,27,0,0,0
2020-08-24 09:30,96,56,40,0,0,0
2020-08-24 09:45,91,53,38,0,0,0
2020-08-24 10:00,64,50,14,0,0,0
2020-08-24 10:15,92,64,28,0,0,0
2020-08-24 10:30,72,41,31,0,0,0
2020-08-24 10:45,99,73,26,0,0,0
2020-08-24 11:00,88,52,36,0,0,0
2020-08-24 11:15,105,60,45,0,0,0
2020-08-24 11:30,86,54,32,0,0,0
2020-08-24 11:45,85,54,31,0,0,0
2020-08-24 12:00,108,68,40,0,0,0
2020-08-24 12:15,97,57,40,0,0,0
2020-08-24 12:30,104,54,50,0,0,0
2020-08-24 12:45,58,31,27,0,0,0
2020-08-24 13:00,98,29,69,0,0,0
2020-08-24 13:15,118,64,54,0,0,0
2020-08-24 13:30,99,56,43,0,0,0
2020-08-24 13:45,111,57,54,0,0,0
2020-08-24 14:00,127,53,74,0,0,0
2020-08-24 14:15,108,64,44,0,0,0
2020-08-24 14:30,96,49,47,0,0,0
2020-08-24 14:45,122,62,60,0,0,0
2020-08-24 15:00,145,84,61,0,0,0
2020-08-24 15:15,118,69,49,0,0,0
2020-08-24 15:30,145,63,82,0,0,0
2020-08-24 15:45,157,73,84,0,0,0
2020-08-24 16:00,160,89,71,0,0,0
2020-08-24 16:15,152,91,61,0,0,0
2020-08-24 16:30,144,69,75,0,0,0
2020-08-24 16:45,157,64,93,0,0,0
2020-08-24 17:00,167,86,81,0,0,0
2020-08-24 17:15,140,66,74,0,0,0
2020-08-24 17:30,148,81,67,0,0,0
2020-08-24 17:45,146,75,71,0,0,0
2020-08-24 18:00,128,60,68,0,0,0
2020-08-24 18:15,117,57,60,0,0,0
2020-08-24 18:30,114,53,61,0,0,0
2020-08-24 18:45,114,65,49,0,0,0
2020-08-24 19:00,94,51,43,0,0,0
2020-08-24 19:15,91,52,39,0,0,0
2020-08-24 19:30,70,37,33,0,0,0
2020-08-24 19:45,72,36,36,0,0,0
2020-08-24 20:00,53,17,36,0,0,0
2020-08-24 20:15,54,25,29,0,0,0
2020-08-24 20:30,49,23,26,0,0,0
2020-08-24 20:45,44,21,23,0,0,0
2020-08-24 21:00,37,17,20,0,0,0
2020-08-24 21:15,35,23,12,0,0,0
2020-08-24 21:30,32,14,18,0,0,0
2020-08-24 21:45,35,19,16,0,0,0
2020-08-24 22:00,31,15,16,0,0,0
2020-08-24 22:15,23,8,15,0,0,0
2020-08-24 22:30,17,9,8,0,0,0
2020-08-24 22:45,19,10,9,0,0,0
2020-08-24 23:00,19,12,7,0,0,0
2020-08-24 23:15,12,9,3,0,0,0
2020-08-24 23:30,13,6,7,0,0,0
2020-08-24 23:45,6,3,3,0,0,0
2020-08-25 00:00,11,6,5,0,0,0
2020-08-25 00:15,3,2,1,0,0,0
2020-08-25 00:30,10,3,7,0,0,0
2020-08-25 00:45,3,1,2,0,0,0
2020-08-25 01:00,4,3,1,0,0,0
2020-08-25 01:15,4,2,2,0,0,0
2020-08-25 01:30,2,2,0,0,0,0
2020-08-25 01:45,3,3,0,0,0,0
2020-08-25 02:00,3,0,3,0,0,0
2020-08-25 02:15,2,1,1,0,0,0
2020-08-25 02:30,1,1,0,0,0,0
2020-08-25 02:45,0,0,0,0,0,0
2020-08-25 03:00,0,0,0,0,0,0
2020-08-25 03:15,0,0,0,0,0,0
2020-08-25 03:30,0,0,0,0,0,0
2020-08-25 03:45,1,0,1,0,0,0
2020-08-25 04:00,0,0,0,0,0,0
2020-08-25 04:15,2,1,1,0,0,0
2020-08-25 04:30,1,0,1,0,0,0
2020-08-25 04:45,2,2,0,0,0,0
2020-08-25 05:00,1,0,1,0,0,0
2020-08-25 05:15,6,1,5,0,0,0
2020-08-25 05:30,13,11,2,0,0,0
2020-08-25 05:45,16,10,6,0,0,0
2020-08-25 06:00,21,17,4,0,0,0
2020-08-25 06:15,28,14,14,0,0,0
2020-08-25 06:30,46,30,16,0,0,0
2020-08-25 06:45,54,31,23,0,0,0
2020-08-25 07:00,96,62,34,0,0,0
2020-08-25 07:15,184,133,51,0,0,0
2020-08-25 07:30,258,205,53,0,0,0
2020-08-25 07:45,234,154,80,0,0,0
2020-08-25 08:00,150,109,41,0,0,0
2020-08-25 08:15,117,84,33,0,0,0
2020-08-25 08:30,113,84,29,0,0,0
2020-08-25 08:45,144,98,46,0,0,0
2020-08-25 09:00,103,74,29,0,0,0
2020-08-25 09:15,88,60,28,0,0,0
2020-08-25 09:30,89,61,28,0,0,0
2020-08-25 09:45,111,94,17,0,0,0
2020-08-25 10:00,105,70,35,0,0,0
2020-08-25 10:15,78,55,23,0,0,0
2020-08-25 10:30,101,59,42,0,0,0
2020-08-25 10:45,105,63,42,0,0,0
2020-08-25 11:00,98,63,35,0,0,0
2020-08-25 11:15,107,63,44,0,0,0
2020-08-25 11:30,96,70,26,0,0,0
2020-08-25 11:45,101,69,32,0,0,0
2020-08-25 12:00,104,59,45,0,0,0
2020-08-25 12:15,105,62,43,0,0,0
2020-08-25 12:30,129,78,51,0,0,0
2020-08-25 12:45,125,62,63,0,0,0
2020-08-25 13:00,142,69,73,0,0,0
2020-08-25 13:15,128,66,62,0,0,0
2020-08-25 13:30,115,66,49,0,0,0
2020-08-25 13:45,160,88,72,0,0,0
2020-08-25 14:00,153,61,92,0,0,0
2020-08-25 14:15,113,58,55,0,0,0
2020-08-25 14:30,125,68,57,0,0,0
2020-08-25 14:45,115,58,57,0,0,0
2020-08-25 15:00,140,79,61,0,0,0
2020-08-25 15:15,119,65,54,0,0,0
2020-08-25 15:30,143,76,67,0,0,0
2020-08-25 15:45,139,88,51,0,0,0
2020-08-25 16:00,107,49,58,0,0,0
2020-08-25 16:15,134,66,68,0,0,0
2020-08-25 16:30,120,43,77,0,0,0
2020-08-25 16:45,138,63,75,0,0,0
2020-08-25 17:00,147,83,64,0,0,0
2020-08-25 17:15,112,50,62,0,0,0
2020-08-25 17:30,104,47,57,0,0,0
2020-08-25 17:45,125,71,54,0,0,0
2020-08-25 18:00,136,53,83,0,0,0
2020-08-25 18:15,106,62,44,0,0,0
2020-08-25 18:30,92,44,48,0,0,0
2020-08-25 18:45,107,56,51,0,0,0
2020-08-25 19:00,108,48,60,0,0,0
2020-08-25 19:15,88,48,40,0,0,0
2020-08-25 19:30,76,36,40,0,0,0
2020-08-25 19:45,85,44,41,0,0,0
2020-08-25 20:00,76,36,40,0,0,0
2020-08-25 20:15,54,25,29,0,0,0
2020-08-25 20:30,38,14,24,0,0,0
2020-08-25 20:45,52,27,25,0,0,0
2020-08-25 21:00,49,29,20,0,0,0
2020-08-25 21:15,58,18,40,0,0,0
2020-08-25 21:30,31,20,11,0,0,0
2020-08-25 21:45,44,18,26,0,0,0
2020-08-25 22:00,27,14,13,0,0,0
2020-08-25 22:15,35,18,17,0,0,0
2020-08-25 22:30,36,14,22,0,0,0
2020-08-25 22:45,19,7,12,0,0,0
2020-08-25 23:00,29,19,10,0,0,0
2020-08-25 23:15,18,15,3,0,0,0
2020-08-25 23:30,11,3,8,0,0,0
2020-08-25 23:45,13,9,4,0,0,0
2020-08-26 00:00,5,1,4,0,0,0
2020-08-26 00:15,11,8,3,0,0,0
2020-08-26 00:30,4,2,2,0,0,0
2020-08-26 00:45,4,1,3,0,0,0
2020-08-26 01:00,3,2,1,0,0,0
2020-08-26 01:15,4,3,1,0,0,0
2020-08-26 01:30,3,0,3,0,0,0
2020-08-26 01:45,3,1,2,0,0,0
2020-08-26 02:00,4,0,4,0,0,0
2020-08-26 02:15,2,1,1,0,0,0
2020-08-26 02:30,3,3,0,0,0,0
2020-08-26 02:45,0,0,0,0,0,0
2020-08-26 03:00,0,0,0,0,0,0
2020-08-26 03:15,1,1,0,0,0,0
2020-08-26 03:30,2,1,1,0,0,0
2020-08-26 03:45,1,0,1,0,0,0
2020-08-26 04:00,0,0,0,0,0,0
2020-08-26 04:15,1,0,1,0,0,0
2020-08-26 04:30,0,0,0,0,0,0
2020-08-26 04:45,0,0,0,0,0,0
2020-08-26 05:00,0,0,0,0,0,0
2020-08-26 05:15,4,3,1,0,0,0
2020-08-26 05:30,13,10,3,0,0,0
2020-08-26 05:45,20,13,7,0,0,0
2020-08-26 06:00,10,9,1,0,0,0
2020-08-26 06:15,23,16,7,0,0,0
2020-08-26 06:30,38,22,16,0,0,0
2020-08-26 06:45,44,28,16,0,0,0
2020-08-26 07:00,72,41,31,0,0,0
2020-08-26 07:15,120,87,33,0,0,0
2020-08-26 07:30,228,191,37,0,0,0
2020-08-26 07:45,194,135,59,0,0,0
2020-08-26 08:00,98,65,33,0,0,0
2020-08-26 08:15,100,77,23,0,0,0
2020-08-26 08:30,109,88,21,0,0,0
2020-08-26 08:45,107,82,25,0,0,0
2020-08-26 09:00,75,53,22,0,0,0
2020-08-26 09:15,81,60,21,0,0,0
2020-08-26 09:30,94,68,26,0,0,0
2020-08-26 09:45,81,66,15,0,0,0
2020-08-26 10:00,60,39,21,0,0,0
2020-08-26 10:15,66,46,20,0,0,0
2020-08-26 10:30,64,34,30,0,0,0
2020-08-26 10:45,69,38,31,0,0,0
2020-08-26 11:00,69,44,25,0,0,0
2020-08-26 11:15,65,38,27,0,0,0
2020-08-26 11:30,64,33,31,0,0,0
2020-08-26 11:45,71,44,27,0,0,0
2020-08-26 12:00,69,39,30,0,0,0
2020-08-26 12:15,83,53,30,0,0,0
2020-08-26 12:30,77,49,28,0,0,0
2020-08-26 12:45,97,54,43,0,0,0
2020-08-26 13:00,92,38,54,0,0,0
2020-08-26 13:15,91,45,46,0,0,0
2020-08-26 13:30,67,28,39,0,0,0
2020-08-26 13:45,97,42,55,0,0,0
2020-08-26 14:00,74,31,43,0,0,0
2020-08-26 14:15,63,38,25,0,0,0
2020-08-26 14:30,65,36,29,0,0,0
2020-08-26 14:45,68,29,39,0,0,0
2020-08-26 15:00,83,40,43,0,0,0
2020-08-26 15:15,83,47,36,0,0,0
2020-08-26 15:30,94,41,53,0,0,0
2020-08-26 15:45,123,65,58,0,0,0
2020-08-26 16:00,132,72,60,0,0,0
2020-08-26 16:15,114,60,54,0,0,0
2020-08-26 16:30,102,51,51,0,0,0
2020-08-26 16:45,118,60,58,0,0,0
2020-08-26 17:00,103,54,49,0,0,0
2020-08-26 17:15,112,54,58,0,0,0
2020-08-26 17:30,89,55,34,0,0,0
2020-08-26 17:45,131,61,70,0,0,0
2020-08-26 18:00,85,38,47,0,0,0
2020-08-26 18:15,100,46,54,0,0,0
2020-08-26 18:30,73,34,39,0,0,0
2020-08-26 18:45,71,35,36,0,0,0
2020-08-26 19:00,67,29,38,0,0,0
2020-08-26 19:15,72,32,40,0,0,0
2020-08-26 19:30,48,21,27,0,0,0
2020-08-26 19:45,61,29,32,0,0,0
2020-08-26 20:00,44,17,27,0,0,0
2020-08-26 20:15,49,35,14,0,0,0
2020-08-26 20:30,35,16,19,0,0,0
2020-08-26 20:45,40,27,13,0,0,0
2020-08-26 21:00,31,19,12,0,0,0
2020-08-26 21:15,39,19,20,0,0,0
2020-08-26 21:30,37,19,18,0,0,0
2020-08-26 21:45,28,14,14,0,0,0
2020-08-26 22:00,22,8,14,0,0,0
2020-08-26 22:15,31,14,17,0,0,0
2020-08-26 22:30,26,14,12,0,0,0
2020-08-26 22:45,16,9,7,0,0,0
2020-08-26 23:00,12,6,6,0,0,0
2020-08-26 23:15,24,12,12,0,0,0
2020-08-26 23:30,15,6,9,0,0,0
2020-08-26 23:45,7,3,4,0,0,0
2020-08-27 00:00,17,7,10,0,0,0
2020-08-27 00:15,12,3,9,0,0,0
2020-08-27 00:30,5,1,4,0,0,0
2020-08-27 00:45,10,4,6,0,0,0
2020-08-27 01:00,4,1,3,0,0,0
2020-08-27 01:15,0,0,0,0,0,0
2020-08-27 01:30,4,3,1,0,0,0
2020-08-27 01:45,3,1,2,0,0,0
2020-08-27 02:00,3,0,3,0,0,0
2020-08-27 02:15,3,1,2,0,0,0
2020-08-27 02:30,0,0,0,0,0,0
2020-08-27 02:45,0,0,0,0,0,0
2020-08-27 03:00,3,1,2,0,0,0
2020-08-27 03:15,2,0,2,0,0,0
2020-08-27 03:30,5,4,1,0,0,0
2020-08-27 03:45,0,0,0,0,0,0
2020-08-27 04:00,1,0,1,0,0,0
2020-08-27 04:15,3,0,3,0,0,0
2020-08-27 04:30,2,0,2,0,0,0
2020-08-27 04:45,1,1,0,0,0,0
2020-08-27 05:00,1,0,1,0,0,0
2020-08-27 05:15,0,0,0,0,0,0
2020-08-27 05:30,14,10,4,0,0,0
2020-08-27 05:45,25,15,10,0,0,0
2020-08-27 06:00,16,12,4,0,0,0
2020-08-27 06:15,20,15,5,0,0,0
2020-08-27 06:30,43,28,15,0,0,0
2020-08-27 06:45,44,27,17,0,0,0
2020-08-27 07:00,76,54,22,0,0,0
2020-08-27 07:15,169,127,42,0,0,0
2020-08-27 07:30,277,231,46,0,0,0
2020-08-27 07:45,228,161,67,0,0,0
2020-08-27 08:00,115,84,31,0,0,0
2020-08-27 08:15,122,90,32,0,0,0
2020-08-27 08:30,131,98,33,0,0,0
2020-08-27 08:45,152,109,43,0,0,0
2020-08-27 09:00,91,69,22,0,0,0
2020-08-27 09:15,105,83,22,0,0,0
2020-08-27 09:30,83,59,24,0,0,0
2020-08-27 09:45,109,74,35,0,0,0
2020-08-27 10:00,84,53,31,0,0,0
2020-08-27 10:15,95,69,26,0,0,0
2020-08-27 10:30,113,76,37,0,0,0
2020-08-27 10:45,101,61,40,0,0,0
2020-08-27 11:00,95,62,33,0,0,0
2020-08-27 11:15,122,76,46,0,0,0
2020-08-27 11:30,112,68,44,0,0,0
2020-08-27 11:45,111,67,44,0,0,0
2020-08-27 12:00,96,64,32,0,0,0
2020-08-27 12:15,102,55,47,0,0,0
2020-08-27 12:30,116,59,57,0,0,0
2020-08-27 12:45,104,54,50,0,0,0
2020-08-27 13:00,145,66,79,0,0,0
2020-08-27 13:15,141,72,69,0,0,0
2020-08-27 13:30,125,68,57,0,0,0
2020-08-27 13:45,159,75,84,0,0,0
2020-08-27 14:00,142,63,79,0,0,0
2020-08-27 14:15,131,68,63,0,0,0
2020-08-27 14:30,151,79,72,0,0,0
2020-08-27 14:45,141,78,63,0,0,0
2020-08-27 15:00,161,87,74,0,0,0
2020-08-27 15:15,145,84,61,0,0,0
2020-08-27 15:30,148,66,82,0,0,0
2020-08-27 15:45,180,102,78,0,0,0
2020-08-27 16:00,180,99,81,0,0,0
2020-08-27 16:15,188,109,79,0,0,0
2020-08-27 16:30,197,119,78,0,0,0
2020-08-27 16:45,190,112,78,0,0,0
2020-08-27 17:00,196,110,86,0,0,0
2020-08-27 17:15,178,78,100,0,0,0
2020-08-27 17:30,167,90,77,0,0,0
2020-08-27 17:45,169,87,82,0,0,0
2020-08-27 18:00,114,55,59,0,0,0
2020-08-27 18:15,156,68,88,0,0,0
2020-08-27 18:30,120,56,64,0,0,0
2020-08-27 18:45,149,77,72,0,0,0
2020-08-27 19:00,142,77,65,0,0,0
2020-08-27 19:15,100,50,50,0,0,0
2020-08-27 19:30,77,37,40,0,0,0
2020-08-27 19:45,92,52,40,0,0,0
2020-08-27 20:00,88,41,47,0,0,0
2020-08-27 20:15,51,24,27,0,0,0
2020-08-27 20:30,55,29,26,0,0,0
2020-08-27 20:45,62,24,38,0,0,0
2020-08-27 21:00,46,23,23,0,0,0
2020-08-27 21:15,60,35,25,0,0,0
2020-08-27 21:30,52,20,32,0,0,0
2020-08-27 21:45,45,16,29,0,0,0
2020-08-27 22:00,36,13,23,0,0,0
2020-08-27 22:15,36,18,18,0,0,0
2020-08-27 22:30,23,15,8,0,0,0
2020-08-27 22:45,34,19,15,0,0,0
2020-08-27 23:00,33,19,14,0,0,0
2020-08-27 23:15,19,12,7,0,0,0
2020-08-27 23:30,17,9,8,0,0,0
2020-08-27 23:45,13,6,7,0,0,0
2020-08-28 00:00,8,4,4,0,0,0
2020-08-28 00:15,11,5,6,0,0,0
2020-08-28 00:30,14,9,5,0,0,0
2020-08-28 00:45,3,2,1,0,0,0
2020-08-28 01:00,4,0,4,0,0,0
2020-08-28 01:15,6,4,2,0,0,0
2020-08-28 01:30,3,2,1,0,0,0
2020-08-28 01:45,3,3,0,0,0,0
2020-08-28 02:00,1,1,0,0,0,0
2020-08-28 02:15,0,0,0,0,0,0
2020-08-28 02:30,5,0,5,0,0,0
2020-08-28 02:45,1,0,1,0,0,0
2020-08-28 03:00,2,0,2,0,0,0
2020-08-28 03:15,4,2,2,0,0,0
2020-08-28 03:30,1,0,1,0,0,0
2020-08-28 03:45,1,1,0,0,0,0
2020-08-28 04:00,2,0,2,0,0,0
2020-08-28 04:15,2,1,1,0,0,0
2020-08-28 04:30,1,0,1,0,0,0
2020-08-28 04:45,0,0,0,0,0,0
2020-08-28 05:00,2,0,2,0,0,0
2020-08-28 05:15,4,1,3,0,0,0
2020-08-28 05:30,9,6,3,0,0,0
2020-08-28 05:45,21,11,10,0,0,0
2020-08-28 06:00,15,11,4,0,0,0
2020-08-28 06:15,28,19,9,0,0,0
2020-08-28 06:30,41,24,17,0,0,0
2020-08-28 06:45,53,41,12,0,0,0
2020-08-28 07:00,66,38,28,0,0,0
2020-08-28 07:15,169,130,39,0,0,0
2020-08-28 07:30,274,232,42,0,0,0
2020-08-28 07:45,221,153,68,0,0,0
2020-08-28 08:00,101,83,18,0,0,0
2020-08-28 08:15,114,77,37,0,0,0
2020-08-28 08:30,97,78,19,0,0,0
2020-08-28 08:45,122,98,24,0,0,0
2020-08-28 09:00,88,66,22,0,0,0
2020-08-28 09:15,98,75,23,0,0,0
2020-08-28 09:30,111,75,36,0,0,0
2020-08-28 09:45,106,82,24,0,0,0
2020-08-28 10:00,103,76,27,0,0,0
2020-08-28 10:15,88,57,31,0,0,0
2020-08-28 10:30,92,58,34,0,0,0
2020-08-28 10:45,118,80,38,0,0,0
2020-08-28 11:00,91,60,31,0,0,0
2020-08-28 11:15,90,52,38,0,0,0
2020-08-28 11:30,105,69,36,0,0,0
2020-08-28 11:45,112,58,54,0,0,0
2020-08-28 12:00,117,59,58,0,0,0
2020-08-28 12:15,131,61,70,0,0,0
2020-08-28 12:30,123,68,55,0,0,0
2020-08-28 12:45,138,66,72,0,0,0
2020-08-28 13:00,165,74,91,0,0,0
2020-08-28 13:15,163,79,84,0,0,0
2020-08-28 13:30,134,67,67,0,0,0
2020-08-28 13:45,138,60,78,0,0,0
2020-08-28 14:00,169,83,86,0,0,0
2020-08-28 14:15,146,72,74,0,0,0
2020-08-28 14:30,155,77,78,0,0,0
2020-08-28 14:45,158,85,73,0,0,0
2020-08-28 15:00,183,96,87,0,0,0
2020-08-28 15:15,174,101,73,0,0,0
2020-08-28 15:30,151,76,75,0,0,0
2020-08-28 15:45,167,80,87,0,0,0
2020-08-28 16:00,138,76,62,0,0,0
2020-08-28 16:15,128,67,61,0,0,0
2020-08-28 16:30,145,90,55,0,0,0
2020-08-28 16:45,149,81,68,0,0,0
2020-08-28 17:00,134,58,76,0,0,0
2020-08-28 17:15,125,71,54,0,0,0
2020-08-28 17:30,131,65,66,0,0,0
2020-08-28 17:45,142,74,68,0,0,0
2020-08-28 18:00,163,93,70,0,0,0
2020-08-28 18:15,135,75,60,0,0,0
2020-08-28 18:30,134,71,63,0,0,0
2020-08-28 18:45,158,97,61,0,0,0
2020-08-28 19:00,133,78,55,0,0,0
2020-08-28 19:15,118,63,55,0,0,0
2020-08-28 19:30,75,37,38,0,0,0
2020-08-28 19:45,109,64,45,0,0,0
2020-08-28 20:00,111,62,49,0,0,0
2020-08-28 20:15,59,25,34,0,0,0
2020-08-28 20:30,55,26,29,0,0,0
2020-08-28 20:45,78,39,39,0,0,0
2020-08-28 21:00,50,30,20,0,0,0
2020-08-28 21:15,27,15,12,0,0,0
2020-08-28 21:30,8,1,7,0,0,0
2020-08-28 21:45,23,13,10,0,0,0
2020-08-28 22:00,37,18,19,0,0,0
2020-08-28 22:15,23,12,11,0,0,0
2020-08-28 22:30,37,15,22,0,0,0
2020-08-28 22:45,32,17,15,0,0,0
2020-08-28 23:00,22,14,8,0,0,0
2020-08-28 23:15,38,31,7,0,0,0
2020-08-28 23:30,22,10,12,0,0,0
2020-08-28 23:45,27,9,18,0,0,0
2020-08-29 00:00,28,14,14,0,0,0
2020-08-29 00:15,27,16,11,0,0,0
2020-08-29 00:30,23,9,14,0,0,0
2020-08-29 00:45,25,9,16,0,0,0
2020-08-29 01:00,14,7,7,0,0,0
2020-08-29 01:15,16,5,11,0,0,0
2020-08-29 01:30,18,10,8,0,0,0
2020-08-29 01:45,14,8,6,0,0,0
2020-08-29 02:00,13,7,6,0,0,0
2020-08-29 02:15,3,0,3,0,0,0
2020-08-29 02:30,3,0,3,0,0,0
2020-08-29 02:45,9,4,5,0,0,0
2020-08-29 03:00,6,1,5,0,0,0
2020-08-29 03:15,7,0,7,0,0,0
2020-08-29 03:30,4,1,3,0,0,0
2020-08-29 03:45,4,0,4,0,0,0
2020-08-29 04:00,7,4,3,0,0,0
2020-08-29 04:15,5,0,5,0,0,0
2020-08-29 04:30,4,2,2,0,0,0
2020-08-29 04:45,0,0,0,0,0,0
2020-08-29 05:00,2,1,1,0,0,0
2020-08-29 05:15,4,2,2,0,0,0
2020-08-29 05:30,9,3,6,0,0,0
2020-08-29 05:45,14,4,10,0,0,0
2020-08-29 06:00,8,5,3,0,0,0
2020-08-29 06:15,4,2,2,0,0,0
2020-08-29 06:30,14,11,3,0,0,0
2020-08-29 06:45,18,15,3,0,0,0
2020-08-29 07:00,17,11,6,0,0,0
2020-08-29 07:15,25,17,8,0,0,0
2020-08-29 07:30,28,17,11,0,0,0
2020-08-29 07:45,45,27,18,0,0,0
2020-08-29 08:00,24,15,9,0,0,0
2020-08-29 08:15,32,23,9,0,0,0
2020-08-29 08:30,51,38,13,0,0,0
2020-08-29 08:45,68,41,27,0,0,0
2020-08-29 09:00,67,40,27,0,0,0
2020-08-29 09:15,81,59,22,0,0,0
2020-08-29 09:30,94,69,25,0,0,0
2020-08-29 09:45,133,99,34,0,0,0
2020-08-29 10:00,118,83,35,0,0,0
2020-08-29 10:15,117,89,28,0,0,0
2020-08-29 10:30,143,107,36,0,0,0
2020-08-29 10:45,150,96,54,0,0,0
2020-08-29 11:00,162,103,59,0,0,0
2020-08-29 11:15,145,92,53,0,0,0
2020-08-29 11:30,132,95,37,0,0,0
2020-08-29 11:45,167,95,72,0,0,0
2020-08-29 12:00,171,106,65,0,0,0
2020-08-29 12:15,160,87,73,0,0,0
2020-08-29 12:30,170,86,84,0,0,0
2020-08-29 12:45,169,100,69,0,0,0
2020-08-29 13:00,151,80,71,0,0,0
2020-08-29 13:15,129,67,62,0,0,0
2020-08-29 13:30,172,107,65,0,0,0
2020-08-29 13:45,144,75,69,0,0,0
2020-08-29 14:00,140,71,69,0,0,0
2020-08-29 14:15,129,70,59,0,0,0
2020-08-29 14:30,127,61,66,0,0,0
2020-08-29 14:45,142,72,70,0,0,0
2020-08-29 15:00,138,82,56,0,0,0
2020-08-29 15:15,104,60,44,0,0,0
2020-08-29 15:30,145,86,59,0,0,0
2020-08-29 15:45,140,79,61,0,0,0
2020-08-29 16:00,114,50,64,0,0,0
2020-08-29 16:15,103,50,53,0,0,0
2020-08-29 16:30,93,50,43,0,0,0
2020-08-29 16:45,93,45,48,0,0,0
2020-08-29 17:00,106,52,54,0,0,0
2020-08-29 17:15,104,66,38,0,0,0
2020-08-29 17:30,109,47,62,0,0,0
2020-08-29 17:45,123,71,52,0,0,0
2020-08-29 18:00,106,61,45,0,0,0
2020-08-29 18:15,117,68,49,0,0,0
2020-08-29 18:30,99,60,39,0,0,0
2020-08-29 18:45,135,84,51,0,0,0
2020-08-29 19:00,92,55,37,0,0,0
2020-08-29 19:15,112,62,50,0,0,0
2020-08-29 19:30,89,49,40,0,0,0
2020-08-29 19:45,82,45,37,0,0,0
2020-08-29 20:00,81,44,37,0,0,0
2020-08-29 20:15,62,35,27,0,0,0
2020-08-29 20:30,59,37,22,0,0,0
2020-08-29 20:45,40,25,15,0,0,0
2020-08-29 21:00,43,20,23,0,0,0
2020-08-29 21:15,38,24,14,0,0,0
2020-08-29 21:30,33,17,16,0,0,0
2020-08-29 21:45,41,14,27,0,0,0
2020-08-29 22:00,39,21,18,0,0,0
2020-08-29 22:15,29,10,19,0,0,0
2020-08-29 22:30,46,27,19,0,0,0
2020-08-29 22:45,34,17,17,0,0,0
2020-08-29 23:00,27,11,16,0,0,0
2020-08-29 23:15,35,19,16,0,0,0
2020-08-29 23:30,26,8,18,0,0,0
2020-08-29 23:45,26,15,11,0,0,0
2020-08-30 00:00,37,23,14,0,0,0
2020-08-30 00:15,28,22,6,0,0,0
2020-08-30 00:30,23,9,14,0,0,0
2020-08-30 00:45,20,6,14,0,0,0
2020-08-30 01:00,12,1,11,0,0,0
2020-08-30 01:15,30,13,17,0,0,0
2020-08-30 01:30,22,8,14,0,0,0
2020-08-30 01:45,16,2,14,0,0,0
2020-08-30 02:00,15,9,6,0,0,0
2020-08-30 02:15,16,5,11,0,0,0
2020-08-30 02:30,5,1,4,0,0,0
2020-08-30 02:45,8,1,7,0,0,0
2020-08-30 03:00,5,1,4,0,0,0
2020-08-30 03:15,7,1,6,0,0,0
2020-08-30 03:30,11,1,10,0,0,0
2020-08-30 03:45,4,2,2,0,0,0
2020-08-30 04:00,3,1,2,0,0,0
2020-08-30 04:15,2,1,1,0,0,0
2020-08-30 04:30,7,5,2,0,0,0
2020-08-30 04:45,0,0,0,0,0,0
2020-08-30 05:00,2,1,1,0,0,0
2020-08-30 05:15,2,1,1,0,0,0
2020-08-30 05:30,7,5,2,0,0,0
2020-08-30 05:45,9,3,6,0,0,0
2020-08-30 06:00,2,1,1,0,0,0
2020-08-30 06:15,6,3,3,0,0,0
2020-08-30 06:30,5,3,2,0,0,0
2020-08-30 06:45,4,4,0,0,0,0
2020-08-30 07:00,6,4,2,0,0,0
2020-08-30 07:15,5,4,1,0,0,0
2020-08-30 07:30,10,5,5,0,0,0
2020-08-30 07:45,11,6,5,0,0,0
2020-08-30 08:00,8,3,5,0,0,0
2020-08-30 08:15,12,8,4,0,0,0
2020-08-30 08:30,15,10,5,0,0,0
2020-08-30 08:45,23,13,10,0,0,0
2020-08-30 09:00,21,15,6,0,0,0
2020-08-30 09:15,19,9,10,0,0,0
2020-08-30 09:30,30,19,11,0,0,0
2020-08-30 09:45,42,28,14,0,0,0
2020-08-30 10:00,47,24,23,0,0,0
2020-08-30 10:15,29,18,11,0,0,0
2020-08-30 10:30,34,22,12,0,0,0
2020-08-30 10:45,41,27,14,0,0,0
2020-08-30 11:00,49,26,23,0,0,0
2020-08-30 11:15,36,20,16,0,0,0
2020-08-30 11:30,52,30,22,0,0,0
2020-08-30 11:45,57,44,13,0,0,0
2020-08-30 12:00,42,23,19,0,0,0
2020-08-30 12:15,80,48,32,0,0,0
2020-08-30 12:30,79,45,34,0,0,0
2020-08-30 12:45,58,32,26,0,0,0
2020-08-30 13:00,68,46,22,0,0,0
2020-08-30 13:15,85,45,40,0,0,0
2020-08-30 13:30,72,44,28,0,0,0
2020-08-30 13:45,95,60,35,0,0,0
2020-08-30 14:00,88,43,45,0,0,0
2020-08-30 14:15,105,60,45,0,0,0
2020-08-30 14:30,76,51,25,0,0,0
2020-08-30 14:45,98,57,41,0,0,0
2020-08-30 15:00,86,52,34,0,0,0
2020-08-30 15:15,92,66,26,0,0,0
2020-08-30 15:30,84,53,31,0,0,0
2020-08-30 15:45,78,44,34,0,0,0
2020-08-30 16:00,100,72,28,0,0,0
2020-08-30 16:15,113,69,44,0,0,0
2020-08-30 16:30,94,64,30,0,0,0
2020-08-30 16:45,79,48,31,0,0,0
2020-08-30 17:00,105,59,46,0,0,0
2020-08-30 17:15,92,58,34,0,0,0
2020-08-30 17:30,115,74,41,0,0,0
2020-08-30 17:45,77,56,21,0,0,0
2020-08-30 18:00,78,45,33,0,0,0
2020-08-30 18:15,93,62,31,0,0,0
2020-08-30 18:30,70,40,30,0,0,0
2020-08-30 18:45,82,49,33,0,0,0
2020-08-30 19:00,71,36,35,0,0,0
2020-08-30 19:15,82,47,35,0,0,0
2020-08-30 19:30,52,21,31,0,0,0
2020-08-30 19:45,48,27,21,0,0,0
2020-08-30 20:00,59,30,29,0,0,0
2020-08-30 20:15,34,11,23,0,0,0
2020-08-30 20:30,38,19,19,0,0,0
2020-08-30 20:45,54,32,22,0,0,0
2020-08-30 21:00,28,13,15,0,0,0
2020-08-30 21:15,41,22,19,0,0,0
2020-08-30 21:30,19,10,9,0,0,0
2020-08-30 21:45,27,15,12,0,0,0
2020-08-30 22:00,24,11,13,0,0,0
2020-08-30 22:15,14,5,9,0,0,0
2020-08-30 22:30,17,5,12,0,0,0
2020-08-30 22:45,20,12,8,0,0,0
2020-08-30 23:00,18,7,11,0,0,0
2020-08-30 23:15,8,2,6,0,0,0
2020-08-30 23:30,18,11,7,0,0,0
2020-08-30 23:45,8,7,1,0,0,0
2020-08-31 00:00,6,2,4,0,0,0
2020-08-31 00:15,1,1,0,0,0,0
2020-08-31 00:30,6,5,1,0,0,0
2020-08-31 00:45,1,0,1,0,0,0
2020-08-31 01:00,3,1,2,0,0,0
2020-08-31 01:15,2,1,1,0,0,0
2020-08-31 01:30,2,0,2,0,0,0
2020-08-31 01:45,5,3,2,0,0,0
2020-08-31 02:00,0,0,0,0,0,0
2020-08-31 02:15,0,0,0,0,0,0
2020-08-31 02:30,1,0,1,0,0,0
2020-08-31 02:45,1,0,1,0,0,0
2020-08-31 03:00,1,1,0,0,0,0
2020-08-31 03:15,1,1,0,0,0,0
2020-08-31 03:30,0,0,0,0,0,0
2020-08-31 03:45,0,0,0,0,0,0
2020-08-31 04:00,0,0,0,0,0,0
2020-08-31 04:15,2,1,1,0,0,0
2020-08-31 04:30,1,0,1,0,0,0
2020-08-31 04:45,1,0,1,0,0,0
2020-08-31 05:00,1,1,0,0,0,0
2020-08-31 05:15,4,2,2,0,0,0
2020-08-31 05:30,7,3,4,0,0,0
2020-08-31 05:45,14,10,4,0,0,0
2020-08-31 06:00,16,9,7,0,0,0
2020-08-31 06:15,33,18,15,0,0,0
2020-08-31 06:30,43,26,17,0,0,0
2020-08-31 06:45,64,39,25,0,0,0
2020-08-31 07:00,79,57,22,0,0,0
2020-08-31 07:15,177,134,43,0,0,0
2020-08-31 07:30,276,211,65,0,0,0
2020-08-31 07:45,247,170,77,0,0,0
2020-08-31 08:00,135,93,42,0,0,0
2020-08-31 08:15,109,70,39,0,0,0
2020-08-31 08:30,127,95,32,0,0,0
2020-08-31 08:45,127,91,36,0,0,0
2020-08-31 09:00,95,66,29,0,0,0
2020-08-31 09:15,101,67,34,0,0,0
2020-08-31 09:30,105,77,28,0,0,0
2020-08-31 09:45,116,85,31,0,0,0
2020-08-31 10:00,96,74,22,0,0,0
2020-08-31 10:15,87,54,33,0,0,0
2020-08-31 10:30,87,46,41,0,0,0
2020-08-31 10:45,101,71,30,0,0,0
2020-08-31 11:00,65,43,22,0,0,0
2020-08-31 11:15,97,58,39,0,0,0
2020-08-31 11:30,101,58,43,0,0,0
2020-08-31 11:45,88,58,30,0,0,0
2020-08-31 12:00,122,71,51,0,0,0
2020-08-31 12:15,107,54,53,0,0,0
2020-08-31 12:30,125,69,56,0,0,0
2020-08-31 12:45,140,75,65,0,0,0
2020-08-31 13:00,129,56,73,0,0,0
2020-08-31 13:15,130,63,67,0,0,0
2020-08-31 13:30,121,58,63,0,0,0
2020-08-31 13:45,143,78,65,0,0,0
2020-08-31 14:00,117,59,58,0,0,0
2020-08-31 14:15,124,72,52,0,0,0
2020-08-31 14:30,148,94,54,0,0,0
2020-08-31 14:45,151,76,75,0,0,0
2020-08-31 15:00,146,85,61,0,0,0
2020-08-31 15:15,150,85,65,0,0,0
2020-08-31 15:30,163,90,73,0,0,0
2020-08-31 15:45,203,98,105,0,0,0
2020-08-31 16:00,176,109,67,0,0,0
2020-08-31 16:15,152,93,59,0,0,0
2020-08-31 16:30,200,107,93,0,0,0
2020-08-31 16:45,191,111,80,0,0,0
2020-08-31 17:00,173,83,90,0,0,0
2020-08-31 17:15,147,79,68,0,0,0
2020-08-31 17:30,173,83,90,0,0,0
2020-08-31 17:45,192,113,79,0,0,0
2020-08-31 18:00,155,77,78,0,0,0
2020-08-31 18:15,146,70,76,0,0,0
2020-08-31 18:30,134,65,69,0,0,0
2020-08-31 18:45,119,60,59,0,0,0
2020-08-31 19:00,118,48,70,0,0,0
2020-08-31 19:15,105,55,50,0,0,0
2020-08-31 19:30,89,46,43,0,0,0
2020-08-31 19:45,76,30,46,0,0,0
2020-08-31 20:00,66,25,41,0,0,0
2020-08-31 20:15,71,25,46,0,0,0
2020-08-31 20:30,66,32,34,0,0,0
2020-08-31 20:45,70,32,38,0,0,0
2020-08-31 21:00,55,35,20,0,0,0
2020-08-31 21:15,53,27,26,0,0,0
2020-08-31 21:30,40,15,25,0,0,0
2020-08-31 21:45,33,12,21,0,0,0
2020-08-31 22:00,39,23,16,0,0,0
2020-08-31 22:15,40,23,17,0,0,0
2020-08-31 22:30,34,16,18,0,0,0
2020-08-31 22:45,26,16,10,0,0,0
2020-08-31 23:00,25,12,13,0,0,0
2020-08-31 23:15,14,5,9,0,0,0
2020-08-31 23:30,13,6,7,0,0,0
2020-08-31 23:45,9,7,2,0,0,0
