Datetime,100034983 (Warendorfer Straße),101034983 (Warendorfer Straße stadteinwärts),102034983 (Warendorfer Straße stadtauswärts),100034983-status,101034983-status,102034983-status
2020-06-01 00:00,10,7,3,0,0,0
2020-06-01 00:15,13,7,6,0,0,0
2020-06-01 00:30,11,7,4,0,0,0
2020-06-01 00:45,7,1,6,0,0,0
2020-06-01 01:00,11,3,8,0,0,0
2020-06-01 01:15,5,2,3,0,0,0
2020-06-01 01:30,5,5,0,0,0,0
2020-06-01 01:45,4,3,1,0,0,0
2020-06-01 02:00,5,3,2,0,0,0
2020-06-01 02:15,5,5,0,0,0,0
2020-06-01 02:30,6,2,4,0,0,0
2020-06-01 02:45,0,0,0,0,0,0
2020-06-01 03:00,1,0,1,0,0,0
2020-06-01 03:15,5,1,4,0,0,0
2020-06-01 03:30,2,2,0,0,0,0
2020-06-01 03:45,5,5,0,0,0,0
2020-06-01 04:00,1,0,1,0,0,0
2020-06-01 04:15,0,0,0,0,0,0
2020-06-01 04:30,0,0,0,0,0,0
2020-06-01 04:45,0,0,0,0,0,0
2020-06-01 05:00,0,0,0,0,0,0
2020-06-01 05:15,4,4,0,0,0,0
2020-06-01 05:30,12,8,4,0,0,0
2020-06-01 05:45,4,4,0,0,0,0
2020-06-01 06:00,4,4,0,0,0,0
2020-06-01 06:15,7,7,0,0,0,0
2020-06-01 06:30,2,2,0,0,0,0
2020-06-01 06:45,6,6,0,0,0,0
2020-06-01 07:00,6,5,1,0,0,0
2020-06-01 07:15,5,3,2,0,0,0
2020-06-01 07:30,6,4,2,0,0,0
2020-06-01 07:45,19,11,8,0,0,0
2020-06-01 08:00,8,5,3,0,0,0
2020-06-01 08:15,19,10,9,0,0,0
2020-06-01 08:30,22,16,6,0,0,0
2020-06-01 08:45,32,22,10,0,0,0
2020-06-01 09:00,10,4,6,0,0,0
2020-06-01 09:15,23,10,13,0,0,0
2020-06-01 09:30,32,22,10,0,0,0
2020-06-01 09:45,64,37,27,0,0,0
2020-06-01 10:00,47,31,16,0,0,0
2020-06-01 10:15,55,31,24,0,0,0
2020-06-01 10:30,51,35,16,0,0,0
2020-06-01 10:45,57,39,18,0,0,0
2020-06-01 11:00,53,34,19,0,0,0
2020-06-01 11:15,66,35,31,0,0,0
2020-06-01 11:30,78,44,34,0,0,0
2020-06-01 11:45,75,44,31,0,0,0
2020-06-01 12:00,77,43,34,0,0,0
2020-06-01 12:15,82,46,36,0,0,0
2020-06-01 12:30,76,33,43,0,0,0
2020-06-01 12:45,78,40,38,0,0,0
2020-06-01 13:00,61,27,34,0,0,0
2020-06-01 13:15,89,41,48,0,0,0
2020-06-01 13:30,96,55,41,0,0,0
2020-06-01 13:45,92,51,41,0,0,0
2020-06-01 14:00,111,59,52,0,0,0
2020-06-01 14:15,103,51,52,0,0,0
2020-06-01 14:30,95,53,42,0,0,0
2020-06-01 14:45,125,80,45,0,0,0
2020-06-01 15:00,119,74,45,0,0,0
2020-06-01 15:15,144,69,75,0,0,0
2020-06-01 15:30,125,78,47,0,0,0
2020-06-01 15:45,127,81,46,0,0,0
2020-06-01 16:00,114,69,45,0,0,0
2020-06-01 16:15,109,72,37,0,0,0
2020-06-01 16:30,103,65,38,0,0,0
2020-06-01 16:45,125,73,52,0,0,0
2020-06-01 17:00,95,51,44,0,0,0
2020-06-01 17:15,122,82,40,0,0,0
2020-06-01 17:30,90,57,33,0,0,0
2020-06-01 17:45,113,75,38,0,0,0
2020-06-01 18:00,135,92,43,0,0,0
2020-06-01 18:15,127,90,37,0,0,0
2020-06-01 18:30,101,67,34,0,0,0
2020-06-01 18:45,96,68,28,0,0,0
2020-06-01 19:00,82,54,28,0,0,0
2020-06-01 19:15,90,53,37,0,0,0
2020-06-01 19:30,70,34,36,0,0,0
2020-06-01 19:45,74,43,31,0,0,0
2020-06-01 20:00,64,37,27,0,0,0
2020-06-01 20:15,46,33,13,0,0,0
2020-06-01 20:30,47,26,21,0,0,0
2020-06-01 20:45,47,28,19,0,0,0
2020-06-01 21:00,38,24,14,0,0,0
2020-06-01 21:15,38,19,19,0,0,0
2020-06-01 21:30,37,15,22,0,0,0
2020-06-01 21:45,43,24,19,0,0,0
2020-06-01 22:00,32,20,12,0,0,0
2020-06-01 22:15,41,26,15,0,0,0
2020-06-01 22:30,18,10,8,0,0,0
2020-06-01 22:45,13,10,3,0,0,0
2020-06-01 23:00,18,12,6,0,0,0
2020-06-01 23:15,10,5,5,0,0,0
2020-06-01 23:30,13,7,6,0,0,0
2020-06-01 23:45,7,5,2,0,0,0
2020-06-02 00:00,7,4,3,0,0,0
2020-06-02 00:15,9,4,5,0,0,0
2020-06-02 00:30,3,3,0,0,0,0
2020-06-02 00:45,8,6,2,0,0,0
2020-06-02 01:00,3,2,1,0,0,0
2020-06-02 01:15,3,1,2,0,0,0
2020-06-02 01:30,5,1,4,0,0,0
2020-06-02 01:45,3,3,0,0,0,0
2020-06-02 02:00,5,2,3,0,0,0
2020-06-02 02:15,1,0,1,0,0,0
2020-06-02 02:30,0,0,0,0,0,0
2020-06-02 02:45,0,0,0,0,0,0
2020-06-02 03:00,0,0,0,0,0,0
2020-06-02 03:15,1,1,0,0,0,0
2020-06-02 03:30,2,0,2,0,0,0
2020-06-02 03:45,1,0,1,0,0,0
2020-06-02 04:00,0,0,0,0,0,0
2020-06-02 04:15,0,0,0,0,0,0
2020-06-02 04:30,1,0,1,0,0,0
2020-06-02 04:45,3,2,1,0,0,0
2020-06-02 05:00,0,0,0,0,0,0
2020-06-02 05:15,3,1,2,0,0,0
2020-06-02 05:30,18,12,6,0,0,0
2020-06-02 05:45,17,6,11,0,0,0
2020-06-02 06:00,18,11,7,0,0,0
2020-06-02 06:15,37,24,13,0,0,0
2020-06-02 06:30,45,26,19,0,0,0
2020-06-02 06:45,54,36,18,0,0,0
2020-06-02 07:00,94,64,30,0,0,0
2020-06-02 07:15,90,50,40,0,0,0
2020-06-02 07:30,134,94,40,0,0,0
2020-06-02 07:45,154,113,41,0,0,0
2020-06-02 08:00,136,91,45,0,0,0
2020-06-02 08:15,113,75,38,0,0,0
2020-06-02 08:30,99,69,30,0,0,0
2020-06-02 08:45,135,108,27,0,0,0
2020-06-02 09:00,113,83,30,0,0,0
2020-06-02 09:15,109,81,28,0,0,0
2020-06-02 09:30,105,79,26,0,0,0
2020-06-02 09:45,151,107,44,0,0,0
2020-06-02 10:00,111,80,31,0,0,0
2020-06-02 10:15,125,94,31,0,0,0
2020-06-02 10:30,99,71,28,0,0,0
2020-06-02 10:45,122,80,42,0,0,0
2020-06-02 11:00,120,77,43,0,0,0
2020-06-02 11:15,149,97,52,0,0,0
2020-06-02 11:30,107,57,50,0,0,0
2020-06-02 11:45,136,89,47,0,0,0
2020-06-02 12:00,141,78,63,0,0,0
2020-06-02 12:15,117,63,54,0,0,0
2020-06-02 12:30,153,86,67,0,0,0
2020-06-02 12:45,127,71,56,0,0,0
2020-06-02 13:00,137,73,64,0,0,0
2020-06-02 13:15,136,60,76,0,0,0
2020-06-02 13:30,140,73,67,0,0,0
2020-06-02 13:45,142,77,65,0,0,0
2020-06-02 14:00,127,63,64,0,0,0
2020-06-02 14:15,129,70,59,0,0,0
2020-06-02 14:30,167,80,87,0,0,0
2020-06-02 14:45,171,95,76,0,0,0
2020-06-02 15:00,142,72,70,0,0,0
2020-06-02 15:15,160,82,78,0,0,0
2020-06-02 15:30,153,72,81,0,0,0
2020-06-02 15:45,186,99,87,0,0,0
2020-06-02 16:00,184,100,84,0,0,0
2020-06-02 16:15,228,128,100,0,0,0
2020-06-02 16:30,183,101,82,0,0,0
2020-06-02 16:45,236,122,114,0,0,0
2020-06-02 17:00,225,109,116,0,0,0
2020-06-02 17:15,191,98,93,0,0,0
2020-06-02 17:30,175,73,102,0,0,0
2020-06-02 17:45,199,109,90,0,0,0
2020-06-02 18:00,156,84,72,0,0,0
2020-06-02 18:15,143,68,75,0,0,0
2020-06-02 18:30,153,71,82,0,0,0
2020-06-02 18:45,158,89,69,0,0,0
2020-06-02 19:00,110,47,63,0,0,0
2020-06-02 19:15,117,59,58,0,0,0
2020-06-02 19:30,102,66,36,0,0,0
2020-06-02 19:45,104,46,58,0,0,0
2020-06-02 20:00,101,55,46,0,0,0
2020-06-02 20:15,78,45,33,0,0,0
2020-06-02 20:30,66,36,30,0,0,0
2020-06-02 20:45,61,33,28,0,0,0
2020-06-02 21:00,54,24,30,0,0,0
2020-06-02 21:15,55,31,24,0,0,0
2020-06-02 21:30,44,25,19,0,0,0
2020-06-02 21:45,42,22,20,0,0,0
2020-06-02 22:00,44,23,21,0,0,0
2020-06-02 22:15,36,22,14,0,0,0
2020-06-02 22:30,42,24,18,0,0,0
2020-06-02 22:45,37,18,19,0,0,0
2020-06-02 23:00,26,18,8,0,0,0
2020-06-02 23:15,24,16,8,0,0,0
2020-06-02 23:30,18,11,7,0,0,0
2020-06-02 23:45,6,6,0,0,0,0
2020-06-03 00:00,23,22,1,0,0,0
2020-06-03 00:15,8,4,4,0,0,0
2020-06-03 00:30,1,0,1,0,0,0
2020-06-03 00:45,6,4,2,0,0,0
2020-06-03 01:00,6,3,3,0,0,0
2020-06-03 01:15,3,1,2,0,0,0
2020-06-03 01:30,3,1,2,0,0,0
2020-06-03 01:45,1,1,0,0,0,0
2020-06-03 02:00,0,0,0,0,0,0
2020-06-03 02:15,1,1,0,0,0,0
2020-06-03 02:30,0,0,0,0,0,0
2020-06-03 02:45,0,0,0,0,0,0
2020-06-03 03:00,2,1,1,0,0,0
2020-06-03 03:15,1,0,1,0,0,0
2020-06-03 03:30,0,0,0,0,0,0
2020-06-03 03:45,2,2,0,0,0,0
2020-06-03 04:00,0,0,0,0,0,0
2020-06-03 04:15,1,0,1,0,0,0
2020-06-03 04:30,1,0,1,0,0,0
2020-06-03 04:45,3,2,1,0,0,0
2020-06-03 05:00,1,0,1,0,0,0
2020-06-03 05:15,5,2,3,0,0,0
2020-06-03 05:30,17,8,9,0,0,0
2020-06-03 05:45,21,12,9,0,0,0
2020-06-03 06:00,26,20,6,0,0,0
2020-06-03 06:15,24,12,12,0,0,0
2020-06-03 06:30,58,43,15,0,0,0
2020-06-03 06:45,72,51,21,0,0,0
2020-06-03 07:00,87,62,25,0,0,0
2020-06-03 07:15,134,85,49,0,0,0
2020-06-03 07:30,141,92,49,0,0,0
2020-06-03 07:45,159,105,54,0,0,0
2020-06-03 08:00,151,101,50,0,0,0
2020-06-03 08:15,137,94,43,0,0,0
2020-06-03 08:30,137,105,32,0,0,0
2020-06-03 08:45,134,101,33,0,0,0
2020-06-03 09:00,107,76,31,0,0,0
2020-06-03 09:15,127,93,34,0,0,0
2020-06-03 09:30,117,84,33,0,0,0
2020-06-03 09:45,139,94,45,0,0,0
2020-06-03 10:00,125,87,38,0,0,0
2020-06-03 10:15,127,96,31,0,0,0
2020-06-03 10:30,159,110,49,0,0,0
2020-06-03 10:45,153,102,51,0,0,0
2020-06-03 11:00,135,79,56,0,0,0
2020-06-03 11:15,141,89,52,0,0,0
2020-06-03 11:30,146,83,63,0,0,0
2020-06-03 11:45,142,92,50,0,0,0
2020-06-03 12:00,126,76,50,0,0,0
2020-06-03 12:15,123,72,51,0,0,0
2020-06-03 12:30,132,66,66,0,0,0
2020-06-03 12:45,177,88,89,0,0,0
2020-06-03 13:00,172,90,82,0,0,0
2020-06-03 13:15,130,44,86,0,0,0
2020-06-03 13:30,141,74,67,0,0,0
2020-06-03 13:45,151,79,72,0,0,0
2020-06-03 14:00,173,78,95,0,0,0
2020-06-03 14:15,143,67,76,0,0,0
2020-06-03 14:30,140,72,68,0,0,0
2020-06-03 14:45,151,79,72,0,0,0
2020-06-03 15:00,122,64,58,0,0,0
2020-06-03 15:15,139,73,66,0,0,0
2020-06-03 15:30,145,63,82,0,0,0
2020-06-03 15:45,192,102,90,0,0,0
2020-06-03 16:00,180,90,90,0,0,0
2020-06-03 16:15,167,93,74,0,0,0
2020-06-03 16:30,217,118,99,0,0,0
2020-06-03 16:45,208,107,101,0,0,0
2020-06-03 17:00,189,91,98,0,0,0
2020-06-03 17:15,184,79,105,0,0,0
2020-06-03 17:30,173,88,85,0,0,0
2020-06-03 17:45,182,96,86,0,0,0
2020-06-03 18:00,167,81,86,0,0,0
2020-06-03 18:15,145,64,81,0,0,0
2020-06-03 18:30,149,74,75,0,0,0
2020-06-03 18:45,138,73,65,0,0,0
2020-06-03 19:00,150,72,78,0,0,0
2020-06-03 19:15,143,64,79,0,0,0
2020-06-03 19:30,103,61,42,0,0,0
2020-06-03 19:45,106,64,42,0,0,0
2020-06-03 20:00,89,43,46,0,0,0
2020-06-03 20:15,70,41,29,0,0,0
2020-06-03 20:30,65,30,35,0,0,0
2020-06-03 20:45,41,22,19,0,0,0
2020-06-03 21:00,51,23,28,0,0,0
2020-06-03 21:15,46,29,17,0,0,0
2020-06-03 21:30,50,21,29,0,0,0
2020-06-03 21:45,42,27,15,0,0,0
2020-06-03 22:00,44,22,22,0,0,0
2020-06-03 22:15,49,21,28,0,0,0
2020-06-03 22:30,39,19,20,0,0,0
2020-06-03 22:45,32,15,17,0,0,0
2020-06-03 23:00,28,17,11,0,0,0
2020-06-03 23:15,27,16,11,0,0,0
2020-06-03 23:30,8,3,5,0,0,0
2020-06-03 23:45,16,12,4,0,0,0
2020-06-04 00:00,21,11,10,0,0,0
2020-06-04 00:15,9,2,7,0,0,0
2020-06-04 00:30,11,6,5,0,0,0
2020-06-04 00:45,7,5,2,0,0,0
2020-06-04 01:00,6,3,3,0,0,0
2020-06-04 01:15,4,2,2,0,0,0
2020-06-04 01:30,6,2,4,0,0,0
2020-06-04 01:45,2,2,0,0,0,0
2020-06-04 02:00,2,2,0,0,0,0
2020-06-04 02:15,5,4,1,0,0,0
2020-06-04 02:30,0,0,0,0,0,0
2020-06-04 02:45,3,2,1,0,0,0
2020-06-04 03:00,1,0,1,0,0,0
2020-06-04 03:15,2,0,2,0,0,0
2020-06-04 03:30,1,1,0,0,0,0
2020-06-04 03:45,0,0,0,0,0,0
2020-06-04 04:00,1,1,0,0,0,0
2020-06-04 04:15,0,0,0,0,0,0
2020-06-04 04:30,1,0,1,0,0,0
2020-06-04 04:45,2,1,1,0,0,0
2020-06-04 05:00,1,0,1,0,0,0
2020-06-04 05:15,1,0,1,0,0,0
2020-06-04 05:30,22,10,12,0,0,0
2020-06-04 05:45,17,10,7,0,0,0
2020-06-04 06:00,25,16,9,0,0,0
2020-06-04 06:15,17,10,7,0,0,0
2020-06-04 06:30,40,25,15,0,0,0
2020-06-04 06:45,64,41,23,0,0,0
2020-06-04 07:00,75,53,22,0,0,0
2020-06-04 07:15,98,64,34,0,0,0
2020-06-04 07:30,180,132,48,0,0,0
2020-06-04 07:45,158,100,58,0,0,0
2020-06-04 08:00,93,71,22,0,0,0
2020-06-04 08:15,136,98,38,0,0,0
2020-06-04 08:30,130,100,30,0,0,0
2020-06-04 08:45,106,77,29,0,0,0
2020-06-04 09:00,85,62,23,0,0,0
2020-06-04 09:15,103,78,25,0,0,0
2020-06-04 09:30,83,77,6,0,0,0
2020-06-04 09:45,111,77,34,0,0,0
2020-06-04 10:00,89,63,26,0,0,0
2020-06-04 10:15,93,64,29,0,0,0
2020-06-04 10:30,93,52,41,0,0,0
2020-06-04 10:45,106,72,34,0,0,0
2020-06-04 11:00,113,70,43,0,0,0
2020-06-04 11:15,103,53,50,0,0,0
2020-06-04 11:30,95,41,54,0,0,0
2020-06-04 11:45,92,54,38,0,0,0
2020-06-04 12:00,99,58,41,0,0,0
2020-06-04 12:15,94,49,45,0,0,0
2020-06-04 12:30,97,51,46,0,0,0
2020-06-04 12:45,115,72,43,0,0,0
2020-06-04 13:00,117,56,61,0,0,0
2020-06-04 13:15,69,27,42,0,0,0
2020-06-04 13:30,92,51,41,0,0,0
2020-06-04 13:45,95,57,38,0,0,0
2020-06-04 14:00,92,44,48,0,0,0
2020-06-04 14:15,100,58,42,0,0,0
2020-06-04 14:30,104,69,35,0,0,0
2020-06-04 14:45,120,66,54,0,0,0
2020-06-04 15:00,124,61,63,0,0,0
2020-06-04 15:15,120,53,67,0,0,0
2020-06-04 15:30,107,63,44,0,0,0
2020-06-04 15:45,127,59,68,0,0,0
2020-06-04 16:00,155,87,68,0,0,0
2020-06-04 16:15,134,80,54,0,0,0
2020-06-04 16:30,134,66,68,0,0,0
2020-06-04 16:45,135,78,57,0,0,0
2020-06-04 17:00,152,71,81,0,0,0
2020-06-04 17:15,148,64,84,0,0,0
2020-06-04 17:30,124,64,60,0,0,0
2020-06-04 17:45,129,51,78,0,0,0
2020-06-04 18:00,96,39,57,0,0,0
2020-06-04 18:15,97,48,49,0,0,0
2020-06-04 18:30,86,35,51,0,0,0
2020-06-04 18:45,86,39,47,0,0,0
2020-06-04 19:00,78,35,43,0,0,0
2020-06-04 19:15,76,27,49,0,0,0
2020-06-04 19:30,66,32,34,0,0,0
2020-06-04 19:45,73,31,42,0,0,0
2020-06-04 20:00,47,23,24,0,0,0
2020-06-04 20:15,34,11,23,0,0,0
2020-06-04 20:30,31,12,19,0,0,0
2020-06-04 20:45,26,10,16,0,0,0
2020-06-04 21:00,31,20,11,0,0,0
2020-06-04 21:15,26,16,10,0,0,0
2020-06-04 21:30,30,17,13,0,0,0
2020-06-04 21:45,24,12,12,0,0,0
2020-06-04 22:00,22,11,11,0,0,0
2020-06-04 22:15,30,24,6,0,0,0
2020-06-04 22:30,32,23,9,0,0,0
2020-06-04 22:45,21,12,9,0,0,0
2020-06-04 23:00,20,13,7,0,0,0
2020-06-04 23:15,26,18,8,0,0,0
2020-06-04 23:30,9,5,4,0,0,0
2020-06-04 23:45,8,4,4,0,0,0
2020-06-05 00:00,15,6,9,0,0,0
2020-06-05 00:15,9,5,4,0,0,0
2020-06-05 00:30,5,2,3,0,0,0
2020-06-05 00:45,2,0,2,0,0,0
2020-06-05 01:00,4,3,1,0,0,0
2020-06-05 01:15,5,1,4,0,0,0
2020-06-05 01:30,2,0,2,0,0,0
2020-06-05 01:45,5,4,1,0,0,0
2020-06-05 02:00,4,1,3,0,0,0
2020-06-05 02:15,2,1,1,0,0,0
2020-06-05 02:30,3,2,1,0,0,0
2020-06-05 02:45,6,6,0,0,0,0
2020-06-05 03:00,2,0,2,0,0,0
2020-06-05 03:15,2,0,2,0,0,0
2020-06-05 03:30,2,2,0,0,0,0
2020-06-05 03:45,1,0,1,0,0,0
2020-06-05 04:00,0,0,0,0,0,0
2020-06-05 04:15,0,0,0,0,0,0
2020-06-05 04:30,0,0,0,0,0,0
2020-06-05 04:45,3,1,2,0,0,0
2020-06-05 05:00,1,1,0,0,0,0
2020-06-05 05:15,5,3,2,0,0,0
2020-06-05 05:30,12,8,4,0,0,0
2020-06-05 05:45,23,9,14,0,0,0
2020-06-05 06:00,16,11,5,0,0,0
2020-06-05 06:15,16,8,8,0,0,0
2020-06-05 06:30,23,14,9,0,0,0
2020-06-05 06:45,57,37,20,0,0,0
2020-06-05 07:00,63,47,16,0,0,0
2020-06-05 07:15,80,50,30,0,0,0
2020-06-05 07:30,177,133,44,0,0,0
2020-06-05 07:45,161,121,40,0,0,0
2020-06-05 08:00,111,86,25,0,0,0
2020-06-05 08:15,94,68,26,0,0,0
2020-06-05 08:30,91,70,21,0,0,0
2020-06-05 08:45,98,70,28,0,0,0
2020-06-05 09:00,89,65,24,0,0,0
2020-06-05 09:15,97,66,31,0,0,0
2020-06-05 09:30,98,67,31,0,0,0
2020-06-05 09:45,122,87,35,0,0,0
2020-06-05 10:00,97,62,35,0,0,0
2020-06-05 10:15,95,67,28,0,0,0
2020-06-05 10:30,102,69,33,0,0,0
2020-06-05 10:45,116,73,43,0,0,0
2020-06-05 11:00,115,80,35,0,0,0
2020-06-05 11:15,94,65,29,0,0,0
2020-06-05 11:30,92,48,44,0,0,0
2020-06-05 11:45,117,60,57,0,0,0
2020-06-05 12:00,108,64,44,0,0,0
2020-06-05 12:15,119,62,57,0,0,0
2020-06-05 12:30,127,71,56,0,0,0
2020-06-05 12:45,120,58,62,0,0,0
2020-06-05 13:00,142,63,79,0,0,0
2020-06-05 13:15,132,54,78,0,0,0
2020-06-05 13:30,103,38,65,0,0,0
2020-06-05 13:45,113,59,54,0,0,0
2020-06-05 14:00,99,48,51,0,0,0
2020-06-05 14:15,77,37,40,0,0,0
2020-06-05 14:30,83,35,48,0,0,0
2020-06-05 14:45,88,39,49,0,0,0
2020-06-05 15:00,78,38,40,0,0,0
2020-06-05 15:15,86,48,38,0,0,0
2020-06-05 15:30,78,35,43,0,0,0
2020-06-05 15:45,86,43,43,0,0,0
2020-06-05 16:00,102,61,41,0,0,0
2020-06-05 16:15,82,47,35,0,0,0
2020-06-05 16:30,71,37,34,0,0,0
2020-06-05 16:45,82,45,37,0,0,0
2020-06-05 17:00,93,48,45,0,0,0
2020-06-05 17:15,88,56,32,0,0,0
2020-06-05 17:30,82,38,44,0,0,0
2020-06-05 17:45,92,39,53,0,0,0
2020-06-05 18:00,59,17,42,0,0,0
2020-06-05 18:15,58,23,35,0,0,0
2020-06-05 18:30,54,22,32,0,0,0
2020-06-05 18:45,65,38,27,0,0,0
2020-06-05 19:00,77,30,47,0,0,0
2020-06-05 19:15,49,16,33,0,0,0
2020-06-05 19:30,61,33,28,0,0,0
2020-06-05 19:45,50,22,28,0,0,0
2020-06-05 20:00,51,18,33,0,0,0
2020-06-05 20:15,31,19,12,0,0,0
2020-06-05 20:30,36,24,12,0,0,0
2020-06-05 20:45,45,25,20,0,0,0
2020-06-05 21:00,25,15,10,0,0,0
2020-06-05 21:15,20,7,13,0,0,0
2020-06-05 21:30,15,6,9,0,0,0
2020-06-05 21:45,23,15,8,0,0,0
2020-06-05 22:00,14,9,5,0,0,0
2020-06-05 22:15,28,12,16,0,0,0
2020-06-05 22:30,29,20,9,0,0,0
2020-06-05 22:45,15,7,8,0,0,0
2020-06-05 23:00,23,13,10,0,0,0
2020-06-05 23:15,14,8,6,0,0,0
2020-06-05 23:30,12,7,5,0,0,0
2020-06-05 23:45,18,11,7,0,0,0
2020-06-06 00:00,14,3,11,0,0,0
2020-06-06 00:15,20,11,9,0,0,0
2020-06-06 00:30,25,19,6,0,0,0
2020-06-06 00:45,14,7,7,0,0,0
2020-06-06 01:00,11,5,6,0,0,0
2020-06-06 01:15,11,5,6,0,0,0
2020-06-06 01:30,12,4,8,0,0,0
2020-06-06 01:45,5,3,2,0,0,0
2020-06-06 02:00,15,4,11,0,0,0
2020-06-06 02:15,9,4,5,0,0,0
2020-06-06 02:30,6,3,3,0,0,0
2020-06-06 02:45,10,8,2,0,0,0
2020-06-06 03:00,7,2,5,0,0,0
2020-06-06 03:15,3,2,1,0,0,0
2020-06-06 03:30,4,3,1,0,0,0
2020-06-06 03:45,1,0,1,0,0,0
2020-06-06 04:00,3,3,0,0,0,0
2020-06-06 04:15,1,1,0,0,0,0
2020-06-06 04:30,2,1,1,0,0,0
2020-06-06 04:45,1,0,1,0,0,0
2020-06-06 05:00,0,0,0,0,0,0
2020-06-06 05:15,3,2,1,0,0,0
2020-06-06 05:30,5,3,2,0,0,0
2020-06-06 05:45,9,4,5,0,0,0
2020-06-06 06:00,11,7,4,0,0,0
2020-06-06 06:15,9,5,4,0,0,0
2020-06-06 06:30,8,7,1,0,0,0
2020-06-06 06:45,23,19,4,0,0,0
2020-06-06 07:00,14,12,2,0,0,0
2020-06-06 07:15,22,15,7,0,0,0
2020-06-06 07:30,32,22,10,0,0,0
2020-06-06 07:45,26,18,8,0,0,0
2020-06-06 08:00,37,28,9,0,0,0
2020-06-06 08:15,38,24,14,0,0,0
2020-06-06 08:30,49,34,15,0,0,0
2020-06-06 08:45,59,41,18,0,0,0
2020-06-06 09:00,50,36,14,0,0,0
2020-06-06 09:15,114,88,26,0,0,0
2020-06-06 09:30,80,57,23,0,0,0
2020-06-06 09:45,121,98,23,0,0,0
2020-06-06 10:00,58,41,17,0,0,0
2020-06-06 10:15,15,9,6,0,0,0
2020-06-06 10:30,45,26,19,0,0,0
2020-06-06 10:45,63,34,29,0,0,0
2020-06-06 11:00,74,47,27,0,0,0
2020-06-06 11:15,99,71,28,0,0,0
2020-06-06 11:30,87,64,23,0,0,0
2020-06-06 11:45,153,116,37,0,0,0
2020-06-06 12:00,130,92,38,0,0,0
2020-06-06 12:15,127,92,35,0,0,0
2020-06-06 12:30,147,107,40,0,0,0
2020-06-06 12:45,150,97,53,0,0,0
2020-06-06 13:00,156,102,54,0,0,0
2020-06-06 13:15,141,87,54,0,0,0
2020-06-06 13:30,152,98,54,0,0,0
2020-06-06 13:45,203,148,55,0,0,0
2020-06-06 14:00,173,118,55,0,0,0
2020-06-06 14:15,105,61,44,0,0,0
2020-06-06 14:30,112,58,54,0,0,0
2020-06-06 14:45,111,46,65,0,0,0
2020-06-06 15:00,127,66,61,0,0,0
2020-06-06 15:15,112,64,48,0,0,0
2020-06-06 15:30,112,62,50,0,0,0
2020-06-06 15:45,135,75,60,0,0,0
2020-06-06 16:00,115,56,59,0,0,0
2020-06-06 16:15,85,37,48,0,0,0
2020-06-06 16:30,106,48,58,0,0,0
2020-06-06 16:45,74,35,39,0,0,0
2020-06-06 17:00,92,36,56,0,0,0
2020-06-06 17:15,85,47,38,0,0,0
2020-06-06 17:30,90,32,58,0,0,0
2020-06-06 17:45,106,45,61,0,0,0
2020-06-06 18:00,88,29,59,0,0,0
2020-06-06 18:15,79,39,40,0,0,0
2020-06-06 18:30,81,45,36,0,0,0
2020-06-06 18:45,78,41,37,0,0,0
2020-06-06 19:00,85,47,38,0,0,0
2020-06-06 19:15,76,52,24,0,0,0
2020-06-06 19:30,79,36,43,0,0,0
2020-06-06 19:45,75,50,25,0,0,0
2020-06-06 20:00,63,34,29,0,0,0
2020-06-06 20:15,63,37,26,0,0,0
2020-06-06 20:30,46,28,18,0,0,0
2020-06-06 20:45,52,27,25,0,0,0
2020-06-06 21:00,38,21,17,0,0,0
2020-06-06 21:15,25,10,15,0,0,0
2020-06-06 21:30,33,21,12,0,0,0
2020-06-06 21:45,33,16,17,0,0,0
2020-06-06 22:00,31,17,14,0,0,0
2020-06-06 22:15,30,15,15,0,0,0
2020-06-06 22:30,18,12,6,0,0,0
2020-06-06 22:45,30,17,13,0,0,0
2020-06-06 23:00,29,21,8,0,0,0
2020-06-06 23:15,19,7,12,0,0,0
2020-06-06 23:30,20,14,6,0,0,0
2020-06-06 23:45,25,12,13,0,0,0
2020-06-07 00:00,24,9,15,0,0,0
2020-06-07 00:15,18,6,12,0,0,0
2020-06-07 00:30,17,8,9,0,0,0
2020-06-07 00:45,16,8,8,0,0,0
2020-06-07 01:00,25,12,13,0,0,0
2020-06-07 01:15,24,19,5,0,0,0
2020-06-07 01:30,25,12,13,0,0,0
2020-06-07 01:45,10,4,6,0,0,0
2020-06-07 02:00,11,7,4,0,0,0
2020-06-07 02:15,18,8,10,0,0,0
2020-06-07 02:30,14,2,12,0,0,0
2020-06-07 02:45,10,5,5,0,0,0
2020-06-07 03:00,6,4,2,0,0,0
2020-06-07 03:15,9,7,2,0,0,0
2020-06-07 03:30,6,1,5,0,0,0
2020-06-07 03:45,2,1,1,0,0,0
2020-06-07 04:00,4,0,4,0,0,0
2020-06-07 04:15,4,3,1,0,0,0
2020-06-07 04:30,0,0,0,0,0,0
2020-06-07 04:45,3,2,1,0,0,0
2020-06-07 05:00,2,1,1,0,0,0
2020-06-07 05:15,2,2,0,0,0,0
2020-06-07 05:30,8,4,4,0,0,0
2020-06-07 05:45,5,3,2,0,0,0
2020-06-07 06:00,3,2,1,0,0,0
2020-06-07 06:15,9,6,3,0,0,0
2020-06-07 06:30,4,2,2,0,0,0
2020-06-07 06:45,4,4,0,0,0,0
2020-06-07 07:00,3,0,3,0,0,0
2020-06-07 07:15,4,1,3,0,0,0
2020-06-07 07:30,12,11,1,0,0,0
2020-06-07 07:45,8,5,3,0,0,0
2020-06-07 08:00,9,3,6,0,0,0
2020-06-07 08:15,9,6,3,0,0,0
2020-06-07 08:30,19,13,6,0,0,0
2020-06-07 08:45,32,22,10,0,0,0
2020-06-07 09:00,7,3,4,0,0,0
2020-06-07 09:15,13,10,3,0,0,0
2020-06-07 09:30,32,23,9,0,0,0
2020-06-07 09:45,37,24,13,0,0,0
2020-06-07 10:00,29,20,9,0,0,0
2020-06-07 10:15,24,16,8,0,0,0
2020-06-07 10:30,31,19,12,0,0,0
2020-06-07 10:45,29,19,10,0,0,0
2020-06-07 11:00,49,31,18,0,0,0
2020-06-07 11:15,36,21,15,0,0,0
2020-06-07 11:30,42,26,16,0,0,0
2020-06-07 11:45,46,27,19,0,0,0
2020-06-07 12:00,22,13,9,0,0,0
2020-06-07 12:15,41,19,22,0,0,0
2020-06-07 12:30,21,14,7,0,0,0
2020-06-07 12:45,50,23,27,0,0,0
2020-06-07 13:00,37,24,13,0,0,0
2020-06-07 13:15,35,24,11,0,0,0
2020-06-07 13:30,44,22,22,0,0,0
2020-06-07 13:45,50,27,23,0,0,0
2020-06-07 14:00,73,41,32,0,0,0
2020-06-07 14:15,47,30,17,0,0,0
2020-06-07 14:30,78,49,29,0,0,0
2020-06-07 14:45,69,36,33,0,0,0
2020-06-07 15:00,41,24,17,0,0,0
2020-06-07 15:15,64,35,29,0,0,0
2020-06-07 15:30,79,52,27,0,0,0
2020-06-07 15:45,78,45,33,0,0,0
2020-06-07 16:00,75,46,29,0,0,0
2020-06-07 16:15,52,23,29,0,0,0
2020-06-07 16:30,58,32,26,0,0,0
2020-06-07 16:45,77,39,38,0,0,0
2020-06-07 17:00,72,39,33,0,0,0
2020-06-07 17:15,82,51,31,0,0,0
2020-06-07 17:30,60,34,26,0,0,0
2020-06-07 17:45,81,53,28,0,0,0
2020-06-07 18:00,59,33,26,0,0,0
2020-06-07 18:15,50,34,16,0,0,0
2020-06-07 18:30,46,27,19,0,0,0
2020-06-07 18:45,64,37,27,0,0,0
2020-06-07 19:00,56,26,30,0,0,0
2020-06-07 19:15,51,28,23,0,0,0
2020-06-07 19:30,55,24,31,0,0,0
2020-06-07 19:45,60,36,24,0,0,0
2020-06-07 20:00,39,20,19,0,0,0
2020-06-07 20:15,29,12,17,0,0,0
2020-06-07 20:30,38,19,19,0,0,0
2020-06-07 20:45,30,20,10,0,0,0
2020-06-07 21:00,31,17,14,0,0,0
2020-06-07 21:15,19,9,10,0,0,0
2020-06-07 21:30,14,4,10,0,0,0
2020-06-07 21:45,27,14,13,0,0,0
2020-06-07 22:00,25,19,6,0,0,0
2020-06-07 22:15,18,10,8,0,0,0
2020-06-07 22:30,35,23,12,0,0,0
2020-06-07 22:45,12,3,9,0,0,0
2020-06-07 23:00,11,5,6,0,0,0
2020-06-07 23:15,8,6,2,0,0,0
2020-06-07 23:30,13,9,4,0,0,0
2020-06-07 23:45,10,2,8,0,0,0
2020-06-08 00:00,14,6,8,0,0,0
2020-06-08 00:15,7,5,2,0,0,0
2020-06-08 00:30,6,2,4,0,0,0
2020-06-08 00:45,3,1,2,0,0,0
2020-06-08 01:00,1,1,0,0,0,0
2020-06-08 01:15,0,0,0,0,0,0
2020-06-08 01:30,1,0,1,0,0,0
2020-06-08 01:45,5,4,1,0,0,0
2020-06-08 02:00,1,0,1,0,0,0
2020-06-08 02:15,0,0,0,0,0,0
2020-06-08 02:30,2,2,0,0,0,0
2020-06-08 02:45,0,0,0,0,0,0
2020-06-08 03:00,0,0,0,0,0,0
2020-06-08 03:15,1,0,1,0,0,0
2020-06-08 03:30,1,1,0,0,0,0
2020-06-08 03:45,1,0,1,0,0,0
2020-06-08 04:00,0,0,0,0,0,0
2020-06-08 04:15,0,0,0,0,0,0
2020-06-08 04:30,0,0,0,0,0,0
2020-06-08 04:45,3,3,0,0,0,0
2020-06-08 05:00,3,2,1,0,0,0
2020-06-08 05:15,1,1,0,0,0,0
2020-06-08 05:30,16,7,9,0,0,0
2020-06-08 05:45,21,11,10,0,0,0
2020-06-08 06:00,20,12,8,0,0,0
2020-06-08 06:15,33,17,16,0,0,0
2020-06-08 06:30,48,37,11,0,0,0
2020-06-08 06:45,77,59,18,0,0,0
2020-06-08 07:00,82,58,24,0,0,0
2020-06-08 07:15,100,69,31,0,0,0
2020-06-08 07:30,140,103,37,0,0,0
2020-06-08 07:45,153,97,56,0,0,0
2020-06-08 08:00,129,93,36,0,0,0
2020-06-08 08:15,120,86,34,0,0,0
2020-06-08 08:30,127,100,27,0,0,0
2020-06-08 08:45,102,74,28,0,0,0
2020-06-08 09:00,94,69,25,0,0,0
2020-06-08 09:15,105,71,34,0,0,0
2020-06-08 09:30,85,63,22,0,0,0
2020-06-08 09:45,108,73,35,0,0,0
2020-06-08 10:00,90,68,22,0,0,0
2020-06-08 10:15,102,73,29,0,0,0
2020-06-08 10:30,117,82,35,0,0,0
2020-06-08 10:45,126,87,39,0,0,0
2020-06-08 11:00,100,75,25,0,0,0
2020-06-08 11:15,104,60,44,0,0,0
2020-06-08 11:30,89,63,26,0,0,0
2020-06-08 11:45,133,76,57,0,0,0
2020-06-08 12:00,109,60,49,0,0,0
2020-06-08 12:15,50,25,25,0,0,0
2020-06-08 12:30,68,24,44,0,0,0
2020-06-08 12:45,108,59,49,0,0,0
2020-06-08 13:00,99,33,66,0,0,0
2020-06-08 13:15,101,56,45,0,0,0
2020-06-08 13:30,90,52,38,0,0,0
2020-06-08 13:45,123,71,52,0,0,0
2020-06-08 14:00,111,60,51,0,0,0
2020-06-08 14:15,118,78,40,0,0,0
2020-06-08 14:30,105,63,42,0,0,0
2020-06-08 14:45,136,91,45,0,0,0
2020-06-08 15:00,90,45,45,0,0,0
2020-06-08 15:15,133,71,62,0,0,0
2020-06-08 15:30,147,93,54,0,0,0
2020-06-08 15:45,183,109,74,0,0,0
2020-06-08 16:00,156,92,64,0,0,0
2020-06-08 16:15,166,97,69,0,0,0
2020-06-08 16:30,175,102,73,0,0,0
2020-06-08 16:45,170,101,69,0,0,0
2020-06-08 17:00,156,82,74,0,0,0
2020-06-08 17:15,162,88,74,0,0,0
2020-06-08 17:30,167,79,88,0,0,0
2020-06-08 17:45,157,74,83,0,0,0
2020-06-08 18:00,148,62,86,0,0,0
2020-06-08 18:15,135,73,62,0,0,0
2020-06-08 18:30,101,48,53,0,0,0
2020-06-08 18:45,117,56,61,0,0,0
2020-06-08 19:00,91,38,53,0,0,0
2020-06-08 19:15,91,43,48,0,0,0
2020-06-08 19:30,59,32,27,0,0,0
2020-06-08 19:45,82,41,41,0,0,0
2020-06-08 20:00,65,31,34,0,0,0
2020-06-08 20:15,65,30,35,0,0,0
2020-06-08 20:30,44,14,30,0,0,0
2020-06-08 20:45,28,13,15,0,0,0
2020-06-08 21:00,41,18,23,0,0,0
2020-06-08 21:15,31,11,20,0,0,0
2020-06-08 21:30,25,12,13,0,0,0
2020-06-08 21:45,36,19,17,0,0,0
2020-06-08 22:00,26,10,16,0,0,0
2020-06-08 22:15,21,10,11,0,0,0
2020-06-08 22:30,26,19,7,0,0,0
2020-06-08 22:45,22,10,12,0,0,0
2020-06-08 23:00,29,17,12,0,0,0
2020-06-08 23:15,21,9,12,0,0,0
2020-06-08 23:30,14,5,9,0,0,0
2020-06-08 23:45,11,7,4,0,0,0
2020-06-09 00:00,7,2,5,0,0,0
2020-06-09 00:15,5,3,2,0,0,0
2020-06-09 00:30,7,2,5,0,0,0
2020-06-09 00:45,8,2,6,0,0,0
2020-06-09 01:00,4,2,2,0,0,0
2020-06-09 01:15,8,1,7,0,0,0
2020-06-09 01:30,4,2,2,0,0,0
2020-06-09 01:45,0,0,0,0,0,0
2020-06-09 02:00,6,4,2,0,0,0
2020-06-09 02:15,2,0,2,0,0,0
2020-06-09 02:30,2,2,0,0,0,0
2020-06-09 02:45,2,1,1,0,0,0
2020-06-09 03:00,0,0,0,0,0,0
2020-06-09 03:15,2,0,2,0,0,0
2020-06-09 03:30,0,0,0,0,0,0
2020-06-09 03:45,0,0,0,0,0,0
2020-06-09 04:00,0,0,0,0,0,0
2020-06-09 04:15,0,0,0,0,0,0
2020-06-09 04:30,1,0,1,0,0,0
2020-06-09 04:45,3,1,2,0,0,0
2020-06-09 05:00,0,0,0,0,0,0
2020-06-09 05:15,3,1,2,0,0,0
2020-06-09 05:30,13,6,7,0,0,0
2020-06-09 05:45,21,9,12,0,0,0
2020-06-09 06:00,27,15,12,0,0,0
2020-06-09 06:15,26,18,8,0,0,0
2020-06-09 06:30,42,29,13,0,0,0
2020-06-09 06:45,62,45,17,0,0,0
2020-06-09 07:00,87,67,20,0,0,0
2020-06-09 07:15,108,74,34,0,0,0
2020-06-09 07:30,156,120,36,0,0,0
2020-06-09 07:45,152,105,47,0,0,0
2020-06-09 08:00,141,98,43,0,0,0
2020-06-09 08:15,124,88,36,0,0,0
2020-06-09 08:30,121,90,31,0,0,0
2020-06-09 08:45,140,89,51,0,0,0
2020-06-09 09:00,106,75,31,0,0,0
2020-06-09 09:15,115,82,33,0,0,0
2020-06-09 09:30,96,71,25,0,0,0
2020-06-09 09:45,98,70,28,0,0,0
2020-06-09 10:00,75,51,24,0,0,0
2020-06-09 10:15,103,74,29,0,0,0
2020-06-09 10:30,100,75,25,0,0,0
2020-06-09 10:45,109,79,30,0,0,0
2020-06-09 11:00,119,77,42,0,0,0
2020-06-09 11:15,125,76,49,0,0,0
2020-06-09 11:30,99,66,33,0,0,0
2020-06-09 11:45,125,82,43,0,0,0
2020-06-09 12:00,115,68,47,0,0,0
2020-06-09 12:15,126,71,55,0,0,0
2020-06-09 12:30,140,87,53,0,0,0
2020-06-09 12:45,127,72,55,0,0,0
2020-06-09 13:00,153,63,90,0,0,0
2020-06-09 13:15,116,60,56,0,0,0
2020-06-09 13:30,104,56,48,0,0,0
2020-06-09 13:45,155,89,66,0,0,0
2020-06-09 14:00,129,69,60,0,0,0
2020-06-09 14:15,136,85,51,0,0,0
2020-06-09 14:30,145,90,55,0,0,0
2020-06-09 14:45,134,92,42,0,0,0
2020-06-09 15:00,139,78,61,0,0,0
2020-06-09 15:15,149,75,74,0,0,0
2020-06-09 15:30,162,92,70,0,0,0
2020-06-09 15:45,171,105,66,0,0,0
2020-06-09 16:00,176,91,85,0,0,0
2020-06-09 16:15,194,109,85,0,0,0
2020-06-09 16:30,146,70,76,0,0,0
2020-06-09 16:45,186,86,100,0,0,0
2020-06-09 17:00,192,109,83,0,0,0
2020-06-09 17:15,176,97,79,0,0,0
2020-06-09 17:30,183,92,91,0,0,0
2020-06-09 17:45,143,72,71,0,0,0
2020-06-09 18:00,159,74,85,0,0,0
2020-06-09 18:15,176,76,100,0,0,0
2020-06-09 18:30,125,65,60,0,0,0
2020-06-09 18:45,155,91,64,0,0,0
2020-06-09 19:00,96,41,55,0,0,0
2020-06-09 19:15,113,61,52,0,0,0
2020-06-09 19:30,99,58,41,0,0,0
2020-06-09 19:45,88,39,49,0,0,0
2020-06-09 20:00,79,27,52,0,0,0
2020-06-09 20:15,73,36,37,0,0,0
2020-06-09 20:30,53,26,27,0,0,0
2020-06-09 20:45,57,29,28,0,0,0
2020-06-09 21:00,44,22,22,0,0,0
2020-06-09 21:15,58,33,25,0,0,0
2020-06-09 21:30,33,16,17,0,0,0
2020-06-09 21:45,41,23,18,0,0,0
2020-06-09 22:00,51,23,28,0,0,0
2020-06-09 22:15,31,20,11,0,0,0
2020-06-09 22:30,33,16,17,0,0,0
2020-06-09 22:45,19,11,8,0,0,0
2020-06-09 23:00,30,19,11,0,0,0
2020-06-09 23:15,16,5,11,0,0,0
2020-06-09 23:30,11,7,4,0,0,0
2020-06-09 23:45,20,15,5,0,0,0
2020-06-10 00:00,18,4,14,0,0,0
2020-06-10 00:15,15,8,7,0,0,0
2020-06-10 00:30,10,7,3,0,0,0
2020-06-10 00:45,7,4,3,0,0,0
2020-06-10 01:00,2,1,1,0,0,0
2020-06-10 01:15,6,6,0,0,0,0
2020-06-10 01:30,4,0,4,0,0,0
2020-06-10 01:45,3,2,1,0,0,0
2020-06-10 02:00,5,5,0,0,0,0
2020-06-10 02:15,2,0,2,0,0,0
2020-06-10 02:30,3,0,3,0,0,0
2020-06-10 02:45,0,0,0,0,0,0
2020-06-10 03:00,0,0,0,0,0,0
2020-06-10 03:15,1,0,1,0,0,0
2020-06-10 03:30,0,0,0,0,0,0
2020-06-10 03:45,0,0,0,0,0,0
2020-06-10 04:00,0,0,0,0,0,0
2020-06-10 04:15,1,0,1,0,0,0
2020-06-10 04:30,0,0,0,0,0,0
2020-06-10 04:45,2,1,1,0,0,0
2020-06-10 05:00,1,0,1,0,0,0
2020-06-10 05:15,4,2,2,0,0,0
2020-06-10 05:30,16,10,6,0,0,0
2020-06-10 05:45,19,9,10,0,0,0
2020-06-10 06:00,23,13,10,0,0,0
2020-06-10 06:15,22,13,9,0,0,0
2020-06-10 06:30,52,33,19,0,0,0
2020-06-10 06:45,81,61,20,0,0,0
2020-06-10 07:00,101,69,32,0,0,0
2020-06-10 07:15,127,81,46,0,0,0
2020-06-10 07:30,193,141,52,0,0,0
2020-06-10 07:45,162,114,48,0,0,0
2020-06-10 08:00,131,101,30,0,0,0
2020-06-10 08:15,139,93,46,0,0,0
2020-06-10 08:30,127,100,27,0,0,0
2020-06-10 08:45,154,115,39,0,0,0
2020-06-10 09:00,100,76,24,0,0,0
2020-06-10 09:15,112,80,32,0,0,0
2020-06-10 09:30,123,96,27,0,0,0
2020-06-10 09:45,118,80,38,0,0,0
2020-06-10 10:00,125,99,26,0,0,0
2020-06-10 10:15,132,90,42,0,0,0
2020-06-10 10:30,139,83,56,0,0,0
2020-06-10 10:45,132,95,37,0,0,0
2020-06-10 11:00,137,92,45,0,0,0
2020-06-10 11:15,114,79,35,0,0,0
2020-06-10 11:30,166,107,59,0,0,0
2020-06-10 11:45,139,93,46,0,0,0
2020-06-10 12:00,136,68,68,0,0,0
2020-06-10 12:15,157,92,65,0,0,0
2020-06-10 12:30,133,72,61,0,0,0
2020-06-10 12:45,159,96,63,0,0,0
2020-06-10 13:00,142,75,67,0,0,0
2020-06-10 13:15,178,96,82,0,0,0
2020-06-10 13:30,142,77,65,0,0,0
2020-06-10 13:45,154,88,66,0,0,0
2020-06-10 14:00,149,72,77,0,0,0
2020-06-10 14:15,143,63,80,0,0,0
2020-06-10 14:30,151,70,81,0,0,0
2020-06-10 14:45,157,103,54,0,0,0
2020-06-10 15:00,138,70,68,0,0,0
2020-06-10 15:15,148,74,74,0,0,0
2020-06-10 15:30,153,72,81,0,0,0
2020-06-10 15:45,177,95,82,0,0,0
2020-06-10 16:00,155,90,65,0,0,0
2020-06-10 16:15,176,101,75,0,0,0
2020-06-10 16:30,150,64,86,0,0,0
2020-06-10 16:45,196,88,108,0,0,0
2020-06-10 17:00,168,82,86,0,0,0
2020-06-10 17:15,162,63,99,0,0,0
2020-06-10 17:30,150,71,79,0,0,0
2020-06-10 17:45,179,95,84,0,0,0
2020-06-10 18:00,145,48,97,0,0,0
2020-06-10 18:15,140,71,69,0,0,0
2020-06-10 18:30,125,68,57,0,0,0
2020-06-10 18:45,153,74,79,0,0,0
2020-06-10 19:00,136,65,71,0,0,0
2020-06-10 19:15,85,40,45,0,0,0
2020-06-10 19:30,79,40,39,0,0,0
2020-06-10 19:45,94,45,49,0,0,0
2020-06-10 20:00,71,36,35,0,0,0
2020-06-10 20:15,91,50,41,0,0,0
2020-06-10 20:30,46,20,26,0,0,0
2020-06-10 20:45,60,31,29,0,0,0
2020-06-10 21:00,47,29,18,0,0,0
2020-06-10 21:15,51,29,22,0,0,0
2020-06-10 21:30,48,18,30,0,0,0
2020-06-10 21:45,36,16,20,0,0,0
2020-06-10 22:00,26,12,14,0,0,0
2020-06-10 22:15,44,20,24,0,0,0
2020-06-10 22:30,31,19,12,0,0,0
2020-06-10 22:45,34,16,18,0,0,0
2020-06-10 23:00,53,28,25,0,0,0
2020-06-10 23:15,31,12,19,0,0,0
2020-06-10 23:30,31,18,13,0,0,0
2020-06-10 23:45,34,10,24,0,0,0
2020-06-11 00:00,16,13,3,0,0,0
2020-06-11 00:15,23,9,14,0,0,0
2020-06-11 00:30,11,5,6,0,0,0
2020-06-11 00:45,31,10,21,0,0,0
2020-06-11 01:00,21,8,13,0,0,0
2020-06-11 01:15,24,9,15,0,0,0
2020-06-11 01:30,19,6,13,0,0,0
2020-06-11 01:45,17,8,9,0,0,0
2020-06-11 02:00,19,10,9,0,0,0
2020-06-11 02:15,10,5,5,0,0,0
2020-06-11 02:30,10,5,5,0,0,0
2020-06-11 02:45,7,1,6,0,0,0
2020-06-11 03:00,6,2,4,0,0,0
2020-06-11 03:15,6,1,5,0,0,0
2020-06-11 03:30,9,5,4,0,0,0
2020-06-11 03:45,7,2,5,0,0,0
2020-06-11 04:00,2,1,1,0,0,0
2020-06-11 04:15,1,0,1,0,0,0
2020-06-11 04:30,7,3,4,0,0,0
2020-06-11 04:45,4,2,2,0,0,0
2020-06-11 05:00,0,0,0,0,0,0
2020-06-11 05:15,4,1,3,0,0,0
2020-06-11 05:30,8,6,2,0,0,0
2020-06-11 05:45,5,1,4,0,0,0
2020-06-11 06:00,2,0,2,0,0,0
2020-06-11 06:15,9,6,3,0,0,0
2020-06-11 06:30,3,2,1,0,0,0
2020-06-11 06:45,9,7,2,0,0,0
2020-06-11 07:00,2,1,1,0,0,0
2020-06-11 07:15,8,6,2,0,0,0
2020-06-11 07:30,10,8,2,0,0,0
2020-06-11 07:45,11,8,3,0,0,0
2020-06-11 08:00,5,4,1,0,0,0
2020-06-11 08:15,4,3,1,0,0,0
2020-06-11 08:30,13,9,4,0,0,0
2020-06-11 08:45,15,8,7,0,0,0
2020-06-11 09:00,21,7,14,0,0,0
2020-06-11 09:15,32,15,17,0,0,0
2020-06-11 09:30,20,10,10,0,0,0
2020-06-11 09:45,39,26,13,0,0,0
2020-06-11 10:00,32,15,17,0,0,0
2020-06-11 10:15,31,17,14,0,0,0
2020-06-11 10:30,36,27,9,0,0,0
2020-06-11 10:45,58,31,27,0,0,0
2020-06-11 11:00,55,22,33,0,0,0
2020-06-11 11:15,38,20,18,0,0,0
2020-06-11 11:30,67,45,22,0,0,0
2020-06-11 11:45,58,30,28,0,0,0
2020-06-11 12:00,45,18,27,0,0,0
2020-06-11 12:15,61,40,21,0,0,0
2020-06-11 12:30,56,29,27,0,0,0
2020-06-11 12:45,52,41,11,0,0,0
2020-06-11 13:00,62,41,21,0,0,0
2020-06-11 13:15,47,32,15,0,0,0
2020-06-11 13:30,60,38,22,0,0,0
2020-06-11 13:45,85,59,26,0,0,0
2020-06-11 14:00,90,46,44,0,0,0
2020-06-11 14:15,97,54,43,0,0,0
2020-06-11 14:30,86,53,33,0,0,0
2020-06-11 14:45,107,68,39,0,0,0
2020-06-11 15:00,96,56,40,0,0,0
2020-06-11 15:15,101,65,36,0,0,0
2020-06-11 15:30,79,51,28,0,0,0
2020-06-11 15:45,113,63,50,0,0,0
2020-06-11 16:00,93,52,41,0,0,0
2020-06-11 16:15,93,65,28,0,0,0
2020-06-11 16:30,102,63,39,0,0,0
2020-06-11 16:45,111,68,43,0,0,0
2020-06-11 17:00,83,48,35,0,0,0
2020-06-11 17:15,79,44,35,0,0,0
2020-06-11 17:30,138,96,42,0,0,0
2020-06-11 17:45,129,89,40,0,0,0
2020-06-11 18:00,95,66,29,0,0,0
2020-06-11 18:15,90,50,40,0,0,0
2020-06-11 18:30,89,55,34,0,0,0
2020-06-11 18:45,85,41,44,0,0,0
2020-06-11 19:00,77,47,30,0,0,0
2020-06-11 19:15,65,41,24,0,0,0
2020-06-11 19:30,58,43,15,0,0,0
2020-06-11 19:45,68,42,26,0,0,0
2020-06-11 20:00,78,41,37,0,0,0
2020-06-11 20:15,50,22,28,0,0,0
2020-06-11 20:30,63,40,23,0,0,0
2020-06-11 20:45,25,20,5,0,0,0
2020-06-11 21:00,36,24,12,0,0,0
2020-06-11 21:15,34,14,20,0,0,0
2020-06-11 21:30,29,22,7,0,0,0
2020-06-11 21:45,39,23,16,0,0,0
2020-06-11 22:00,35,20,15,0,0,0
2020-06-11 22:15,42,32,10,0,0,0
2020-06-11 22:30,18,8,10,0,0,0
2020-06-11 22:45,19,15,4,0,0,0
2020-06-11 23:00,33,17,16,0,0,0
2020-06-11 23:15,20,11,9,0,0,0
2020-06-11 23:30,20,10,10,0,0,0
2020-06-11 23:45,17,5,12,0,0,0
2020-06-12 00:00,9,7,2,0,0,0
2020-06-12 00:15,10,8,2,0,0,0
2020-06-12 00:30,11,8,3,0,0,0
2020-06-12 00:45,13,6,7,0,0,0
2020-06-12 01:00,19,7,12,0,0,0
2020-06-12 01:15,5,2,3,0,0,0
2020-06-12 01:30,4,3,1,0,0,0
2020-06-12 01:45,8,2,6,0,0,0
2020-06-12 02:00,1,1,0,0,0,0
2020-06-12 02:15,3,2,1,0,0,0
2020-06-12 02:30,4,2,2,0,0,0
2020-06-12 02:45,0,0,0,0,0,0
2020-06-12 03:00,2,0,2,0,0,0
2020-06-12 03:15,1,1,0,0,0,0
2020-06-12 03:30,2,0,2,0,0,0
2020-06-12 03:45,4,3,1,0,0,0
2020-06-12 04:00,0,0,0,0,0,0
2020-06-12 04:15,0,0,0,0,0,0
2020-06-12 04:30,0,0,0,0,0,0
2020-06-12 04:45,2,2,0,0,0,0
2020-06-12 05:00,4,3,1,0,0,0
2020-06-12 05:15,3,2,1,0,0,0
2020-06-12 05:30,12,9,3,0,0,0
2020-06-12 05:45,19,6,13,0,0,0
2020-06-12 06:00,12,6,6,0,0,0
2020-06-12 06:15,20,14,6,0,0,0
2020-06-12 06:30,26,17,9,0,0,0
2020-06-12 06:45,38,27,11,0,0,0
2020-06-12 07:00,41,28,13,0,0,0
2020-06-12 07:15,86,66,20,0,0,0
2020-06-12 07:30,125,84,41,0,0,0
2020-06-12 07:45,130,92,38,0,0,0
2020-06-12 08:00,87,66,21,0,0,0
2020-06-12 08:15,81,62,19,0,0,0
2020-06-12 08:30,104,75,29,0,0,0
2020-06-12 08:45,101,75,26,0,0,0
2020-06-12 09:00,88,59,29,0,0,0
2020-06-12 09:15,95,69,26,0,0,0
2020-06-12 09:30,99,73,26,0,0,0
2020-06-12 09:45,143,107,36,0,0,0
2020-06-12 10:00,125,91,34,0,0,0
2020-06-12 10:15,121,84,37,0,0,0
2020-06-12 10:30,140,89,51,0,0,0
2020-06-12 10:45,148,100,48,0,0,0
2020-06-12 11:00,118,75,43,0,0,0
2020-06-12 11:15,151,90,61,0,0,0
2020-06-12 11:30,151,93,58,0,0,0
2020-06-12 11:45,167,104,63,0,0,0
2020-06-12 12:00,166,83,83,0,0,0
2020-06-12 12:15,164,95,69,0,0,0
2020-06-12 12:30,183,86,97,0,0,0
2020-06-12 12:45,188,102,86,0,0,0
2020-06-12 13:00,146,85,61,0,0,0
2020-06-12 13:15,195,100,95,0,0,0
2020-06-12 13:30,171,88,83,0,0,0
2020-06-12 13:45,149,73,76,0,0,0
2020-06-12 14:00,171,88,83,0,0,0
2020-06-12 14:15,159,89,70,0,0,0
2020-06-12 14:30,157,98,59,0,0,0
2020-06-12 14:45,188,98,90,0,0,0
2020-06-12 15:00,163,93,70,0,0,0
2020-06-12 15:15,181,90,91,0,0,0
2020-06-12 15:30,159,82,77,0,0,0
2020-06-12 15:45,163,96,67,0,0,0
2020-06-12 16:00,174,93,81,0,0,0
2020-06-12 16:15,175,97,78,0,0,0
2020-06-12 16:30,154,75,79,0,0,0
2020-06-12 16:45,167,100,67,0,0,0
2020-06-12 17:00,168,88,80,0,0,0
2020-06-12 17:15,175,102,73,0,0,0
2020-06-12 17:30,167,97,70,0,0,0
2020-06-12 17:45,169,99,70,0,0,0
2020-06-12 18:00,174,104,70,0,0,0
2020-06-12 18:15,175,88,87,0,0,0
2020-06-12 18:30,150,86,64,0,0,0
2020-06-12 18:45,168,105,63,0,0,0
2020-06-12 19:00,136,69,67,0,0,0
2020-06-12 19:15,121,55,66,0,0,0
2020-06-12 19:30,121,66,55,0,0,0
2020-06-12 19:45,119,69,50,0,0,0
2020-06-12 20:00,96,51,45,0,0,0
2020-06-12 20:15,64,34,30,0,0,0
2020-06-12 20:30,62,31,31,0,0,0
2020-06-12 20:45,64,38,26,0,0,0
2020-06-12 21:00,72,47,25,0,0,0
2020-06-12 21:15,41,33,8,0,0,0
2020-06-12 21:30,54,31,23,0,0,0
2020-06-12 21:45,53,28,25,0,0,0
2020-06-12 22:00,51,30,21,0,0,0
2020-06-12 22:15,68,45,23,0,0,0
2020-06-12 22:30,39,27,12,0,0,0
2020-06-12 22:45,55,39,16,0,0,0
2020-06-12 23:00,40,17,23,0,0,0
2020-06-12 23:15,54,31,23,0,0,0
2020-06-12 23:30,33,20,13,0,0,0
2020-06-12 23:45,39,19,20,0,0,0
2020-06-13 00:00,39,20,19,0,0,0
2020-06-13 00:15,39,30,9,0,0,0
2020-06-13 00:30,39,24,15,0,0,0
2020-06-13 00:45,36,25,11,0,0,0
2020-06-13 01:00,23,12,11,0,0,0
2020-06-13 01:15,23,14,9,0,0,0
2020-06-13 01:30,12,4,8,0,0,0
2020-06-13 01:45,13,6,7,0,0,0
2020-06-13 02:00,19,11,8,0,0,0
2020-06-13 02:15,17,12,5,0,0,0
2020-06-13 02:30,14,4,10,0,0,0
2020-06-13 02:45,13,6,7,0,0,0
2020-06-13 03:00,4,3,1,0,0,0
2020-06-13 03:15,3,1,2,0,0,0
2020-06-13 03:30,7,1,6,0,0,0
2020-06-13 03:45,7,3,4,0,0,0
2020-06-13 04:00,5,0,5,0,0,0
2020-06-13 04:15,6,3,3,0,0,0
2020-06-13 04:30,3,3,0,0,0,0
2020-06-13 04:45,2,1,1,0,0,0
2020-06-13 05:00,3,3,0,0,0,0
2020-06-13 05:15,0,0,0,0,0,0
2020-06-13 05:30,6,3,3,0,0,0
2020-06-13 05:45,16,9,7,0,0,0
2020-06-13 06:00,5,3,2,0,0,0
2020-06-13 06:15,4,3,1,0,0,0
2020-06-13 06:30,12,6,6,0,0,0
2020-06-13 06:45,19,16,3,0,0,0
2020-06-13 07:00,17,13,4,0,0,0
2020-06-13 07:15,22,14,8,0,0,0
2020-06-13 07:30,32,27,5,0,0,0
2020-06-13 07:45,29,22,7,0,0,0
2020-06-13 08:00,38,24,14,0,0,0
2020-06-13 08:15,42,28,14,0,0,0
2020-06-13 08:30,41,32,9,0,0,0
2020-06-13 08:45,71,57,14,0,0,0
2020-06-13 09:00,59,42,17,0,0,0
2020-06-13 09:15,92,66,26,0,0,0
2020-06-13 09:30,97,72,25,0,0,0
2020-06-13 09:45,137,105,32,0,0,0
2020-06-13 10:00,152,104,48,0,0,0
2020-06-13 10:15,157,113,44,0,0,0
2020-06-13 10:30,155,116,39,0,0,0
2020-06-13 10:45,152,117,35,0,0,0
2020-06-13 11:00,140,85,55,0,0,0
2020-06-13 11:15,153,104,49,0,0,0
2020-06-13 11:30,188,124,64,0,0,0
2020-06-13 11:45,183,120,63,0,0,0
2020-06-13 12:00,140,77,63,0,0,0
2020-06-13 12:15,179,92,87,0,0,0
2020-06-13 12:30,178,90,88,0,0,0
2020-06-13 12:45,208,102,106,0,0,0
2020-06-13 13:00,148,79,69,0,0,0
2020-06-13 13:15,182,106,76,0,0,0
2020-06-13 13:30,158,94,64,0,0,0
2020-06-13 13:45,176,96,80,0,0,0
2020-06-13 14:00,127,65,62,0,0,0
2020-06-13 14:15,118,57,61,0,0,0
2020-06-13 14:30,143,54,89,0,0,0
2020-06-13 14:45,169,89,80,0,0,0
2020-06-13 15:00,141,62,79,0,0,0
2020-06-13 15:15,152,81,71,0,0,0
2020-06-13 15:30,99,46,53,0,0,0
2020-06-13 15:45,135,80,55,0,0,0
2020-06-13 16:00,130,71,59,0,0,0
2020-06-13 16:15,124,74,50,0,0,0
2020-06-13 16:30,128,54,74,0,0,0
2020-06-13 16:45,93,51,42,0,0,0
2020-06-13 17:00,100,50,50,0,0,0
2020-06-13 17:15,110,66,44,0,0,0
2020-06-13 17:30,98,49,49,0,0,0
2020-06-13 17:45,110,65,45,0,0,0
2020-06-13 18:00,98,49,49,0,0,0
2020-06-13 18:15,94,48,46,0,0,0
2020-06-13 18:30,76,42,34,0,0,0
2020-06-13 18:45,84,45,39,0,0,0
2020-06-13 19:00,73,35,38,0,0,0
2020-06-13 19:15,69,37,32,0,0,0
2020-06-13 19:30,64,39,25,0,0,0
2020-06-13 19:45,66,41,25,0,0,0
2020-06-13 20:00,79,45,34,0,0,0
2020-06-13 20:15,58,37,21,0,0,0
2020-06-13 20:30,73,38,35,0,0,0
2020-06-13 20:45,60,31,29,0,0,0
2020-06-13 21:00,41,18,23,0,0,0
2020-06-13 21:15,43,26,17,0,0,0
2020-06-13 21:30,43,27,16,0,0,0
2020-06-13 21:45,27,15,12,0,0,0
2020-06-13 22:00,20,14,6,0,0,0
2020-06-13 22:15,34,19,15,0,0,0
2020-06-13 22:30,25,10,15,0,0,0
2020-06-13 22:45,26,19,7,0,0,0
2020-06-13 23:00,20,9,11,0,0,0
2020-06-13 23:15,33,24,9,0,0,0
2020-06-13 23:30,37,18,19,0,0,0
2020-06-13 23:45,23,10,13,0,0,0
2020-06-14 00:00,21,11,10,0,0,0
2020-06-14 00:15,24,19,5,0,0,0
2020-06-14 00:30,22,13,9,0,0,0
2020-06-14 00:45,25,13,12,0,0,0
2020-06-14 01:00,15,11,4,0,0,0
2020-06-14 01:15,22,6,16,0,0,0
2020-06-14 01:30,10,3,7,0,0,0
2020-06-14 01:45,19,8,11,0,0,0
2020-06-14 02:00,22,12,10,0,0,0
2020-06-14 02:15,14,5,9,0,0,0
2020-06-14 02:30,8,6,2,0,0,0
2020-06-14 02:45,15,7,8,0,0,0
2020-06-14 03:00,4,2,2,0,0,0
2020-06-14 03:15,10,6,4,0,0,0
2020-06-14 03:30,4,1,3,0,0,0
2020-06-14 03:45,5,3,2,0,0,0
2020-06-14 04:00,4,2,2,0,0,0
2020-06-14 04:15,3,3,0,0,0,0
2020-06-14 04:30,3,1,2,0,0,0
2020-06-14 04:45,1,1,0,0,0,0
2020-06-14 05:00,0,0,0,0,0,0
2020-06-14 05:15,0,0,0,0,0,0
2020-06-14 05:30,7,3,4,0,0,0
2020-06-14 05:45,6,3,3,0,0,0
2020-06-14 06:00,2,1,1,0,0,0
2020-06-14 06:15,8,6,2,0,0,0
2020-06-14 06:30,5,2,3,0,0,0
2020-06-14 06:45,4,4,0,0,0,0
2020-06-14 07:00,3,2,1,0,0,0
2020-06-14 07:15,4,2,2,0,0,0
2020-06-14 07:30,7,3,4,0,0,0
2020-06-14 07:45,6,6,0,0,0,0
2020-06-14 08:00,13,8,5,0,0,0
2020-06-14 08:15,9,7,2,0,0,0
2020-06-14 08:30,9,5,4,0,0,0
2020-06-14 08:45,21,11,10,0,0,0
2020-06-14 09:00,21,15,6,0,0,0
2020-06-14 09:15,19,9,10,0,0,0
2020-06-14 09:30,25,14,11,0,0,0
2020-06-14 09:45,43,31,12,0,0,0
2020-06-14 10:00,33,18,15,0,0,0
2020-06-14 10:15,34,25,9,0,0,0
2020-06-14 10:30,30,22,8,0,0,0
2020-06-14 10:45,37,19,18,0,0,0
2020-06-14 11:00,33,17,16,0,0,0
2020-06-14 11:15,37,22,15,0,0,0
2020-06-14 11:30,30,22,8,0,0,0
2020-06-14 11:45,39,27,12,0,0,0
2020-06-14 12:00,44,31,13,0,0,0
2020-06-14 12:15,39,28,11,0,0,0
2020-06-14 12:30,61,29,32,0,0,0
2020-06-14 12:45,51,22,29,0,0,0
2020-06-14 13:00,57,34,23,0,0,0
2020-06-14 13:15,46,30,16,0,0,0
2020-06-14 13:30,54,24,30,0,0,0
2020-06-14 13:45,72,51,21,0,0,0
2020-06-14 14:00,65,36,29,0,0,0
2020-06-14 14:15,71,41,30,0,0,0
2020-06-14 14:30,54,33,21,0,0,0
2020-06-14 14:45,69,50,19,0,0,0
2020-06-14 15:00,65,44,21,0,0,0
2020-06-14 15:15,69,30,39,0,0,0
2020-06-14 15:30,66,41,25,0,0,0
2020-06-14 15:45,79,58,21,0,0,0
2020-06-14 16:00,53,32,21,0,0,0
2020-06-14 16:15,69,31,38,0,0,0
2020-06-14 16:30,69,31,38,0,0,0
2020-06-14 16:45,57,26,31,0,0,0
2020-06-14 17:00,42,24,18,0,0,0
2020-06-14 17:15,59,38,21,0,0,0
2020-06-14 17:30,49,26,23,0,0,0
2020-06-14 17:45,39,16,23,0,0,0
2020-06-14 18:00,29,15,14,0,0,0
2020-06-14 18:15,27,16,11,0,0,0
2020-06-14 18:30,18,8,10,0,0,0
2020-06-14 18:45,29,20,9,0,0,0
2020-06-14 19:00,23,10,13,0,0,0
2020-06-14 19:15,13,7,6,0,0,0
2020-06-14 19:30,17,12,5,0,0,0
2020-06-14 19:45,17,11,6,0,0,0
2020-06-14 20:00,16,7,9,0,0,0
2020-06-14 20:15,12,8,4,0,0,0
2020-06-14 20:30,8,3,5,0,0,0
2020-06-14 20:45,12,8,4,0,0,0
2020-06-14 21:00,10,6,4,0,0,0
2020-06-14 21:15,14,7,7,0,0,0
2020-06-14 21:30,6,2,4,0,0,0
2020-06-14 21:45,5,3,2,0,0,0
2020-06-14 22:00,9,3,6,0,0,0
2020-06-14 22:15,9,6,3,0,0,0
2020-06-14 22:30,6,4,2,0,0,0
2020-06-14 22:45,9,2,7,0,0,0
2020-06-14 23:00,7,2,5,0,0,0
2020-06-14 23:15,7,4,3,0,0,0
2020-06-14 23:30,7,4,3,0,0,0
2020-06-14 23:45,2,1,1,0,0,0
2020-06-15 00:00,3,1,2,0,0,0
2020-06-15 00:15,3,1,2,0,0,0
2020-06-15 00:30,5,1,4,0,0,0
2020-06-15 00:45,2,2,0,0,0,0
2020-06-15 01:00,3,2,1,0,0,0
2020-06-15 01:15,0,0,0,0,0,0
2020-06-15 01:30,2,1,1,0,0,0
2020-06-15 01:45,2,1,1,0,0,0
2020-06-15 02:00,0,0,0,0,0,0
2020-06-15 02:15,1,0,1,0,0,0
2020-06-15 02:30,0,0,0,0,0,0
2020-06-15 02:45,1,1,0,0,0,0
2020-06-15 03:00,1,0,1,0,0,0
2020-06-15 03:15,0,0,0,0,0,0
2020-06-15 03:30,0,0,0,0,0,0
2020-06-15 03:45,1,1,0,0,0,0
2020-06-15 04:00,0,0,0,0,0,0
2020-06-15 04:15,0,0,0,0,0,0
2020-06-15 04:30,0,0,0,0,0,0
2020-06-15 04:45,2,0,2,0,0,0
2020-06-15 05:00,2,1,1,0,0,0
2020-06-15 05:15,6,4,2,0,0,0
2020-06-15 05:30,11,5,6,0,0,0
2020-06-15 05:45,14,6,8,0,0,0
2020-06-15 06:00,19,10,9,0,0,0
2020-06-15 06:15,23,16,7,0,0,0
2020-06-15 06:30,34,22,12,0,0,0
2020-06-15 06:45,50,34,16,0,0,0
2020-06-15 07:00,63,39,24,0,0,0
2020-06-15 07:15,117,78,39,0,0,0
2020-06-15 07:30,141,98,43,0,0,0
2020-06-15 07:45,144,87,57,0,0,0
2020-06-15 08:00,112,79,33,0,0,0
2020-06-15 08:15,112,76,36,0,0,0
2020-06-15 08:30,111,89,22,0,0,0
2020-06-15 08:45,92,77,15,0,0,0
2020-06-15 09:00,84,63,21,0,0,0
2020-06-15 09:15,79,54,25,0,0,0
2020-06-15 09:30,87,59,28,0,0,0
2020-06-15 09:45,82,51,31,0,0,0
2020-06-15 10:00,57,42,15,0,0,0
2020-06-15 10:15,60,44,16,0,0,0
2020-06-15 10:30,73,42,31,0,0,0
2020-06-15 10:45,88,60,28,0,0,0
2020-06-15 11:00,89,57,32,0,0,0
2020-06-15 11:15,88,52,36,0,0,0
2020-06-15 11:30,75,52,23,0,0,0
2020-06-15 11:45,103,63,40,0,0,0
2020-06-15 12:00,95,53,42,0,0,0
2020-06-15 12:15,120,71,49,0,0,0
2020-06-15 12:30,103,57,46,0,0,0
2020-06-15 12:45,117,65,52,0,0,0
2020-06-15 13:00,92,35,57,0,0,0
2020-06-15 13:15,106,53,53,0,0,0
2020-06-15 13:30,100,52,48,0,0,0
2020-06-15 13:45,153,89,64,0,0,0
2020-06-15 14:00,86,56,30,0,0,0
2020-06-15 14:15,116,77,39,0,0,0
2020-06-15 14:30,104,73,31,0,0,0
2020-06-15 14:45,110,78,32,0,0,0
2020-06-15 15:00,101,61,40,0,0,0
2020-06-15 15:15,119,70,49,0,0,0
2020-06-15 15:30,140,87,53,0,0,0
2020-06-15 15:45,167,100,67,0,0,0
2020-06-15 16:00,155,103,52,0,0,0
2020-06-15 16:15,161,94,67,0,0,0
2020-06-15 16:30,131,83,48,0,0,0
2020-06-15 16:45,140,93,47,0,0,0
2020-06-15 17:00,155,86,69,0,0,0
2020-06-15 17:15,136,61,75,0,0,0
2020-06-15 17:30,106,59,47,0,0,0
2020-06-15 17:45,98,42,56,0,0,0
2020-06-15 18:00,94,44,50,0,0,0
2020-06-15 18:15,79,36,43,0,0,0
2020-06-15 18:30,57,25,32,0,0,0
2020-06-15 18:45,71,35,36,0,0,0
2020-06-15 19:00,63,32,31,0,0,0
2020-06-15 19:15,60,38,22,0,0,0
2020-06-15 19:30,41,26,15,0,0,0
2020-06-15 19:45,71,36,35,0,0,0
2020-06-15 20:00,52,27,25,0,0,0
2020-06-15 20:15,48,30,18,0,0,0
2020-06-15 20:30,44,27,17,0,0,0
2020-06-15 20:45,26,11,15,0,0,0
2020-06-15 21:00,32,21,11,0,0,0
2020-06-15 21:15,28,18,10,0,0,0
2020-06-15 21:30,34,23,11,0,0,0
2020-06-15 21:45,40,17,23,0,0,0
2020-06-15 22:00,34,16,18,0,0,0
2020-06-15 22:15,24,17,7,0,0,0
2020-06-15 22:30,22,12,10,0,0,0
2020-06-15 22:45,29,9,20,0,0,0
2020-06-15 23:00,13,3,10,0,0,0
2020-06-15 23:15,19,12,7,0,0,0
2020-06-15 23:30,12,5,7,0,0,0
2020-06-15 23:45,11,4,7,0,0,0
2020-06-16 00:00,8,6,2,0,0,0
2020-06-16 00:15,6,2,4,0,0,0
2020-06-16 00:30,9,5,4,0,0,0
2020-06-16 00:45,4,1,3,0,0,0
2020-06-16 01:00,3,0,3,0,0,0
2020-06-16 01:15,5,2,3,0,0,0
2020-06-16 01:30,8,4,4,0,0,0
2020-06-16 01:45,1,1,0,0,0,0
2020-06-16 02:00,4,3,1,0,0,0
2020-06-16 02:15,2,1,1,0,0,0
2020-06-16 02:30,2,1,1,0,0,0
2020-06-16 02:45,2,1,1,0,0,0
2020-06-16 03:00,2,1,1,0,0,0
2020-06-16 03:15,2,1,1,0,0,0
2020-06-16 03:30,0,0,0,0,0,0
2020-06-16 03:45,0,0,0,0,0,0
2020-06-16 04:00,0,0,0,0,0,0
2020-06-16 04:15,0,0,0,0,0,0
2020-06-16 04:30,0,0,0,0,0,0
2020-06-16 04:45,1,0,1,0,0,0
2020-06-16 05:00,3,2,1,0,0,0
2020-06-16 05:15,3,1,2,0,0,0
2020-06-16 05:30,10,7,3,0,0,0
2020-06-16 05:45,25,10,15,0,0,0
2020-06-16 06:00,17,9,8,0,0,0
2020-06-16 06:15,18,10,8,0,0,0
2020-06-16 06:30,49,28,21,0,0,0
2020-06-16 06:45,60,45,15,0,0,0
2020-06-16 07:00,68,46,22,0,0,0
2020-06-16 07:15,100,64,36,0,0,0
2020-06-16 07:30,145,100,45,0,0,0
2020-06-16 07:45,137,97,40,0,0,0
2020-06-16 08:00,126,97,29,0,0,0
2020-06-16 08:15,144,104,40,0,0,0
2020-06-16 08:30,107,74,33,0,0,0
2020-06-16 08:45,140,102,38,0,0,0
2020-06-16 09:00,78,57,21,0,0,0
2020-06-16 09:15,81,56,25,0,0,0
2020-06-16 09:30,101,73,28,0,0,0
2020-06-16 09:45,100,71,29,0,0,0
2020-06-16 10:00,92,66,26,0,0,0
2020-06-16 10:15,95,66,29,0,0,0
2020-06-16 10:30,81,57,24,0,0,0
2020-06-16 10:45,92,61,31,0,0,0
2020-06-16 11:00,104,63,41,0,0,0
2020-06-16 11:15,104,67,37,0,0,0
2020-06-16 11:30,98,51,47,0,0,0
2020-06-16 11:45,118,73,45,0,0,0
2020-06-16 12:00,94,58,36,0,0,0
2020-06-16 12:15,102,62,40,0,0,0
2020-06-16 12:30,106,53,53,0,0,0
2020-06-16 12:45,120,66,54,0,0,0
2020-06-16 13:00,126,59,67,0,0,0
2020-06-16 13:15,129,61,68,0,0,0
2020-06-16 13:30,109,48,61,0,0,0
2020-06-16 13:45,154,82,72,0,0,0
2020-06-16 14:00,132,67,65,0,0,0
2020-06-16 14:15,139,86,53,0,0,0
2020-06-16 14:30,122,81,41,0,0,0
2020-06-16 14:45,161,86,75,0,0,0
2020-06-16 15:00,104,58,46,0,0,0
2020-06-16 15:15,139,70,69,0,0,0
2020-06-16 15:30,121,68,53,0,0,0
2020-06-16 15:45,149,98,51,0,0,0
2020-06-16 16:00,176,102,74,0,0,0
2020-06-16 16:15,176,94,82,0,0,0
2020-06-16 16:30,163,90,73,0,0,0
2020-06-16 16:45,178,99,79,0,0,0
2020-06-16 17:00,160,100,60,0,0,0
2020-06-16 17:15,176,82,94,0,0,0
2020-06-16 17:30,163,72,91,0,0,0
2020-06-16 17:45,154,80,74,0,0,0
2020-06-16 18:00,156,76,80,0,0,0
2020-06-16 18:15,132,57,75,0,0,0
2020-06-16 18:30,135,58,77,0,0,0
2020-06-16 18:45,150,75,75,0,0,0
2020-06-16 19:00,89,37,52,0,0,0
2020-06-16 19:15,95,42,53,0,0,0
2020-06-16 19:30,71,38,33,0,0,0
2020-06-16 19:45,96,51,45,0,0,0
2020-06-16 20:00,73,32,41,0,0,0
2020-06-16 20:15,77,28,49,0,0,0
2020-06-16 20:30,61,34,27,0,0,0
2020-06-16 20:45,38,16,22,0,0,0
2020-06-16 21:00,39,20,19,0,0,0
2020-06-16 21:15,37,16,21,0,0,0
2020-06-16 21:30,50,27,23,0,0,0
2020-06-16 21:45,29,20,9,0,0,0
2020-06-16 22:00,28,20,8,0,0,0
2020-06-16 22:15,44,27,17,0,0,0
2020-06-16 22:30,46,27,19,0,0,0
2020-06-16 22:45,30,20,10,0,0,0
2020-06-16 23:00,36,25,11,0,0,0
2020-06-16 23:15,32,17,15,0,0,0
2020-06-16 23:30,13,4,9,0,0,0
2020-06-16 23:45,21,11,10,0,0,0
2020-06-17 00:00,13,6,7,0,0,0
2020-06-17 00:15,19,13,6,0,0,0
2020-06-17 00:30,5,3,2,0,0,0
2020-06-17 00:45,8,4,4,0,0,0
2020-06-17 01:00,5,0,5,0,0,0
2020-06-17 01:15,4,1,3,0,0,0
2020-06-17 01:30,2,2,0,0,0,0
2020-06-17 01:45,3,2,1,0,0,0
2020-06-17 02:00,3,2,1,0,0,0
2020-06-17 02:15,4,2,2,0,0,0
2020-06-17 02:30,0,0,0,0,0,0
2020-06-17 02:45,2,1,1,0,0,0
2020-06-17 03:00,0,0,0,0,0,0
2020-06-17 03:15,0,0,0,0,0,0
2020-06-17 03:30,1,0,1,0,0,0
2020-06-17 03:45,3,3,0,0,0,0
2020-06-17 04:00,0,0,0,0,0,0
2020-06-17 04:15,1,0,1,0,0,0
2020-06-17 04:30,0,0,0,0,0,0
2020-06-17 04:45,0,0,0,0,0,0
2020-06-17 05:00,2,1,1,0,0,0
2020-06-17 05:15,4,3,1,0,0,0
2020-06-17 05:30,11,6,5,0,0,0
2020-06-17 05:45,21,10,11,0,0,0
2020-06-17 06:00,14,10,4,0,0,0
2020-06-17 06:15,18,12,6,0,0,0
2020-06-17 06:30,41,24,17,0,0,0
2020-06-17 06:45,60,45,15,0,0,0
2020-06-17 07:00,80,56,24,0,0,0
2020-06-17 07:15,104,69,35,0,0,0
2020-06-17 07:30,174,124,50,0,0,0
2020-06-17 07:45,192,130,62,0,0,0
2020-06-17 08:00,157,126,31,0,0,0
2020-06-17 08:15,141,100,41,0,0,0
2020-06-17 08:30,126,84,42,0,0,0
2020-06-17 08:45,155,113,42,0,0,0
2020-06-17 09:00,130,87,43,0,0,0
2020-06-17 09:15,116,86,30,0,0,0
2020-06-17 09:30,126,100,26,0,0,0
2020-06-17 09:45,139,105,34,0,0,0
2020-06-17 10:00,121,88,33,0,0,0
2020-06-17 10:15,120,83,37,0,0,0
2020-06-17 10:30,136,97,39,0,0,0
2020-06-17 10:45,133,82,51,0,0,0
2020-06-17 11:00,128,74,54,0,0,0
2020-06-17 11:15,134,82,52,0,0,0
2020-06-17 11:30,145,85,60,0,0,0
2020-06-17 11:45,124,72,52,0,0,0
2020-06-17 12:00,122,65,57,0,0,0
2020-06-17 12:15,154,97,57,0,0,0
2020-06-17 12:30,177,106,71,0,0,0
2020-06-17 12:45,141,63,78,0,0,0
2020-06-17 13:00,158,78,80,0,0,0
2020-06-17 13:15,131,77,54,0,0,0
2020-06-17 13:30,114,55,59,0,0,0
2020-06-17 13:45,129,68,61,0,0,0
2020-06-17 14:00,113,64,49,0,0,0
2020-06-17 14:15,133,77,56,0,0,0
2020-06-17 14:30,136,83,53,0,0,0
2020-06-17 14:45,155,93,62,0,0,0
2020-06-17 15:00,106,61,45,0,0,0
2020-06-17 15:15,128,79,49,0,0,0
2020-06-17 15:30,139,75,64,0,0,0
2020-06-17 15:45,133,82,51,0,0,0
2020-06-17 16:00,135,76,59,0,0,0
2020-06-17 16:15,138,83,55,0,0,0
2020-06-17 16:30,140,79,61,0,0,0
2020-06-17 16:45,175,102,73,0,0,0
2020-06-17 17:00,197,98,99,0,0,0
2020-06-17 17:15,155,68,87,0,0,0
2020-06-17 17:30,82,37,45,0,0,0
2020-06-17 17:45,68,22,46,0,0,0
2020-06-17 18:00,68,27,41,0,0,0
2020-06-17 18:15,79,45,34,0,0,0
2020-06-17 18:30,73,31,42,0,0,0
2020-06-17 18:45,84,45,39,0,0,0
2020-06-17 19:00,64,30,34,0,0,0
2020-06-17 19:15,61,18,43,0,0,0
2020-06-17 19:30,63,34,29,0,0,0
2020-06-17 19:45,76,42,34,0,0,0
2020-06-17 20:00,56,32,24,0,0,0
2020-06-17 20:15,45,28,17,0,0,0
2020-06-17 20:30,30,19,11,0,0,0
2020-06-17 20:45,35,28,7,0,0,0
2020-06-17 21:00,45,23,22,0,0,0
2020-06-17 21:15,31,9,22,0,0,0
2020-06-17 21:30,41,24,17,0,0,0
2020-06-17 21:45,31,18,13,0,0,0
2020-06-17 22:00,23,9,14,0,0,0
2020-06-17 22:15,35,19,16,0,0,0
2020-06-17 22:30,28,14,14,0,0,0
2020-06-17 22:45,37,18,19,0,0,0
2020-06-17 23:00,46,29,17,0,0,0
2020-06-17 23:15,17,10,7,0,0,0
2020-06-17 23:30,25,11,14,0,0,0
2020-06-17 23:45,9,4,5,0,0,0
2020-06-18 00:00,12,2,10,0,0,0
2020-06-18 00:15,13,11,2,0,0,0
2020-06-18 00:30,4,1,3,0,0,0
2020-06-18 00:45,3,3,0,0,0,0
2020-06-18 01:00,3,1,2,0,0,0
2020-06-18 01:15,9,4,5,0,0,0
2020-06-18 01:30,4,2,2,0,0,0
2020-06-18 01:45,6,5,1,0,0,0
2020-06-18 02:00,3,1,2,0,0,0
2020-06-18 02:15,2,2,0,0,0,0
2020-06-18 02:30,0,0,0,0,0,0
2020-06-18 02:45,2,0,2,0,0,0
2020-06-18 03:00,0,0,0,0,0,0
2020-06-18 03:15,0,0,0,0,0,0
2020-06-18 03:30,2,2,0,0,0,0
2020-06-18 03:45,1,1,0,0,0,0
2020-06-18 04:00,0,0,0,0,0,0
2020-06-18 04:15,3,0,3,0,0,0
2020-06-18 04:30,0,0,0,0,0,0
2020-06-18 04:45,0,0,0,0,0,0
2020-06-18 05:00,2,0,2,0,0,0
2020-06-18 05:15,6,5,1,0,0,0
2020-06-18 05:30,14,7,7,0,0,0
2020-06-18 05:45,16,10,6,0,0,0
2020-06-18 06:00,17,14,3,0,0,0
2020-06-18 06:15,23,12,11,0,0,0
2020-06-18 06:30,28,16,12,0,0,0
2020-06-18 06:45,53,35,18,0,0,0
2020-06-18 07:00,72,54,18,0,0,0
2020-06-18 07:15,94,56,38,0,0,0
2020-06-18 07:30,148,102,46,0,0,0
2020-06-18 07:45,154,102,52,0,0,0
2020-06-18 08:00,118,82,36,0,0,0
2020-06-18 08:15,124,87,37,0,0,0
2020-06-18 08:30,122,90,32,0,0,0
2020-06-18 08:45,107,65,42,0,0,0
2020-06-18 09:00,81,59,22,0,0,0
2020-06-18 09:15,87,66,21,0,0,0
2020-06-18 09:30,80,58,22,0,0,0
2020-06-18 09:45,120,96,24,0,0,0
2020-06-18 10:00,65,46,19,0,0,0
2020-06-18 10:15,80,48,32,0,0,0
2020-06-18 10:30,77,46,31,0,0,0
2020-06-18 10:45,87,52,35,0,0,0
2020-06-18 11:00,65,32,33,0,0,0
2020-06-18 11:15,67,43,24,0,0,0
2020-06-18 11:30,98,58,40,0,0,0
2020-06-18 11:45,107,55,52,0,0,0
2020-06-18 12:00,74,46,28,0,0,0
2020-06-18 12:15,103,63,40,0,0,0
2020-06-18 12:30,85,42,43,0,0,0
2020-06-18 12:45,102,58,44,0,0,0
2020-06-18 13:00,96,53,43,0,0,0
2020-06-18 13:15,98,57,41,0,0,0
2020-06-18 13:30,109,70,39,0,0,0
2020-06-18 13:45,137,86,51,0,0,0
2020-06-18 14:00,96,45,51,0,0,0
2020-06-18 14:15,121,64,57,0,0,0
2020-06-18 14:30,117,71,46,0,0,0
2020-06-18 14:45,157,95,62,0,0,0
2020-06-18 15:00,111,76,35,0,0,0
2020-06-18 15:15,122,76,46,0,0,0
2020-06-18 15:30,128,79,49,0,0,0
2020-06-18 15:45,140,93,47,0,0,0
2020-06-18 16:00,128,86,42,0,0,0
2020-06-18 16:15,168,103,65,0,0,0
2020-06-18 16:30,156,95,61,0,0,0
2020-06-18 16:45,151,95,56,0,0,0
2020-06-18 17:00,156,79,77,0,0,0
2020-06-18 17:15,158,79,79,0,0,0
2020-06-18 17:30,133,80,53,0,0,0
2020-06-18 17:45,161,101,60,0,0,0
2020-06-18 18:00,135,65,70,0,0,0
2020-06-18 18:15,118,74,44,0,0,0
2020-06-18 18:30,118,56,62,0,0,0
2020-06-18 18:45,130,70,60,0,0,0
2020-06-18 19:00,109,48,61,0,0,0
2020-06-18 19:15,76,44,32,0,0,0
2020-06-18 19:30,73,42,31,0,0,0
2020-06-18 19:45,102,63,39,0,0,0
2020-06-18 20:00,84,39,45,0,0,0
2020-06-18 20:15,62,27,35,0,0,0
2020-06-18 20:30,41,17,24,0,0,0
2020-06-18 20:45,35,18,17,0,0,0
2020-06-18 21:00,41,21,20,0,0,0
2020-06-18 21:15,45,26,19,0,0,0
2020-06-18 21:30,56,32,24,0,0,0
2020-06-18 21:45,37,20,17,0,0,0
2020-06-18 22:00,44,29,15,0,0,0
2020-06-18 22:15,32,21,11,0,0,0
2020-06-18 22:30,38,17,21,0,0,0
2020-06-18 22:45,34,24,10,0,0,0
2020-06-18 23:00,31,13,18,0,0,0
2020-06-18 23:15,37,21,16,0,0,0
2020-06-18 23:30,26,8,18,0,0,0
2020-06-18 23:45,17,6,11,0,0,0
2020-06-19 00:00,14,7,7,0,0,0
2020-06-19 00:15,21,9,12,0,0,0
2020-06-19 00:30,16,8,8,0,0,0
2020-06-19 00:45,14,6,8,0,0,0
2020-06-19 01:00,11,5,6,0,0,0
2020-06-19 01:15,10,4,6,0,0,0
2020-06-19 01:30,7,2,5,0,0,0
2020-06-19 01:45,8,5,3,0,0,0
2020-06-19 02:00,3,0,3,0,0,0
2020-06-19 02:15,4,1,3,0,0,0
2020-06-19 02:30,6,3,3,0,0,0
2020-06-19 02:45,0,0,0,0,0,0
2020-06-19 03:00,2,1,1,0,0,0
2020-06-19 03:15,2,2,0,0,0,0
2020-06-19 03:30,4,2,2,0,0,0
2020-06-19 03:45,1,0,1,0,0,0
2020-06-19 04:00,1,0,1,0,0,0
2020-06-19 04:15,1,0,1,0,0,0
2020-06-19 04:30,1,0,1,0,0,0
2020-06-19 04:45,1,0,1,0,0,0
2020-06-19 05:00,1,0,1,0,0,0
2020-06-19 05:15,4,4,0,0,0,0
2020-06-19 05:30,14,10,4,0,0,0
2020-06-19 05:45,13,2,11,0,0,0
2020-06-19 06:00,17,13,4,0,0,0
2020-06-19 06:15,20,12,8,0,0,0
2020-06-19 06:30,33,25,8,0,0,0
2020-06-19 06:45,57,43,14,0,0,0
2020-06-19 07:00,74,49,25,0,0,0
2020-06-19 07:15,103,77,26,0,0,0
2020-06-19 07:30,155,110,45,0,0,0
2020-06-19 07:45,152,112,40,0,0,0
2020-06-19 08:00,110,86,24,0,0,0
2020-06-19 08:15,137,101,36,0,0,0
2020-06-19 08:30,103,79,24,0,0,0
2020-06-19 08:45,123,89,34,0,0,0
2020-06-19 09:00,92,62,30,0,0,0
2020-06-19 09:15,115,87,28,0,0,0
2020-06-19 09:30,113,87,26,0,0,0
2020-06-19 09:45,131,84,47,0,0,0
2020-06-19 10:00,131,96,35,0,0,0
2020-06-19 10:15,91,61,30,0,0,0
2020-06-19 10:30,109,78,31,0,0,0
2020-06-19 10:45,140,92,48,0,0,0
2020-06-19 11:00,105,69,36,0,0,0
2020-06-19 11:15,125,82,43,0,0,0
2020-06-19 11:30,127,82,45,0,0,0
2020-06-19 11:45,168,96,72,0,0,0
2020-06-19 12:00,129,73,56,0,0,0
2020-06-19 12:15,134,70,64,0,0,0
2020-06-19 12:30,158,86,72,0,0,0
2020-06-19 12:45,163,99,64,0,0,0
2020-06-19 13:00,179,92,87,0,0,0
2020-06-19 13:15,154,82,72,0,0,0
2020-06-19 13:30,148,74,74,0,0,0
2020-06-19 13:45,161,99,62,0,0,0
2020-06-19 14:00,175,96,79,0,0,0
2020-06-19 14:15,145,84,61,0,0,0
2020-06-19 14:30,167,100,67,0,0,0
2020-06-19 14:45,167,89,78,0,0,0
2020-06-19 15:00,167,79,88,0,0,0
2020-06-19 15:15,156,86,70,0,0,0
2020-06-19 15:30,161,88,73,0,0,0
2020-06-19 15:45,188,111,77,0,0,0
2020-06-19 16:00,148,74,74,0,0,0
2020-06-19 16:15,153,80,73,0,0,0
2020-06-19 16:30,141,72,69,0,0,0
2020-06-19 16:45,187,116,71,0,0,0
2020-06-19 17:00,118,66,52,0,0,0
2020-06-19 17:15,171,97,74,0,0,0
2020-06-19 17:30,148,65,83,0,0,0
2020-06-19 17:45,209,101,108,0,0,0
2020-06-19 18:00,154,72,82,0,0,0
2020-06-19 18:15,155,72,83,0,0,0
2020-06-19 18:30,154,62,92,0,0,0
2020-06-19 18:45,177,98,79,0,0,0
2020-06-19 19:00,148,86,62,0,0,0
2020-06-19 19:15,126,66,60,0,0,0
2020-06-19 19:30,97,57,40,0,0,0
2020-06-19 19:45,102,66,36,0,0,0
2020-06-19 20:00,89,50,39,0,0,0
2020-06-19 20:15,93,47,46,0,0,0
2020-06-19 20:30,64,37,27,0,0,0
2020-06-19 20:45,50,20,30,0,0,0
2020-06-19 21:00,63,46,17,0,0,0
2020-06-19 21:15,59,31,28,0,0,0
2020-06-19 21:30,50,29,21,0,0,0
2020-06-19 21:45,41,18,23,0,0,0
2020-06-19 22:00,28,12,16,0,0,0
2020-06-19 22:15,30,19,11,0,0,0
2020-06-19 22:30,37,21,16,0,0,0
2020-06-19 22:45,29,22,7,0,0,0
2020-06-19 23:00,44,24,20,0,0,0
2020-06-19 23:15,47,28,19,0,0,0
2020-06-19 23:30,39,23,16,0,0,0
2020-06-19 23:45,17,10,7,0,0,0
2020-06-20 00:00,36,23,13,0,0,0
2020-06-20 00:15,31,16,15,0,0,0
2020-06-20 00:30,41,25,16,0,0,0
2020-06-20 00:45,34,16,18,0,0,0
2020-06-20 01:00,27,16,11,0,0,0
2020-06-20 01:15,17,10,7,0,0,0
2020-06-20 01:30,24,9,15,0,0,0
2020-06-20 01:45,17,3,14,0,0,0
2020-06-20 02:00,6,2,4,0,0,0
2020-06-20 02:15,16,7,9,0,0,0
2020-06-20 02:30,11,1,10,0,0,0
2020-06-20 02:45,8,4,4,0,0,0
2020-06-20 03:00,8,3,5,0,0,0
2020-06-20 03:15,5,0,5,0,0,0
2020-06-20 03:30,5,1,4,0,0,0
2020-06-20 03:45,2,0,2,0,0,0
2020-06-20 04:00,6,0,6,0,0,0
2020-06-20 04:15,7,3,4,0,0,0
2020-06-20 04:30,3,1,2,0,0,0
2020-06-20 04:45,2,0,2,0,0,0
2020-06-20 05:00,2,2,0,0,0,0
2020-06-20 05:15,2,1,1,0,0,0
2020-06-20 05:30,7,4,3,0,0,0
2020-06-20 05:45,7,4,3,0,0,0
2020-06-20 06:00,7,6,1,0,0,0
2020-06-20 06:15,4,2,2,0,0,0
2020-06-20 06:30,8,7,1,0,0,0
2020-06-20 06:45,13,13,0,0,0,0
2020-06-20 07:00,19,14,5,0,0,0
2020-06-20 07:15,16,9,7,0,0,0
2020-06-20 07:30,26,16,10,0,0,0
2020-06-20 07:45,36,26,10,0,0,0
2020-06-20 08:00,36,21,15,0,0,0
2020-06-20 08:15,34,23,11,0,0,0
2020-06-20 08:30,68,47,21,0,0,0
2020-06-20 08:45,68,50,18,0,0,0
2020-06-20 09:00,85,59,26,0,0,0
2020-06-20 09:15,87,66,21,0,0,0
2020-06-20 09:30,101,72,29,0,0,0
2020-06-20 09:45,153,124,29,0,0,0
2020-06-20 10:00,123,93,30,0,0,0
2020-06-20 10:15,146,126,20,0,0,0
2020-06-20 10:30,140,91,49,0,0,0
2020-06-20 10:45,166,111,55,0,0,0
2020-06-20 11:00,159,112,47,0,0,0
2020-06-20 11:15,151,108,43,0,0,0
2020-06-20 11:30,152,104,48,0,0,0
2020-06-20 11:45,177,117,60,0,0,0
2020-06-20 12:00,159,107,52,0,0,0
2020-06-20 12:15,194,111,83,0,0,0
2020-06-20 12:30,189,114,75,0,0,0
2020-06-20 12:45,201,120,81,0,0,0
2020-06-20 13:00,171,96,75,0,0,0
2020-06-20 13:15,171,105,66,0,0,0
2020-06-20 13:30,155,80,75,0,0,0
2020-06-20 13:45,195,109,86,0,0,0
2020-06-20 14:00,173,82,91,0,0,0
2020-06-20 14:15,154,79,75,0,0,0
2020-06-20 14:30,185,85,100,0,0,0
2020-06-20 14:45,160,89,71,0,0,0
2020-06-20 15:00,155,72,83,0,0,0
2020-06-20 15:15,126,65,61,0,0,0
2020-06-20 15:30,145,74,71,0,0,0
2020-06-20 15:45,134,77,57,0,0,0
2020-06-20 16:00,139,85,54,0,0,0
2020-06-20 16:15,128,75,53,0,0,0
2020-06-20 16:30,111,59,52,0,0,0
2020-06-20 16:45,109,65,44,0,0,0
2020-06-20 17:00,103,54,49,0,0,0
2020-06-20 17:15,117,60,57,0,0,0
2020-06-20 17:30,165,86,79,0,0,0
2020-06-20 17:45,146,68,78,0,0,0
2020-06-20 18:00,126,59,67,0,0,0
2020-06-20 18:15,117,60,57,0,0,0
2020-06-20 18:30,111,61,50,0,0,0
2020-06-20 18:45,147,75,72,0,0,0
2020-06-20 19:00,97,38,59,0,0,0
2020-06-20 19:15,105,61,44,0,0,0
2020-06-20 19:30,94,48,46,0,0,0
2020-06-20 19:45,101,54,47,0,0,0
2020-06-20 20:00,62,39,23,0,0,0
2020-06-20 20:15,62,34,28,0,0,0
2020-06-20 20:30,44,28,16,0,0,0
2020-06-20 20:45,68,31,37,0,0,0
2020-06-20 21:00,75,48,27,0,0,0
2020-06-20 21:15,82,42,40,0,0,0
2020-06-20 21:30,47,29,18,0,0,0
2020-06-20 21:45,36,22,14,0,0,0
2020-06-20 22:00,40,17,23,0,0,0
2020-06-20 22:15,32,22,10,0,0,0
2020-06-20 22:30,31,11,20,0,0,0
2020-06-20 22:45,44,18,26,0,0,0
2020-06-20 23:00,49,30,19,0,0,0
2020-06-20 23:15,28,14,14,0,0,0
2020-06-20 23:30,31,13,18,0,0,0
2020-06-20 23:45,45,28,17,0,0,0
2020-06-21 00:00,38,24,14,0,0,0
2020-06-21 00:15,41,32,9,0,0,0
2020-06-21 00:30,29,13,16,0,0,0
2020-06-21 00:45,25,12,13,0,0,0
2020-06-21 01:00,34,19,15,0,0,0
2020-06-21 01:15,31,15,16,0,0,0
2020-06-21 01:30,16,7,9,0,0,0
2020-06-21 01:45,21,8,13,0,0,0
2020-06-21 02:00,12,6,6,0,0,0
2020-06-21 02:15,28,20,8,0,0,0
2020-06-21 02:30,14,6,8,0,0,0
2020-06-21 02:45,14,7,7,0,0,0
2020-06-21 03:00,6,2,4,0,0,0
2020-06-21 03:15,15,10,5,0,0,0
2020-06-21 03:30,15,9,6,0,0,0
2020-06-21 03:45,11,6,5,0,0,0
2020-06-21 04:00,7,3,4,0,0,0
2020-06-21 04:15,10,5,5,0,0,0
2020-06-21 04:30,4,1,3,0,0,0
2020-06-21 04:45,6,2,4,0,0,0
2020-06-21 05:00,0,0,0,0,0,0
2020-06-21 05:15,6,5,1,0,0,0
2020-06-21 05:30,7,3,4,0,0,0
2020-06-21 05:45,7,2,5,0,0,0
2020-06-21 06:00,10,5,5,0,0,0
2020-06-21 06:15,12,7,5,0,0,0
2020-06-21 06:30,9,5,4,0,0,0
2020-06-21 06:45,8,6,2,0,0,0
2020-06-21 07:00,5,4,1,0,0,0
2020-06-21 07:15,6,5,1,0,0,0
2020-06-21 07:30,8,4,4,0,0,0
2020-06-21 07:45,6,4,2,0,0,0
2020-06-21 08:00,16,11,5,0,0,0
2020-06-21 08:15,9,6,3,0,0,0
2020-06-21 08:30,17,12,5,0,0,0
2020-06-21 08:45,25,13,12,0,0,0
2020-06-21 09:00,19,13,6,0,0,0
2020-06-21 09:15,33,23,10,0,0,0
2020-06-21 09:30,25,10,15,0,0,0
2020-06-21 09:45,61,41,20,0,0,0
2020-06-21 10:00,51,38,13,0,0,0
2020-06-21 10:15,38,23,15,0,0,0
2020-06-21 10:30,47,23,24,0,0,0
2020-06-21 10:45,60,38,22,0,0,0
2020-06-21 11:00,49,28,21,0,0,0
2020-06-21 11:15,73,38,35,0,0,0
2020-06-21 11:30,66,38,28,0,0,0
2020-06-21 11:45,98,55,43,0,0,0
2020-06-21 12:00,76,43,33,0,0,0
2020-06-21 12:15,68,35,33,0,0,0
2020-06-21 12:30,90,42,48,0,0,0
2020-06-21 12:45,65,47,18,0,0,0
2020-06-21 13:00,83,43,40,0,0,0
2020-06-21 13:15,96,58,38,0,0,0
2020-06-21 13:30,76,52,24,0,0,0
2020-06-21 13:45,80,53,27,0,0,0
2020-06-21 14:00,118,61,57,0,0,0
2020-06-21 14:15,80,43,37,0,0,0
2020-06-21 14:30,121,77,44,0,0,0
2020-06-21 14:45,129,81,48,0,0,0
2020-06-21 15:00,101,69,32,0,0,0
2020-06-21 15:15,110,71,39,0,0,0
2020-06-21 15:30,132,88,44,0,0,0
2020-06-21 15:45,113,71,42,0,0,0
2020-06-21 16:00,117,67,50,0,0,0
2020-06-21 16:15,106,64,42,0,0,0
2020-06-21 16:30,131,87,44,0,0,0
2020-06-21 16:45,142,82,60,0,0,0
2020-06-21 17:00,120,79,41,0,0,0
2020-06-21 17:15,107,70,37,0,0,0
2020-06-21 17:30,103,55,48,0,0,0
2020-06-21 17:45,129,56,73,0,0,0
2020-06-21 18:00,121,77,44,0,0,0
2020-06-21 18:15,126,89,37,0,0,0
2020-06-21 18:30,92,61,31,0,0,0
2020-06-21 18:45,92,49,43,0,0,0
2020-06-21 19:00,96,51,45,0,0,0
2020-06-21 19:15,71,44,27,0,0,0
2020-06-21 19:30,58,33,25,0,0,0
2020-06-21 19:45,71,32,39,0,0,0
2020-06-21 20:00,66,41,25,0,0,0
2020-06-21 20:15,40,26,14,0,0,0
2020-06-21 20:30,40,17,23,0,0,0
2020-06-21 20:45,36,19,17,0,0,0
2020-06-21 21:00,40,15,25,0,0,0
2020-06-21 21:15,37,14,23,0,0,0
2020-06-21 21:30,36,16,20,0,0,0
2020-06-21 21:45,37,21,16,0,0,0
2020-06-21 22:00,27,18,9,0,0,0
2020-06-21 22:15,20,11,9,0,0,0
2020-06-21 22:30,27,16,11,0,0,0
2020-06-21 22:45,24,19,5,0,0,0
2020-06-21 23:00,16,9,7,0,0,0
2020-06-21 23:15,16,11,5,0,0,0
2020-06-21 23:30,8,6,2,0,0,0
2020-06-21 23:45,6,3,3,0,0,0
2020-06-22 00:00,12,7,5,0,0,0
2020-06-22 00:15,10,7,3,0,0,0
2020-06-22 00:30,1,1,0,0,0,0
2020-06-22 00:45,2,1,1,0,0,0
2020-06-22 01:00,4,1,3,0,0,0
2020-06-22 01:15,3,0,3,0,0,0
2020-06-22 01:30,1,1,0,0,0,0
2020-06-22 01:45,7,3,4,0,0,0
2020-06-22 02:00,0,0,0,0,0,0
2020-06-22 02:15,1,0,1,0,0,0
2020-06-22 02:30,3,2,1,0,0,0
2020-06-22 02:45,1,1,0,0,0,0
2020-06-22 03:00,0,0,0,0,0,0
2020-06-22 03:15,0,0,0,0,0,0
2020-06-22 03:30,0,0,0,0,0,0
2020-06-22 03:45,0,0,0,0,0,0
2020-06-22 04:00,2,0,2,0,0,0
2020-06-22 04:15,1,0,1,0,0,0
2020-06-22 04:30,0,0,0,0,0,0
2020-06-22 04:45,1,1,0,0,0,0
2020-06-22 05:00,4,3,1,0,0,0
2020-06-22 05:15,5,2,3,0,0,0
2020-06-22 05:30,10,4,6,0,0,0
2020-06-22 05:45,20,10,10,0,0,0
2020-06-22 06:00,23,14,9,0,0,0
2020-06-22 06:15,25,17,8,0,0,0
2020-06-22 06:30,52,32,20,0,0,0
2020-06-22 06:45,77,47,30,0,0,0
2020-06-22 07:00,90,68,22,0,0,0
2020-06-22 07:15,129,90,39,0,0,0
2020-06-22 07:30,169,119,50,0,0,0
2020-06-22 07:45,158,113,45,0,0,0
2020-06-22 08:00,152,103,49,0,0,0
2020-06-22 08:15,143,103,40,0,0,0
2020-06-22 08:30,107,77,30,0,0,0
2020-06-22 08:45,149,115,34,0,0,0
2020-06-22 09:00,109,80,29,0,0,0
2020-06-22 09:15,104,73,31,0,0,0
2020-06-22 09:30,115,89,26,0,0,0
2020-06-22 09:45,129,89,40,0,0,0
2020-06-22 10:00,99,75,24,0,0,0
2020-06-22 10:15,121,76,45,0,0,0
2020-06-22 10:30,86,59,27,0,0,0
2020-06-22 10:45,123,82,41,0,0,0
2020-06-22 11:00,117,70,47,0,0,0
2020-06-22 11:15,111,69,42,0,0,0
2020-06-22 11:30,132,86,46,0,0,0
2020-06-22 11:45,134,74,60,0,0,0
2020-06-22 12:00,126,91,35,0,0,0
2020-06-22 12:15,142,75,67,0,0,0
2020-06-22 12:30,114,67,47,0,0,0
2020-06-22 12:45,164,98,66,0,0,0
2020-06-22 13:00,122,53,69,0,0,0
2020-06-22 13:15,158,76,82,0,0,0
2020-06-22 13:30,139,71,68,0,0,0
2020-06-22 13:45,158,94,64,0,0,0
2020-06-22 14:00,157,89,68,0,0,0
2020-06-22 14:15,136,72,64,0,0,0
2020-06-22 14:30,163,92,71,0,0,0
2020-06-22 14:45,145,73,72,0,0,0
2020-06-22 15:00,152,87,65,0,0,0
2020-06-22 15:15,162,99,63,0,0,0
2020-06-22 15:30,162,87,75,0,0,0
2020-06-22 15:45,193,106,87,0,0,0
2020-06-22 16:00,168,88,80,0,0,0
2020-06-22 16:15,186,102,84,0,0,0
2020-06-22 16:30,177,112,65,0,0,0
2020-06-22 16:45,179,83,96,0,0,0
2020-06-22 17:00,203,92,111,0,0,0
2020-06-22 17:15,216,100,116,0,0,0
2020-06-22 17:30,142,69,73,0,0,0
2020-06-22 17:45,170,87,83,0,0,0
2020-06-22 18:00,170,69,101,0,0,0
2020-06-22 18:15,173,78,95,0,0,0
2020-06-22 18:30,123,66,57,0,0,0
2020-06-22 18:45,144,75,69,0,0,0
2020-06-22 19:00,124,59,65,0,0,0
2020-06-22 19:15,118,55,63,0,0,0
2020-06-22 19:30,79,41,38,0,0,0
2020-06-22 19:45,98,44,54,0,0,0
2020-06-22 20:00,93,54,39,0,0,0
2020-06-22 20:15,81,43,38,0,0,0
2020-06-22 20:30,58,26,32,0,0,0
2020-06-22 20:45,55,28,27,0,0,0
2020-06-22 21:00,88,55,33,0,0,0
2020-06-22 21:15,39,22,17,0,0,0
2020-06-22 21:30,52,22,30,0,0,0
2020-06-22 21:45,27,13,14,0,0,0
2020-06-22 22:00,56,32,24,0,0,0
2020-06-22 22:15,38,15,23,0,0,0
2020-06-22 22:30,33,19,14,0,0,0
2020-06-22 22:45,25,10,15,0,0,0
2020-06-22 23:00,24,14,10,0,0,0
2020-06-22 23:15,23,14,9,0,0,0
2020-06-22 23:30,18,9,9,0,0,0
2020-06-22 23:45,13,4,9,0,0,0
2020-06-23 00:00,20,15,5,0,0,0
2020-06-23 00:15,4,3,1,0,0,0
2020-06-23 00:30,15,12,3,0,0,0
2020-06-23 00:45,14,9,5,0,0,0
2020-06-23 01:00,8,5,3,0,0,0
2020-06-23 01:15,2,1,1,0,0,0
2020-06-23 01:30,14,7,7,0,0,0
2020-06-23 01:45,10,4,6,0,0,0
2020-06-23 02:00,2,0,2,0,0,0
2020-06-23 02:15,3,2,1,0,0,0
2020-06-23 02:30,1,0,1,0,0,0
2020-06-23 02:45,0,0,0,0,0,0
2020-06-23 03:00,0,0,0,0,0,0
2020-06-23 03:15,2,0,2,0,0,0
2020-06-23 03:30,0,0,0,0,0,0
2020-06-23 03:45,2,2,0,0,0,0
2020-06-23 04:00,1,1,0,0,0,0
2020-06-23 04:15,2,0,2,0,0,0
2020-06-23 04:30,2,1,1,0,0,0
2020-06-23 04:45,2,0,2,0,0,0
2020-06-23 05:00,4,4,0,0,0,0
2020-06-23 05:15,5,1,4,0,0,0
2020-06-23 05:30,14,11,3,0,0,0
2020-06-23 05:45,19,11,8,0,0,0
2020-06-23 06:00,26,14,12,0,0,0
2020-06-23 06:15,41,26,15,0,0,0
2020-06-23 06:30,49,34,15,0,0,0
2020-06-23 06:45,76,50,26,0,0,0
2020-06-23 07:00,100,71,29,0,0,0
2020-06-23 07:15,111,72,39,0,0,0
2020-06-23 07:30,193,138,55,0,0,0
2020-06-23 07:45,183,128,55,0,0,0
2020-06-23 08:00,144,109,35,0,0,0
2020-06-23 08:15,148,107,41,0,0,0
2020-06-23 08:30,131,92,39,0,0,0
2020-06-23 08:45,144,100,44,0,0,0
2020-06-23 09:00,104,74,30,0,0,0
2020-06-23 09:15,134,90,44,0,0,0
2020-06-23 09:30,124,90,34,0,0,0
2020-06-23 09:45,138,107,31,0,0,0
2020-06-23 10:00,131,80,51,0,0,0
2020-06-23 10:15,102,73,29,0,0,0
2020-06-23 10:30,91,57,34,0,0,0
2020-06-23 10:45,120,86,34,0,0,0
2020-06-23 11:00,113,57,56,0,0,0
2020-06-23 11:15,133,77,56,0,0,0
2020-06-23 11:30,135,81,54,0,0,0
2020-06-23 11:45,104,59,45,0,0,0
2020-06-23 12:00,129,78,51,0,0,0
2020-06-23 12:15,142,77,65,0,0,0
2020-06-23 12:30,156,89,67,0,0,0
2020-06-23 12:45,141,74,67,0,0,0
2020-06-23 13:00,145,70,75,0,0,0
2020-06-23 13:15,131,60,71,0,0,0
2020-06-23 13:30,156,84,72,0,0,0
2020-06-23 13:45,144,77,67,0,0,0
2020-06-23 14:00,166,85,81,0,0,0
2020-06-23 14:15,138,70,68,0,0,0
2020-06-23 14:30,171,91,80,0,0,0
2020-06-23 14:45,141,77,64,0,0,0
2020-06-23 15:00,136,68,68,0,0,0
2020-06-23 15:15,142,80,62,0,0,0
2020-06-23 15:30,186,103,83,0,0,0
2020-06-23 15:45,195,92,103,0,0,0
2020-06-23 16:00,194,96,98,0,0,0
2020-06-23 16:15,198,113,85,0,0,0
2020-06-23 16:30,229,108,121,0,0,0
2020-06-23 16:45,214,113,101,0,0,0
2020-06-23 17:00,215,104,111,0,0,0
2020-06-23 17:15,189,98,91,0,0,0
2020-06-23 17:30,195,94,101,0,0,0
2020-06-23 17:45,218,105,113,0,0,0
2020-06-23 18:00,192,100,92,0,0,0
2020-06-23 18:15,170,80,90,0,0,0
2020-06-23 18:30,175,83,92,0,0,0
2020-06-23 18:45,196,103,93,0,0,0
2020-06-23 19:00,140,69,71,0,0,0
2020-06-23 19:15,149,85,64,0,0,0
2020-06-23 19:30,144,79,65,0,0,0
2020-06-23 19:45,122,61,61,0,0,0
2020-06-23 20:00,140,67,73,0,0,0
2020-06-23 20:15,105,51,54,0,0,0
2020-06-23 20:30,82,46,36,0,0,0
2020-06-23 20:45,91,51,40,0,0,0
2020-06-23 21:00,79,45,34,0,0,0
2020-06-23 21:15,64,29,35,0,0,0
2020-06-23 21:30,67,41,26,0,0,0
2020-06-23 21:45,48,28,20,0,0,0
2020-06-23 22:00,73,51,22,0,0,0
2020-06-23 22:15,59,35,24,0,0,0
2020-06-23 22:30,43,26,17,0,0,0
2020-06-23 22:45,62,35,27,0,0,0
2020-06-23 23:00,38,17,21,0,0,0
2020-06-23 23:15,38,22,16,0,0,0
2020-06-23 23:30,32,21,11,0,0,0
2020-06-23 23:45,9,3,6,0,0,0
2020-06-24 00:00,15,9,6,0,0,0
2020-06-24 00:15,14,8,6,0,0,0
2020-06-24 00:30,16,10,6,0,0,0
2020-06-24 00:45,15,6,9,0,0,0
2020-06-24 01:00,10,6,4,0,0,0
2020-06-24 01:15,5,4,1,0,0,0
2020-06-24 01:30,7,4,3,0,0,0
2020-06-24 01:45,6,5,1,0,0,0
2020-06-24 02:00,2,2,0,0,0,0
2020-06-24 02:15,3,2,1,0,0,0
2020-06-24 02:30,0,0,0,0,0,0
2020-06-24 02:45,2,1,1,0,0,0
2020-06-24 03:00,0,0,0,0,0,0
2020-06-24 03:15,4,4,0,0,0,0
2020-06-24 03:30,1,1,0,0,0,0
2020-06-24 03:45,0,0,0,0,0,0
2020-06-24 04:00,0,0,0,0,0,0
2020-06-24 04:15,1,0,1,0,0,0
2020-06-24 04:30,1,1,0,0,0,0
2020-06-24 04:45,1,1,0,0,0,0
2020-06-24 05:00,3,2,1,0,0,0
2020-06-24 05:15,3,1,2,0,0,0
2020-06-24 05:30,10,5,5,0,0,0
2020-06-24 05:45,27,15,12,0,0,0
2020-06-24 06:00,24,15,9,0,0,0
2020-06-24 06:15,33,20,13,0,0,0
2020-06-24 06:30,57,37,20,0,0,0
2020-06-24 06:45,62,37,25,0,0,0
2020-06-24 07:00,99,75,24,0,0,0
2020-06-24 07:15,131,84,47,0,0,0
2020-06-24 07:30,223,169,54,0,0,0
2020-06-24 07:45,185,127,58,0,0,0
2020-06-24 08:00,142,100,42,0,0,0
2020-06-24 08:15,163,115,48,0,0,0
2020-06-24 08:30,163,129,34,0,0,0
2020-06-24 08:45,145,102,43,0,0,0
2020-06-24 09:00,127,87,40,0,0,0
2020-06-24 09:15,139,110,29,0,0,0
2020-06-24 09:30,140,114,26,0,0,0
2020-06-24 09:45,157,119,38,0,0,0
2020-06-24 10:00,113,84,29,0,0,0
2020-06-24 10:15,151,112,39,0,0,0
2020-06-24 10:30,129,79,50,0,0,0
2020-06-24 10:45,163,104,59,0,0,0
2020-06-24 11:00,151,93,58,0,0,0
2020-06-24 11:15,134,87,47,0,0,0
2020-06-24 11:30,143,87,56,0,0,0
2020-06-24 11:45,148,87,61,0,0,0
2020-06-24 12:00,168,103,65,0,0,0
2020-06-24 12:15,153,84,69,0,0,0
2020-06-24 12:30,176,92,84,0,0,0
2020-06-24 12:45,172,86,86,0,0,0
2020-06-24 13:00,170,75,95,0,0,0
2020-06-24 13:15,146,66,80,0,0,0
2020-06-24 13:30,154,79,75,0,0,0
2020-06-24 13:45,174,74,100,0,0,0
2020-06-24 14:00,134,62,72,0,0,0
2020-06-24 14:15,154,77,77,0,0,0
2020-06-24 14:30,194,91,103,0,0,0
2020-06-24 14:45,159,84,75,0,0,0
2020-06-24 15:00,135,68,67,0,0,0
2020-06-24 15:15,143,73,70,0,0,0
2020-06-24 15:30,185,101,84,0,0,0
2020-06-24 15:45,206,101,105,0,0,0
2020-06-24 16:00,177,88,89,0,0,0
2020-06-24 16:15,169,70,99,0,0,0
2020-06-24 16:30,226,130,96,0,0,0
2020-06-24 16:45,238,116,122,0,0,0
2020-06-24 17:00,198,101,97,0,0,0
2020-06-24 17:15,243,136,107,0,0,0
2020-06-24 17:30,179,88,91,0,0,0
2020-06-24 17:45,200,103,97,0,0,0
2020-06-24 18:00,211,102,109,0,0,0
2020-06-24 18:15,197,94,103,0,0,0
2020-06-24 18:30,175,77,98,0,0,0
2020-06-24 18:45,199,106,93,0,0,0
2020-06-24 19:00,165,86,79,0,0,0
2020-06-24 19:15,159,68,91,0,0,0
2020-06-24 19:30,122,70,52,0,0,0
2020-06-24 19:45,124,58,66,0,0,0
2020-06-24 20:00,93,59,34,0,0,0
2020-06-24 20:15,96,51,45,0,0,0
2020-06-24 20:30,85,47,38,0,0,0
2020-06-24 20:45,86,59,27,0,0,0
2020-06-24 21:00,84,61,23,0,0,0
2020-06-24 21:15,80,58,22,0,0,0
2020-06-24 21:30,73,37,36,0,0,0
2020-06-24 21:45,58,37,21,0,0,0
2020-06-24 22:00,61,39,22,0,0,0
2020-06-24 22:15,51,34,17,0,0,0
2020-06-24 22:30,72,47,25,0,0,0
2020-06-24 22:45,67,39,28,0,0,0
2020-06-24 23:00,50,35,15,0,0,0
2020-06-24 23:15,62,41,21,0,0,0
2020-06-24 23:30,35,17,18,0,0,0
2020-06-24 23:45,20,15,5,0,0,0
2020-06-25 00:00,24,18,6,0,0,0
2020-06-25 00:15,19,18,1,0,0,0
2020-06-25 00:30,22,12,10,0,0,0
2020-06-25 00:45,16,10,6,0,0,0
2020-06-25 01:00,8,3,5,0,0,0
2020-06-25 01:15,12,6,6,0,0,0
2020-06-25 01:30,6,3,3,0,0,0
2020-06-25 01:45,10,5,5,0,0,0
2020-06-25 02:00,6,3,3,0,0,0
2020-06-25 02:15,6,1,5,0,0,0
2020-06-25 02:30,1,0,1,0,0,0
2020-06-25 02:45,1,0,1,0,0,0
2020-06-25 03:00,2,0,2,0,0,0
2020-06-25 03:15,1,0,1,0,0,0
2020-06-25 03:30,1,1,0,0,0,0
2020-06-25 03:45,0,0,0,0,0,0
2020-06-25 04:00,0,0,0,0,0,0
2020-06-25 04:15,2,1,1,0,0,0
2020-06-25 04:30,0,0,0,0,0,0
2020-06-25 04:45,3,1,2,0,0,0
2020-06-25 05:00,2,2,0,0,0,0
2020-06-25 05:15,4,4,0,0,0,0
2020-06-25 05:30,17,11,6,0,0,0
2020-06-25 05:45,22,9,13,0,0,0
2020-06-25 06:00,19,13,6,0,0,0
2020-06-25 06:15,28,16,12,0,0,0
2020-06-25 06:30,36,24,12,0,0,0
2020-06-25 06:45,73,50,23,0,0,0
2020-06-25 07:00,93,66,27,0,0,0
2020-06-25 07:15,114,72,42,0,0,0
2020-06-25 07:30,171,118,53,0,0,0
2020-06-25 07:45,182,122,60,0,0,0
2020-06-25 08:00,134,101,33,0,0,0
2020-06-25 08:15,145,100,45,0,0,0
2020-06-25 08:30,129,98,31,0,0,0
2020-06-25 08:45,119,92,27,0,0,0
2020-06-25 09:00,134,102,32,0,0,0
2020-06-25 09:15,110,78,32,0,0,0
2020-06-25 09:30,118,80,38,0,0,0
2020-06-25 09:45,136,97,39,0,0,0
2020-06-25 10:00,80,55,25,0,0,0
2020-06-25 10:15,91,63,28,0,0,0
2020-06-25 10:30,117,78,39,0,0,0
2020-06-25 10:45,137,80,57,0,0,0
2020-06-25 11:00,105,59,46,0,0,0
2020-06-25 11:15,131,84,47,0,0,0
2020-06-25 11:30,133,77,56,0,0,0
2020-06-25 11:45,128,72,56,0,0,0
2020-06-25 12:00,90,68,22,0,0,0
2020-06-25 12:15,68,68,0,0,0,0
2020-06-25 12:30,82,69,13,0,0,0
2020-06-25 12:45,143,78,65,0,0,0
2020-06-25 13:00,138,72,66,0,0,0
2020-06-25 13:15,133,72,61,0,0,0
2020-06-25 13:30,115,60,55,0,0,0
2020-06-25 13:45,131,83,48,0,0,0
2020-06-25 14:00,137,69,68,0,0,0
2020-06-25 14:15,159,91,68,0,0,0
2020-06-25 14:30,183,110,73,0,0,0
2020-06-25 14:45,136,79,57,0,0,0
2020-06-25 15:00,131,82,49,0,0,0
2020-06-25 15:15,146,77,69,0,0,0
2020-06-25 15:30,155,95,60,0,0,0
2020-06-25 15:45,200,130,70,0,0,0
2020-06-25 16:00,173,82,91,0,0,0
2020-06-25 16:15,188,101,87,0,0,0
2020-06-25 16:30,166,93,73,0,0,0
2020-06-25 16:45,171,100,71,0,0,0
2020-06-25 17:00,175,92,83,0,0,0
2020-06-25 17:15,157,96,61,0,0,0
2020-06-25 17:30,174,116,58,0,0,0
2020-06-25 17:45,177,114,63,0,0,0
2020-06-25 18:00,169,113,56,0,0,0
2020-06-25 18:15,170,99,71,0,0,0
2020-06-25 18:30,149,81,68,0,0,0
2020-06-25 18:45,143,85,58,0,0,0
2020-06-25 19:00,145,85,60,0,0,0
2020-06-25 19:15,129,77,52,0,0,0
2020-06-25 19:30,102,57,45,0,0,0
2020-06-25 19:45,120,65,55,0,0,0
2020-06-25 20:00,122,76,46,0,0,0
2020-06-25 20:15,69,40,29,0,0,0
2020-06-25 20:30,73,34,39,0,0,0
2020-06-25 20:45,61,35,26,0,0,0
2020-06-25 21:00,61,42,19,0,0,0
2020-06-25 21:15,67,39,28,0,0,0
2020-06-25 21:30,60,39,21,0,0,0
2020-06-25 21:45,45,23,22,0,0,0
2020-06-25 22:00,56,35,21,0,0,0
2020-06-25 22:15,45,33,12,0,0,0
2020-06-25 22:30,69,42,27,0,0,0
2020-06-25 22:45,42,26,16,0,0,0
2020-06-25 23:00,55,35,20,0,0,0
2020-06-25 23:15,43,35,8,0,0,0
2020-06-25 23:30,29,22,7,0,0,0
2020-06-25 23:45,34,23,11,0,0,0
2020-06-26 00:00,26,18,8,0,0,0
2020-06-26 00:15,11,5,6,0,0,0
2020-06-26 00:30,14,8,6,0,0,0
2020-06-26 00:45,19,7,12,0,0,0
2020-06-26 01:00,10,8,2,0,0,0
2020-06-26 01:15,4,1,3,0,0,0
2020-06-26 01:30,9,3,6,0,0,0
2020-06-26 01:45,2,2,0,0,0,0
2020-06-26 02:00,5,2,3,0,0,0
2020-06-26 02:15,4,2,2,0,0,0
2020-06-26 02:30,3,3,0,0,0,0
2020-06-26 02:45,2,0,2,0,0,0
2020-06-26 03:00,1,0,1,0,0,0
2020-06-26 03:15,4,2,2,0,0,0
2020-06-26 03:30,4,3,1,0,0,0
2020-06-26 03:45,3,0,3,0,0,0
2020-06-26 04:00,0,0,0,0,0,0
2020-06-26 04:15,2,0,2,0,0,0
2020-06-26 04:30,1,1,0,0,0,0
2020-06-26 04:45,2,0,2,0,0,0
2020-06-26 05:00,4,2,2,0,0,0
2020-06-26 05:15,7,3,4,0,0,0
2020-06-26 05:30,10,7,3,0,0,0
2020-06-26 05:45,14,4,10,0,0,0
2020-06-26 06:00,28,13,15,0,0,0
2020-06-26 06:15,24,16,8,0,0,0
2020-06-26 06:30,47,33,14,0,0,0
2020-06-26 06:45,71,47,24,0,0,0
2020-06-26 07:00,83,58,25,0,0,0
2020-06-26 07:15,97,66,31,0,0,0
2020-06-26 07:30,168,125,43,0,0,0
2020-06-26 07:45,160,119,41,0,0,0
2020-06-26 08:00,132,94,38,0,0,0
2020-06-26 08:15,123,81,42,0,0,0
2020-06-26 08:30,100,69,31,0,0,0
2020-06-26 08:45,145,108,37,0,0,0
2020-06-26 09:00,101,74,27,0,0,0
2020-06-26 09:15,121,88,33,0,0,0
2020-06-26 09:30,108,75,33,0,0,0
2020-06-26 09:45,133,92,41,0,0,0
2020-06-26 10:00,107,75,32,0,0,0
2020-06-26 10:15,124,77,47,0,0,0
2020-06-26 10:30,130,90,40,0,0,0
2020-06-26 10:45,133,87,46,0,0,0
2020-06-26 11:00,135,76,59,0,0,0
2020-06-26 11:15,138,77,61,0,0,0
2020-06-26 11:30,109,66,43,0,0,0
2020-06-26 11:45,128,90,38,0,0,0
2020-06-26 12:00,137,87,50,0,0,0
2020-06-26 12:15,168,85,83,0,0,0
2020-06-26 12:30,145,81,64,0,0,0
2020-06-26 12:45,159,81,78,0,0,0
2020-06-26 13:00,133,67,66,0,0,0
2020-06-26 13:15,140,71,69,0,0,0
2020-06-26 13:30,122,72,50,0,0,0
2020-06-26 13:45,172,92,80,0,0,0
2020-06-26 14:00,141,78,63,0,0,0
2020-06-26 14:15,148,86,62,0,0,0
2020-06-26 14:30,172,106,66,0,0,0
2020-06-26 14:45,162,91,71,0,0,0
2020-06-26 15:00,175,98,77,0,0,0
2020-06-26 15:15,185,96,89,0,0,0
2020-06-26 15:30,164,69,95,0,0,0
2020-06-26 15:45,153,74,79,0,0,0
2020-06-26 16:00,164,91,73,0,0,0
2020-06-26 16:15,158,65,93,0,0,0
2020-06-26 16:30,163,88,75,0,0,0
2020-06-26 16:45,173,87,86,0,0,0
2020-06-26 17:00,163,89,74,0,0,0
2020-06-26 17:15,159,81,78,0,0,0
2020-06-26 17:30,161,87,74,0,0,0
2020-06-26 17:45,182,100,82,0,0,0
2020-06-26 18:00,180,90,90,0,0,0
2020-06-26 18:15,153,66,87,0,0,0
2020-06-26 18:30,148,89,59,0,0,0
2020-06-26 18:45,147,98,49,0,0,0
2020-06-26 19:00,166,94,72,0,0,0
2020-06-26 19:15,141,76,65,0,0,0
2020-06-26 19:30,99,67,32,0,0,0
2020-06-26 19:45,129,91,38,0,0,0
2020-06-26 20:00,103,62,41,0,0,0
2020-06-26 20:15,96,60,36,0,0,0
2020-06-26 20:30,84,48,36,0,0,0
2020-06-26 20:45,90,60,30,0,0,0
2020-06-26 21:00,61,34,27,0,0,0
2020-06-26 21:15,68,38,30,0,0,0
2020-06-26 21:30,79,45,34,0,0,0
2020-06-26 21:45,87,58,29,0,0,0
2020-06-26 22:00,77,55,22,0,0,0
2020-06-26 22:15,56,35,21,0,0,0
2020-06-26 22:30,57,38,19,0,0,0
2020-06-26 22:45,44,32,12,0,0,0
2020-06-26 23:00,62,41,21,0,0,0
2020-06-26 23:15,53,42,11,0,0,0
2020-06-26 23:30,51,39,12,0,0,0
2020-06-26 23:45,52,39,13,0,0,0
2020-06-27 00:00,46,30,16,0,0,0
2020-06-27 00:15,39,28,11,0,0,0
2020-06-27 00:30,29,17,12,0,0,0
2020-06-27 00:45,39,22,17,0,0,0
2020-06-27 01:00,27,14,13,0,0,0
2020-06-27 01:15,36,16,20,0,0,0
2020-06-27 01:30,21,7,14,0,0,0
2020-06-27 01:45,14,9,5,0,0,0
2020-06-27 02:00,15,5,10,0,0,0
2020-06-27 02:15,10,6,4,0,0,0
2020-06-27 02:30,9,7,2,0,0,0
2020-06-27 02:45,12,6,6,0,0,0
2020-06-27 03:00,6,2,4,0,0,0
2020-06-27 03:15,9,5,4,0,0,0
2020-06-27 03:30,1,1,0,0,0,0
2020-06-27 03:45,7,0,7,0,0,0
2020-06-27 04:00,7,0,7,0,0,0
2020-06-27 04:15,4,0,4,0,0,0
2020-06-27 04:30,5,2,3,0,0,0
2020-06-27 04:45,3,1,2,0,0,0
2020-06-27 05:00,2,1,1,0,0,0
2020-06-27 05:15,4,4,0,0,0,0
2020-06-27 05:30,5,3,2,0,0,0
2020-06-27 05:45,7,3,4,0,0,0
2020-06-27 06:00,4,4,0,0,0,0
2020-06-27 06:15,2,2,0,0,0,0
2020-06-27 06:30,9,7,2,0,0,0
2020-06-27 06:45,20,17,3,0,0,0
2020-06-27 07:00,12,5,7,0,0,0
2020-06-27 07:15,26,16,10,0,0,0
2020-06-27 07:30,30,21,9,0,0,0
2020-06-27 07:45,43,30,13,0,0,0
2020-06-27 08:00,43,31,12,0,0,0
2020-06-27 08:15,54,37,17,0,0,0
2020-06-27 08:30,55,40,15,0,0,0
2020-06-27 08:45,67,42,25,0,0,0
2020-06-27 09:00,63,48,15,0,0,0
2020-06-27 09:15,92,65,27,0,0,0
2020-06-27 09:30,97,68,29,0,0,0
2020-06-27 09:45,129,101,28,0,0,0
2020-06-27 10:00,108,75,33,0,0,0
2020-06-27 10:15,114,82,32,0,0,0
2020-06-27 10:30,103,72,31,0,0,0
2020-06-27 10:45,137,98,39,0,0,0
2020-06-27 11:00,131,85,46,0,0,0
2020-06-27 11:15,119,81,38,0,0,0
2020-06-27 11:30,141,86,55,0,0,0
2020-06-27 11:45,133,93,40,0,0,0
2020-06-27 12:00,171,100,71,0,0,0
2020-06-27 12:15,135,84,51,0,0,0
2020-06-27 12:30,142,94,48,0,0,0
2020-06-27 12:45,144,78,66,0,0,0
2020-06-27 13:00,164,100,64,0,0,0
2020-06-27 13:15,143,74,69,0,0,0
2020-06-27 13:30,143,86,57,0,0,0
2020-06-27 13:45,134,70,64,0,0,0
2020-06-27 14:00,117,76,41,0,0,0
2020-06-27 14:15,141,88,53,0,0,0
2020-06-27 14:30,138,80,58,0,0,0
2020-06-27 14:45,122,66,56,0,0,0
2020-06-27 15:00,108,62,46,0,0,0
2020-06-27 15:15,121,64,57,0,0,0
2020-06-27 15:30,89,40,49,0,0,0
2020-06-27 15:45,89,50,39,0,0,0
2020-06-27 16:00,80,46,34,0,0,0
2020-06-27 16:15,87,55,32,0,0,0
2020-06-27 16:30,89,54,35,0,0,0
2020-06-27 16:45,83,55,28,0,0,0
2020-06-27 17:00,82,49,33,0,0,0
2020-06-27 17:15,114,70,44,0,0,0
2020-06-27 17:30,80,40,40,0,0,0
2020-06-27 17:45,113,61,52,0,0,0
2020-06-27 18:00,102,59,43,0,0,0
2020-06-27 18:15,124,57,67,0,0,0
2020-06-27 18:30,79,49,30,0,0,0
2020-06-27 18:45,85,33,52,0,0,0
2020-06-27 19:00,76,43,33,0,0,0
2020-06-27 19:15,96,57,39,0,0,0
2020-06-27 19:30,77,45,32,0,0,0
2020-06-27 19:45,91,50,41,0,0,0
2020-06-27 20:00,81,44,37,0,0,0
2020-06-27 20:15,67,33,34,0,0,0
2020-06-27 20:30,62,27,35,0,0,0
2020-06-27 20:45,57,36,21,0,0,0
2020-06-27 21:00,52,34,18,0,0,0
2020-06-27 21:15,47,33,14,0,0,0
2020-06-27 21:30,27,20,7,0,0,0
2020-06-27 21:45,47,32,15,0,0,0
2020-06-27 22:00,41,15,26,0,0,0
2020-06-27 22:15,39,25,14,0,0,0
2020-06-27 22:30,38,23,15,0,0,0
2020-06-27 22:45,26,14,12,0,0,0
2020-06-27 23:00,26,14,12,0,0,0
2020-06-27 23:15,35,21,14,0,0,0
2020-06-27 23:30,44,28,16,0,0,0
2020-06-27 23:45,26,14,12,0,0,0
2020-06-28 00:00,41,23,18,0,0,0
2020-06-28 00:15,33,20,13,0,0,0
2020-06-28 00:30,22,16,6,0,0,0
2020-06-28 00:45,28,12,16,0,0,0
2020-06-28 01:00,22,14,8,0,0,0
2020-06-28 01:15,31,20,11,0,0,0
2020-06-28 01:30,23,12,11,0,0,0
2020-06-28 01:45,18,1,17,0,0,0
2020-06-28 02:00,23,13,10,0,0,0
2020-06-28 02:15,20,12,8,0,0,0
2020-06-28 02:30,7,4,3,0,0,0
2020-06-28 02:45,12,7,5,0,0,0
2020-06-28 03:00,11,7,4,0,0,0
2020-06-28 03:15,6,0,6,0,0,0
2020-06-28 03:30,7,3,4,0,0,0
2020-06-28 03:45,3,0,3,0,0,0
2020-06-28 04:00,7,2,5,0,0,0
2020-06-28 04:15,5,1,4,0,0,0
2020-06-28 04:30,5,1,4,0,0,0
2020-06-28 04:45,5,3,2,0,0,0
2020-06-28 05:00,4,2,2,0,0,0
2020-06-28 05:15,6,3,3,0,0,0
2020-06-28 05:30,5,2,3,0,0,0
2020-06-28 05:45,5,2,3,0,0,0
2020-06-28 06:00,7,6,1,0,0,0
2020-06-28 06:15,4,3,1,0,0,0
2020-06-28 06:30,3,1,2,0,0,0
2020-06-28 06:45,3,2,1,0,0,0
2020-06-28 07:00,5,2,3,0,0,0
2020-06-28 07:15,6,5,1,0,0,0
2020-06-28 07:30,11,6,5,0,0,0
2020-06-28 07:45,13,8,5,0,0,0
2020-06-28 08:00,13,11,2,0,0,0
2020-06-28 08:15,18,13,5,0,0,0
2020-06-28 08:30,13,8,5,0,0,0
2020-06-28 08:45,16,12,4,0,0,0
2020-06-28 09:00,15,7,8,0,0,0
2020-06-28 09:15,18,8,10,0,0,0
2020-06-28 09:30,27,13,14,0,0,0
2020-06-28 09:45,46,24,22,0,0,0
2020-06-28 10:00,34,26,8,0,0,0
2020-06-28 10:15,29,18,11,0,0,0
2020-06-28 10:30,29,21,8,0,0,0
2020-06-28 10:45,34,28,6,0,0,0
2020-06-28 11:00,41,29,12,0,0,0
2020-06-28 11:15,36,23,13,0,0,0
2020-06-28 11:30,24,18,6,0,0,0
2020-06-28 11:45,54,30,24,0,0,0
2020-06-28 12:00,35,20,15,0,0,0
2020-06-28 12:15,49,29,20,0,0,0
2020-06-28 12:30,64,34,30,0,0,0
2020-06-28 12:45,54,29,25,0,0,0
2020-06-28 13:00,34,22,12,0,0,0
2020-06-28 13:15,49,31,18,0,0,0
2020-06-28 13:30,75,38,37,0,0,0
2020-06-28 13:45,57,34,23,0,0,0
2020-06-28 14:00,48,30,18,0,0,0
2020-06-28 14:15,64,33,31,0,0,0
2020-06-28 14:30,49,30,19,0,0,0
2020-06-28 14:45,73,35,38,0,0,0
2020-06-28 15:00,74,42,32,0,0,0
2020-06-28 15:15,72,36,36,0,0,0
2020-06-28 15:30,70,46,24,0,0,0
2020-06-28 15:45,76,52,24,0,0,0
2020-06-28 16:00,67,38,29,0,0,0
2020-06-28 16:15,79,48,31,0,0,0
2020-06-28 16:30,72,43,29,0,0,0
2020-06-28 16:45,86,59,27,0,0,0
2020-06-28 17:00,78,52,26,0,0,0
2020-06-28 17:15,82,50,32,0,0,0
2020-06-28 17:30,91,45,46,0,0,0
2020-06-28 17:45,89,55,34,0,0,0
2020-06-28 18:00,81,42,39,0,0,0
2020-06-28 18:15,74,37,37,0,0,0
2020-06-28 18:30,67,34,33,0,0,0
2020-06-28 18:45,69,48,21,0,0,0
2020-06-28 19:00,55,33,22,0,0,0
2020-06-28 19:15,58,32,26,0,0,0
2020-06-28 19:30,45,19,26,0,0,0
2020-06-28 19:45,56,25,31,0,0,0
2020-06-28 20:00,47,27,20,0,0,0
2020-06-28 20:15,39,22,17,0,0,0
2020-06-28 20:30,27,15,12,0,0,0
2020-06-28 20:45,28,12,16,0,0,0
2020-06-28 21:00,37,19,18,0,0,0
2020-06-28 21:15,36,21,15,0,0,0
2020-06-28 21:30,23,14,9,0,0,0
2020-06-28 21:45,31,22,9,0,0,0
2020-06-28 22:00,19,8,11,0,0,0
2020-06-28 22:15,29,18,11,0,0,0
2020-06-28 22:30,15,9,6,0,0,0
2020-06-28 22:45,11,4,7,0,0,0
2020-06-28 23:00,12,5,7,0,0,0
2020-06-28 23:15,20,13,7,0,0,0
2020-06-28 23:30,10,5,5,0,0,0
2020-06-28 23:45,8,4,4,0,0,0
2020-06-29 00:00,6,1,5,0,0,0
2020-06-29 00:15,7,2,5,0,0,0
2020-06-29 00:30,8,2,6,0,0,0
2020-06-29 00:45,5,0,5,0,0,0
2020-06-29 01:00,4,1,3,0,0,0
2020-06-29 01:15,3,0,3,0,0,0
2020-06-29 01:30,1,1,0,0,0,0
2020-06-29 01:45,7,2,5,0,0,0
2020-06-29 02:00,5,2,3,0,0,0
2020-06-29 02:15,0,0,0,0,0,0
2020-06-29 02:30,2,2,0,0,0,0
2020-06-29 02:45,1,1,0,0,0,0
2020-06-29 03:00,2,1,1,0,0,0
2020-06-29 03:15,0,0,0,0,0,0
2020-06-29 03:30,0,0,0,0,0,0
2020-06-29 03:45,1,0,1,0,0,0
2020-06-29 04:00,1,1,0,0,0,0
2020-06-29 04:15,3,1,2,0,0,0
2020-06-29 04:30,1,1,0,0,0,0
2020-06-29 04:45,4,1,3,0,0,0
2020-06-29 05:00,0,0,0,0,0,0
2020-06-29 05:15,5,4,1,0,0,0
2020-06-29 05:30,14,9,5,0,0,0
2020-06-29 05:45,19,7,12,0,0,0
2020-06-29 06:00,18,12,6,0,0,0
2020-06-29 06:15,34,18,16,0,0,0
2020-06-29 06:30,53,34,19,0,0,0
2020-06-29 06:45,60,42,18,0,0,0
2020-06-29 07:00,79,52,27,0,0,0
2020-06-29 07:15,120,73,47,0,0,0
2020-06-29 07:30,116,72,44,0,0,0
2020-06-29 07:45,120,89,31,0,0,0
2020-06-29 08:00,119,80,39,0,0,0
2020-06-29 08:15,122,86,36,0,0,0
2020-06-29 08:30,124,100,24,0,0,0
2020-06-29 08:45,124,87,37,0,0,0
2020-06-29 09:00,57,37,20,0,0,0
2020-06-29 09:15,87,66,21,0,0,0
2020-06-29 09:30,80,60,20,0,0,0
2020-06-29 09:45,129,97,32,0,0,0
2020-06-29 10:00,88,57,31,0,0,0
2020-06-29 10:15,88,58,30,0,0,0
2020-06-29 10:30,93,66,27,0,0,0
2020-06-29 10:45,120,82,38,0,0,0
2020-06-29 11:00,101,68,33,0,0,0
2020-06-29 11:15,97,58,39,0,0,0
2020-06-29 11:30,99,60,39,0,0,0
2020-06-29 11:45,104,62,42,0,0,0
2020-06-29 12:00,132,90,42,0,0,0
2020-06-29 12:15,121,60,61,0,0,0
2020-06-29 12:30,98,53,45,0,0,0
2020-06-29 12:45,116,62,54,0,0,0
2020-06-29 13:00,102,58,44,0,0,0
2020-06-29 13:15,120,68,52,0,0,0
2020-06-29 13:30,108,71,37,0,0,0
2020-06-29 13:45,119,66,53,0,0,0
2020-06-29 14:00,115,59,56,0,0,0
2020-06-29 14:15,117,66,51,0,0,0
2020-06-29 14:30,136,84,52,0,0,0
2020-06-29 14:45,128,79,49,0,0,0
2020-06-29 15:00,154,91,63,0,0,0
2020-06-29 15:15,112,69,43,0,0,0
2020-06-29 15:30,130,77,53,0,0,0
2020-06-29 15:45,164,105,59,0,0,0
2020-06-29 16:00,175,90,85,0,0,0
2020-06-29 16:15,175,92,83,0,0,0
2020-06-29 16:30,176,81,95,0,0,0
2020-06-29 16:45,167,94,73,0,0,0
2020-06-29 17:00,195,97,98,0,0,0
2020-06-29 17:15,169,70,99,0,0,0
2020-06-29 17:30,149,78,71,0,0,0
2020-06-29 17:45,185,94,91,0,0,0
2020-06-29 18:00,167,71,96,0,0,0
2020-06-29 18:15,125,61,64,0,0,0
2020-06-29 18:30,96,44,52,0,0,0
2020-06-29 18:45,114,52,62,0,0,0
2020-06-29 19:00,112,47,65,0,0,0
2020-06-29 19:15,121,69,52,0,0,0
2020-06-29 19:30,87,35,52,0,0,0
2020-06-29 19:45,81,39,42,0,0,0
2020-06-29 20:00,93,47,46,0,0,0
2020-06-29 20:15,69,31,38,0,0,0
2020-06-29 20:30,38,18,20,0,0,0
2020-06-29 20:45,57,26,31,0,0,0
2020-06-29 21:00,36,22,14,0,0,0
2020-06-29 21:15,45,24,21,0,0,0
2020-06-29 21:30,28,11,17,0,0,0
2020-06-29 21:45,36,21,15,0,0,0
2020-06-29 22:00,24,8,16,0,0,0
2020-06-29 22:15,28,14,14,0,0,0
2020-06-29 22:30,47,24,23,0,0,0
2020-06-29 22:45,34,20,14,0,0,0
2020-06-29 23:00,27,20,7,0,0,0
2020-06-29 23:15,12,6,6,0,0,0
2020-06-29 23:30,16,12,4,0,0,0
2020-06-29 23:45,16,5,11,0,0,0
2020-06-30 00:00,18,12,6,0,0,0
2020-06-30 00:15,9,8,1,0,0,0
2020-06-30 00:30,2,0,2,0,0,0
2020-06-30 00:45,10,3,7,0,0,0
2020-06-30 01:00,5,1,4,0,0,0
2020-06-30 01:15,5,3,2,0,0,0
2020-06-30 01:30,3,2,1,0,0,0
2020-06-30 01:45,3,2,1,0,0,0
2020-06-30 02:00,3,3,0,0,0,0
2020-06-30 02:15,1,1,0,0,0,0
2020-06-30 02:30,1,1,0,0,0,0
2020-06-30 02:45,2,1,1,0,0,0
2020-06-30 03:00,1,1,0,0,0,0
2020-06-30 03:15,1,0,1,0,0,0
2020-06-30 03:30,2,1,1,0,0,0
2020-06-30 03:45,2,1,1,0,0,0
2020-06-30 04:00,2,1,1,0,0,0
2020-06-30 04:15,2,0,2,0,0,0
2020-06-30 04:30,2,1,1,0,0,0
2020-06-30 04:45,5,1,4,0,0,0
2020-06-30 05:00,4,2,2,0,0,0
2020-06-30 05:15,4,2,2,0,0,0
2020-06-30 05:30,16,9,7,0,0,0
2020-06-30 05:45,24,13,11,0,0,0
2020-06-30 06:00,20,13,7,0,0,0
2020-06-30 06:15,26,16,10,0,0,0
2020-06-30 06:30,39,21,18,0,0,0
2020-06-30 06:45,71,44,27,0,0,0
2020-06-30 07:00,87,51,36,0,0,0
2020-06-30 07:15,88,46,42,0,0,0
2020-06-30 07:30,121,81,40,0,0,0
2020-06-30 07:45,144,95,49,0,0,0
2020-06-30 08:00,112,82,30,0,0,0
2020-06-30 08:15,119,75,44,0,0,0
2020-06-30 08:30,129,95,34,0,0,0
2020-06-30 08:45,145,109,36,0,0,0
2020-06-30 09:00,87,67,20,0,0,0
2020-06-30 09:15,107,73,34,0,0,0
2020-06-30 09:30,91,64,27,0,0,0
2020-06-30 09:45,92,60,32,0,0,0
2020-06-30 10:00,99,66,33,0,0,0
2020-06-30 10:15,105,80,25,0,0,0
2020-06-30 10:30,104,68,36,0,0,0
2020-06-30 10:45,99,65,34,0,0,0
2020-06-30 11:00,79,61,18,0,0,0
2020-06-30 11:15,109,64,45,0,0,0
2020-06-30 11:30,97,72,25,0,0,0
2020-06-30 11:45,107,62,45,0,0,0
2020-06-30 12:00,102,63,39,0,0,0
2020-06-30 12:15,136,80,56,0,0,0
2020-06-30 12:30,113,69,44,0,0,0
2020-06-30 12:45,120,67,53,0,0,0
2020-06-30 13:00,123,59,64,0,0,0
2020-06-30 13:15,111,58,53,0,0,0
2020-06-30 13:30,97,50,47,0,0,0
2020-06-30 13:45,128,77,51,0,0,0
2020-06-30 14:00,111,51,60,0,0,0
2020-06-30 14:15,123,71,52,0,0,0
2020-06-30 14:30,128,76,52,0,0,0
2020-06-30 14:45,126,76,50,0,0,0
2020-06-30 15:00,116,79,37,0,0,0
2020-06-30 15:15,140,74,66,0,0,0
2020-06-30 15:30,124,71,53,0,0,0
2020-06-30 15:45,136,84,52,0,0,0
2020-06-30 16:00,163,83,80,0,0,0
2020-06-30 16:15,165,88,77,0,0,0
2020-06-30 16:30,170,82,88,0,0,0
2020-06-30 16:45,162,87,75,0,0,0
2020-06-30 17:00,186,93,93,0,0,0
2020-06-30 17:15,149,77,72,0,0,0
2020-06-30 17:30,139,69,70,0,0,0
2020-06-30 17:45,169,86,83,0,0,0
2020-06-30 18:00,150,70,80,0,0,0
2020-06-30 18:15,122,69,53,0,0,0
2020-06-30 18:30,118,57,61,0,0,0
2020-06-30 18:45,116,60,56,0,0,0
2020-06-30 19:00,97,47,50,0,0,0
2020-06-30 19:15,86,38,48,0,0,0
2020-06-30 19:30,64,32,32,0,0,0
2020-06-30 19:45,80,32,48,0,0,0
2020-06-30 20:00,75,38,37,0,0,0
2020-06-30 20:15,79,29,50,0,0,0
2020-06-30 20:30,48,19,29,0,0,0
2020-06-30 20:45,50,30,20,0,0,0
2020-06-30 21:00,53,23,30,0,0,0
2020-06-30 21:15,41,15,26,0,0,0
2020-06-30 21:30,34,22,12,0,0,0
2020-06-30 21:45,42,17,25,0,0,0
2020-06-30 22:00,30,17,13,0,0,0
2020-06-30 22:15,30,18,12,0,0,0
2020-06-30 22:30,31,21,10,0,0,0
2020-06-30 22:45,32,17,15,0,0,0
2020-06-30 23:00,26,16,10,0,0,0
2020-06-30 23:15,30,23,7,0,0,0
2020-06-30 23:30,16,7,9,0,0,0
2020-06-30 23:45,15,9,6,0,0,0
