Datetime,100034983 (Warendorfer Straße),101034983 (Warendorfer Straße stadteinwärts),102034983 (Warendorfer Straße stadtauswärts),100034983-status,101034983-status,102034983-status
2020-11-01 00:00,22,18,4,0,0,0
2020-11-01 00:15,29,15,14,0,0,0
2020-11-01 00:30,21,13,8,0,0,0
2020-11-01 00:45,22,14,8,0,0,0
2020-11-01 01:00,14,10,4,0,0,0
2020-11-01 01:15,12,8,4,0,0,0
2020-11-01 01:30,9,2,7,0,0,0
2020-11-01 01:45,16,10,6,0,0,0
2020-11-01 02:00,21,12,9,0,0,0
2020-11-01 02:15,7,3,4,0,0,0
2020-11-01 02:30,8,0,8,0,0,0
2020-11-01 02:45,5,0,5,0,0,0
2020-11-01 03:00,3,1,2,0,0,0
2020-11-01 03:15,7,5,2,0,0,0
2020-11-01 03:30,6,3,3,0,0,0
2020-11-01 03:45,9,6,3,0,0,0
2020-11-01 04:00,7,6,1,0,0,0
2020-11-01 04:15,5,4,1,0,0,0
2020-11-01 04:30,0,0,0,0,0,0
2020-11-01 04:45,3,0,3,0,0,0
2020-11-01 05:00,2,0,2,0,0,0
2020-11-01 05:15,5,2,3,0,0,0
2020-11-01 05:30,7,5,2,0,0,0
2020-11-01 05:45,13,5,8,0,0,0
2020-11-01 06:00,3,1,2,0,0,0
2020-11-01 06:15,3,3,0,0,0,0
2020-11-01 06:30,1,0,1,0,0,0
2020-11-01 06:45,5,3,2,0,0,0
2020-11-01 07:00,3,1,2,0,0,0
2020-11-01 07:15,7,6,1,0,0,0
2020-11-01 07:30,5,4,1,0,0,0
2020-11-01 07:45,4,2,2,0,0,0
2020-11-01 08:00,8,5,3,0,0,0
2020-11-01 08:15,16,16,0,0,0,0
2020-11-01 08:30,5,4,1,0,0,0
2020-11-01 08:45,21,14,7,0,0,0
2020-11-01 09:00,10,6,4,0,0,0
2020-11-01 09:15,14,8,6,0,0,0
2020-11-01 09:30,20,16,4,0,0,0
2020-11-01 09:45,45,35,10,0,0,0
2020-11-01 10:00,31,23,8,0,0,0
2020-11-01 10:15,34,26,8,0,0,0
2020-11-01 10:30,46,35,11,0,0,0
2020-11-01 10:45,49,28,21,0,0,0
2020-11-01 11:00,40,27,13,0,0,0
2020-11-01 11:15,47,31,16,0,0,0
2020-11-01 11:30,50,28,22,0,0,0
2020-11-01 11:45,63,49,14,0,0,0
2020-11-01 12:00,60,23,37,0,0,0
2020-11-01 12:15,53,31,22,0,0,0
2020-11-01 12:30,63,31,32,0,0,0
2020-11-01 12:45,66,37,29,0,0,0
2020-11-01 13:00,63,40,23,0,0,0
2020-11-01 13:15,48,31,17,0,0,0
2020-11-01 13:30,65,32,33,0,0,0
2020-11-01 13:45,73,53,20,0,0,0
2020-11-01 14:00,68,41,27,0,0,0
2020-11-01 14:15,60,33,27,0,0,0
2020-11-01 14:30,62,38,24,0,0,0
2020-11-01 14:45,77,43,34,0,0,0
2020-11-01 15:00,54,38,16,0,0,0
2020-11-01 15:15,63,36,27,0,0,0
2020-11-01 15:30,51,27,24,0,0,0
2020-11-01 15:45,64,34,30,0,0,0
2020-11-01 16:00,66,38,28,0,0,0
2020-11-01 16:15,42,21,21,0,0,0
2020-11-01 16:30,45,22,23,0,0,0
2020-11-01 16:45,57,35,22,0,0,0
2020-11-01 17:00,51,32,19,0,0,0
2020-11-01 17:15,41,25,16,0,0,0
2020-11-01 17:30,52,22,30,0,0,0
2020-11-01 17:45,61,37,24,0,0,0
2020-11-01 18:00,58,31,27,0,0,0
2020-11-01 18:15,29,13,16,0,0,0
2020-11-01 18:30,27,20,7,0,0,0
2020-11-01 18:45,31,13,18,0,0,0
2020-11-01 19:00,37,27,10,0,0,0
2020-11-01 19:15,34,18,16,0,0,0
2020-11-01 19:30,32,13,19,0,0,0
2020-11-01 19:45,35,13,22,0,0,0
2020-11-01 20:00,45,24,21,0,0,0
2020-11-01 20:15,30,12,18,0,0,0
2020-11-01 20:30,24,14,10,0,0,0
2020-11-01 20:45,21,10,11,0,0,0
2020-11-01 21:00,21,11,10,0,0,0
2020-11-01 21:15,18,8,10,0,0,0
2020-11-01 21:30,28,17,11,0,0,0
2020-11-01 21:45,20,15,5,0,0,0
2020-11-01 22:00,23,10,13,0,0,0
2020-11-01 22:15,9,3,6,0,0,0
2020-11-01 22:30,21,10,11,0,0,0
2020-11-01 22:45,10,7,3,0,0,0
2020-11-01 23:00,14,10,4,0,0,0
2020-11-01 23:15,11,5,6,0,0,0
2020-11-01 23:30,8,3,5,0,0,0
2020-11-01 23:45,12,5,7,0,0,0
2020-11-02 00:00,6,2,4,0,0,0
2020-11-02 00:15,12,7,5,0,0,0
2020-11-02 00:30,6,4,2,0,0,0
2020-11-02 00:45,1,1,0,0,0,0
2020-11-02 01:00,3,2,1,0,0,0
2020-11-02 01:15,0,0,0,0,0,0
2020-11-02 01:30,0,0,0,0,0,0
2020-11-02 01:45,1,1,0,0,0,0
2020-11-02 02:00,0,0,0,0,0,0
2020-11-02 02:15,1,0,1,0,0,0
2020-11-02 02:30,1,0,1,0,0,0
2020-11-02 02:45,0,0,0,0,0,0
2020-11-02 03:00,1,0,1,0,0,0
2020-11-02 03:15,0,0,0,0,0,0
2020-11-02 03:30,0,0,0,0,0,0
2020-11-02 03:45,0,0,0,0,0,0
2020-11-02 04:00,0,0,0,0,0,0
2020-11-02 04:15,1,1,0,0,0,0
2020-11-02 04:30,2,0,2,0,0,0
2020-11-02 04:45,0,0,0,0,0,0
2020-11-02 05:00,4,2,2,0,0,0
2020-11-02 05:15,2,2,0,0,0,0
2020-11-02 05:30,9,7,2,0,0,0
2020-11-02 05:45,24,16,8,0,0,0
2020-11-02 06:00,20,12,8,0,0,0
2020-11-02 06:15,25,15,10,0,0,0
2020-11-02 06:30,41,26,15,0,0,0
2020-11-02 06:45,65,45,20,0,0,0
2020-11-02 07:00,67,50,17,0,0,0
2020-11-02 07:15,154,117,37,0,0,0
2020-11-02 07:30,260,210,50,0,0,0
2020-11-02 07:45,188,133,55,0,0,0
2020-11-02 08:00,137,111,26,0,0,0
2020-11-02 08:15,114,82,32,0,0,0
2020-11-02 08:30,110,87,23,0,0,0
2020-11-02 08:45,133,91,42,0,0,0
2020-11-02 09:00,72,58,14,0,0,0
2020-11-02 09:15,79,54,25,0,0,0
2020-11-02 09:30,87,61,26,0,0,0
2020-11-02 09:45,82,60,22,0,0,0
2020-11-02 10:00,84,65,19,0,0,0
2020-11-02 10:15,89,54,35,0,0,0
2020-11-02 10:30,77,47,30,0,0,0
2020-11-02 10:45,66,37,29,0,0,0
2020-11-02 11:00,86,48,38,0,0,0
2020-11-02 11:15,90,50,40,0,0,0
2020-11-02 11:30,91,57,34,0,0,0
2020-11-02 11:45,100,60,40,0,0,0
2020-11-02 12:00,86,44,42,0,0,0
2020-11-02 12:15,98,55,43,0,0,0
2020-11-02 12:30,88,40,48,0,0,0
2020-11-02 12:45,139,59,80,0,0,0
2020-11-02 13:00,94,46,48,0,0,0
2020-11-02 13:15,95,45,50,0,0,0
2020-11-02 13:30,100,59,41,0,0,0
2020-11-02 13:45,143,89,54,0,0,0
2020-11-02 14:00,129,66,63,0,0,0
2020-11-02 14:15,99,52,47,0,0,0
2020-11-02 14:30,111,66,45,0,0,0
2020-11-02 14:45,126,61,65,0,0,0
2020-11-02 15:00,96,53,43,0,0,0
2020-11-02 15:15,97,49,48,0,0,0
2020-11-02 15:30,126,59,67,0,0,0
2020-11-02 15:45,156,82,74,0,0,0
2020-11-02 16:00,119,56,63,0,0,0
2020-11-02 16:15,129,68,61,0,0,0
2020-11-02 16:30,163,84,79,0,0,0
2020-11-02 16:45,162,76,86,0,0,0
2020-11-02 17:00,169,66,103,0,0,0
2020-11-02 17:15,101,46,55,0,0,0
2020-11-02 17:30,112,43,69,0,0,0
2020-11-02 17:45,116,50,66,0,0,0
2020-11-02 18:00,90,39,51,0,0,0
2020-11-02 18:15,103,47,56,0,0,0
2020-11-02 18:30,62,23,39,0,0,0
2020-11-02 18:45,45,17,28,0,0,0
2020-11-02 19:00,50,23,27,0,0,0
2020-11-02 19:15,44,18,26,0,0,0
2020-11-02 19:30,29,9,20,0,0,0
2020-11-02 19:45,21,11,10,0,0,0
2020-11-02 20:00,37,23,14,0,0,0
2020-11-02 20:15,32,17,15,0,0,0
2020-11-02 20:30,32,15,17,0,0,0
2020-11-02 20:45,18,11,7,0,0,0
2020-11-02 21:00,22,9,13,0,0,0
2020-11-02 21:15,21,11,10,0,0,0
2020-11-02 21:30,13,5,8,0,0,0
2020-11-02 21:45,14,7,7,0,0,0
2020-11-02 22:00,17,8,9,0,0,0
2020-11-02 22:15,13,4,9,0,0,0
2020-11-02 22:30,6,3,3,0,0,0
2020-11-02 22:45,10,4,6,0,0,0
2020-11-02 23:00,9,5,4,0,0,0
2020-11-02 23:15,8,0,8,0,0,0
2020-11-02 23:30,6,3,3,0,0,0
2020-11-02 23:45,7,4,3,0,0,0
2020-11-03 00:00,3,2,1,0,0,0
2020-11-03 00:15,1,0,1,0,0,0
2020-11-03 00:30,1,0,1,0,0,0
2020-11-03 00:45,3,1,2,0,0,0
2020-11-03 01:00,5,5,0,0,0,0
2020-11-03 01:15,3,2,1,0,0,0
2020-11-03 01:30,0,0,0,0,0,0
2020-11-03 01:45,0,0,0,0,0,0
2020-11-03 02:00,1,0,1,0,0,0
2020-11-03 02:15,1,0,1,0,0,0
2020-11-03 02:30,1,0,1,0,0,0
2020-11-03 02:45,1,0,1,0,0,0
2020-11-03 03:00,0,0,0,0,0,0
2020-11-03 03:15,2,2,0,0,0,0
2020-11-03 03:30,3,2,1,0,0,0
2020-11-03 03:45,0,0,0,0,0,0
2020-11-03 04:00,0,0,0,0,0,0
2020-11-03 04:15,1,1,0,0,0,0
2020-11-03 04:30,1,0,1,0,0,0
2020-11-03 04:45,2,0,2,0,0,0
2020-11-03 05:00,0,0,0,0,0,0
2020-11-03 05:15,4,2,2,0,0,0
2020-11-03 05:30,17,13,4,0,0,0
2020-11-03 05:45,13,8,5,0,0,0
2020-11-03 06:00,20,10,10,0,0,0
2020-11-03 06:15,27,20,7,0,0,0
2020-11-03 06:30,46,30,16,0,0,0
2020-11-03 06:45,75,58,17,0,0,0
2020-11-03 07:00,73,55,18,0,0,0
2020-11-03 07:15,182,142,40,0,0,0
2020-11-03 07:30,310,257,53,0,0,0
2020-11-03 07:45,238,176,62,0,0,0
2020-11-03 08:00,144,112,32,0,0,0
2020-11-03 08:15,120,88,32,0,0,0
2020-11-03 08:30,146,106,40,0,0,0
2020-11-03 08:45,134,101,33,0,0,0
2020-11-03 09:00,95,68,27,0,0,0
2020-11-03 09:15,105,78,27,0,0,0
2020-11-03 09:30,86,54,32,0,0,0
2020-11-03 09:45,110,89,21,0,0,0
2020-11-03 10:00,87,63,24,0,0,0
2020-11-03 10:15,87,64,23,0,0,0
2020-11-03 10:30,75,56,19,0,0,0
2020-11-03 10:45,100,62,38,0,0,0
2020-11-03 11:00,93,64,29,0,0,0
2020-11-03 11:15,92,49,43,0,0,0
2020-11-03 11:30,98,61,37,0,0,0
2020-11-03 11:45,110,70,40,0,0,0
2020-11-03 12:00,113,74,39,0,0,0
2020-11-03 12:15,102,49,53,0,0,0
2020-11-03 12:30,118,47,71,0,0,0
2020-11-03 12:45,120,60,60,0,0,0
2020-11-03 13:00,156,72,84,0,0,0
2020-11-03 13:15,134,67,67,0,0,0
2020-11-03 13:30,135,62,73,0,0,0
2020-11-03 13:45,152,68,84,0,0,0
2020-11-03 14:00,133,71,62,0,0,0
2020-11-03 14:15,122,75,47,0,0,0
2020-11-03 14:30,129,78,51,0,0,0
2020-11-03 14:45,147,89,58,0,0,0
2020-11-03 15:00,156,78,78,0,0,0
2020-11-03 15:15,123,76,47,0,0,0
2020-11-03 15:30,153,84,69,0,0,0
2020-11-03 15:45,171,103,68,0,0,0
2020-11-03 16:00,175,99,76,0,0,0
2020-11-03 16:15,166,83,83,0,0,0
2020-11-03 16:30,178,77,101,0,0,0
2020-11-03 16:45,161,87,74,0,0,0
2020-11-03 17:00,158,65,93,0,0,0
2020-11-03 17:15,152,64,88,0,0,0
2020-11-03 17:30,133,63,70,0,0,0
2020-11-03 17:45,126,60,66,0,0,0
2020-11-03 18:00,104,45,59,0,0,0
2020-11-03 18:15,106,48,58,0,0,0
2020-11-03 18:30,88,36,52,0,0,0
2020-11-03 18:45,87,37,50,0,0,0
2020-11-03 19:00,72,26,46,0,0,0
2020-11-03 19:15,55,30,25,0,0,0
2020-11-03 19:30,60,32,28,0,0,0
2020-11-03 19:45,52,25,27,0,0,0
2020-11-03 20:00,47,26,21,0,0,0
2020-11-03 20:15,27,16,11,0,0,0
2020-11-03 20:30,38,19,19,0,0,0
2020-11-03 20:45,21,6,15,0,0,0
2020-11-03 21:00,20,15,5,0,0,0
2020-11-03 21:15,22,8,14,0,0,0
2020-11-03 21:30,16,6,10,0,0,0
2020-11-03 21:45,12,7,5,0,0,0
2020-11-03 22:00,20,12,8,0,0,0
2020-11-03 22:15,10,5,5,0,0,0
2020-11-03 22:30,9,6,3,0,0,0
2020-11-03 22:45,11,7,4,0,0,0
2020-11-03 23:00,9,5,4,0,0,0
2020-11-03 23:15,14,8,6,0,0,0
2020-11-03 23:30,13,6,7,0,0,0
2020-11-03 23:45,12,4,8,0,0,0
2020-11-04 00:00,7,5,2,0,0,0
2020-11-04 00:15,13,8,5,0,0,0
2020-11-04 00:30,5,0,5,0,0,0
2020-11-04 00:45,0,0,0,0,0,0
2020-11-04 01:00,2,1,1,0,0,0
2020-11-04 01:15,3,1,2,0,0,0
2020-11-04 01:30,4,4,0,0,0,0
2020-11-04 01:45,3,2,1,0,0,0
2020-11-04 02:00,0,0,0,0,0,0
2020-11-04 02:15,2,2,0,0,0,0
2020-11-04 02:30,2,0,2,0,0,0
2020-11-04 02:45,1,0,1,0,0,0
2020-11-04 03:00,1,1,0,0,0,0
2020-11-04 03:15,1,0,1,0,0,0
2020-11-04 03:30,2,2,0,0,0,0
2020-11-04 03:45,1,0,1,0,0,0
2020-11-04 04:00,0,0,0,0,0,0
2020-11-04 04:15,0,0,0,0,0,0
2020-11-04 04:30,1,1,0,0,0,0
2020-11-04 04:45,2,1,1,0,0,0
2020-11-04 05:00,0,0,0,0,0,0
2020-11-04 05:15,5,3,2,0,0,0
2020-11-04 05:30,19,16,3,0,0,0
2020-11-04 05:45,21,13,8,0,0,0
2020-11-04 06:00,19,10,9,0,0,0
2020-11-04 06:15,32,21,11,0,0,0
2020-11-04 06:30,46,34,12,0,0,0
2020-11-04 06:45,76,55,21,0,0,0
2020-11-04 07:00,62,51,11,0,0,0
2020-11-04 07:15,180,134,46,0,0,0
2020-11-04 07:30,289,231,58,0,0,0
2020-11-04 07:45,228,164,64,0,0,0
2020-11-04 08:00,154,118,36,0,0,0
2020-11-04 08:15,139,104,35,0,0,0
2020-11-04 08:30,138,103,35,0,0,0
2020-11-04 08:45,135,98,37,0,0,0
2020-11-04 09:00,99,70,29,0,0,0
2020-11-04 09:15,89,73,16,0,0,0
2020-11-04 09:30,121,92,29,0,0,0
2020-11-04 09:45,126,93,33,0,0,0
2020-11-04 10:00,89,65,24,0,0,0
2020-11-04 10:15,91,70,21,0,0,0
2020-11-04 10:30,99,72,27,0,0,0
2020-11-04 10:45,105,73,32,0,0,0
2020-11-04 11:00,115,81,34,0,0,0
2020-11-04 11:15,120,67,53,0,0,0
2020-11-04 11:30,113,67,46,0,0,0
2020-11-04 11:45,116,73,43,0,0,0
2020-11-04 12:00,121,74,47,0,0,0
2020-11-04 12:15,122,75,47,0,0,0
2020-11-04 12:30,131,74,57,0,0,0
2020-11-04 12:45,153,86,67,0,0,0
2020-11-04 13:00,164,73,91,0,0,0
2020-11-04 13:15,140,74,66,0,0,0
2020-11-04 13:30,107,55,52,0,0,0
2020-11-04 13:45,176,99,77,0,0,0
2020-11-04 14:00,131,69,62,0,0,0
2020-11-04 14:15,122,65,57,0,0,0
2020-11-04 14:30,119,67,52,0,0,0
2020-11-04 14:45,147,75,72,0,0,0
2020-11-04 15:00,142,65,77,0,0,0
2020-11-04 15:15,133,81,52,0,0,0
2020-11-04 15:30,158,87,71,0,0,0
2020-11-04 15:45,137,74,63,0,0,0
2020-11-04 16:00,175,103,72,0,0,0
2020-11-04 16:15,147,74,73,0,0,0
2020-11-04 16:30,138,73,65,0,0,0
2020-11-04 16:45,153,78,75,0,0,0
2020-11-04 17:00,167,61,106,0,0,0
2020-11-04 17:15,142,63,79,0,0,0
2020-11-04 17:30,127,71,56,0,0,0
2020-11-04 17:45,130,58,72,0,0,0
2020-11-04 18:00,115,39,76,0,0,0
2020-11-04 18:15,94,42,52,0,0,0
2020-11-04 18:30,65,28,37,0,0,0
2020-11-04 18:45,80,43,37,0,0,0
2020-11-04 19:00,64,24,40,0,0,0
2020-11-04 19:15,76,34,42,0,0,0
2020-11-04 19:30,65,34,31,0,0,0
2020-11-04 19:45,49,26,23,0,0,0
2020-11-04 20:00,48,22,26,0,0,0
2020-11-04 20:15,33,16,17,0,0,0
2020-11-04 20:30,27,9,18,0,0,0
2020-11-04 20:45,27,16,11,0,0,0
2020-11-04 21:00,17,6,11,0,0,0
2020-11-04 21:15,18,13,5,0,0,0
2020-11-04 21:30,17,10,7,0,0,0
2020-11-04 21:45,17,11,6,0,0,0
2020-11-04 22:00,14,9,5,0,0,0
2020-11-04 22:15,20,12,8,0,0,0
2020-11-04 22:30,16,12,4,0,0,0
2020-11-04 22:45,29,15,14,0,0,0
2020-11-04 23:00,22,14,8,0,0,0
2020-11-04 23:15,15,4,11,0,0,0
2020-11-04 23:30,10,1,9,0,0,0
2020-11-04 23:45,10,4,6,0,0,0
2020-11-05 00:00,5,1,4,0,0,0
2020-11-05 00:15,9,6,3,0,0,0
2020-11-05 00:30,3,1,2,0,0,0
2020-11-05 00:45,4,3,1,0,0,0
2020-11-05 01:00,1,0,1,0,0,0
2020-11-05 01:15,3,2,1,0,0,0
2020-11-05 01:30,3,1,2,0,0,0
2020-11-05 01:45,1,1,0,0,0,0
2020-11-05 02:00,3,1,2,0,0,0
2020-11-05 02:15,2,0,2,0,0,0
2020-11-05 02:30,0,0,0,0,0,0
2020-11-05 02:45,1,0,1,0,0,0
2020-11-05 03:00,0,0,0,0,0,0
2020-11-05 03:15,0,0,0,0,0,0
2020-11-05 03:30,0,0,0,0,0,0
2020-11-05 03:45,0,0,0,0,0,0
2020-11-05 04:00,1,1,0,0,0,0
2020-11-05 04:15,2,2,0,0,0,0
2020-11-05 04:30,4,4,0,0,0,0
2020-11-05 04:45,0,0,0,0,0,0
2020-11-05 05:00,2,1,1,0,0,0
2020-11-05 05:15,5,3,2,0,0,0
2020-11-05 05:30,17,12,5,0,0,0
2020-11-05 05:45,15,11,4,0,0,0
2020-11-05 06:00,23,10,13,0,0,0
2020-11-05 06:15,29,21,8,0,0,0
2020-11-05 06:30,44,29,15,0,0,0
2020-11-05 06:45,51,36,15,0,0,0
2020-11-05 07:00,81,62,19,0,0,0
2020-11-05 07:15,182,146,36,0,0,0
2020-11-05 07:30,263,226,37,0,0,0
2020-11-05 07:45,212,156,56,0,0,0
2020-11-05 08:00,147,109,38,0,0,0
2020-11-05 08:15,125,95,30,0,0,0
2020-11-05 08:30,112,85,27,0,0,0
2020-11-05 08:45,142,110,32,0,0,0
2020-11-05 09:00,115,83,32,0,0,0
2020-11-05 09:15,101,70,31,0,0,0
2020-11-05 09:30,78,60,18,0,0,0
2020-11-05 09:45,96,65,31,0,0,0
2020-11-05 10:00,86,69,17,0,0,0
2020-11-05 10:15,87,65,22,0,0,0
2020-11-05 10:30,68,53,15,0,0,0
2020-11-05 10:45,99,77,22,0,0,0
2020-11-05 11:00,79,53,26,0,0,0
2020-11-05 11:15,80,47,33,0,0,0
2020-11-05 11:30,95,52,43,0,0,0
2020-11-05 11:45,107,64,43,0,0,0
2020-11-05 12:00,79,41,38,0,0,0
2020-11-05 12:15,109,59,50,0,0,0
2020-11-05 12:30,119,62,57,0,0,0
2020-11-05 12:45,124,71,53,0,0,0
2020-11-05 13:00,129,62,67,0,0,0
2020-11-05 13:15,125,57,68,0,0,0
2020-11-05 13:30,83,44,39,0,0,0
2020-11-05 13:45,147,75,72,0,0,0
2020-11-05 14:00,121,44,77,0,0,0
2020-11-05 14:15,127,76,51,0,0,0
2020-11-05 14:30,107,65,42,0,0,0
2020-11-05 14:45,155,94,61,0,0,0
2020-11-05 15:00,124,62,62,0,0,0
2020-11-05 15:15,137,82,55,0,0,0
2020-11-05 15:30,119,60,59,0,0,0
2020-11-05 15:45,175,101,74,0,0,0
2020-11-05 16:00,156,89,67,0,0,0
2020-11-05 16:15,183,98,85,0,0,0
2020-11-05 16:30,153,79,74,0,0,0
2020-11-05 16:45,181,97,84,0,0,0
2020-11-05 17:00,160,66,94,0,0,0
2020-11-05 17:15,187,98,89,0,0,0
2020-11-05 17:30,113,49,64,0,0,0
2020-11-05 17:45,121,53,68,0,0,0
2020-11-05 18:00,129,63,66,0,0,0
2020-11-05 18:15,112,46,66,0,0,0
2020-11-05 18:30,90,38,52,0,0,0
2020-11-05 18:45,79,30,49,0,0,0
2020-11-05 19:00,70,37,33,0,0,0
2020-11-05 19:15,66,27,39,0,0,0
2020-11-05 19:30,57,22,35,0,0,0
2020-11-05 19:45,57,26,31,0,0,0
2020-11-05 20:00,38,14,24,0,0,0
2020-11-05 20:15,39,18,21,0,0,0
2020-11-05 20:30,33,19,14,0,0,0
2020-11-05 20:45,29,11,18,0,0,0
2020-11-05 21:00,19,7,12,0,0,0
2020-11-05 21:15,22,10,12,0,0,0
2020-11-05 21:30,16,7,9,0,0,0
2020-11-05 21:45,17,10,7,0,0,0
2020-11-05 22:00,12,7,5,0,0,0
2020-11-05 22:15,16,10,6,0,0,0
2020-11-05 22:30,16,10,6,0,0,0
2020-11-05 22:45,19,14,5,0,0,0
2020-11-05 23:00,15,11,4,0,0,0
2020-11-05 23:15,8,4,4,0,0,0
2020-11-05 23:30,6,3,3,0,0,0
2020-11-05 23:45,6,3,3,0,0,0
2020-11-06 00:00,8,6,2,0,0,0
2020-11-06 00:15,4,1,3,0,0,0
2020-11-06 00:30,6,5,1,0,0,0
2020-11-06 00:45,4,2,2,0,0,0
2020-11-06 01:00,5,1,4,0,0,0
2020-11-06 01:15,2,0,2,0,0,0
2020-11-06 01:30,1,0,1,0,0,0
2020-11-06 01:45,0,0,0,0,0,0
2020-11-06 02:00,2,1,1,0,0,0
2020-11-06 02:15,3,3,0,0,0,0
2020-11-06 02:30,0,0,0,0,0,0
2020-11-06 02:45,3,3,0,0,0,0
2020-11-06 03:00,1,0,1,0,0,0
2020-11-06 03:15,2,2,0,0,0,0
2020-11-06 03:30,1,1,0,0,0,0
2020-11-06 03:45,0,0,0,0,0,0
2020-11-06 04:00,2,2,0,0,0,0
2020-11-06 04:15,1,1,0,0,0,0
2020-11-06 04:30,0,0,0,0,0,0
2020-11-06 04:45,1,1,0,0,0,0
2020-11-06 05:00,0,0,0,0,0,0
2020-11-06 05:15,4,3,1,0,0,0
2020-11-06 05:30,15,11,4,0,0,0
2020-11-06 05:45,15,6,9,0,0,0
2020-11-06 06:00,20,11,9,0,0,0
2020-11-06 06:15,31,23,8,0,0,0
2020-11-06 06:30,33,18,15,0,0,0
2020-11-06 06:45,63,49,14,0,0,0
2020-11-06 07:00,69,53,16,0,0,0
2020-11-06 07:15,151,113,38,0,0,0
2020-11-06 07:30,249,209,40,0,0,0
2020-11-06 07:45,200,139,61,0,0,0
2020-11-06 08:00,112,86,26,0,0,0
2020-11-06 08:15,128,100,28,0,0,0
2020-11-06 08:30,100,82,18,0,0,0
2020-11-06 08:45,123,103,20,0,0,0
2020-11-06 09:00,88,64,24,0,0,0
2020-11-06 09:15,78,60,18,0,0,0
2020-11-06 09:30,107,69,38,0,0,0
2020-11-06 09:45,107,77,30,0,0,0
2020-11-06 10:00,72,52,20,0,0,0
2020-11-06 10:15,66,47,19,0,0,0
2020-11-06 10:30,81,50,31,0,0,0
2020-11-06 10:45,90,59,31,0,0,0
2020-11-06 11:00,101,57,44,0,0,0
2020-11-06 11:15,88,54,34,0,0,0
2020-11-06 11:30,112,65,47,0,0,0
2020-11-06 11:45,100,59,41,0,0,0
2020-11-06 12:00,104,64,40,0,0,0
2020-11-06 12:15,119,71,48,0,0,0
2020-11-06 12:30,130,66,64,0,0,0
2020-11-06 12:45,132,67,65,0,0,0
2020-11-06 13:00,136,65,71,0,0,0
2020-11-06 13:15,152,64,88,0,0,0
2020-11-06 13:30,136,71,65,0,0,0
2020-11-06 13:45,135,75,60,0,0,0
2020-11-06 14:00,134,65,69,0,0,0
2020-11-06 14:15,144,88,56,0,0,0
2020-11-06 14:30,113,68,45,0,0,0
2020-11-06 14:45,150,84,66,0,0,0
2020-11-06 15:00,131,62,69,0,0,0
2020-11-06 15:15,158,92,66,0,0,0
2020-11-06 15:30,143,77,66,0,0,0
2020-11-06 15:45,161,95,66,0,0,0
2020-11-06 16:00,136,76,60,0,0,0
2020-11-06 16:15,152,98,54,0,0,0
2020-11-06 16:30,124,63,61,0,0,0
2020-11-06 16:45,153,77,76,0,0,0
2020-11-06 17:00,135,65,70,0,0,0
2020-11-06 17:15,138,62,76,0,0,0
2020-11-06 17:30,87,50,37,0,0,0
2020-11-06 17:45,111,51,60,0,0,0
2020-11-06 18:00,89,37,52,0,0,0
2020-11-06 18:15,80,34,46,0,0,0
2020-11-06 18:30,95,28,67,0,0,0
2020-11-06 18:45,70,38,32,0,0,0
2020-11-06 19:00,81,34,47,0,0,0
2020-11-06 19:15,52,16,36,0,0,0
2020-11-06 19:30,41,18,23,0,0,0
2020-11-06 19:45,36,18,18,0,0,0
2020-11-06 20:00,45,22,23,0,0,0
2020-11-06 20:15,35,13,22,0,0,0
2020-11-06 20:30,26,18,8,0,0,0
2020-11-06 20:45,33,13,20,0,0,0
2020-11-06 21:00,22,7,15,0,0,0
2020-11-06 21:15,22,16,6,0,0,0
2020-11-06 21:30,22,11,11,0,0,0
2020-11-06 21:45,14,10,4,0,0,0
2020-11-06 22:00,17,10,7,0,0,0
2020-11-06 22:15,9,6,3,0,0,0
2020-11-06 22:30,9,5,4,0,0,0
2020-11-06 22:45,11,3,8,0,0,0
2020-11-06 23:00,16,9,7,0,0,0
2020-11-06 23:15,20,10,10,0,0,0
2020-11-06 23:30,19,10,9,0,0,0
2020-11-06 23:45,24,14,10,0,0,0
2020-11-07 00:00,12,7,5,0,0,0
2020-11-07 00:15,14,12,2,0,0,0
2020-11-07 00:30,12,10,2,0,0,0
2020-11-07 00:45,17,11,6,0,0,0
2020-11-07 01:00,13,11,2,0,0,0
2020-11-07 01:15,7,5,2,0,0,0
2020-11-07 01:30,8,6,2,0,0,0
2020-11-07 01:45,5,4,1,0,0,0
2020-11-07 02:00,4,2,2,0,0,0
2020-11-07 02:15,5,3,2,0,0,0
2020-11-07 02:30,1,0,1,0,0,0
2020-11-07 02:45,6,4,2,0,0,0
2020-11-07 03:00,6,3,3,0,0,0
2020-11-07 03:15,0,0,0,0,0,0
2020-11-07 03:30,0,0,0,0,0,0
2020-11-07 03:45,2,2,0,0,0,0
2020-11-07 04:00,0,0,0,0,0,0
2020-11-07 04:15,0,0,0,0,0,0
2020-11-07 04:30,1,1,0,0,0,0
2020-11-07 04:45,0,0,0,0,0,0
2020-11-07 05:00,1,1,0,0,0,0
2020-11-07 05:15,5,3,2,0,0,0
2020-11-07 05:30,4,1,3,0,0,0
2020-11-07 05:45,10,4,6,0,0,0
2020-11-07 06:00,5,4,1,0,0,0
2020-11-07 06:15,7,6,1,0,0,0
2020-11-07 06:30,14,7,7,0,0,0
2020-11-07 06:45,22,14,8,0,0,0
2020-11-07 07:00,7,3,4,0,0,0
2020-11-07 07:15,19,12,7,0,0,0
2020-11-07 07:30,20,14,6,0,0,0
2020-11-07 07:45,29,22,7,0,0,0
2020-11-07 08:00,36,26,10,0,0,0
2020-11-07 08:15,48,38,10,0,0,0
2020-11-07 08:30,52,40,12,0,0,0
2020-11-07 08:45,82,50,32,0,0,0
2020-11-07 09:00,52,35,17,0,0,0
2020-11-07 09:15,71,57,14,0,0,0
2020-11-07 09:30,92,68,24,0,0,0
2020-11-07 09:45,110,91,19,0,0,0
2020-11-07 10:00,109,83,26,0,0,0
2020-11-07 10:15,94,74,20,0,0,0
2020-11-07 10:30,126,95,31,0,0,0
2020-11-07 10:45,153,113,40,0,0,0
2020-11-07 11:00,153,98,55,0,0,0
2020-11-07 11:15,146,93,53,0,0,0
2020-11-07 11:30,165,105,60,0,0,0
2020-11-07 11:45,147,93,54,0,0,0
2020-11-07 12:00,170,106,64,0,0,0
2020-11-07 12:15,166,117,49,0,0,0
2020-11-07 12:30,163,109,54,0,0,0
2020-11-07 12:45,162,100,62,0,0,0
2020-11-07 13:00,163,93,70,0,0,0
2020-11-07 13:15,171,101,70,0,0,0
2020-11-07 13:30,178,89,89,0,0,0
2020-11-07 13:45,165,87,78,0,0,0
2020-11-07 14:00,167,82,85,0,0,0
2020-11-07 14:15,122,48,74,0,0,0
2020-11-07 14:30,113,61,52,0,0,0
2020-11-07 14:45,136,87,49,0,0,0
2020-11-07 15:00,147,76,71,0,0,0
2020-11-07 15:15,116,73,43,0,0,0
2020-11-07 15:30,111,71,40,0,0,0
2020-11-07 15:45,128,72,56,0,0,0
2020-11-07 16:00,103,53,50,0,0,0
2020-11-07 16:15,112,58,54,0,0,0
2020-11-07 16:30,127,69,58,0,0,0
2020-11-07 16:45,102,52,50,0,0,0
2020-11-07 17:00,116,64,52,0,0,0
2020-11-07 17:15,78,24,54,0,0,0
2020-11-07 17:30,63,38,25,0,0,0
2020-11-07 17:45,57,28,29,0,0,0
2020-11-07 18:00,61,37,24,0,0,0
2020-11-07 18:15,62,29,33,0,0,0
2020-11-07 18:30,53,27,26,0,0,0
2020-11-07 18:45,39,18,21,0,0,0
2020-11-07 19:00,59,32,27,0,0,0
2020-11-07 19:15,46,23,23,0,0,0
2020-11-07 19:30,34,19,15,0,0,0
2020-11-07 19:45,35,17,18,0,0,0
2020-11-07 20:00,32,15,17,0,0,0
2020-11-07 20:15,16,3,13,0,0,0
2020-11-07 20:30,21,10,11,0,0,0
2020-11-07 20:45,16,8,8,0,0,0
2020-11-07 21:00,11,6,5,0,0,0
2020-11-07 21:15,21,17,4,0,0,0
2020-11-07 21:30,15,8,7,0,0,0
2020-11-07 21:45,9,5,4,0,0,0
2020-11-07 22:00,12,8,4,0,0,0
2020-11-07 22:15,9,7,2,0,0,0
2020-11-07 22:30,9,5,4,0,0,0
2020-11-07 22:45,9,3,6,0,0,0
2020-11-07 23:00,19,14,5,0,0,0
2020-11-07 23:15,12,7,5,0,0,0
2020-11-07 23:30,18,10,8,0,0,0
2020-11-07 23:45,23,12,11,0,0,0
2020-11-08 00:00,13,4,9,0,0,0
2020-11-08 00:15,21,7,14,0,0,0
2020-11-08 00:30,11,3,8,0,0,0
2020-11-08 00:45,11,7,4,0,0,0
2020-11-08 01:00,11,5,6,0,0,0
2020-11-08 01:15,3,2,1,0,0,0
2020-11-08 01:30,6,3,3,0,0,0
2020-11-08 01:45,7,4,3,0,0,0
2020-11-08 02:00,9,6,3,0,0,0
2020-11-08 02:15,7,3,4,0,0,0
2020-11-08 02:30,6,2,4,0,0,0
2020-11-08 02:45,5,0,5,0,0,0
2020-11-08 03:00,1,1,0,0,0,0
2020-11-08 03:15,2,1,1,0,0,0
2020-11-08 03:30,4,3,1,0,0,0
2020-11-08 03:45,1,1,0,0,0,0
2020-11-08 04:00,0,0,0,0,0,0
2020-11-08 04:15,0,0,0,0,0,0
2020-11-08 04:30,0,0,0,0,0,0
2020-11-08 04:45,1,0,1,0,0,0
2020-11-08 05:00,1,0,1,0,0,0
2020-11-08 05:15,2,1,1,0,0,0
2020-11-08 05:30,10,3,7,0,0,0
2020-11-08 05:45,4,0,4,0,0,0
2020-11-08 06:00,5,4,1,0,0,0
2020-11-08 06:15,7,6,1,0,0,0
2020-11-08 06:30,4,3,1,0,0,0
2020-11-08 06:45,7,4,3,0,0,0
2020-11-08 07:00,5,2,3,0,0,0
2020-11-08 07:15,2,2,0,0,0,0
2020-11-08 07:30,9,5,4,0,0,0
2020-11-08 07:45,10,6,4,0,0,0
2020-11-08 08:00,6,5,1,0,0,0
2020-11-08 08:15,5,3,2,0,0,0
2020-11-08 08:30,12,8,4,0,0,0
2020-11-08 08:45,13,8,5,0,0,0
2020-11-08 09:00,17,14,3,0,0,0
2020-11-08 09:15,16,10,6,0,0,0
2020-11-08 09:30,34,23,11,0,0,0
2020-11-08 09:45,29,19,10,0,0,0
2020-11-08 10:00,25,16,9,0,0,0
2020-11-08 10:15,31,18,13,0,0,0
2020-11-08 10:30,35,24,11,0,0,0
2020-11-08 10:45,47,28,19,0,0,0
2020-11-08 11:00,43,34,9,0,0,0
2020-11-08 11:15,61,49,12,0,0,0
2020-11-08 11:30,36,18,18,0,0,0
2020-11-08 11:45,43,28,15,0,0,0
2020-11-08 12:00,58,23,35,0,0,0
2020-11-08 12:15,58,33,25,0,0,0
2020-11-08 12:30,79,47,32,0,0,0
2020-11-08 12:45,82,57,25,0,0,0
2020-11-08 13:00,80,48,32,0,0,0
2020-11-08 13:15,67,45,22,0,0,0
2020-11-08 13:30,85,55,30,0,0,0
2020-11-08 13:45,87,52,35,0,0,0
2020-11-08 14:00,93,73,20,0,0,0
2020-11-08 14:15,90,63,27,0,0,0
2020-11-08 14:30,97,57,40,0,0,0
2020-11-08 14:45,91,52,39,0,0,0
2020-11-08 15:00,108,69,39,0,0,0
2020-11-08 15:15,94,57,37,0,0,0
2020-11-08 15:30,82,49,33,0,0,0
2020-11-08 15:45,101,70,31,0,0,0
2020-11-08 16:00,77,47,30,0,0,0
2020-11-08 16:15,62,34,28,0,0,0
2020-11-08 16:30,76,50,26,0,0,0
2020-11-08 16:45,67,39,28,0,0,0
2020-11-08 17:00,66,36,30,0,0,0
2020-11-08 17:15,59,32,27,0,0,0
2020-11-08 17:30,61,37,24,0,0,0
2020-11-08 17:45,44,31,13,0,0,0
2020-11-08 18:00,53,25,28,0,0,0
2020-11-08 18:15,27,14,13,0,0,0
2020-11-08 18:30,29,22,7,0,0,0
2020-11-08 18:45,36,16,20,0,0,0
2020-11-08 19:00,27,15,12,0,0,0
2020-11-08 19:15,27,16,11,0,0,0
2020-11-08 19:30,24,17,7,0,0,0
2020-11-08 19:45,26,10,16,0,0,0
2020-11-08 20:00,29,16,13,0,0,0
2020-11-08 20:15,21,9,12,0,0,0
2020-11-08 20:30,18,11,7,0,0,0
2020-11-08 20:45,19,10,9,0,0,0
2020-11-08 21:00,17,7,10,0,0,0
2020-11-08 21:15,9,3,6,0,0,0
2020-11-08 21:30,13,9,4,0,0,0
2020-11-08 21:45,9,3,6,0,0,0
2020-11-08 22:00,21,13,8,0,0,0
2020-11-08 22:15,16,13,3,0,0,0
2020-11-08 22:30,11,7,4,0,0,0
2020-11-08 22:45,9,6,3,0,0,0
2020-11-08 23:00,7,1,6,0,0,0
2020-11-08 23:15,9,4,5,0,0,0
2020-11-08 23:30,2,0,2,0,0,0
2020-11-08 23:45,4,1,3,0,0,0
2020-11-09 00:00,2,1,1,0,0,0
2020-11-09 00:15,10,8,2,0,0,0
2020-11-09 00:30,2,1,1,0,0,0
2020-11-09 00:45,3,3,0,0,0,0
2020-11-09 01:00,1,1,0,0,0,0
2020-11-09 01:15,1,1,0,0,0,0
2020-11-09 01:30,0,0,0,0,0,0
2020-11-09 01:45,1,1,0,0,0,0
2020-11-09 02:00,0,0,0,0,0,0
2020-11-09 02:15,0,0,0,0,0,0
2020-11-09 02:30,1,1,0,0,0,0
2020-11-09 02:45,0,0,0,0,0,0
2020-11-09 03:00,0,0,0,0,0,0
2020-11-09 03:15,1,1,0,0,0,0
2020-11-09 03:30,0,0,0,0,0,0
2020-11-09 03:45,0,0,0,0,0,0
2020-11-09 04:00,0,0,0,0,0,0
2020-11-09 04:15,3,3,0,0,0,0
2020-11-09 04:30,0,0,0,0,0,0
2020-11-09 04:45,2,2,0,0,0,0
2020-11-09 05:00,1,1,0,0,0,0
2020-11-09 05:15,3,2,1,0,0,0
2020-11-09 05:30,16,13,3,0,0,0
2020-11-09 05:45,10,2,8,0,0,0
2020-11-09 06:00,13,10,3,0,0,0
2020-11-09 06:15,32,22,10,0,0,0
2020-11-09 06:30,50,32,18,0,0,0
2020-11-09 06:45,67,51,16,0,0,0
2020-11-09 07:00,84,64,20,0,0,0
2020-11-09 07:15,182,150,32,0,0,0
2020-11-09 07:30,310,254,56,0,0,0
2020-11-09 07:45,198,138,60,0,0,0
2020-11-09 08:00,150,108,42,0,0,0
2020-11-09 08:15,123,86,37,0,0,0
2020-11-09 08:30,96,76,20,0,0,0
2020-11-09 08:45,134,104,30,0,0,0
2020-11-09 09:00,104,78,26,0,0,0
2020-11-09 09:15,98,68,30,0,0,0
2020-11-09 09:30,93,71,22,0,0,0
2020-11-09 09:45,114,83,31,0,0,0
2020-11-09 10:00,96,73,23,0,0,0
2020-11-09 10:15,89,63,26,0,0,0
2020-11-09 10:30,67,43,24,0,0,0
2020-11-09 10:45,81,45,36,0,0,0
2020-11-09 11:00,94,62,32,0,0,0
2020-11-09 11:15,88,57,31,0,0,0
2020-11-09 11:30,95,56,39,0,0,0
2020-11-09 11:45,88,56,32,0,0,0
2020-11-09 12:00,86,50,36,0,0,0
2020-11-09 12:15,92,52,40,0,0,0
2020-11-09 12:30,116,62,54,0,0,0
2020-11-09 12:45,114,61,53,0,0,0
2020-11-09 13:00,126,58,68,0,0,0
2020-11-09 13:15,118,54,64,0,0,0
2020-11-09 13:30,134,71,63,0,0,0
2020-11-09 13:45,156,105,51,0,0,0
2020-11-09 14:00,106,51,55,0,0,0
2020-11-09 14:15,129,75,54,0,0,0
2020-11-09 14:30,109,67,42,0,0,0
2020-11-09 14:45,127,78,49,0,0,0
2020-11-09 15:00,145,75,70,0,0,0
2020-11-09 15:15,144,85,59,0,0,0
2020-11-09 15:30,167,80,87,0,0,0
2020-11-09 15:45,214,106,108,0,0,0
2020-11-09 16:00,159,73,86,0,0,0
2020-11-09 16:15,178,95,83,0,0,0
2020-11-09 16:30,177,98,79,0,0,0
2020-11-09 16:45,156,63,93,0,0,0
2020-11-09 17:00,170,79,91,0,0,0
2020-11-09 17:15,138,59,79,0,0,0
2020-11-09 17:30,131,60,71,0,0,0
2020-11-09 17:45,111,47,64,0,0,0
2020-11-09 18:00,124,64,60,0,0,0
2020-11-09 18:15,97,44,53,0,0,0
2020-11-09 18:30,86,35,51,0,0,0
2020-11-09 18:45,70,35,35,0,0,0
2020-11-09 19:00,62,20,42,0,0,0
2020-11-09 19:15,64,24,40,0,0,0
2020-11-09 19:30,53,22,31,0,0,0
2020-11-09 19:45,49,24,25,0,0,0
2020-11-09 20:00,58,27,31,0,0,0
2020-11-09 20:15,36,19,17,0,0,0
2020-11-09 20:30,26,16,10,0,0,0
2020-11-09 20:45,14,6,8,0,0,0
2020-11-09 21:00,20,7,13,0,0,0
2020-11-09 21:15,9,4,5,0,0,0
2020-11-09 21:30,19,10,9,0,0,0
2020-11-09 21:45,23,10,13,0,0,0
2020-11-09 22:00,19,14,5,0,0,0
2020-11-09 22:15,14,8,6,0,0,0
2020-11-09 22:30,9,7,2,0,0,0
2020-11-09 22:45,13,6,7,0,0,0
2020-11-09 23:00,8,4,4,0,0,0
2020-11-09 23:15,10,6,4,0,0,0
2020-11-09 23:30,6,4,2,0,0,0
2020-11-09 23:45,13,4,9,0,0,0
2020-11-10 00:00,4,1,3,0,0,0
2020-11-10 00:15,3,2,1,0,0,0
2020-11-10 00:30,3,0,3,0,0,0
2020-11-10 00:45,3,1,2,0,0,0
2020-11-10 01:00,5,4,1,0,0,0
2020-11-10 01:15,1,0,1,0,0,0
2020-11-10 01:30,1,0,1,0,0,0
2020-11-10 01:45,2,1,1,0,0,0
2020-11-10 02:00,2,2,0,0,0,0
2020-11-10 02:15,0,0,0,0,0,0
2020-11-10 02:30,2,1,1,0,0,0
2020-11-10 02:45,0,0,0,0,0,0
2020-11-10 03:00,0,0,0,0,0,0
2020-11-10 03:15,0,0,0,0,0,0
2020-11-10 03:30,0,0,0,0,0,0
2020-11-10 03:45,1,1,0,0,0,0
2020-11-10 04:00,1,0,1,0,0,0
2020-11-10 04:15,2,2,0,0,0,0
2020-11-10 04:30,0,0,0,0,0,0
2020-11-10 04:45,1,1,0,0,0,0
2020-11-10 05:00,1,1,0,0,0,0
2020-11-10 05:15,1,0,1,0,0,0
2020-11-10 05:30,14,10,4,0,0,0
2020-11-10 05:45,15,8,7,0,0,0
2020-11-10 06:00,20,13,7,0,0,0
2020-11-10 06:15,29,17,12,0,0,0
2020-11-10 06:30,44,26,18,0,0,0
2020-11-10 06:45,76,53,23,0,0,0
2020-11-10 07:00,80,61,19,0,0,0
2020-11-10 07:15,177,142,35,0,0,0
2020-11-10 07:30,268,221,47,0,0,0
2020-11-10 07:45,222,160,62,0,0,0
2020-11-10 08:00,138,107,31,0,0,0
2020-11-10 08:15,142,111,31,0,0,0
2020-11-10 08:30,102,77,25,0,0,0
2020-11-10 08:45,148,116,32,0,0,0
2020-11-10 09:00,94,68,26,0,0,0
2020-11-10 09:15,107,70,37,0,0,0
2020-11-10 09:30,106,78,28,0,0,0
2020-11-10 09:45,88,64,24,0,0,0
2020-11-10 10:00,60,40,20,0,0,0
2020-11-10 10:15,92,62,30,0,0,0
2020-11-10 10:30,75,55,20,0,0,0
2020-11-10 10:45,86,59,27,0,0,0
2020-11-10 11:00,81,48,33,0,0,0
2020-11-10 11:15,99,56,43,0,0,0
2020-11-10 11:30,94,66,28,0,0,0
2020-11-10 11:45,93,56,37,0,0,0
2020-11-10 12:00,110,59,51,0,0,0
2020-11-10 12:15,102,62,40,0,0,0
2020-11-10 12:30,100,56,44,0,0,0
2020-11-10 12:45,122,63,59,0,0,0
2020-11-10 13:00,158,65,93,0,0,0
2020-11-10 13:15,135,64,71,0,0,0
2020-11-10 13:30,125,60,65,0,0,0
2020-11-10 13:45,170,93,77,0,0,0
2020-11-10 14:00,144,74,70,0,0,0
2020-11-10 14:15,147,80,67,0,0,0
2020-11-10 14:30,147,94,53,0,0,0
2020-11-10 14:45,126,77,49,0,0,0
2020-11-10 15:00,162,90,72,0,0,0
2020-11-10 15:15,141,90,51,0,0,0
2020-11-10 15:30,147,81,66,0,0,0
2020-11-10 15:45,211,121,90,0,0,0
2020-11-10 16:00,148,78,70,0,0,0
2020-11-10 16:15,170,79,91,0,0,0
2020-11-10 16:30,147,71,76,0,0,0
2020-11-10 16:45,171,80,91,0,0,0
2020-11-10 17:00,171,68,103,0,0,0
2020-11-10 17:15,157,77,80,0,0,0
2020-11-10 17:30,146,65,81,0,0,0
2020-11-10 17:45,111,55,56,0,0,0
2020-11-10 18:00,123,50,73,0,0,0
2020-11-10 18:15,93,32,61,0,0,0
2020-11-10 18:30,102,42,60,0,0,0
2020-11-10 18:45,96,41,55,0,0,0
2020-11-10 19:00,80,29,51,0,0,0
2020-11-10 19:15,58,25,33,0,0,0
2020-11-10 19:30,45,16,29,0,0,0
2020-11-10 19:45,55,26,29,0,0,0
2020-11-10 20:00,51,28,23,0,0,0
2020-11-10 20:15,46,21,25,0,0,0
2020-11-10 20:30,27,11,16,0,0,0
2020-11-10 20:45,33,19,14,0,0,0
2020-11-10 21:00,21,15,6,0,0,0
2020-11-10 21:15,24,8,16,0,0,0
2020-11-10 21:30,17,4,13,0,0,0
2020-11-10 21:45,11,8,3,0,0,0
2020-11-10 22:00,21,11,10,0,0,0
2020-11-10 22:15,16,11,5,0,0,0
2020-11-10 22:30,12,5,7,0,0,0
2020-11-10 22:45,18,11,7,0,0,0
2020-11-10 23:00,10,5,5,0,0,0
2020-11-10 23:15,12,5,7,0,0,0
2020-11-10 23:30,10,3,7,0,0,0
2020-11-10 23:45,7,4,3,0,0,0
2020-11-11 00:00,6,0,6,0,0,0
2020-11-11 00:15,12,4,8,0,0,0
2020-11-11 00:30,3,2,1,0,0,0
2020-11-11 00:45,9,8,1,0,0,0
2020-11-11 01:00,0,0,0,0,0,0
2020-11-11 01:15,1,1,0,0,0,0
2020-11-11 01:30,3,3,0,0,0,0
2020-11-11 01:45,3,1,2,0,0,0
2020-11-11 02:00,0,0,0,0,0,0
2020-11-11 02:15,1,0,1,0,0,0
2020-11-11 02:30,0,0,0,0,0,0
2020-11-11 02:45,0,0,0,0,0,0
2020-11-11 03:00,1,1,0,0,0,0
2020-11-11 03:15,2,0,2,0,0,0
2020-11-11 03:30,1,1,0,0,0,0
2020-11-11 03:45,1,1,0,0,0,0
2020-11-11 04:00,1,0,1,0,0,0
2020-11-11 04:15,1,1,0,0,0,0
2020-11-11 04:30,2,2,0,0,0,0
2020-11-11 04:45,0,0,0,0,0,0
2020-11-11 05:00,3,1,2,0,0,0
2020-11-11 05:15,6,6,0,0,0,0
2020-11-11 05:30,12,10,2,0,0,0
2020-11-11 05:45,10,8,2,0,0,0
2020-11-11 06:00,16,13,3,0,0,0
2020-11-11 06:15,31,19,12,0,0,0
2020-11-11 06:30,46,25,21,0,0,0
2020-11-11 06:45,59,45,14,0,0,0
2020-11-11 07:00,85,64,21,0,0,0
2020-11-11 07:15,160,132,28,0,0,0
2020-11-11 07:30,283,236,47,0,0,0
2020-11-11 07:45,194,142,52,0,0,0
2020-11-11 08:00,155,109,46,0,0,0
2020-11-11 08:15,127,95,32,0,0,0
2020-11-11 08:30,110,82,28,0,0,0
2020-11-11 08:45,134,103,31,0,0,0
2020-11-11 09:00,103,79,24,0,0,0
2020-11-11 09:15,110,79,31,0,0,0
2020-11-11 09:30,105,82,23,0,0,0
2020-11-11 09:45,111,75,36,0,0,0
2020-11-11 10:00,77,59,18,0,0,0
2020-11-11 10:15,93,62,31,0,0,0
2020-11-11 10:30,81,62,19,0,0,0
2020-11-11 10:45,98,61,37,0,0,0
2020-11-11 11:00,105,57,48,0,0,0
2020-11-11 11:15,114,69,45,0,0,0
2020-11-11 11:30,88,57,31,0,0,0
2020-11-11 11:45,123,75,48,0,0,0
2020-11-11 12:00,110,72,38,0,0,0
2020-11-11 12:15,120,73,47,0,0,0
2020-11-11 12:30,128,57,71,0,0,0
2020-11-11 12:45,114,69,45,0,0,0
2020-11-11 13:00,163,78,85,0,0,0
2020-11-11 13:15,137,59,78,0,0,0
2020-11-11 13:30,102,49,53,0,0,0
2020-11-11 13:45,134,71,63,0,0,0
2020-11-11 14:00,122,57,65,0,0,0
2020-11-11 14:15,119,67,52,0,0,0
2020-11-11 14:30,119,72,47,0,0,0
2020-11-11 14:45,148,77,71,0,0,0
2020-11-11 15:00,127,63,64,0,0,0
2020-11-11 15:15,96,49,47,0,0,0
2020-11-11 15:30,132,61,71,0,0,0
2020-11-11 15:45,135,76,59,0,0,0
2020-11-11 16:00,149,84,65,0,0,0
2020-11-11 16:15,173,89,84,0,0,0
2020-11-11 16:30,145,81,64,0,0,0
2020-11-11 16:45,138,63,75,0,0,0
2020-11-11 17:00,136,68,68,0,0,0
2020-11-11 17:15,127,49,78,0,0,0
2020-11-11 17:30,117,53,64,0,0,0
2020-11-11 17:45,122,56,66,0,0,0
2020-11-11 18:00,117,50,67,0,0,0
2020-11-11 18:15,86,29,57,0,0,0
2020-11-11 18:30,73,26,47,0,0,0
2020-11-11 18:45,79,28,51,0,0,0
2020-11-11 19:00,67,21,46,0,0,0
2020-11-11 19:15,67,28,39,0,0,0
2020-11-11 19:30,57,30,27,0,0,0
2020-11-11 19:45,35,17,18,0,0,0
2020-11-11 20:00,47,20,27,0,0,0
2020-11-11 20:15,30,15,15,0,0,0
2020-11-11 20:30,34,18,16,0,0,0
2020-11-11 20:45,26,15,11,0,0,0
2020-11-11 21:00,22,12,10,0,0,0
2020-11-11 21:15,21,9,12,0,0,0
2020-11-11 21:30,18,10,8,0,0,0
2020-11-11 21:45,11,4,7,0,0,0
2020-11-11 22:00,15,6,9,0,0,0
2020-11-11 22:15,26,18,8,0,0,0
2020-11-11 22:30,15,9,6,0,0,0
2020-11-11 22:45,13,3,10,0,0,0
2020-11-11 23:00,14,7,7,0,0,0
2020-11-11 23:15,10,7,3,0,0,0
2020-11-11 23:30,15,4,11,0,0,0
2020-11-11 23:45,7,4,3,0,0,0
2020-11-12 00:00,12,6,6,0,0,0
2020-11-12 00:15,2,2,0,0,0,0
2020-11-12 00:30,13,9,4,0,0,0
2020-11-12 00:45,4,1,3,0,0,0
2020-11-12 01:00,4,2,2,0,0,0
2020-11-12 01:15,7,3,4,0,0,0
2020-11-12 01:30,5,4,1,0,0,0
2020-11-12 01:45,2,0,2,0,0,0
2020-11-12 02:00,5,3,2,0,0,0
2020-11-12 02:15,4,2,2,0,0,0
2020-11-12 02:30,0,0,0,0,0,0
2020-11-12 02:45,2,0,2,0,0,0
2020-11-12 03:00,3,3,0,0,0,0
2020-11-12 03:15,2,1,1,0,0,0
2020-11-12 03:30,0,0,0,0,0,0
2020-11-12 03:45,2,2,0,0,0,0
2020-11-12 04:00,1,0,1,0,0,0
2020-11-12 04:15,0,0,0,0,0,0
2020-11-12 04:30,0,0,0,0,0,0
2020-11-12 04:45,0,0,0,0,0,0
2020-11-12 05:00,2,2,0,0,0,0
2020-11-12 05:15,2,2,0,0,0,0
2020-11-12 05:30,14,12,2,0,0,0
2020-11-12 05:45,19,10,9,0,0,0
2020-11-12 06:00,17,13,4,0,0,0
2020-11-12 06:15,24,21,3,0,0,0
2020-11-12 06:30,45,27,18,0,0,0
2020-11-12 06:45,57,41,16,0,0,0
2020-11-12 07:00,65,46,19,0,0,0
2020-11-12 07:15,118,91,27,0,0,0
2020-11-12 07:30,153,94,59,0,0,0
2020-11-12 07:45,279,222,57,0,0,0
2020-11-12 08:00,247,210,37,0,0,0
2020-11-12 08:15,164,138,26,0,0,0
2020-11-12 08:30,128,97,31,0,0,0
2020-11-12 08:45,131,96,35,0,0,0
2020-11-12 09:00,83,59,24,0,0,0
2020-11-12 09:15,104,72,32,0,0,0
2020-11-12 09:30,62,42,20,0,0,0
2020-11-12 09:45,89,66,23,0,0,0
2020-11-12 10:00,66,40,26,0,0,0
2020-11-12 10:15,70,47,23,0,0,0
2020-11-12 10:30,63,41,22,0,0,0
2020-11-12 10:45,66,46,20,0,0,0
2020-11-12 11:00,73,47,26,0,0,0
2020-11-12 11:15,64,39,25,0,0,0
2020-11-12 11:30,80,57,23,0,0,0
2020-11-12 11:45,107,67,40,0,0,0
2020-11-12 12:00,90,49,41,0,0,0
2020-11-12 12:15,97,63,34,0,0,0
2020-11-12 12:30,86,50,36,0,0,0
2020-11-12 12:45,117,54,63,0,0,0
2020-11-12 13:00,132,61,71,0,0,0
2020-11-12 13:15,125,57,68,0,0,0
2020-11-12 13:30,113,51,62,0,0,0
2020-11-12 13:45,131,67,64,0,0,0
2020-11-12 14:00,111,57,54,0,0,0
2020-11-12 14:15,140,57,83,0,0,0
2020-11-12 14:30,153,75,78,0,0,0
2020-11-12 14:45,115,59,56,0,0,0
2020-11-12 15:00,128,77,51,0,0,0
2020-11-12 15:15,152,94,58,0,0,0
2020-11-12 15:30,161,83,78,0,0,0
2020-11-12 15:45,156,81,75,0,0,0
2020-11-12 16:00,152,82,70,0,0,0
2020-11-12 16:15,166,93,73,0,0,0
2020-11-12 16:30,190,91,99,0,0,0
2020-11-12 16:45,177,87,90,0,0,0
2020-11-12 17:00,143,63,80,0,0,0
2020-11-12 17:15,134,65,69,0,0,0
2020-11-12 17:30,128,64,64,0,0,0
2020-11-12 17:45,136,69,67,0,0,0
2020-11-12 18:00,124,51,73,0,0,0
2020-11-12 18:15,106,44,62,0,0,0
2020-11-12 18:30,85,38,47,0,0,0
2020-11-12 18:45,83,22,61,0,0,0
2020-11-12 19:00,77,31,46,0,0,0
2020-11-12 19:15,55,27,28,0,0,0
2020-11-12 19:30,51,14,37,0,0,0
2020-11-12 19:45,63,32,31,0,0,0
2020-11-12 20:00,32,15,17,0,0,0
2020-11-12 20:15,24,7,17,0,0,0
2020-11-12 20:30,16,6,10,0,0,0
2020-11-12 20:45,24,12,12,0,0,0
2020-11-12 21:00,28,18,10,0,0,0
2020-11-12 21:15,22,13,9,0,0,0
2020-11-12 21:30,14,6,8,0,0,0
2020-11-12 21:45,20,12,8,0,0,0
2020-11-12 22:00,20,12,8,0,0,0
2020-11-12 22:15,15,8,7,0,0,0
2020-11-12 22:30,19,8,11,0,0,0
2020-11-12 22:45,14,7,7,0,0,0
2020-11-12 23:00,13,9,4,0,0,0
2020-11-12 23:15,13,9,4,0,0,0
2020-11-12 23:30,12,6,6,0,0,0
2020-11-12 23:45,1,1,0,0,0,0
2020-11-13 00:00,7,3,4,0,0,0
2020-11-13 00:15,13,7,6,0,0,0
2020-11-13 00:30,1,1,0,0,0,0
2020-11-13 00:45,1,0,1,0,0,0
2020-11-13 01:00,1,0,1,0,0,0
2020-11-13 01:15,2,0,2,0,0,0
2020-11-13 01:30,1,0,1,0,0,0
2020-11-13 01:45,3,2,1,0,0,0
2020-11-13 02:00,2,0,2,0,0,0
2020-11-13 02:15,0,0,0,0,0,0
2020-11-13 02:30,3,1,2,0,0,0
2020-11-13 02:45,2,0,2,0,0,0
2020-11-13 03:00,2,2,0,0,0,0
2020-11-13 03:15,1,1,0,0,0,0
2020-11-13 03:30,2,0,2,0,0,0
2020-11-13 03:45,1,1,0,0,0,0
2020-11-13 04:00,2,1,1,0,0,0
2020-11-13 04:15,2,1,1,0,0,0
2020-11-13 04:30,0,0,0,0,0,0
2020-11-13 04:45,0,0,0,0,0,0
2020-11-13 05:00,0,0,0,0,0,0
2020-11-13 05:15,3,2,1,0,0,0
2020-11-13 05:30,16,14,2,0,0,0
2020-11-13 05:45,17,6,11,0,0,0
2020-11-13 06:00,14,7,7,0,0,0
2020-11-13 06:15,26,16,10,0,0,0
2020-11-13 06:30,40,19,21,0,0,0
2020-11-13 06:45,61,48,13,0,0,0
2020-11-13 07:00,47,32,15,0,0,0
2020-11-13 07:15,105,82,23,0,0,0
2020-11-13 07:30,134,96,38,0,0,0
2020-11-13 07:45,258,216,42,0,0,0
2020-11-13 08:00,229,196,33,0,0,0
2020-11-13 08:15,134,114,20,0,0,0
2020-11-13 08:30,92,69,23,0,0,0
2020-11-13 08:45,125,100,25,0,0,0
2020-11-13 09:00,87,72,15,0,0,0
2020-11-13 09:15,92,71,21,0,0,0
2020-11-13 09:30,84,61,23,0,0,0
2020-11-13 09:45,105,74,31,0,0,0
2020-11-13 10:00,95,68,27,0,0,0
2020-11-13 10:15,88,64,24,0,0,0
2020-11-13 10:30,79,48,31,0,0,0
2020-11-13 10:45,91,57,34,0,0,0
2020-11-13 11:00,111,76,35,0,0,0
2020-11-13 11:15,93,54,39,0,0,0
2020-11-13 11:30,95,50,45,0,0,0
2020-11-13 11:45,101,52,49,0,0,0
2020-11-13 12:00,101,59,42,0,0,0
2020-11-13 12:15,115,63,52,0,0,0
2020-11-13 12:30,113,71,42,0,0,0
2020-11-13 12:45,127,73,54,0,0,0
2020-11-13 13:00,158,77,81,0,0,0
2020-11-13 13:15,142,53,89,0,0,0
2020-11-13 13:30,135,62,73,0,0,0
2020-11-13 13:45,150,73,77,0,0,0
2020-11-13 14:00,141,76,65,0,0,0
2020-11-13 14:15,157,83,74,0,0,0
2020-11-13 14:30,152,79,73,0,0,0
2020-11-13 14:45,140,81,59,0,0,0
2020-11-13 15:00,138,79,59,0,0,0
2020-11-13 15:15,175,95,80,0,0,0
2020-11-13 15:30,139,65,74,0,0,0
2020-11-13 15:45,155,79,76,0,0,0
2020-11-13 16:00,159,85,74,0,0,0
2020-11-13 16:15,145,82,63,0,0,0
2020-11-13 16:30,126,65,61,0,0,0
2020-11-13 16:45,130,61,69,0,0,0
2020-11-13 17:00,122,66,56,0,0,0
2020-11-13 17:15,107,52,55,0,0,0
2020-11-13 17:30,78,40,38,0,0,0
2020-11-13 17:45,109,50,59,0,0,0
2020-11-13 18:00,99,41,58,0,0,0
2020-11-13 18:15,82,36,46,0,0,0
2020-11-13 18:30,94,39,55,0,0,0
2020-11-13 18:45,62,17,45,0,0,0
2020-11-13 19:00,60,19,41,0,0,0
2020-11-13 19:15,66,32,34,0,0,0
2020-11-13 19:30,31,15,16,0,0,0
2020-11-13 19:45,54,30,24,0,0,0
2020-11-13 20:00,43,17,26,0,0,0
2020-11-13 20:15,27,13,14,0,0,0
2020-11-13 20:30,23,9,14,0,0,0
2020-11-13 20:45,30,14,16,0,0,0
2020-11-13 21:00,26,8,18,0,0,0
2020-11-13 21:15,24,9,15,0,0,0
2020-11-13 21:30,15,8,7,0,0,0
2020-11-13 21:45,15,9,6,0,0,0
2020-11-13 22:00,13,8,5,0,0,0
2020-11-13 22:15,12,5,7,0,0,0
2020-11-13 22:30,11,4,7,0,0,0
2020-11-13 22:45,16,10,6,0,0,0
2020-11-13 23:00,15,9,6,0,0,0
2020-11-13 23:15,8,7,1,0,0,0
2020-11-13 23:30,12,6,6,0,0,0
2020-11-13 23:45,12,5,7,0,0,0
2020-11-14 00:00,17,10,7,0,0,0
2020-11-14 00:15,11,7,4,0,0,0
2020-11-14 00:30,8,5,3,0,0,0
2020-11-14 00:45,5,1,4,0,0,0
2020-11-14 01:00,13,7,6,0,0,0
2020-11-14 01:15,8,4,4,0,0,0
2020-11-14 01:30,7,3,4,0,0,0
2020-11-14 01:45,11,7,4,0,0,0
2020-11-14 02:00,16,7,9,0,0,0
2020-11-14 02:15,3,0,3,0,0,0
2020-11-14 02:30,7,3,4,0,0,0
2020-11-14 02:45,6,2,4,0,0,0
2020-11-14 03:00,6,6,0,0,0,0
2020-11-14 03:15,3,1,2,0,0,0
2020-11-14 03:30,1,0,1,0,0,0
2020-11-14 03:45,4,2,2,0,0,0
2020-11-14 04:00,2,2,0,0,0,0
2020-11-14 04:15,2,2,0,0,0,0
2020-11-14 04:30,3,3,0,0,0,0
2020-11-14 04:45,3,3,0,0,0,0
2020-11-14 05:00,3,3,0,0,0,0
2020-11-14 05:15,2,1,1,0,0,0
2020-11-14 05:30,7,5,2,0,0,0
2020-11-14 05:45,12,4,8,0,0,0
2020-11-14 06:00,5,2,3,0,0,0
2020-11-14 06:15,5,3,2,0,0,0
2020-11-14 06:30,3,2,1,0,0,0
2020-11-14 06:45,17,11,6,0,0,0
2020-11-14 07:00,9,7,2,0,0,0
2020-11-14 07:15,21,15,6,0,0,0
2020-11-14 07:30,39,25,14,0,0,0
2020-11-14 07:45,28,18,10,0,0,0
2020-11-14 08:00,25,16,9,0,0,0
2020-11-14 08:15,35,28,7,0,0,0
2020-11-14 08:30,35,29,6,0,0,0
2020-11-14 08:45,39,26,13,0,0,0
2020-11-14 09:00,56,37,19,0,0,0
2020-11-14 09:15,43,32,11,0,0,0
2020-11-14 09:30,72,57,15,0,0,0
2020-11-14 09:45,103,74,29,0,0,0
2020-11-14 10:00,104,79,25,0,0,0
2020-11-14 10:15,117,92,25,0,0,0
2020-11-14 10:30,118,96,22,0,0,0
2020-11-14 10:45,143,106,37,0,0,0
2020-11-14 11:00,139,91,48,0,0,0
2020-11-14 11:15,162,114,48,0,0,0
2020-11-14 11:30,124,76,48,0,0,0
2020-11-14 11:45,155,101,54,0,0,0
2020-11-14 12:00,158,88,70,0,0,0
2020-11-14 12:15,169,107,62,0,0,0
2020-11-14 12:30,170,109,61,0,0,0
2020-11-14 12:45,148,81,67,0,0,0
2020-11-14 13:00,153,92,61,0,0,0
2020-11-14 13:15,138,75,63,0,0,0
2020-11-14 13:30,163,87,76,0,0,0
2020-11-14 13:45,143,74,69,0,0,0
2020-11-14 14:00,147,84,63,0,0,0
2020-11-14 14:15,160,74,86,0,0,0
2020-11-14 14:30,148,79,69,0,0,0
2020-11-14 14:45,130,65,65,0,0,0
2020-11-14 15:00,138,68,70,0,0,0
2020-11-14 15:15,108,57,51,0,0,0
2020-11-14 15:30,125,75,50,0,0,0
2020-11-14 15:45,94,50,44,0,0,0
2020-11-14 16:00,118,57,61,0,0,0
2020-11-14 16:15,110,58,52,0,0,0
2020-11-14 16:30,108,62,46,0,0,0
2020-11-14 16:45,91,42,49,0,0,0
2020-11-14 17:00,84,41,43,0,0,0
2020-11-14 17:15,79,50,29,0,0,0
2020-11-14 17:30,62,29,33,0,0,0
2020-11-14 17:45,78,42,36,0,0,0
2020-11-14 18:00,59,25,34,0,0,0
2020-11-14 18:15,62,19,43,0,0,0
2020-11-14 18:30,54,19,35,0,0,0
2020-11-14 18:45,60,30,30,0,0,0
2020-11-14 19:00,41,21,20,0,0,0
2020-11-14 19:15,49,23,26,0,0,0
2020-11-14 19:30,37,18,19,0,0,0
2020-11-14 19:45,31,20,11,0,0,0
2020-11-14 20:00,43,25,18,0,0,0
2020-11-14 20:15,25,18,7,0,0,0
2020-11-14 20:30,35,22,13,0,0,0
2020-11-14 20:45,20,9,11,0,0,0
2020-11-14 21:00,19,10,9,0,0,0
2020-11-14 21:15,12,6,6,0,0,0
2020-11-14 21:30,9,3,6,0,0,0
2020-11-14 21:45,14,11,3,0,0,0
2020-11-14 22:00,14,7,7,0,0,0
2020-11-14 22:15,17,10,7,0,0,0
2020-11-14 22:30,6,2,4,0,0,0
2020-11-14 22:45,6,2,4,0,0,0
2020-11-14 23:00,12,8,4,0,0,0
2020-11-14 23:15,14,8,6,0,0,0
2020-11-14 23:30,16,11,5,0,0,0
2020-11-14 23:45,22,14,8,0,0,0
2020-11-15 00:00,22,12,10,0,0,0
2020-11-15 00:15,9,5,4,0,0,0
2020-11-15 00:30,12,8,4,0,0,0
2020-11-15 00:45,16,14,2,0,0,0
2020-11-15 01:00,5,2,3,0,0,0
2020-11-15 01:15,7,4,3,0,0,0
2020-11-15 01:30,10,5,5,0,0,0
2020-11-15 01:45,7,3,4,0,0,0
2020-11-15 02:00,2,1,1,0,0,0
2020-11-15 02:15,5,1,4,0,0,0
2020-11-15 02:30,6,1,5,0,0,0
2020-11-15 02:45,3,0,3,0,0,0
2020-11-15 03:00,2,2,0,0,0,0
2020-11-15 03:15,1,1,0,0,0,0
2020-11-15 03:30,2,2,0,0,0,0
2020-11-15 03:45,2,1,1,0,0,0
2020-11-15 04:00,2,1,1,0,0,0
2020-11-15 04:15,2,2,0,0,0,0
2020-11-15 04:30,1,1,0,0,0,0
2020-11-15 04:45,1,1,0,0,0,0
2020-11-15 05:00,1,0,1,0,0,0
2020-11-15 05:15,0,0,0,0,0,0
2020-11-15 05:30,3,2,1,0,0,0
2020-11-15 05:45,4,1,3,0,0,0
2020-11-15 06:00,3,2,1,0,0,0
2020-11-15 06:15,6,5,1,0,0,0
2020-11-15 06:30,2,1,1,0,0,0
2020-11-15 06:45,1,1,0,0,0,0
2020-11-15 07:00,1,1,0,0,0,0
2020-11-15 07:15,3,1,2,0,0,0
2020-11-15 07:30,8,6,2,0,0,0
2020-11-15 07:45,9,6,3,0,0,0
2020-11-15 08:00,8,6,2,0,0,0
2020-11-15 08:15,10,7,3,0,0,0
2020-11-15 08:30,13,11,2,0,0,0
2020-11-15 08:45,21,14,7,0,0,0
2020-11-15 09:00,15,8,7,0,0,0
2020-11-15 09:15,9,2,7,0,0,0
2020-11-15 09:30,20,13,7,0,0,0
2020-11-15 09:45,33,25,8,0,0,0
2020-11-15 10:00,36,16,20,0,0,0
2020-11-15 10:15,44,29,15,0,0,0
2020-11-15 10:30,50,38,12,0,0,0
2020-11-15 10:45,42,23,19,0,0,0
2020-11-15 11:00,31,16,15,0,0,0
2020-11-15 11:15,49,29,20,0,0,0
2020-11-15 11:30,68,51,17,0,0,0
2020-11-15 11:45,53,24,29,0,0,0
2020-11-15 12:00,65,38,27,0,0,0
2020-11-15 12:15,57,34,23,0,0,0
2020-11-15 12:30,63,41,22,0,0,0
2020-11-15 12:45,71,40,31,0,0,0
2020-11-15 13:00,72,44,28,0,0,0
2020-11-15 13:15,76,40,36,0,0,0
2020-11-15 13:30,55,30,25,0,0,0
2020-11-15 13:45,86,52,34,0,0,0
2020-11-15 14:00,65,40,25,0,0,0
2020-11-15 14:15,67,41,26,0,0,0
2020-11-15 14:30,76,47,29,0,0,0
2020-11-15 14:45,66,33,33,0,0,0
2020-11-15 15:00,67,42,25,0,0,0
2020-11-15 15:15,67,49,18,0,0,0
2020-11-15 15:30,54,28,26,0,0,0
2020-11-15 15:45,71,42,29,0,0,0
2020-11-15 16:00,63,36,27,0,0,0
2020-11-15 16:15,58,22,36,0,0,0
2020-11-15 16:30,53,25,28,0,0,0
2020-11-15 16:45,48,20,28,0,0,0
2020-11-15 17:00,43,20,23,0,0,0
2020-11-15 17:15,46,20,26,0,0,0
2020-11-15 17:30,28,17,11,0,0,0
2020-11-15 17:45,25,13,12,0,0,0
2020-11-15 18:00,37,13,24,0,0,0
2020-11-15 18:15,28,18,10,0,0,0
2020-11-15 18:30,27,17,10,0,0,0
2020-11-15 18:45,35,23,12,0,0,0
2020-11-15 19:00,29,20,9,0,0,0
2020-11-15 19:15,29,18,11,0,0,0
2020-11-15 19:30,24,11,13,0,0,0
2020-11-15 19:45,18,13,5,0,0,0
2020-11-15 20:00,17,10,7,0,0,0
2020-11-15 20:15,17,10,7,0,0,0
2020-11-15 20:30,13,7,6,0,0,0
2020-11-15 20:45,13,8,5,0,0,0
2020-11-15 21:00,12,4,8,0,0,0
2020-11-15 21:15,13,7,6,0,0,0
2020-11-15 21:30,12,2,10,0,0,0
2020-11-15 21:45,10,5,5,0,0,0
2020-11-15 22:00,11,7,4,0,0,0
2020-11-15 22:15,17,12,5,0,0,0
2020-11-15 22:30,12,6,6,0,0,0
2020-11-15 22:45,5,1,4,0,0,0
2020-11-15 23:00,13,7,6,0,0,0
2020-11-15 23:15,8,7,1,0,0,0
2020-11-15 23:30,5,3,2,0,0,0
2020-11-15 23:45,5,4,1,0,0,0
2020-11-16 00:00,5,3,2,0,0,0
2020-11-16 00:15,1,1,0,0,0,0
2020-11-16 00:30,1,1,0,0,0,0
2020-11-16 00:45,3,3,0,0,0,0
2020-11-16 01:00,2,1,1,0,0,0
2020-11-16 01:15,2,0,2,0,0,0
2020-11-16 01:30,4,4,0,0,0,0
2020-11-16 01:45,3,1,2,0,0,0
2020-11-16 02:00,1,1,0,0,0,0
2020-11-16 02:15,1,0,1,0,0,0
2020-11-16 02:30,0,0,0,0,0,0
2020-11-16 02:45,0,0,0,0,0,0
2020-11-16 03:00,3,3,0,0,0,0
2020-11-16 03:15,0,0,0,0,0,0
2020-11-16 03:30,0,0,0,0,0,0
2020-11-16 03:45,0,0,0,0,0,0
2020-11-16 04:00,0,0,0,0,0,0
2020-11-16 04:15,0,0,0,0,0,0
2020-11-16 04:30,2,2,0,0,0,0
2020-11-16 04:45,2,2,0,0,0,0
2020-11-16 05:00,0,0,0,0,0,0
2020-11-16 05:15,4,4,0,0,0,0
2020-11-16 05:30,14,6,8,0,0,0
2020-11-16 05:45,12,6,6,0,0,0
2020-11-16 06:00,19,14,5,0,0,0
2020-11-16 06:15,31,16,15,0,0,0
2020-11-16 06:30,32,18,14,0,0,0
2020-11-16 06:45,77,54,23,0,0,0
2020-11-16 07:00,58,45,13,0,0,0
2020-11-16 07:15,98,66,32,0,0,0
2020-11-16 07:30,144,102,42,0,0,0
2020-11-16 07:45,250,191,59,0,0,0
2020-11-16 08:00,250,213,37,0,0,0
2020-11-16 08:15,141,111,30,0,0,0
2020-11-16 08:30,112,79,33,0,0,0
2020-11-16 08:45,147,120,27,0,0,0
2020-11-16 09:00,80,58,22,0,0,0
2020-11-16 09:15,90,61,29,0,0,0
2020-11-16 09:30,83,58,25,0,0,0
2020-11-16 09:45,118,83,35,0,0,0
2020-11-16 10:00,59,41,18,0,0,0
2020-11-16 10:15,84,50,34,0,0,0
2020-11-16 10:30,79,55,24,0,0,0
2020-11-16 10:45,75,46,29,0,0,0
2020-11-16 11:00,86,55,31,0,0,0
2020-11-16 11:15,86,52,34,0,0,0
2020-11-16 11:30,90,56,34,0,0,0
2020-11-16 11:45,74,53,21,0,0,0
2020-11-16 12:00,95,53,42,0,0,0
2020-11-16 12:15,91,46,45,0,0,0
2020-11-16 12:30,83,34,49,0,0,0
2020-11-16 12:45,93,57,36,0,0,0
2020-11-16 13:00,91,42,49,0,0,0
2020-11-16 13:15,119,38,81,0,0,0
2020-11-16 13:30,100,47,53,0,0,0
2020-11-16 13:45,109,61,48,0,0,0
2020-11-16 14:00,95,59,36,0,0,0
2020-11-16 14:15,96,46,50,0,0,0
2020-11-16 14:30,99,48,51,0,0,0
2020-11-16 14:45,105,59,46,0,0,0
2020-11-16 15:00,111,55,56,0,0,0
2020-11-16 15:15,141,81,60,0,0,0
2020-11-16 15:30,128,58,70,0,0,0
2020-11-16 15:45,148,77,71,0,0,0
2020-11-16 16:00,168,73,95,0,0,0
2020-11-16 16:15,139,68,71,0,0,0
2020-11-16 16:30,130,60,70,0,0,0
2020-11-16 16:45,131,60,71,0,0,0
2020-11-16 17:00,127,67,60,0,0,0
2020-11-16 17:15,154,78,76,0,0,0
2020-11-16 17:30,116,38,78,0,0,0
2020-11-16 17:45,112,52,60,0,0,0
2020-11-16 18:00,135,71,64,0,0,0
2020-11-16 18:15,76,32,44,0,0,0
2020-11-16 18:30,74,38,36,0,0,0
2020-11-16 18:45,66,32,34,0,0,0
2020-11-16 19:00,51,18,33,0,0,0
2020-11-16 19:15,50,27,23,0,0,0
2020-11-16 19:30,43,15,28,0,0,0
2020-11-16 19:45,37,18,19,0,0,0
2020-11-16 20:00,45,24,21,0,0,0
2020-11-16 20:15,26,11,15,0,0,0
2020-11-16 20:30,27,11,16,0,0,0
2020-11-16 20:45,20,10,10,0,0,0
2020-11-16 21:00,21,14,7,0,0,0
2020-11-16 21:15,22,7,15,0,0,0
2020-11-16 21:30,14,4,10,0,0,0
2020-11-16 21:45,20,5,15,0,0,0
2020-11-16 22:00,22,12,10,0,0,0
2020-11-16 22:15,20,10,10,0,0,0
2020-11-16 22:30,11,6,5,0,0,0
2020-11-16 22:45,12,5,7,0,0,0
2020-11-16 23:00,11,5,6,0,0,0
2020-11-16 23:15,9,3,6,0,0,0
2020-11-16 23:30,6,2,4,0,0,0
2020-11-16 23:45,3,0,3,0,0,0
2020-11-17 00:00,5,4,1,0,0,0
2020-11-17 00:15,3,2,1,0,0,0
2020-11-17 00:30,4,3,1,0,0,0
2020-11-17 00:45,5,5,0,0,0,0
2020-11-17 01:00,3,2,1,0,0,0
2020-11-17 01:15,1,0,1,0,0,0
2020-11-17 01:30,5,4,1,0,0,0
2020-11-17 01:45,3,1,2,0,0,0
2020-11-17 02:00,1,0,1,0,0,0
2020-11-17 02:15,2,2,0,0,0,0
2020-11-17 02:30,2,1,1,0,0,0
2020-11-17 02:45,0,0,0,0,0,0
2020-11-17 03:00,0,0,0,0,0,0
2020-11-17 03:15,1,1,0,0,0,0
2020-11-17 03:30,2,2,0,0,0,0
2020-11-17 03:45,0,0,0,0,0,0
2020-11-17 04:00,1,0,1,0,0,0
2020-11-17 04:15,1,1,0,0,0,0
2020-11-17 04:30,0,0,0,0,0,0
2020-11-17 04:45,2,2,0,0,0,0
2020-11-17 05:00,1,0,1,0,0,0
2020-11-17 05:15,6,6,0,0,0,0
2020-11-17 05:30,15,12,3,0,0,0
2020-11-17 05:45,16,9,7,0,0,0
2020-11-17 06:00,14,9,5,0,0,0
2020-11-17 06:15,32,25,7,0,0,0
2020-11-17 06:30,32,18,14,0,0,0
2020-11-17 06:45,64,41,23,0,0,0
2020-11-17 07:00,67,50,17,0,0,0
2020-11-17 07:15,85,57,28,0,0,0
2020-11-17 07:30,116,75,41,0,0,0
2020-11-17 07:45,241,186,55,0,0,0
2020-11-17 08:00,213,179,34,0,0,0
2020-11-17 08:15,131,95,36,0,0,0
2020-11-17 08:30,76,57,19,0,0,0
2020-11-17 08:45,117,100,17,0,0,0
2020-11-17 09:00,72,51,21,0,0,0
2020-11-17 09:15,75,58,17,0,0,0
2020-11-17 09:30,75,55,20,0,0,0
2020-11-17 09:45,104,75,29,0,0,0
2020-11-17 10:00,52,39,13,0,0,0
2020-11-17 10:15,70,48,22,0,0,0
2020-11-17 10:30,59,36,23,0,0,0
2020-11-17 10:45,47,29,18,0,0,0
2020-11-17 11:00,58,41,17,0,0,0
2020-11-17 11:15,54,28,26,0,0,0
2020-11-17 11:30,63,38,25,0,0,0
2020-11-17 11:45,81,45,36,0,0,0
2020-11-17 12:00,92,58,34,0,0,0
2020-11-17 12:15,58,33,25,0,0,0
2020-11-17 12:30,84,36,48,0,0,0
2020-11-17 12:45,92,52,40,0,0,0
2020-11-17 13:00,104,58,46,0,0,0
2020-11-17 13:15,115,63,52,0,0,0
2020-11-17 13:30,108,42,66,0,0,0
2020-11-17 13:45,96,52,44,0,0,0
2020-11-17 14:00,104,53,51,0,0,0
2020-11-17 14:15,135,51,84,0,0,0
2020-11-17 14:30,122,66,56,0,0,0
2020-11-17 14:45,97,59,38,0,0,0
2020-11-17 15:00,98,57,41,0,0,0
2020-11-17 15:15,133,67,66,0,0,0
2020-11-17 15:30,123,65,58,0,0,0
2020-11-17 15:45,152,94,58,0,0,0
2020-11-17 16:00,125,72,53,0,0,0
2020-11-17 16:15,157,92,65,0,0,0
2020-11-17 16:30,157,82,75,0,0,0
2020-11-17 16:45,142,64,78,0,0,0
2020-11-17 17:00,155,77,78,0,0,0
2020-11-17 17:15,143,78,65,0,0,0
2020-11-17 17:30,117,46,71,0,0,0
2020-11-17 17:45,104,48,56,0,0,0
2020-11-17 18:00,111,41,70,0,0,0
2020-11-17 18:15,101,45,56,0,0,0
2020-11-17 18:30,71,34,37,0,0,0
2020-11-17 18:45,94,46,48,0,0,0
2020-11-17 19:00,63,26,37,0,0,0
2020-11-17 19:15,64,30,34,0,0,0
2020-11-17 19:30,67,26,41,0,0,0
2020-11-17 19:45,47,26,21,0,0,0
2020-11-17 20:00,45,25,20,0,0,0
2020-11-17 20:15,33,10,23,0,0,0
2020-11-17 20:30,33,20,13,0,0,0
2020-11-17 20:45,22,9,13,0,0,0
2020-11-17 21:00,20,13,7,0,0,0
2020-11-17 21:15,18,7,11,0,0,0
2020-11-17 21:30,14,7,7,0,0,0
2020-11-17 21:45,13,5,8,0,0,0
2020-11-17 22:00,11,4,7,0,0,0
2020-11-17 22:15,17,9,8,0,0,0
2020-11-17 22:30,10,6,4,0,0,0
2020-11-17 22:45,17,8,9,0,0,0
2020-11-17 23:00,14,3,11,0,0,0
2020-11-17 23:15,14,5,9,0,0,0
2020-11-17 23:30,11,6,5,0,0,0
2020-11-17 23:45,3,2,1,0,0,0
2020-11-18 00:00,5,5,0,0,0,0
2020-11-18 00:15,6,2,4,0,0,0
2020-11-18 00:30,7,3,4,0,0,0
2020-11-18 00:45,4,2,2,0,0,0
2020-11-18 01:00,5,4,1,0,0,0
2020-11-18 01:15,0,0,0,0,0,0
2020-11-18 01:30,2,1,1,0,0,0
2020-11-18 01:45,4,3,1,0,0,0
2020-11-18 02:00,2,1,1,0,0,0
2020-11-18 02:15,0,0,0,0,0,0
2020-11-18 02:30,1,0,1,0,0,0
2020-11-18 02:45,0,0,0,0,0,0
2020-11-18 03:00,0,0,0,0,0,0
2020-11-18 03:15,0,0,0,0,0,0
2020-11-18 03:30,0,0,0,0,0,0
2020-11-18 03:45,1,1,0,0,0,0
2020-11-18 04:00,1,0,1,0,0,0
2020-11-18 04:15,3,3,0,0,0,0
2020-11-18 04:30,2,2,0,0,0,0
2020-11-18 04:45,1,1,0,0,0,0
2020-11-18 05:00,1,1,0,0,0,0
2020-11-18 05:15,3,3,0,0,0,0
2020-11-18 05:30,20,14,6,0,0,0
2020-11-18 05:45,15,11,4,0,0,0
2020-11-18 06:00,13,9,4,0,0,0
2020-11-18 06:15,23,15,8,0,0,0
2020-11-18 06:30,42,26,16,0,0,0
2020-11-18 06:45,70,56,14,0,0,0
2020-11-18 07:00,69,48,21,0,0,0
2020-11-18 07:15,123,91,32,0,0,0
2020-11-18 07:30,185,123,62,0,0,0
2020-11-18 07:45,265,208,57,0,0,0
2020-11-18 08:00,233,199,34,0,0,0
2020-11-18 08:15,153,126,27,0,0,0
2020-11-18 08:30,120,93,27,0,0,0
2020-11-18 08:45,136,99,37,0,0,0
2020-11-18 09:00,109,78,31,0,0,0
2020-11-18 09:15,102,71,31,0,0,0
2020-11-18 09:30,113,80,33,0,0,0
2020-11-18 09:45,149,112,37,0,0,0
2020-11-18 10:00,111,80,31,0,0,0
2020-11-18 10:15,117,84,33,0,0,0
2020-11-18 10:30,111,79,32,0,0,0
2020-11-18 10:45,123,80,43,0,0,0
2020-11-18 11:00,103,64,39,0,0,0
2020-11-18 11:15,111,71,40,0,0,0
2020-11-18 11:30,144,90,54,0,0,0
2020-11-18 11:45,131,76,55,0,0,0
2020-11-18 12:00,119,69,50,0,0,0
2020-11-18 12:15,153,88,65,0,0,0
2020-11-18 12:30,166,92,74,0,0,0
2020-11-18 12:45,153,79,74,0,0,0
2020-11-18 13:00,155,85,70,0,0,0
2020-11-18 13:15,166,75,91,0,0,0
2020-11-18 13:30,160,92,68,0,0,0
2020-11-18 13:45,140,77,63,0,0,0
2020-11-18 14:00,137,69,68,0,0,0
2020-11-18 14:15,178,84,94,0,0,0
2020-11-18 14:30,138,59,79,0,0,0
2020-11-18 14:45,140,77,63,0,0,0
2020-11-18 15:00,154,92,62,0,0,0
2020-11-18 15:15,147,71,76,0,0,0
2020-11-18 15:30,191,113,78,0,0,0
2020-11-18 15:45,166,84,82,0,0,0
2020-11-18 16:00,175,91,84,0,0,0
2020-11-18 16:15,171,82,89,0,0,0
2020-11-18 16:30,180,95,85,0,0,0
2020-11-18 16:45,169,85,84,0,0,0
2020-11-18 17:00,151,46,105,0,0,0
2020-11-18 17:15,142,66,76,0,0,0
2020-11-18 17:30,116,51,65,0,0,0
2020-11-18 17:45,96,44,52,0,0,0
2020-11-18 18:00,109,47,62,0,0,0
2020-11-18 18:15,110,43,67,0,0,0
2020-11-18 18:30,104,48,56,0,0,0
2020-11-18 18:45,80,28,52,0,0,0
2020-11-18 19:00,69,22,47,0,0,0
2020-11-18 19:15,59,28,31,0,0,0
2020-11-18 19:30,48,21,27,0,0,0
2020-11-18 19:45,55,27,28,0,0,0
2020-11-18 20:00,51,23,28,0,0,0
2020-11-18 20:15,37,19,18,0,0,0
2020-11-18 20:30,34,20,14,0,0,0
2020-11-18 20:45,27,11,16,0,0,0
2020-11-18 21:00,26,15,11,0,0,0
2020-11-18 21:15,23,12,11,0,0,0
2020-11-18 21:30,14,10,4,0,0,0
2020-11-18 21:45,13,6,7,0,0,0
2020-11-18 22:00,17,11,6,0,0,0
2020-11-18 22:15,30,19,11,0,0,0
2020-11-18 22:30,21,10,11,0,0,0
2020-11-18 22:45,16,9,7,0,0,0
2020-11-18 23:00,17,9,8,0,0,0
2020-11-18 23:15,22,12,10,0,0,0
2020-11-18 23:30,9,3,6,0,0,0
2020-11-18 23:45,7,6,1,0,0,0
2020-11-19 00:00,8,5,3,0,0,0
2020-11-19 00:15,7,4,3,0,0,0
2020-11-19 00:30,5,3,2,0,0,0
2020-11-19 00:45,6,4,2,0,0,0
2020-11-19 01:00,7,4,3,0,0,0
2020-11-19 01:15,2,0,2,0,0,0
2020-11-19 01:30,1,0,1,0,0,0
2020-11-19 01:45,5,4,1,0,0,0
2020-11-19 02:00,0,0,0,0,0,0
2020-11-19 02:15,0,0,0,0,0,0
2020-11-19 02:30,2,2,0,0,0,0
2020-11-19 02:45,2,0,2,0,0,0
2020-11-19 03:00,0,0,0,0,0,0
2020-11-19 03:15,0,0,0,0,0,0
2020-11-19 03:30,0,0,0,0,0,0
2020-11-19 03:45,3,3,0,0,0,0
2020-11-19 04:00,0,0,0,0,0,0
2020-11-19 04:15,1,1,0,0,0,0
2020-11-19 04:30,0,0,0,0,0,0
2020-11-19 04:45,1,0,1,0,0,0
2020-11-19 05:00,0,0,0,0,0,0
2020-11-19 05:15,2,2,0,0,0,0
2020-11-19 05:30,16,11,5,0,0,0
2020-11-19 05:45,17,9,8,0,0,0
2020-11-19 06:00,18,13,5,0,0,0
2020-11-19 06:15,27,19,8,0,0,0
2020-11-19 06:30,40,26,14,0,0,0
2020-11-19 06:45,46,31,15,0,0,0
2020-11-19 07:00,77,52,25,0,0,0
2020-11-19 07:15,104,78,26,0,0,0
2020-11-19 07:30,147,103,44,0,0,0
2020-11-19 07:45,216,163,53,0,0,0
2020-11-19 08:00,205,180,25,0,0,0
2020-11-19 08:15,127,104,23,0,0,0
2020-11-19 08:30,132,92,40,0,0,0
2020-11-19 08:45,140,97,43,0,0,0
2020-11-19 09:00,86,60,26,0,0,0
2020-11-19 09:15,81,59,22,0,0,0
2020-11-19 09:30,84,60,24,0,0,0
2020-11-19 09:45,121,92,29,0,0,0
2020-11-19 10:00,76,57,19,0,0,0
2020-11-19 10:15,74,41,33,0,0,0
2020-11-19 10:30,77,52,25,0,0,0
2020-11-19 10:45,67,46,21,0,0,0
2020-11-19 11:00,65,42,23,0,0,0
2020-11-19 11:15,71,42,29,0,0,0
2020-11-19 11:30,83,54,29,0,0,0
2020-11-19 11:45,96,64,32,0,0,0
2020-11-19 12:00,99,64,35,0,0,0
2020-11-19 12:15,98,55,43,0,0,0
2020-11-19 12:30,75,32,43,0,0,0
2020-11-19 12:45,105,61,44,0,0,0
2020-11-19 13:00,115,64,51,0,0,0
2020-11-19 13:15,111,58,53,0,0,0
2020-11-19 13:30,89,30,59,0,0,0
2020-11-19 13:45,68,34,34,0,0,0
2020-11-19 14:00,89,41,48,0,0,0
2020-11-19 14:15,102,52,50,0,0,0
2020-11-19 14:30,120,70,50,0,0,0
2020-11-19 14:45,92,43,49,0,0,0
2020-11-19 15:00,122,77,45,0,0,0
2020-11-19 15:15,100,60,40,0,0,0
2020-11-19 15:30,123,63,60,0,0,0
2020-11-19 15:45,173,101,72,0,0,0
2020-11-19 16:00,139,69,70,0,0,0
2020-11-19 16:15,168,87,81,0,0,0
2020-11-19 16:30,132,69,63,0,0,0
2020-11-19 16:45,151,74,77,0,0,0
2020-11-19 17:00,150,58,92,0,0,0
2020-11-19 17:15,135,62,73,0,0,0
2020-11-19 17:30,101,42,59,0,0,0
2020-11-19 17:45,108,47,61,0,0,0
2020-11-19 18:00,127,52,75,0,0,0
2020-11-19 18:15,90,41,49,0,0,0
2020-11-19 18:30,81,31,50,0,0,0
2020-11-19 18:45,96,38,58,0,0,0
2020-11-19 19:00,77,27,50,0,0,0
2020-11-19 19:15,57,30,27,0,0,0
2020-11-19 19:30,52,24,28,0,0,0
2020-11-19 19:45,47,17,30,0,0,0
2020-11-19 20:00,54,32,22,0,0,0
2020-11-19 20:15,45,24,21,0,0,0
2020-11-19 20:30,27,9,18,0,0,0
2020-11-19 20:45,19,12,7,0,0,0
2020-11-19 21:00,29,10,19,0,0,0
2020-11-19 21:15,17,5,12,0,0,0
2020-11-19 21:30,14,9,5,0,0,0
2020-11-19 21:45,15,8,7,0,0,0
2020-11-19 22:00,15,12,3,0,0,0
2020-11-19 22:15,18,15,3,0,0,0
2020-11-19 22:30,13,8,5,0,0,0
2020-11-19 22:45,9,4,5,0,0,0
2020-11-19 23:00,17,7,10,0,0,0
2020-11-19 23:15,11,4,7,0,0,0
2020-11-19 23:30,6,3,3,0,0,0
2020-11-19 23:45,4,1,3,0,0,0
2020-11-20 00:00,8,6,2,0,0,0
2020-11-20 00:15,8,5,3,0,0,0
2020-11-20 00:30,2,2,0,0,0,0
2020-11-20 00:45,3,0,3,0,0,0
2020-11-20 01:00,3,2,1,0,0,0
2020-11-20 01:15,4,0,4,0,0,0
2020-11-20 01:30,1,1,0,0,0,0
2020-11-20 01:45,3,1,2,0,0,0
2020-11-20 02:00,3,0,3,0,0,0
2020-11-20 02:15,3,2,1,0,0,0
2020-11-20 02:30,2,1,1,0,0,0
2020-11-20 02:45,0,0,0,0,0,0
2020-11-20 03:00,1,0,1,0,0,0
2020-11-20 03:15,3,1,2,0,0,0
2020-11-20 03:30,0,0,0,0,0,0
2020-11-20 03:45,1,1,0,0,0,0
2020-11-20 04:00,1,0,1,0,0,0
2020-11-20 04:15,3,2,1,0,0,0
2020-11-20 04:30,0,0,0,0,0,0
2020-11-20 04:45,1,1,0,0,0,0
2020-11-20 05:00,0,0,0,0,0,0
2020-11-20 05:15,5,4,1,0,0,0
2020-11-20 05:30,15,13,2,0,0,0
2020-11-20 05:45,12,4,8,0,0,0
2020-11-20 06:00,14,8,6,0,0,0
2020-11-20 06:15,19,12,7,0,0,0
2020-11-20 06:30,38,22,16,0,0,0
2020-11-20 06:45,52,39,13,0,0,0
2020-11-20 07:00,62,40,22,0,0,0
2020-11-20 07:15,94,69,25,0,0,0
2020-11-20 07:30,157,115,42,0,0,0
2020-11-20 07:45,235,187,48,0,0,0
2020-11-20 08:00,229,200,29,0,0,0
2020-11-20 08:15,130,108,22,0,0,0
2020-11-20 08:30,93,67,26,0,0,0
2020-11-20 08:45,146,115,31,0,0,0
2020-11-20 09:00,92,62,30,0,0,0
2020-11-20 09:15,87,68,19,0,0,0
2020-11-20 09:30,84,57,27,0,0,0
2020-11-20 09:45,113,79,34,0,0,0
2020-11-20 10:00,74,58,16,0,0,0
2020-11-20 10:15,93,70,23,0,0,0
2020-11-20 10:30,80,53,27,0,0,0
2020-11-20 10:45,83,55,28,0,0,0
2020-11-20 11:00,91,60,31,0,0,0
2020-11-20 11:15,109,65,44,0,0,0
2020-11-20 11:30,104,56,48,0,0,0
2020-11-20 11:45,117,79,38,0,0,0
2020-11-20 12:00,100,60,40,0,0,0
2020-11-20 12:15,94,58,36,0,0,0
2020-11-20 12:30,111,65,46,0,0,0
2020-11-20 12:45,115,59,56,0,0,0
2020-11-20 13:00,165,78,87,0,0,0
2020-11-20 13:15,158,65,93,0,0,0
2020-11-20 13:30,137,70,67,0,0,0
2020-11-20 13:45,142,60,82,0,0,0
2020-11-20 14:00,147,76,71,0,0,0
2020-11-20 14:15,146,73,73,0,0,0
2020-11-20 14:30,149,81,68,0,0,0
2020-11-20 14:45,157,94,63,0,0,0
2020-11-20 15:00,131,64,67,0,0,0
2020-11-20 15:15,141,86,55,0,0,0
2020-11-20 15:30,137,73,64,0,0,0
2020-11-20 15:45,136,72,64,0,0,0
2020-11-20 16:00,161,100,61,0,0,0
2020-11-20 16:15,164,81,83,0,0,0
2020-11-20 16:30,130,59,71,0,0,0
2020-11-20 16:45,131,62,69,0,0,0
2020-11-20 17:00,114,55,59,0,0,0
2020-11-20 17:15,92,41,51,0,0,0
2020-11-20 17:30,84,31,53,0,0,0
2020-11-20 17:45,101,42,59,0,0,0
2020-11-20 18:00,103,46,57,0,0,0
2020-11-20 18:15,75,30,45,0,0,0
2020-11-20 18:30,74,33,41,0,0,0
2020-11-20 18:45,71,37,34,0,0,0
2020-11-20 19:00,83,34,49,0,0,0
2020-11-20 19:15,62,17,45,0,0,0
2020-11-20 19:30,60,28,32,0,0,0
2020-11-20 19:45,56,24,32,0,0,0
2020-11-20 20:00,45,13,32,0,0,0
2020-11-20 20:15,36,17,19,0,0,0
2020-11-20 20:30,43,20,23,0,0,0
2020-11-20 20:45,24,11,13,0,0,0
2020-11-20 21:00,30,20,10,0,0,0
2020-11-20 21:15,21,12,9,0,0,0
2020-11-20 21:30,17,6,11,0,0,0
2020-11-20 21:45,20,14,6,0,0,0
2020-11-20 22:00,13,5,8,0,0,0
2020-11-20 22:15,24,21,3,0,0,0
2020-11-20 22:30,18,13,5,0,0,0
2020-11-20 22:45,11,6,5,0,0,0
2020-11-20 23:00,21,15,6,0,0,0
2020-11-20 23:15,7,5,2,0,0,0
2020-11-20 23:30,18,14,4,0,0,0
2020-11-20 23:45,11,5,6,0,0,0
2020-11-21 00:00,14,5,9,0,0,0
2020-11-21 00:15,14,7,7,0,0,0
2020-11-21 00:30,11,6,5,0,0,0
2020-11-21 00:45,10,5,5,0,0,0
2020-11-21 01:00,7,4,3,0,0,0
2020-11-21 01:15,3,2,1,0,0,0
2020-11-21 01:30,7,2,5,0,0,0
2020-11-21 01:45,4,4,0,0,0,0
2020-11-21 02:00,8,3,5,0,0,0
2020-11-21 02:15,8,7,1,0,0,0
2020-11-21 02:30,6,5,1,0,0,0
2020-11-21 02:45,4,3,1,0,0,0
2020-11-21 03:00,1,0,1,0,0,0
2020-11-21 03:15,3,1,2,0,0,0
2020-11-21 03:30,1,0,1,0,0,0
2020-11-21 03:45,2,1,1,0,0,0
2020-11-21 04:00,3,0,3,0,0,0
2020-11-21 04:15,1,1,0,0,0,0
2020-11-21 04:30,2,1,1,0,0,0
2020-11-21 04:45,2,2,0,0,0,0
2020-11-21 05:00,1,1,0,0,0,0
2020-11-21 05:15,2,2,0,0,0,0
2020-11-21 05:30,9,4,5,0,0,0
2020-11-21 05:45,9,4,5,0,0,0
2020-11-21 06:00,6,3,3,0,0,0
2020-11-21 06:15,3,2,1,0,0,0
2020-11-21 06:30,5,5,0,0,0,0
2020-11-21 06:45,18,11,7,0,0,0
2020-11-21 07:00,13,11,2,0,0,0
2020-11-21 07:15,9,7,2,0,0,0
2020-11-21 07:30,21,12,9,0,0,0
2020-11-21 07:45,25,14,11,0,0,0
2020-11-21 08:00,31,21,10,0,0,0
2020-11-21 08:15,21,16,5,0,0,0
2020-11-21 08:30,40,26,14,0,0,0
2020-11-21 08:45,47,35,12,0,0,0
2020-11-21 09:00,67,55,12,0,0,0
2020-11-21 09:15,60,51,9,0,0,0
2020-11-21 09:30,69,53,16,0,0,0
2020-11-21 09:45,103,73,30,0,0,0
2020-11-21 10:00,78,64,14,0,0,0
2020-11-21 10:15,110,89,21,0,0,0
2020-11-21 10:30,121,86,35,0,0,0
2020-11-21 10:45,123,88,35,0,0,0
2020-11-21 11:00,137,96,41,0,0,0
2020-11-21 11:15,129,85,44,0,0,0
2020-11-21 11:30,157,107,50,0,0,0
2020-11-21 11:45,123,69,54,0,0,0
2020-11-21 12:00,109,56,53,0,0,0
2020-11-21 12:15,116,75,41,0,0,0
2020-11-21 12:30,104,70,34,0,0,0
2020-11-21 12:45,123,77,46,0,0,0
2020-11-21 13:00,125,69,56,0,0,0
2020-11-21 13:15,126,72,54,0,0,0
2020-11-21 13:30,131,75,56,0,0,0
2020-11-21 13:45,133,65,68,0,0,0
2020-11-21 14:00,120,62,58,0,0,0
2020-11-21 14:15,106,63,43,0,0,0
2020-11-21 14:30,111,54,57,0,0,0
2020-11-21 14:45,105,49,56,0,0,0
2020-11-21 15:00,90,40,50,0,0,0
2020-11-21 15:15,111,57,54,0,0,0
2020-11-21 15:30,86,56,30,0,0,0
2020-11-21 15:45,84,46,38,0,0,0
2020-11-21 16:00,101,53,48,0,0,0
2020-11-21 16:15,98,42,56,0,0,0
2020-11-21 16:30,61,28,33,0,0,0
2020-11-21 16:45,66,34,32,0,0,0
2020-11-21 17:00,66,43,23,0,0,0
2020-11-21 17:15,72,40,32,0,0,0
2020-11-21 17:30,51,29,22,0,0,0
2020-11-21 17:45,50,23,27,0,0,0
2020-11-21 18:00,79,40,39,0,0,0
2020-11-21 18:15,64,23,41,0,0,0
2020-11-21 18:30,51,17,34,0,0,0
2020-11-21 18:45,52,24,28,0,0,0
2020-11-21 19:00,61,24,37,0,0,0
2020-11-21 19:15,46,26,20,0,0,0
2020-11-21 19:30,30,15,15,0,0,0
2020-11-21 19:45,35,22,13,0,0,0
2020-11-21 20:00,38,13,25,0,0,0
2020-11-21 20:15,27,17,10,0,0,0
2020-11-21 20:30,23,18,5,0,0,0
2020-11-21 20:45,26,15,11,0,0,0
2020-11-21 21:00,22,14,8,0,0,0
2020-11-21 21:15,20,12,8,0,0,0
2020-11-21 21:30,19,7,12,0,0,0
2020-11-21 21:45,14,6,8,0,0,0
2020-11-21 22:00,6,5,1,0,0,0
2020-11-21 22:15,10,6,4,0,0,0
2020-11-21 22:30,9,7,2,0,0,0
2020-11-21 22:45,12,8,4,0,0,0
2020-11-21 23:00,7,6,1,0,0,0
2020-11-21 23:15,15,7,8,0,0,0
2020-11-21 23:30,22,13,9,0,0,0
2020-11-21 23:45,18,13,5,0,0,0
2020-11-22 00:00,10,5,5,0,0,0
2020-11-22 00:15,20,11,9,0,0,0
2020-11-22 00:30,4,2,2,0,0,0
2020-11-22 00:45,9,4,5,0,0,0
2020-11-22 01:00,3,1,2,0,0,0
2020-11-22 01:15,12,9,3,0,0,0
2020-11-22 01:30,9,5,4,0,0,0
2020-11-22 01:45,10,7,3,0,0,0
2020-11-22 02:00,6,2,4,0,0,0
2020-11-22 02:15,8,6,2,0,0,0
2020-11-22 02:30,7,4,3,0,0,0
2020-11-22 02:45,4,0,4,0,0,0
2020-11-22 03:00,6,2,4,0,0,0
2020-11-22 03:15,2,1,1,0,0,0
2020-11-22 03:30,1,0,1,0,0,0
2020-11-22 03:45,1,1,0,0,0,0
2020-11-22 04:00,3,3,0,0,0,0
2020-11-22 04:15,1,0,1,0,0,0
2020-11-22 04:30,0,0,0,0,0,0
2020-11-22 04:45,0,0,0,0,0,0
2020-11-22 05:00,0,0,0,0,0,0
2020-11-22 05:15,2,2,0,0,0,0
2020-11-22 05:30,6,6,0,0,0,0
2020-11-22 05:45,3,0,3,0,0,0
2020-11-22 06:00,4,2,2,0,0,0
2020-11-22 06:15,3,2,1,0,0,0
2020-11-22 06:30,6,5,1,0,0,0
2020-11-22 06:45,2,1,1,0,0,0
2020-11-22 07:00,4,1,3,0,0,0
2020-11-22 07:15,3,3,0,0,0,0
2020-11-22 07:30,6,3,3,0,0,0
2020-11-22 07:45,2,2,0,0,0,0
2020-11-22 08:00,6,4,2,0,0,0
2020-11-22 08:15,4,4,0,0,0,0
2020-11-22 08:30,10,6,4,0,0,0
2020-11-22 08:45,16,12,4,0,0,0
2020-11-22 09:00,13,9,4,0,0,0
2020-11-22 09:15,9,7,2,0,0,0
2020-11-22 09:30,12,4,8,0,0,0
2020-11-22 09:45,27,18,9,0,0,0
2020-11-22 10:00,11,9,2,0,0,0
2020-11-22 10:15,27,20,7,0,0,0
2020-11-22 10:30,12,4,8,0,0,0
2020-11-22 10:45,17,7,10,0,0,0
2020-11-22 11:00,17,7,10,0,0,0
2020-11-22 11:15,22,16,6,0,0,0
2020-11-22 11:30,18,9,9,0,0,0
2020-11-22 11:45,20,11,9,0,0,0
2020-11-22 12:00,14,7,7,0,0,0
2020-11-22 12:15,18,12,6,0,0,0
2020-11-22 12:30,34,22,12,0,0,0
2020-11-22 12:45,40,22,18,0,0,0
2020-11-22 13:00,31,20,11,0,0,0
2020-11-22 13:15,45,22,23,0,0,0
2020-11-22 13:30,39,27,12,0,0,0
2020-11-22 13:45,45,25,20,0,0,0
2020-11-22 14:00,31,19,12,0,0,0
2020-11-22 14:15,51,28,23,0,0,0
2020-11-22 14:30,42,26,16,0,0,0
2020-11-22 14:45,59,42,17,0,0,0
2020-11-22 15:00,46,34,12,0,0,0
2020-11-22 15:15,63,42,21,0,0,0
2020-11-22 15:30,42,22,20,0,0,0
2020-11-22 15:45,47,28,19,0,0,0
2020-11-22 16:00,34,18,16,0,0,0
2020-11-22 16:15,38,20,18,0,0,0
2020-11-22 16:30,50,31,19,0,0,0
2020-11-22 16:45,40,12,28,0,0,0
2020-11-22 17:00,37,25,12,0,0,0
2020-11-22 17:15,34,23,11,0,0,0
2020-11-22 17:30,46,26,20,0,0,0
2020-11-22 17:45,43,30,13,0,0,0
2020-11-22 18:00,49,24,25,0,0,0
2020-11-22 18:15,33,19,14,0,0,0
2020-11-22 18:30,35,14,21,0,0,0
2020-11-22 18:45,27,18,9,0,0,0
2020-11-22 19:00,24,10,14,0,0,0
2020-11-22 19:15,33,10,23,0,0,0
2020-11-22 19:30,29,19,10,0,0,0
2020-11-22 19:45,25,13,12,0,0,0
2020-11-22 20:00,20,11,9,0,0,0
2020-11-22 20:15,20,10,10,0,0,0
2020-11-22 20:30,18,9,9,0,0,0
2020-11-22 20:45,24,13,11,0,0,0
2020-11-22 21:00,14,9,5,0,0,0
2020-11-22 21:15,17,7,10,0,0,0
2020-11-22 21:30,10,8,2,0,0,0
2020-11-22 21:45,10,9,1,0,0,0
2020-11-22 22:00,21,14,7,0,0,0
2020-11-22 22:15,10,6,4,0,0,0
2020-11-22 22:30,15,10,5,0,0,0
2020-11-22 22:45,10,4,6,0,0,0
2020-11-22 23:00,5,0,5,0,0,0
2020-11-22 23:15,9,7,2,0,0,0
2020-11-22 23:30,6,2,4,0,0,0
2020-11-22 23:45,0,0,0,0,0,0
2020-11-23 00:00,8,5,3,0,0,0
2020-11-23 00:15,4,0,4,0,0,0
2020-11-23 00:30,5,2,3,0,0,0
2020-11-23 00:45,0,0,0,0,0,0
2020-11-23 01:00,4,1,3,0,0,0
2020-11-23 01:15,0,0,0,0,0,0
2020-11-23 01:30,2,2,0,0,0,0
2020-11-23 01:45,2,1,1,0,0,0
2020-11-23 02:00,0,0,0,0,0,0
2020-11-23 02:15,1,0,1,0,0,0
2020-11-23 02:30,3,3,0,0,0,0
2020-11-23 02:45,1,0,1,0,0,0
2020-11-23 03:00,0,0,0,0,0,0
2020-11-23 03:15,1,1,0,0,0,0
2020-11-23 03:30,0,0,0,0,0,0
2020-11-23 03:45,1,1,0,0,0,0
2020-11-23 04:00,1,0,1,0,0,0
2020-11-23 04:15,1,0,1,0,0,0
2020-11-23 04:30,1,1,0,0,0,0
2020-11-23 04:45,0,0,0,0,0,0
2020-11-23 05:00,0,0,0,0,0,0
2020-11-23 05:15,3,3,0,0,0,0
2020-11-23 05:30,11,9,2,0,0,0
2020-11-23 05:45,14,9,5,0,0,0
2020-11-23 06:00,15,7,8,0,0,0
2020-11-23 06:15,24,14,10,0,0,0
2020-11-23 06:30,45,23,22,0,0,0
2020-11-23 06:45,53,42,11,0,0,0
2020-11-23 07:00,61,45,16,0,0,0
2020-11-23 07:15,83,60,23,0,0,0
2020-11-23 07:30,156,103,53,0,0,0
2020-11-23 07:45,253,190,63,0,0,0
2020-11-23 08:00,248,207,41,0,0,0
2020-11-23 08:15,172,135,37,0,0,0
2020-11-23 08:30,104,82,22,0,0,0
2020-11-23 08:45,136,101,35,0,0,0
2020-11-23 09:00,94,70,24,0,0,0
2020-11-23 09:15,80,65,15,0,0,0
2020-11-23 09:30,91,67,24,0,0,0
2020-11-23 09:45,110,79,31,0,0,0
2020-11-23 10:00,93,76,17,0,0,0
2020-11-23 10:15,87,60,27,0,0,0
2020-11-23 10:30,87,70,17,0,0,0
2020-11-23 10:45,82,54,28,0,0,0
2020-11-23 11:00,74,52,22,0,0,0
2020-11-23 11:15,87,58,29,0,0,0
2020-11-23 11:30,100,60,40,0,0,0
2020-11-23 11:45,84,57,27,0,0,0
2020-11-23 12:00,102,49,53,0,0,0
2020-11-23 12:15,100,73,27,0,0,0
2020-11-23 12:30,110,54,56,0,0,0
2020-11-23 12:45,100,58,42,0,0,0
2020-11-23 13:00,140,65,75,0,0,0
2020-11-23 13:15,149,62,87,0,0,0
2020-11-23 13:30,124,66,58,0,0,0
2020-11-23 13:45,108,65,43,0,0,0
2020-11-23 14:00,133,69,64,0,0,0
2020-11-23 14:15,127,69,58,0,0,0
2020-11-23 14:30,127,57,70,0,0,0
2020-11-23 14:45,139,77,62,0,0,0
2020-11-23 15:00,129,73,56,0,0,0
2020-11-23 15:15,126,68,58,0,0,0
2020-11-23 15:30,146,68,78,0,0,0
2020-11-23 15:45,201,112,89,0,0,0
2020-11-23 16:00,178,100,78,0,0,0
2020-11-23 16:15,167,85,82,0,0,0
2020-11-23 16:30,173,96,77,0,0,0
2020-11-23 16:45,177,88,89,0,0,0
2020-11-23 17:00,170,85,85,0,0,0
2020-11-23 17:15,151,67,84,0,0,0
2020-11-23 17:30,112,54,58,0,0,0
2020-11-23 17:45,118,47,71,0,0,0
2020-11-23 18:00,115,52,63,0,0,0
2020-11-23 18:15,89,35,54,0,0,0
2020-11-23 18:30,80,33,47,0,0,0
2020-11-23 18:45,59,24,35,0,0,0
2020-11-23 19:00,63,25,38,0,0,0
2020-11-23 19:15,50,16,34,0,0,0
2020-11-23 19:30,41,28,13,0,0,0
2020-11-23 19:45,45,26,19,0,0,0
2020-11-23 20:00,38,22,16,0,0,0
2020-11-23 20:15,30,16,14,0,0,0
2020-11-23 20:30,26,13,13,0,0,0
2020-11-23 20:45,18,10,8,0,0,0
2020-11-23 21:00,29,16,13,0,0,0
2020-11-23 21:15,27,13,14,0,0,0
2020-11-23 21:30,15,5,10,0,0,0
2020-11-23 21:45,13,3,10,0,0,0
2020-11-23 22:00,10,5,5,0,0,0
2020-11-23 22:15,8,2,6,0,0,0
2020-11-23 22:30,10,6,4,0,0,0
2020-11-23 22:45,9,6,3,0,0,0
2020-11-23 23:00,11,5,6,0,0,0
2020-11-23 23:15,10,6,4,0,0,0
2020-11-23 23:30,4,1,3,0,0,0
2020-11-23 23:45,8,5,3,0,0,0
2020-11-24 00:00,6,4,2,0,0,0
2020-11-24 00:15,6,4,2,0,0,0
2020-11-24 00:30,0,0,0,0,0,0
2020-11-24 00:45,1,0,1,0,0,0
2020-11-24 01:00,3,3,0,0,0,0
2020-11-24 01:15,0,0,0,0,0,0
2020-11-24 01:30,1,0,1,0,0,0
2020-11-24 01:45,2,0,2,0,0,0
2020-11-24 02:00,1,1,0,0,0,0
2020-11-24 02:15,0,0,0,0,0,0
2020-11-24 02:30,0,0,0,0,0,0
2020-11-24 02:45,1,0,1,0,0,0
2020-11-24 03:00,1,0,1,0,0,0
2020-11-24 03:15,0,0,0,0,0,0
2020-11-24 03:30,0,0,0,0,0,0
2020-11-24 03:45,1,1,0,0,0,0
2020-11-24 04:00,1,0,1,0,0,0
2020-11-24 04:15,2,0,2,0,0,0
2020-11-24 04:30,2,2,0,0,0,0
2020-11-24 04:45,1,1,0,0,0,0
2020-11-24 05:00,0,0,0,0,0,0
2020-11-24 05:15,3,3,0,0,0,0
2020-11-24 05:30,12,8,4,0,0,0
2020-11-24 05:45,18,10,8,0,0,0
2020-11-24 06:00,18,9,9,0,0,0
2020-11-24 06:15,23,14,9,0,0,0
2020-11-24 06:30,54,33,21,0,0,0
2020-11-24 06:45,56,38,18,0,0,0
2020-11-24 07:00,71,50,21,0,0,0
2020-11-24 07:15,99,69,30,0,0,0
2020-11-24 07:30,152,101,51,0,0,0
2020-11-24 07:45,270,208,62,0,0,0
2020-11-24 08:00,243,204,39,0,0,0
2020-11-24 08:15,133,107,26,0,0,0
2020-11-24 08:30,122,94,28,0,0,0
2020-11-24 08:45,142,108,34,0,0,0
2020-11-24 09:00,98,75,23,0,0,0
2020-11-24 09:15,84,55,29,0,0,0
2020-11-24 09:30,97,72,25,0,0,0
2020-11-24 09:45,105,82,23,0,0,0
2020-11-24 10:00,64,42,22,0,0,0
2020-11-24 10:15,84,60,24,0,0,0
2020-11-24 10:30,82,55,27,0,0,0
2020-11-24 10:45,108,71,37,0,0,0
2020-11-24 11:00,76,51,25,0,0,0
2020-11-24 11:15,90,51,39,0,0,0
2020-11-24 11:30,85,57,28,0,0,0
2020-11-24 11:45,87,59,28,0,0,0
2020-11-24 12:00,117,71,46,0,0,0
2020-11-24 12:15,99,50,49,0,0,0
2020-11-24 12:30,102,66,36,0,0,0
2020-11-24 12:45,103,56,47,0,0,0
2020-11-24 13:00,119,64,55,0,0,0
2020-11-24 13:15,131,61,70,0,0,0
2020-11-24 13:30,125,58,67,0,0,0
2020-11-24 13:45,127,75,52,0,0,0
2020-11-24 14:00,124,72,52,0,0,0
2020-11-24 14:15,129,56,73,0,0,0
2020-11-24 14:30,132,52,80,0,0,0
2020-11-24 14:45,134,71,63,0,0,0
2020-11-24 15:00,142,72,70,0,0,0
2020-11-24 15:15,123,76,47,0,0,0
2020-11-24 15:30,151,83,68,0,0,0
2020-11-24 15:45,161,96,65,0,0,0
2020-11-24 16:00,188,96,92,0,0,0
2020-11-24 16:15,154,90,64,0,0,0
2020-11-24 16:30,161,74,87,0,0,0
2020-11-24 16:45,152,81,71,0,0,0
2020-11-24 17:00,161,72,89,0,0,0
2020-11-24 17:15,158,72,86,0,0,0
2020-11-24 17:30,124,60,64,0,0,0
2020-11-24 17:45,153,83,70,0,0,0
2020-11-24 18:00,117,53,64,0,0,0
2020-11-24 18:15,93,46,47,0,0,0
2020-11-24 18:30,91,38,53,0,0,0
2020-11-24 18:45,86,40,46,0,0,0
2020-11-24 19:00,83,27,56,0,0,0
2020-11-24 19:15,71,34,37,0,0,0
2020-11-24 19:30,36,16,20,0,0,0
2020-11-24 19:45,47,17,30,0,0,0
2020-11-24 20:00,46,21,25,0,0,0
2020-11-24 20:15,36,16,20,0,0,0
2020-11-24 20:30,26,15,11,0,0,0
2020-11-24 20:45,25,15,10,0,0,0
2020-11-24 21:00,20,7,13,0,0,0
2020-11-24 21:15,22,14,8,0,0,0
2020-11-24 21:30,27,13,14,0,0,0
2020-11-24 21:45,12,6,6,0,0,0
2020-11-24 22:00,14,9,5,0,0,0
2020-11-24 22:15,18,8,10,0,0,0
2020-11-24 22:30,11,4,7,0,0,0
2020-11-24 22:45,16,6,10,0,0,0
2020-11-24 23:00,17,8,9,0,0,0
2020-11-24 23:15,7,4,3,0,0,0
2020-11-24 23:30,11,10,1,0,0,0
2020-11-24 23:45,6,4,2,0,0,0
2020-11-25 00:00,6,4,2,0,0,0
2020-11-25 00:15,2,2,0,0,0,0
2020-11-25 00:30,3,1,2,0,0,0
2020-11-25 00:45,2,1,1,0,0,0
2020-11-25 01:00,7,5,2,0,0,0
2020-11-25 01:15,4,3,1,0,0,0
2020-11-25 01:30,1,0,1,0,0,0
2020-11-25 01:45,0,0,0,0,0,0
2020-11-25 02:00,2,0,2,0,0,0
2020-11-25 02:15,1,0,1,0,0,0
2020-11-25 02:30,0,0,0,0,0,0
2020-11-25 02:45,0,0,0,0,0,0
2020-11-25 03:00,3,3,0,0,0,0
2020-11-25 03:15,0,0,0,0,0,0
2020-11-25 03:30,1,1,0,0,0,0
2020-11-25 03:45,2,2,0,0,0,0
2020-11-25 04:00,5,4,1,0,0,0
2020-11-25 04:15,1,0,1,0,0,0
2020-11-25 04:30,2,2,0,0,0,0
2020-11-25 04:45,4,3,1,0,0,0
2020-11-25 05:00,0,0,0,0,0,0
2020-11-25 05:15,4,4,0,0,0,0
2020-11-25 05:30,15,13,2,0,0,0
2020-11-25 05:45,14,8,6,0,0,0
2020-11-25 06:00,20,16,4,0,0,0
2020-11-25 06:15,18,14,4,0,0,0
2020-11-25 06:30,40,19,21,0,0,0
2020-11-25 06:45,58,38,20,0,0,0
2020-11-25 07:00,70,51,19,0,0,0
2020-11-25 07:15,116,76,40,0,0,0
2020-11-25 07:30,160,112,48,0,0,0
2020-11-25 07:45,297,229,68,0,0,0
2020-11-25 08:00,256,215,41,0,0,0
2020-11-25 08:15,191,151,40,0,0,0
2020-11-25 08:30,122,95,27,0,0,0
2020-11-25 08:45,139,103,36,0,0,0
2020-11-25 09:00,108,74,34,0,0,0
2020-11-25 09:15,112,79,33,0,0,0
2020-11-25 09:30,104,83,21,0,0,0
2020-11-25 09:45,125,99,26,0,0,0
2020-11-25 10:00,97,59,38,0,0,0
2020-11-25 10:15,122,81,41,0,0,0
2020-11-25 10:30,101,81,20,0,0,0
2020-11-25 10:45,109,77,32,0,0,0
2020-11-25 11:00,122,79,43,0,0,0
2020-11-25 11:15,141,93,48,0,0,0
2020-11-25 11:30,120,68,52,0,0,0
2020-11-25 11:45,143,95,48,0,0,0
2020-11-25 12:00,143,85,58,0,0,0
2020-11-25 12:15,133,75,58,0,0,0
2020-11-25 12:30,131,66,65,0,0,0
2020-11-25 12:45,130,74,56,0,0,0
2020-11-25 13:00,146,73,73,0,0,0
2020-11-25 13:15,138,65,73,0,0,0
2020-11-25 13:30,152,90,62,0,0,0
2020-11-25 13:45,135,70,65,0,0,0
2020-11-25 14:00,146,75,71,0,0,0
2020-11-25 14:15,118,52,66,0,0,0
2020-11-25 14:30,116,44,72,0,0,0
2020-11-25 14:45,143,79,64,0,0,0
2020-11-25 15:00,148,78,70,0,0,0
2020-11-25 15:15,140,68,72,0,0,0
2020-11-25 15:30,157,83,74,0,0,0
2020-11-25 15:45,193,114,79,0,0,0
2020-11-25 16:00,165,91,74,0,0,0
2020-11-25 16:15,185,101,84,0,0,0
2020-11-25 16:30,139,78,61,0,0,0
2020-11-25 16:45,153,78,75,0,0,0
2020-11-25 17:00,140,68,72,0,0,0
2020-11-25 17:15,146,68,78,0,0,0
2020-11-25 17:30,109,47,62,0,0,0
2020-11-25 17:45,124,47,77,0,0,0
2020-11-25 18:00,112,42,70,0,0,0
2020-11-25 18:15,94,37,57,0,0,0
2020-11-25 18:30,77,35,42,0,0,0
2020-11-25 18:45,85,37,48,0,0,0
2020-11-25 19:00,67,30,37,0,0,0
2020-11-25 19:15,68,30,38,0,0,0
2020-11-25 19:30,37,18,19,0,0,0
2020-11-25 19:45,37,12,25,0,0,0
2020-11-25 20:00,48,21,27,0,0,0
2020-11-25 20:15,32,17,15,0,0,0
2020-11-25 20:30,35,21,14,0,0,0
2020-11-25 20:45,19,10,9,0,0,0
2020-11-25 21:00,23,11,12,0,0,0
2020-11-25 21:15,25,15,10,0,0,0
2020-11-25 21:30,19,8,11,0,0,0
2020-11-25 21:45,13,11,2,0,0,0
2020-11-25 22:00,12,3,9,0,0,0
2020-11-25 22:15,9,5,4,0,0,0
2020-11-25 22:30,18,13,5,0,0,0
2020-11-25 22:45,17,8,9,0,0,0
2020-11-25 23:00,22,12,10,0,0,0
2020-11-25 23:15,12,8,4,0,0,0
2020-11-25 23:30,5,4,1,0,0,0
2020-11-25 23:45,6,3,3,0,0,0
2020-11-26 00:00,7,6,1,0,0,0
2020-11-26 00:15,3,1,2,0,0,0
2020-11-26 00:30,6,4,2,0,0,0
2020-11-26 00:45,5,2,3,0,0,0
2020-11-26 01:00,1,0,1,0,0,0
2020-11-26 01:15,3,1,2,0,0,0
2020-11-26 01:30,3,1,2,0,0,0
2020-11-26 01:45,5,2,3,0,0,0
2020-11-26 02:00,0,0,0,0,0,0
2020-11-26 02:15,2,2,0,0,0,0
2020-11-26 02:30,1,1,0,0,0,0
2020-11-26 02:45,1,0,1,0,0,0
2020-11-26 03:00,1,0,1,0,0,0
2020-11-26 03:15,3,3,0,0,0,0
2020-11-26 03:30,2,2,0,0,0,0
2020-11-26 03:45,1,1,0,0,0,0
2020-11-26 04:00,1,0,1,0,0,0
2020-11-26 04:15,1,0,1,0,0,0
2020-11-26 04:30,0,0,0,0,0,0
2020-11-26 04:45,0,0,0,0,0,0
2020-11-26 05:00,0,0,0,0,0,0
2020-11-26 05:15,3,3,0,0,0,0
2020-11-26 05:30,14,13,1,0,0,0
2020-11-26 05:45,15,5,10,0,0,0
2020-11-26 06:00,22,18,4,0,0,0
2020-11-26 06:15,28,20,8,0,0,0
2020-11-26 06:30,29,16,13,0,0,0
2020-11-26 06:45,54,32,22,0,0,0
2020-11-26 07:00,69,50,19,0,0,0
2020-11-26 07:15,84,64,20,0,0,0
2020-11-26 07:30,152,100,52,0,0,0
2020-11-26 07:45,264,210,54,0,0,0
2020-11-26 08:00,233,192,41,0,0,0
2020-11-26 08:15,159,118,41,0,0,0
2020-11-26 08:30,83,66,17,0,0,0
2020-11-26 08:45,130,100,30,0,0,0
2020-11-26 09:00,71,55,16,0,0,0
2020-11-26 09:15,91,72,19,0,0,0
2020-11-26 09:30,83,58,25,0,0,0
2020-11-26 09:45,101,65,36,0,0,0
2020-11-26 10:00,79,55,24,0,0,0
2020-11-26 10:15,70,50,20,0,0,0
2020-11-26 10:30,68,46,22,0,0,0
2020-11-26 10:45,67,45,22,0,0,0
2020-11-26 11:00,54,29,25,0,0,0
2020-11-26 11:15,88,56,32,0,0,0
2020-11-26 11:30,85,60,25,0,0,0
2020-11-26 11:45,64,41,23,0,0,0
2020-11-26 12:00,75,43,32,0,0,0
2020-11-26 12:15,91,43,48,0,0,0
2020-11-26 12:30,90,46,44,0,0,0
2020-11-26 12:45,106,62,44,0,0,0
2020-11-26 13:00,119,64,55,0,0,0
2020-11-26 13:15,107,52,55,0,0,0
2020-11-26 13:30,112,44,68,0,0,0
2020-11-26 13:45,107,56,51,0,0,0
2020-11-26 14:00,97,51,46,0,0,0
2020-11-26 14:15,125,57,68,0,0,0
2020-11-26 14:30,95,37,58,0,0,0
2020-11-26 14:45,121,62,59,0,0,0
2020-11-26 15:00,126,69,57,0,0,0
2020-11-26 15:15,122,59,63,0,0,0
2020-11-26 15:30,121,69,52,0,0,0
2020-11-26 15:45,133,74,59,0,0,0
2020-11-26 16:00,149,86,63,0,0,0
2020-11-26 16:15,162,96,66,0,0,0
2020-11-26 16:30,115,69,46,0,0,0
2020-11-26 16:45,151,81,70,0,0,0
2020-11-26 17:00,159,84,75,0,0,0
2020-11-26 17:15,126,54,72,0,0,0
2020-11-26 17:30,129,54,75,0,0,0
2020-11-26 17:45,92,55,37,0,0,0
2020-11-26 18:00,92,42,50,0,0,0
2020-11-26 18:15,114,49,65,0,0,0
2020-11-26 18:30,93,36,57,0,0,0
2020-11-26 18:45,101,39,62,0,0,0
2020-11-26 19:00,70,24,46,0,0,0
2020-11-26 19:15,55,24,31,0,0,0
2020-11-26 19:30,54,20,34,0,0,0
2020-11-26 19:45,49,21,28,0,0,0
2020-11-26 20:00,39,20,19,0,0,0
2020-11-26 20:15,37,15,22,0,0,0
2020-11-26 20:30,26,8,18,0,0,0
2020-11-26 20:45,20,16,4,0,0,0
2020-11-26 21:00,33,16,17,0,0,0
2020-11-26 21:15,29,16,13,0,0,0
2020-11-26 21:30,20,9,11,0,0,0
2020-11-26 21:45,14,7,7,0,0,0
2020-11-26 22:00,28,16,12,0,0,0
2020-11-26 22:15,22,12,10,0,0,0
2020-11-26 22:30,14,7,7,0,0,0
2020-11-26 22:45,16,12,4,0,0,0
2020-11-26 23:00,8,3,5,0,0,0
2020-11-26 23:15,12,5,7,0,0,0
2020-11-26 23:30,12,6,6,0,0,0
2020-11-26 23:45,7,3,4,0,0,0
2020-11-27 00:00,3,1,2,0,0,0
2020-11-27 00:15,4,2,2,0,0,0
2020-11-27 00:30,1,0,1,0,0,0
2020-11-27 00:45,0,0,0,0,0,0
2020-11-27 01:00,2,0,2,0,0,0
2020-11-27 01:15,4,4,0,0,0,0
2020-11-27 01:30,6,2,4,0,0,0
2020-11-27 01:45,3,3,0,0,0,0
2020-11-27 02:00,2,0,2,0,0,0
2020-11-27 02:15,2,1,1,0,0,0
2020-11-27 02:30,1,0,1,0,0,0
2020-11-27 02:45,0,0,0,0,0,0
2020-11-27 03:00,0,0,0,0,0,0
2020-11-27 03:15,1,1,0,0,0,0
2020-11-27 03:30,0,0,0,0,0,0
2020-11-27 03:45,2,2,0,0,0,0
2020-11-27 04:00,3,2,1,0,0,0
2020-11-27 04:15,1,0,1,0,0,0
2020-11-27 04:30,0,0,0,0,0,0
2020-11-27 04:45,0,0,0,0,0,0
2020-11-27 05:00,3,3,0,0,0,0
2020-11-27 05:15,4,3,1,0,0,0
2020-11-27 05:30,6,5,1,0,0,0
2020-11-27 05:45,12,6,6,0,0,0
2020-11-27 06:00,11,7,4,0,0,0
2020-11-27 06:15,32,22,10,0,0,0
2020-11-27 06:30,38,20,18,0,0,0
2020-11-27 06:45,52,35,17,0,0,0
2020-11-27 07:00,61,41,20,0,0,0
2020-11-27 07:15,102,73,29,0,0,0
2020-11-27 07:30,148,101,47,0,0,0
2020-11-27 07:45,204,150,54,0,0,0
2020-11-27 08:00,252,212,40,0,0,0
2020-11-27 08:15,155,120,35,0,0,0
2020-11-27 08:30,107,74,33,0,0,0
2020-11-27 08:45,124,98,26,0,0,0
2020-11-27 09:00,98,71,27,0,0,0
2020-11-27 09:15,70,57,13,0,0,0
2020-11-27 09:30,97,72,25,0,0,0
2020-11-27 09:45,124,80,44,0,0,0
2020-11-27 10:00,97,64,33,0,0,0
2020-11-27 10:15,90,72,18,0,0,0
2020-11-27 10:30,94,67,27,0,0,0
2020-11-27 10:45,109,78,31,0,0,0
2020-11-27 11:00,106,69,37,0,0,0
2020-11-27 11:15,112,66,46,0,0,0
2020-11-27 11:30,124,63,61,0,0,0
2020-11-27 11:45,123,77,46,0,0,0
2020-11-27 12:00,126,52,74,0,0,0
2020-11-27 12:15,108,64,44,0,0,0
2020-11-27 12:30,133,79,54,0,0,0
2020-11-27 12:45,113,59,54,0,0,0
2020-11-27 13:00,149,63,86,0,0,0
2020-11-27 13:15,173,74,99,0,0,0
2020-11-27 13:30,165,86,79,0,0,0
2020-11-27 13:45,143,64,79,0,0,0
2020-11-27 14:00,159,72,87,0,0,0
2020-11-27 14:15,143,70,73,0,0,0
2020-11-27 14:30,152,78,74,0,0,0
2020-11-27 14:45,154,93,61,0,0,0
2020-11-27 15:00,170,105,65,0,0,0
2020-11-27 15:15,162,86,76,0,0,0
2020-11-27 15:30,168,101,67,0,0,0
2020-11-27 15:45,155,101,54,0,0,0
2020-11-27 16:00,161,92,69,0,0,0
2020-11-27 16:15,166,84,82,0,0,0
2020-11-27 16:30,153,74,79,0,0,0
2020-11-27 16:45,146,84,62,0,0,0
2020-11-27 17:00,140,68,72,0,0,0
2020-11-27 17:15,117,60,57,0,0,0
2020-11-27 17:30,107,46,61,0,0,0
2020-11-27 17:45,83,33,50,0,0,0
2020-11-27 18:00,97,44,53,0,0,0
2020-11-27 18:15,84,29,55,0,0,0
2020-11-27 18:30,75,27,48,0,0,0
2020-11-27 18:45,78,27,51,0,0,0
2020-11-27 19:00,64,36,28,0,0,0
2020-11-27 19:15,51,16,35,0,0,0
2020-11-27 19:30,50,25,25,0,0,0
2020-11-27 19:45,53,26,27,0,0,0
2020-11-27 20:00,55,26,29,0,0,0
2020-11-27 20:15,34,17,17,0,0,0
2020-11-27 20:30,32,19,13,0,0,0
2020-11-27 20:45,25,17,8,0,0,0
2020-11-27 21:00,25,15,10,0,0,0
2020-11-27 21:15,24,12,12,0,0,0
2020-11-27 21:30,9,5,4,0,0,0
2020-11-27 21:45,20,8,12,0,0,0
2020-11-27 22:00,17,11,6,0,0,0
2020-11-27 22:15,11,4,7,0,0,0
2020-11-27 22:30,15,9,6,0,0,0
2020-11-27 22:45,13,6,7,0,0,0
2020-11-27 23:00,10,5,5,0,0,0
2020-11-27 23:15,12,4,8,0,0,0
2020-11-27 23:30,16,9,7,0,0,0
2020-11-27 23:45,13,6,7,0,0,0
2020-11-28 00:00,12,5,7,0,0,0
2020-11-28 00:15,8,6,2,0,0,0
2020-11-28 00:30,8,5,3,0,0,0
2020-11-28 00:45,8,5,3,0,0,0
2020-11-28 01:00,10,7,3,0,0,0
2020-11-28 01:15,6,3,3,0,0,0
2020-11-28 01:30,5,2,3,0,0,0
2020-11-28 01:45,6,4,2,0,0,0
2020-11-28 02:00,5,3,2,0,0,0
2020-11-28 02:15,4,1,3,0,0,0
2020-11-28 02:30,1,0,1,0,0,0
2020-11-28 02:45,3,2,1,0,0,0
2020-11-28 03:00,0,0,0,0,0,0
2020-11-28 03:15,4,3,1,0,0,0
2020-11-28 03:30,4,0,4,0,0,0
2020-11-28 03:45,1,1,0,0,0,0
2020-11-28 04:00,1,1,0,0,0,0
2020-11-28 04:15,0,0,0,0,0,0
2020-11-28 04:30,1,0,1,0,0,0
2020-11-28 04:45,2,2,0,0,0,0
2020-11-28 05:00,0,0,0,0,0,0
2020-11-28 05:15,1,1,0,0,0,0
2020-11-28 05:30,6,4,2,0,0,0
2020-11-28 05:45,9,4,5,0,0,0
2020-11-28 06:00,6,4,2,0,0,0
2020-11-28 06:15,3,1,2,0,0,0
2020-11-28 06:30,4,4,0,0,0,0
2020-11-28 06:45,15,13,2,0,0,0
2020-11-28 07:00,13,8,5,0,0,0
2020-11-28 07:15,14,11,3,0,0,0
2020-11-28 07:30,29,20,9,0,0,0
2020-11-28 07:45,21,10,11,0,0,0
2020-11-28 08:00,28,17,11,0,0,0
2020-11-28 08:15,46,34,12,0,0,0
2020-11-28 08:30,43,37,6,0,0,0
2020-11-28 08:45,44,30,14,0,0,0
2020-11-28 09:00,71,50,21,0,0,0
2020-11-28 09:15,72,52,20,0,0,0
2020-11-28 09:30,95,77,18,0,0,0
2020-11-28 09:45,68,44,24,0,0,0
2020-11-28 10:00,91,68,23,0,0,0
2020-11-28 10:15,112,70,42,0,0,0
2020-11-28 10:30,119,88,31,0,0,0
2020-11-28 10:45,129,96,33,0,0,0
2020-11-28 11:00,126,83,43,0,0,0
2020-11-28 11:15,130,76,54,0,0,0
2020-11-28 11:30,120,78,42,0,0,0
2020-11-28 11:45,152,85,67,0,0,0
2020-11-28 12:00,156,109,47,0,0,0
2020-11-28 12:15,129,59,70,0,0,0
2020-11-28 12:30,161,107,54,0,0,0
2020-11-28 12:45,154,104,50,0,0,0
2020-11-28 13:00,126,65,61,0,0,0
2020-11-28 13:15,125,67,58,0,0,0
2020-11-28 13:30,132,86,46,0,0,0
2020-11-28 13:45,130,63,67,0,0,0
2020-11-28 14:00,140,70,70,0,0,0
2020-11-28 14:15,105,57,48,0,0,0
2020-11-28 14:30,92,31,61,0,0,0
2020-11-28 14:45,98,52,46,0,0,0
2020-11-28 15:00,107,65,42,0,0,0
2020-11-28 15:15,78,37,41,0,0,0
2020-11-28 15:30,84,46,38,0,0,0
2020-11-28 15:45,94,47,47,0,0,0
2020-11-28 16:00,121,80,41,0,0,0
2020-11-28 16:15,99,53,46,0,0,0
2020-11-28 16:30,80,40,40,0,0,0
2020-11-28 16:45,58,26,32,0,0,0
2020-11-28 17:00,65,34,31,0,0,0
2020-11-28 17:15,59,30,29,0,0,0
2020-11-28 17:30,59,27,32,0,0,0
2020-11-28 17:45,73,38,35,0,0,0
2020-11-28 18:00,62,26,36,0,0,0
2020-11-28 18:15,47,16,31,0,0,0
2020-11-28 18:30,51,22,29,0,0,0
2020-11-28 18:45,54,30,24,0,0,0
2020-11-28 19:00,60,24,36,0,0,0
2020-11-28 19:15,44,23,21,0,0,0
2020-11-28 19:30,43,22,21,0,0,0
2020-11-28 19:45,35,23,12,0,0,0
2020-11-28 20:00,28,13,15,0,0,0
2020-11-28 20:15,26,12,14,0,0,0
2020-11-28 20:30,31,19,12,0,0,0
2020-11-28 20:45,18,7,11,0,0,0
2020-11-28 21:00,19,7,12,0,0,0
2020-11-28 21:15,30,19,11,0,0,0
2020-11-28 21:30,19,11,8,0,0,0
2020-11-28 21:45,18,14,4,0,0,0
2020-11-28 22:00,9,5,4,0,0,0
2020-11-28 22:15,16,6,10,0,0,0
2020-11-28 22:30,9,3,6,0,0,0
2020-11-28 22:45,16,7,9,0,0,0
2020-11-28 23:00,8,5,3,0,0,0
2020-11-28 23:15,11,10,1,0,0,0
2020-11-28 23:30,19,10,9,0,0,0
2020-11-28 23:45,11,8,3,0,0,0
2020-11-29 00:00,16,12,4,0,0,0
2020-11-29 00:15,9,6,3,0,0,0
2020-11-29 00:30,13,8,5,0,0,0
2020-11-29 00:45,14,3,11,0,0,0
2020-11-29 01:00,18,11,7,0,0,0
2020-11-29 01:15,13,5,8,0,0,0
2020-11-29 01:30,10,4,6,0,0,0
2020-11-29 01:45,12,6,6,0,0,0
2020-11-29 02:00,7,3,4,0,0,0
2020-11-29 02:15,3,1,2,0,0,0
2020-11-29 02:30,2,2,0,0,0,0
2020-11-29 02:45,6,3,3,0,0,0
2020-11-29 03:00,3,2,1,0,0,0
2020-11-29 03:15,3,1,2,0,0,0
2020-11-29 03:30,2,1,1,0,0,0
2020-11-29 03:45,0,0,0,0,0,0
2020-11-29 04:00,0,0,0,0,0,0
2020-11-29 04:15,1,1,0,0,0,0
2020-11-29 04:30,0,0,0,0,0,0
2020-11-29 04:45,3,0,3,0,0,0
2020-11-29 05:00,2,2,0,0,0,0
2020-11-29 05:15,3,2,1,0,0,0
2020-11-29 05:30,4,2,2,0,0,0
2020-11-29 05:45,7,1,6,0,0,0
2020-11-29 06:00,6,2,4,0,0,0
2020-11-29 06:15,4,3,1,0,0,0
2020-11-29 06:30,5,4,1,0,0,0
2020-11-29 06:45,2,2,0,0,0,0
2020-11-29 07:00,2,2,0,0,0,0
2020-11-29 07:15,4,3,1,0,0,0
2020-11-29 07:30,6,4,2,0,0,0
2020-11-29 07:45,7,5,2,0,0,0
2020-11-29 08:00,6,3,3,0,0,0
2020-11-29 08:15,15,13,2,0,0,0
2020-11-29 08:30,11,9,2,0,0,0
2020-11-29 08:45,9,4,5,0,0,0
2020-11-29 09:00,12,9,3,0,0,0
2020-11-29 09:15,15,12,3,0,0,0
2020-11-29 09:30,22,19,3,0,0,0
2020-11-29 09:45,25,14,11,0,0,0
2020-11-29 10:00,13,9,4,0,0,0
2020-11-29 10:15,16,7,9,0,0,0
2020-11-29 10:30,27,22,5,0,0,0
2020-11-29 10:45,31,19,12,0,0,0
2020-11-29 11:00,24,20,4,0,0,0
2020-11-29 11:15,15,6,9,0,0,0
2020-11-29 11:30,35,21,14,0,0,0
2020-11-29 11:45,40,30,10,0,0,0
2020-11-29 12:00,54,33,21,0,0,0
2020-11-29 12:15,45,31,14,0,0,0
2020-11-29 12:30,54,35,19,0,0,0
2020-11-29 12:45,46,28,18,0,0,0
2020-11-29 13:00,44,30,14,0,0,0
2020-11-29 13:15,53,35,18,0,0,0
2020-11-29 13:30,49,27,22,0,0,0
2020-11-29 13:45,57,34,23,0,0,0
2020-11-29 14:00,49,30,19,0,0,0
2020-11-29 14:15,60,45,15,0,0,0
2020-11-29 14:30,63,41,22,0,0,0
2020-11-29 14:45,70,45,25,0,0,0
2020-11-29 15:00,57,37,20,0,0,0
2020-11-29 15:15,68,44,24,0,0,0
2020-11-29 15:30,48,25,23,0,0,0
2020-11-29 15:45,56,34,22,0,0,0
2020-11-29 16:00,57,29,28,0,0,0
2020-11-29 16:15,57,25,32,0,0,0
2020-11-29 16:30,53,34,19,0,0,0
2020-11-29 16:45,55,31,24,0,0,0
2020-11-29 17:00,41,27,14,0,0,0
2020-11-29 17:15,38,22,16,0,0,0
2020-11-29 17:30,49,31,18,0,0,0
2020-11-29 17:45,34,14,20,0,0,0
2020-11-29 18:00,29,16,13,0,0,0
2020-11-29 18:15,31,24,7,0,0,0
2020-11-29 18:30,35,18,17,0,0,0
2020-11-29 18:45,26,13,13,0,0,0
2020-11-29 19:00,28,17,11,0,0,0
2020-11-29 19:15,26,17,9,0,0,0
2020-11-29 19:30,33,15,18,0,0,0
2020-11-29 19:45,29,15,14,0,0,0
2020-11-29 20:00,19,6,13,0,0,0
2020-11-29 20:15,15,11,4,0,0,0
2020-11-29 20:30,17,10,7,0,0,0
2020-11-29 20:45,25,13,12,0,0,0
2020-11-29 21:00,13,8,5,0,0,0
2020-11-29 21:15,23,12,11,0,0,0
2020-11-29 21:30,8,1,7,0,0,0
2020-11-29 21:45,9,4,5,0,0,0
2020-11-29 22:00,13,10,3,0,0,0
2020-11-29 22:15,9,7,2,0,0,0
2020-11-29 22:30,5,4,1,0,0,0
2020-11-29 22:45,10,6,4,0,0,0
2020-11-29 23:00,5,2,3,0,0,0
2020-11-29 23:15,4,2,2,0,0,0
2020-11-29 23:30,8,6,2,0,0,0
2020-11-29 23:45,5,3,2,0,0,0
2020-11-30 00:00,5,4,1,0,0,0
2020-11-30 00:15,2,2,0,0,0,0
2020-11-30 00:30,2,1,1,0,0,0
2020-11-30 00:45,3,3,0,0,0,0
2020-11-30 01:00,1,0,1,0,0,0
2020-11-30 01:15,3,2,1,0,0,0
2020-11-30 01:30,2,0,2,0,0,0
2020-11-30 01:45,6,1,5,0,0,0
2020-11-30 02:00,1,1,0,0,0,0
2020-11-30 02:15,1,0,1,0,0,0
2020-11-30 02:30,1,1,0,0,0,0
2020-11-30 02:45,0,0,0,0,0,0
2020-11-30 03:00,0,0,0,0,0,0
2020-11-30 03:15,0,0,0,0,0,0
2020-11-30 03:30,1,1,0,0,0,0
2020-11-30 03:45,0,0,0,0,0,0
2020-11-30 04:00,1,0,1,0,0,0
2020-11-30 04:15,2,0,2,0,0,0
2020-11-30 04:30,0,0,0,0,0,0
2020-11-30 04:45,2,1,1,0,0,0
2020-11-30 05:00,0,0,0,0,0,0
2020-11-30 05:15,4,3,1,0,0,0
2020-11-30 05:30,10,6,4,0,0,0
2020-11-30 05:45,14,3,11,0,0,0
2020-11-30 06:00,12,8,4,0,0,0
2020-11-30 06:15,20,11,9,0,0,0
2020-11-30 06:30,41,29,12,0,0,0
2020-11-30 06:45,56,33,23,0,0,0
2020-11-30 07:00,62,50,12,0,0,0
2020-11-30 07:15,78,51,27,0,0,0
2020-11-30 07:30,127,89,38,0,0,0
2020-11-30 07:45,212,164,48,0,0,0
2020-11-30 08:00,269,238,31,0,0,0
2020-11-30 08:15,129,97,32,0,0,0
2020-11-30 08:30,103,89,14,0,0,0
2020-11-30 08:45,105,80,25,0,0,0
2020-11-30 09:00,98,70,28,0,0,0
2020-11-30 09:15,93,65,28,0,0,0
2020-11-30 09:30,94,71,23,0,0,0
2020-11-30 09:45,88,60,28,0,0,0
2020-11-30 10:00,71,52,19,0,0,0
2020-11-30 10:15,70,47,23,0,0,0
2020-11-30 10:30,88,58,30,0,0,0
2020-11-30 10:45,91,67,24,0,0,0
2020-11-30 11:00,65,45,20,0,0,0
2020-11-30 11:15,70,37,33,0,0,0
2020-11-30 11:30,96,60,36,0,0,0
2020-11-30 11:45,100,59,41,0,0,0
2020-11-30 12:00,102,61,41,0,0,0
2020-11-30 12:15,85,51,34,0,0,0
2020-11-30 12:30,100,62,38,0,0,0
2020-11-30 12:45,97,57,40,0,0,0
2020-11-30 13:00,99,38,61,0,0,0
2020-11-30 13:15,129,60,69,0,0,0
2020-11-30 13:30,127,60,67,0,0,0
2020-11-30 13:45,111,67,44,0,0,0
2020-11-30 14:00,101,61,40,0,0,0
2020-11-30 14:15,129,79,50,0,0,0
2020-11-30 14:30,119,64,55,0,0,0
2020-11-30 14:45,129,77,52,0,0,0
2020-11-30 15:00,122,70,52,0,0,0
2020-11-30 15:15,120,63,57,0,0,0
2020-11-30 15:30,136,72,64,0,0,0
2020-11-30 15:45,146,81,65,0,0,0
2020-11-30 16:00,162,89,73,0,0,0
2020-11-30 16:15,122,59,63,0,0,0
2020-11-30 16:30,133,61,72,0,0,0
2020-11-30 16:45,116,72,44,0,0,0
2020-11-30 17:00,125,62,63,0,0,0
2020-11-30 17:15,121,55,66,0,0,0
2020-11-30 17:30,107,48,59,0,0,0
2020-11-30 17:45,99,49,50,0,0,0
2020-11-30 18:00,77,24,53,0,0,0
2020-11-30 18:15,78,32,46,0,0,0
2020-11-30 18:30,60,24,36,0,0,0
2020-11-30 18:45,65,30,35,0,0,0
2020-11-30 19:00,49,17,32,0,0,0
2020-11-30 19:15,30,12,18,0,0,0
2020-11-30 19:30,29,12,17,0,0,0
2020-11-30 19:45,29,13,16,0,0,0
2020-11-30 20:00,39,21,18,0,0,0
2020-11-30 20:15,19,7,12,0,0,0
2020-11-30 20:30,19,8,11,0,0,0
2020-11-30 20:45,19,13,6,0,0,0
2020-11-30 21:00,18,5,13,0,0,0
2020-11-30 21:15,10,7,3,0,0,0
2020-11-30 21:30,10,5,5,0,0,0
2020-11-30 21:45,9,4,5,0,0,0
2020-11-30 22:00,11,4,7,0,0,0
2020-11-30 22:15,12,4,8,0,0,0
2020-11-30 22:30,8,5,3,0,0,0
2020-11-30 22:45,7,4,3,0,0,0
2020-11-30 23:00,4,1,3,0,0,0
2020-11-30 23:15,3,0,3,0,0,0
2020-11-30 23:30,5,4,1,0,0,0
2020-11-30 23:45,5,5,0,0,0,0
