Datetime,100034983 (Warendorfer Straße),101034983 (Warendorfer Straße stadteinwärts),102034983 (Warendorfer Straße stadtauswärts),100034983-status,101034983-status,102034983-status
2021-05-01 00:00,23,15,8,0,0,0
2021-05-01 00:15,7,0,7,0,0,0
2021-05-01 00:30,17,7,10,0,0,0
2021-05-01 00:45,14,6,8,0,0,0
2021-05-01 01:00,18,12,6,0,0,0
2021-05-01 01:15,10,5,5,0,0,0
2021-05-01 01:30,17,7,10,0,0,0
2021-05-01 01:45,5,2,3,0,0,0
2021-05-01 02:00,9,4,5,0,0,0
2021-05-01 02:15,6,2,4,0,0,0
2021-05-01 02:30,4,0,4,0,0,0
2021-05-01 02:45,0,0,0,0,0,0
2021-05-01 03:00,2,1,1,0,0,0
2021-05-01 03:15,1,1,0,0,0,0
2021-05-01 03:30,4,2,2,0,0,0
2021-05-01 03:45,6,3,3,0,0,0
2021-05-01 04:00,5,2,3,0,0,0
2021-05-01 04:15,2,1,1,0,0,0
2021-05-01 04:30,1,1,0,0,0,0
2021-05-01 04:45,1,1,0,0,0,0
2021-05-01 05:00,0,0,0,0,0,0
2021-05-01 05:15,1,0,1,0,0,0
2021-05-01 05:30,4,4,0,0,0,0
2021-05-01 05:45,12,3,9,0,0,0
2021-05-01 06:00,7,3,4,0,0,0
2021-05-01 06:15,5,4,1,0,0,0
2021-05-01 06:30,7,7,0,0,0,0
2021-05-01 06:45,3,2,1,0,0,0
2021-05-01 07:00,8,5,3,0,0,0
2021-05-01 07:15,6,6,0,0,0,0
2021-05-01 07:30,6,5,1,0,0,0
2021-05-01 07:45,11,4,7,0,0,0
2021-05-01 08:00,11,9,2,0,0,0
2021-05-01 08:15,11,3,8,0,0,0
2021-05-01 08:30,12,6,6,0,0,0
2021-05-01 08:45,24,11,13,0,0,0
2021-05-01 09:00,18,12,6,0,0,0
2021-05-01 09:15,29,18,11,0,0,0
2021-05-01 09:30,22,12,10,0,0,0
2021-05-01 09:45,38,22,16,0,0,0
2021-05-01 10:00,39,29,10,0,0,0
2021-05-01 10:15,32,23,9,0,0,0
2021-05-01 10:30,44,27,17,0,0,0
2021-05-01 10:45,59,42,17,0,0,0
2021-05-01 11:00,40,26,14,0,0,0
2021-05-01 11:15,65,45,20,0,0,0
2021-05-01 11:30,67,42,25,0,0,0
2021-05-01 11:45,70,43,27,0,0,0
2021-05-01 12:00,63,34,29,0,0,0
2021-05-01 12:15,63,32,31,0,0,0
2021-05-01 12:30,67,38,29,0,0,0
2021-05-01 12:45,73,35,38,0,0,0
2021-05-01 13:00,83,47,36,0,0,0
2021-05-01 13:15,75,35,40,0,0,0
2021-05-01 13:30,85,42,43,0,0,0
2021-05-01 13:45,66,46,20,0,0,0
2021-05-01 14:00,88,45,43,0,0,0
2021-05-01 14:15,96,58,38,0,0,0
2021-05-01 14:30,82,45,37,0,0,0
2021-05-01 14:45,85,55,30,0,0,0
2021-05-01 15:00,76,43,33,0,0,0
2021-05-01 15:15,79,41,38,0,0,0
2021-05-01 15:30,78,49,29,0,0,0
2021-05-01 15:45,101,62,39,0,0,0
2021-05-01 16:00,98,50,48,0,0,0
2021-05-01 16:15,73,41,32,0,0,0
2021-05-01 16:30,96,54,42,0,0,0
2021-05-01 16:45,74,42,32,0,0,0
2021-05-01 17:00,95,47,48,0,0,0
2021-05-01 17:15,79,52,27,0,0,0
2021-05-01 17:30,59,27,32,0,0,0
2021-05-01 17:45,74,37,37,0,0,0
2021-05-01 18:00,68,38,30,0,0,0
2021-05-01 18:15,52,22,30,0,0,0
2021-05-01 18:30,71,37,34,0,0,0
2021-05-01 18:45,90,61,29,0,0,0
2021-05-01 19:00,47,34,13,0,0,0
2021-05-01 19:15,62,35,27,0,0,0
2021-05-01 19:30,62,37,25,0,0,0
2021-05-01 19:45,42,25,17,0,0,0
2021-05-01 20:00,44,23,21,0,0,0
2021-05-01 20:15,31,19,12,0,0,0
2021-05-01 20:30,20,11,9,0,0,0
2021-05-01 20:45,31,21,10,0,0,0
2021-05-01 21:00,31,18,13,0,0,0
2021-05-01 21:15,21,9,12,0,0,0
2021-05-01 21:30,29,13,16,0,0,0
2021-05-01 21:45,26,11,15,0,0,0
2021-05-01 22:00,22,15,7,0,0,0
2021-05-01 22:15,19,13,6,0,0,0
2021-05-01 22:30,20,15,5,0,0,0
2021-05-01 22:45,25,18,7,0,0,0
2021-05-01 23:00,19,8,11,0,0,0
2021-05-01 23:15,25,15,10,0,0,0
2021-05-01 23:30,21,13,8,0,0,0
2021-05-01 23:45,28,20,8,0,0,0
2021-05-02 00:00,29,15,14,0,0,0
2021-05-02 00:15,11,3,8,0,0,0
2021-05-02 00:30,13,7,6,0,0,0
2021-05-02 00:45,24,16,8,0,0,0
2021-05-02 01:00,13,7,6,0,0,0
2021-05-02 01:15,14,5,9,0,0,0
2021-05-02 01:30,12,7,5,0,0,0
2021-05-02 01:45,6,2,4,0,0,0
2021-05-02 02:00,9,3,6,0,0,0
2021-05-02 02:15,4,0,4,0,0,0
2021-05-02 02:30,11,6,5,0,0,0
2021-05-02 02:45,5,3,2,0,0,0
2021-05-02 03:00,7,5,2,0,0,0
2021-05-02 03:15,1,1,0,0,0,0
2021-05-02 03:30,5,4,1,0,0,0
2021-05-02 03:45,4,4,0,0,0,0
2021-05-02 04:00,3,3,0,0,0,0
2021-05-02 04:15,3,3,0,0,0,0
2021-05-02 04:30,2,0,2,0,0,0
2021-05-02 04:45,3,2,1,0,0,0
2021-05-02 05:00,5,4,1,0,0,0
2021-05-02 05:15,2,1,1,0,0,0
2021-05-02 05:30,7,7,0,0,0,0
2021-05-02 05:45,5,0,5,0,0,0
2021-05-02 06:00,6,3,3,0,0,0
2021-05-02 06:15,2,1,1,0,0,0
2021-05-02 06:30,9,6,3,0,0,0
2021-05-02 06:45,6,5,1,0,0,0
2021-05-02 07:00,3,1,2,0,0,0
2021-05-02 07:15,3,2,1,0,0,0
2021-05-02 07:30,7,4,3,0,0,0
2021-05-02 07:45,8,4,4,0,0,0
2021-05-02 08:00,12,5,7,0,0,0
2021-05-02 08:15,10,7,3,0,0,0
2021-05-02 08:30,10,7,3,0,0,0
2021-05-02 08:45,13,6,7,0,0,0
2021-05-02 09:00,18,16,2,0,0,0
2021-05-02 09:15,12,9,3,0,0,0
2021-05-02 09:30,29,20,9,0,0,0
2021-05-02 09:45,33,17,16,0,0,0
2021-05-02 10:00,35,28,7,0,0,0
2021-05-02 10:15,27,8,19,0,0,0
2021-05-02 10:30,44,29,15,0,0,0
2021-05-02 10:45,22,15,7,0,0,0
2021-05-02 11:00,34,16,18,0,0,0
2021-05-02 11:15,41,27,14,0,0,0
2021-05-02 11:30,43,28,15,0,0,0
2021-05-02 11:45,47,32,15,0,0,0
2021-05-02 12:00,51,26,25,0,0,0
2021-05-02 12:15,58,31,27,0,0,0
2021-05-02 12:30,51,29,22,0,0,0
2021-05-02 12:45,56,28,28,0,0,0
2021-05-02 13:00,54,29,25,0,0,0
2021-05-02 13:15,56,33,23,0,0,0
2021-05-02 13:30,37,19,18,0,0,0
2021-05-02 13:45,40,21,19,0,0,0
2021-05-02 14:00,56,33,23,0,0,0
2021-05-02 14:15,60,36,24,0,0,0
2021-05-02 14:30,57,27,30,0,0,0
2021-05-02 14:45,80,55,25,0,0,0
2021-05-02 15:00,65,31,34,0,0,0
2021-05-02 15:15,69,40,29,0,0,0
2021-05-02 15:30,67,47,20,0,0,0
2021-05-02 15:45,84,50,34,0,0,0
2021-05-02 16:00,45,23,22,0,0,0
2021-05-02 16:15,57,37,20,0,0,0
2021-05-02 16:30,51,29,22,0,0,0
2021-05-02 16:45,51,30,21,0,0,0
2021-05-02 17:00,62,45,17,0,0,0
2021-05-02 17:15,57,35,22,0,0,0
2021-05-02 17:30,55,38,17,0,0,0
2021-05-02 17:45,59,35,24,0,0,0
2021-05-02 18:00,40,22,18,0,0,0
2021-05-02 18:15,43,22,21,0,0,0
2021-05-02 18:30,38,23,15,0,0,0
2021-05-02 18:45,37,21,16,0,0,0
2021-05-02 19:00,45,17,28,0,0,0
2021-05-02 19:15,30,20,10,0,0,0
2021-05-02 19:30,34,12,22,0,0,0
2021-05-02 19:45,34,18,16,0,0,0
2021-05-02 20:00,39,22,17,0,0,0
2021-05-02 20:15,28,16,12,0,0,0
2021-05-02 20:30,22,14,8,0,0,0
2021-05-02 20:45,25,15,10,0,0,0
2021-05-02 21:00,26,11,15,0,0,0
2021-05-02 21:15,13,7,6,0,0,0
2021-05-02 21:30,13,8,5,0,0,0
2021-05-02 21:45,14,8,6,0,0,0
2021-05-02 22:00,10,8,2,0,0,0
2021-05-02 22:15,11,8,3,0,0,0
2021-05-02 22:30,11,9,2,0,0,0
2021-05-02 22:45,2,2,0,0,0,0
2021-05-02 23:00,9,4,5,0,0,0
2021-05-02 23:15,4,4,0,0,0,0
2021-05-02 23:30,2,0,2,0,0,0
2021-05-02 23:45,1,0,1,0,0,0
2021-05-03 00:00,4,3,1,0,0,0
2021-05-03 00:15,3,0,3,0,0,0
2021-05-03 00:30,3,2,1,0,0,0
2021-05-03 00:45,0,0,0,0,0,0
2021-05-03 01:00,4,1,3,0,0,0
2021-05-03 01:15,1,1,0,0,0,0
2021-05-03 01:30,5,1,4,0,0,0
2021-05-03 01:45,1,1,0,0,0,0
2021-05-03 02:00,2,0,2,0,0,0
2021-05-03 02:15,0,0,0,0,0,0
2021-05-03 02:30,0,0,0,0,0,0
2021-05-03 02:45,1,1,0,0,0,0
2021-05-03 03:00,1,1,0,0,0,0
2021-05-03 03:15,0,0,0,0,0,0
2021-05-03 03:30,1,0,1,0,0,0
2021-05-03 03:45,1,1,0,0,0,0
2021-05-03 04:00,0,0,0,0,0,0
2021-05-03 04:15,0,0,0,0,0,0
2021-05-03 04:30,2,1,1,0,0,0
2021-05-03 04:45,2,2,0,0,0,0
2021-05-03 05:00,1,1,0,0,0,0
2021-05-03 05:15,2,1,1,0,0,0
2021-05-03 05:30,9,8,1,0,0,0
2021-05-03 05:45,20,11,9,0,0,0
2021-05-03 06:00,17,11,6,0,0,0
2021-05-03 06:15,28,13,15,0,0,0
2021-05-03 06:30,34,23,11,0,0,0
2021-05-03 06:45,59,40,19,0,0,0
2021-05-03 07:00,78,49,29,0,0,0
2021-05-03 07:15,96,64,32,0,0,0
2021-05-03 07:30,141,108,33,0,0,0
2021-05-03 07:45,203,169,34,0,0,0
2021-05-03 08:00,186,159,27,0,0,0
2021-05-03 08:15,158,118,40,0,0,0
2021-05-03 08:30,120,87,33,0,0,0
2021-05-03 08:45,131,100,31,0,0,0
2021-05-03 09:00,84,71,13,0,0,0
2021-05-03 09:15,91,65,26,0,0,0
2021-05-03 09:30,101,67,34,0,0,0
2021-05-03 09:45,112,82,30,0,0,0
2021-05-03 10:00,82,54,28,0,0,0
2021-05-03 10:15,89,67,22,0,0,0
2021-05-03 10:30,90,62,28,0,0,0
2021-05-03 10:45,95,59,36,0,0,0
2021-05-03 11:00,84,60,24,0,0,0
2021-05-03 11:15,65,35,30,0,0,0
2021-05-03 11:30,96,47,49,0,0,0
2021-05-03 11:45,108,60,48,0,0,0
2021-05-03 12:00,91,55,36,0,0,0
2021-05-03 12:15,103,59,44,0,0,0
2021-05-03 12:30,82,42,40,0,0,0
2021-05-03 12:45,122,55,67,0,0,0
2021-05-03 13:00,101,51,50,0,0,0
2021-05-03 13:15,100,48,52,0,0,0
2021-05-03 13:30,100,50,50,0,0,0
2021-05-03 13:45,124,60,64,0,0,0
2021-05-03 14:00,93,48,45,0,0,0
2021-05-03 14:15,135,73,62,0,0,0
2021-05-03 14:30,120,69,51,0,0,0
2021-05-03 14:45,117,67,50,0,0,0
2021-05-03 15:00,126,70,56,0,0,0
2021-05-03 15:15,112,56,56,0,0,0
2021-05-03 15:30,92,52,40,0,0,0
2021-05-03 15:45,150,74,76,0,0,0
2021-05-03 16:00,149,89,60,0,0,0
2021-05-03 16:15,158,85,73,0,0,0
2021-05-03 16:30,136,76,60,0,0,0
2021-05-03 16:45,157,86,71,0,0,0
2021-05-03 17:00,125,56,69,0,0,0
2021-05-03 17:15,163,75,88,0,0,0
2021-05-03 17:30,165,79,86,0,0,0
2021-05-03 17:45,130,59,71,0,0,0
2021-05-03 18:00,105,43,62,0,0,0
2021-05-03 18:15,95,30,65,0,0,0
2021-05-03 18:30,75,30,45,0,0,0
2021-05-03 18:45,83,39,44,0,0,0
2021-05-03 19:00,84,37,47,0,0,0
2021-05-03 19:15,69,33,36,0,0,0
2021-05-03 19:30,35,20,15,0,0,0
2021-05-03 19:45,51,23,28,0,0,0
2021-05-03 20:00,31,18,13,0,0,0
2021-05-03 20:15,45,25,20,0,0,0
2021-05-03 20:30,32,14,18,0,0,0
2021-05-03 20:45,39,16,23,0,0,0
2021-05-03 21:00,23,16,7,0,0,0
2021-05-03 21:15,26,10,16,0,0,0
2021-05-03 21:30,13,9,4,0,0,0
2021-05-03 21:45,17,8,9,0,0,0
2021-05-03 22:00,19,9,10,0,0,0
2021-05-03 22:15,21,10,11,0,0,0
2021-05-03 22:30,18,14,4,0,0,0
2021-05-03 22:45,7,2,5,0,0,0
2021-05-03 23:00,9,7,2,0,0,0
2021-05-03 23:15,9,4,5,0,0,0
2021-05-03 23:30,9,1,8,0,0,0
2021-05-03 23:45,2,2,0,0,0,0
2021-05-04 00:00,1,1,0,0,0,0
2021-05-04 00:15,5,3,2,0,0,0
2021-05-04 00:30,0,0,0,0,0,0
2021-05-04 00:45,2,1,1,0,0,0
2021-05-04 01:00,0,0,0,0,0,0
2021-05-04 01:15,0,0,0,0,0,0
2021-05-04 01:30,1,1,0,0,0,0
2021-05-04 01:45,3,2,1,0,0,0
2021-05-04 02:00,2,2,0,0,0,0
2021-05-04 02:15,1,0,1,0,0,0
2021-05-04 02:30,0,0,0,0,0,0
2021-05-04 02:45,0,0,0,0,0,0
2021-05-04 03:00,0,0,0,0,0,0
2021-05-04 03:15,0,0,0,0,0,0
2021-05-04 03:30,0,0,0,0,0,0
2021-05-04 03:45,1,1,0,0,0,0
2021-05-04 04:00,3,3,0,0,0,0
2021-05-04 04:15,0,0,0,0,0,0
2021-05-04 04:30,0,0,0,0,0,0
2021-05-04 04:45,0,0,0,0,0,0
2021-05-04 05:00,0,0,0,0,0,0
2021-05-04 05:15,1,1,0,0,0,0
2021-05-04 05:30,7,5,2,0,0,0
2021-05-04 05:45,16,5,11,0,0,0
2021-05-04 06:00,10,5,5,0,0,0
2021-05-04 06:15,17,9,8,0,0,0
2021-05-04 06:30,34,17,17,0,0,0
2021-05-04 06:45,50,32,18,0,0,0
2021-05-04 07:00,70,43,27,0,0,0
2021-05-04 07:15,84,55,29,0,0,0
2021-05-04 07:30,117,86,31,0,0,0
2021-05-04 07:45,153,124,29,0,0,0
2021-05-04 08:00,169,145,24,0,0,0
2021-05-04 08:15,128,92,36,0,0,0
2021-05-04 08:30,97,68,29,0,0,0
2021-05-04 08:45,81,60,21,0,0,0
2021-05-04 09:00,65,47,18,0,0,0
2021-05-04 09:15,67,49,18,0,0,0
2021-05-04 09:30,61,43,18,0,0,0
2021-05-04 09:45,71,55,16,0,0,0
2021-05-04 10:00,40,27,13,0,0,0
2021-05-04 10:15,52,29,23,0,0,0
2021-05-04 10:30,53,32,21,0,0,0
2021-05-04 10:45,57,39,18,0,0,0
2021-05-04 11:00,40,25,15,0,0,0
2021-05-04 11:15,46,22,24,0,0,0
2021-05-04 11:30,45,27,18,0,0,0
2021-05-04 11:45,66,41,25,0,0,0
2021-05-04 12:00,67,44,23,0,0,0
2021-05-04 12:15,59,33,26,0,0,0
2021-05-04 12:30,59,32,27,0,0,0
2021-05-04 12:45,69,28,41,0,0,0
2021-05-04 13:00,87,35,52,0,0,0
2021-05-04 13:15,98,39,59,0,0,0
2021-05-04 13:30,64,24,40,0,0,0
2021-05-04 13:45,79,48,31,0,0,0
2021-05-04 14:00,70,34,36,0,0,0
2021-05-04 14:15,63,32,31,0,0,0
2021-05-04 14:30,57,24,33,0,0,0
2021-05-04 14:45,70,40,30,0,0,0
2021-05-04 15:00,74,32,42,0,0,0
2021-05-04 15:15,56,32,24,0,0,0
2021-05-04 15:30,68,32,36,0,0,0
2021-05-04 15:45,91,50,41,0,0,0
2021-05-04 16:00,90,42,48,0,0,0
2021-05-04 16:15,104,57,47,0,0,0
2021-05-04 16:30,114,65,49,0,0,0
2021-05-04 16:45,114,59,55,0,0,0
2021-05-04 17:00,93,49,44,0,0,0
2021-05-04 17:15,108,55,53,0,0,0
2021-05-04 17:30,89,36,53,0,0,0
2021-05-04 17:45,75,39,36,0,0,0
2021-05-04 18:00,82,38,44,0,0,0
2021-05-04 18:15,82,37,45,0,0,0
2021-05-04 18:30,69,28,41,0,0,0
2021-05-04 18:45,66,32,34,0,0,0
2021-05-04 19:00,34,17,17,0,0,0
2021-05-04 19:15,46,14,32,0,0,0
2021-05-04 19:30,32,16,16,0,0,0
2021-05-04 19:45,41,20,21,0,0,0
2021-05-04 20:00,33,18,15,0,0,0
2021-05-04 20:15,30,13,17,0,0,0
2021-05-04 20:30,32,18,14,0,0,0
2021-05-04 20:45,27,15,12,0,0,0
2021-05-04 21:00,16,6,10,0,0,0
2021-05-04 21:15,18,6,12,0,0,0
2021-05-04 21:30,22,12,10,0,0,0
2021-05-04 21:45,17,9,8,0,0,0
2021-05-04 22:00,18,13,5,0,0,0
2021-05-04 22:15,19,12,7,0,0,0
2021-05-04 22:30,21,12,9,0,0,0
2021-05-04 22:45,14,8,6,0,0,0
2021-05-04 23:00,16,10,6,0,0,0
2021-05-04 23:15,21,15,6,0,0,0
2021-05-04 23:30,11,10,1,0,0,0
2021-05-04 23:45,12,7,5,0,0,0
2021-05-05 00:00,11,5,6,0,0,0
2021-05-05 00:15,0,0,0,0,0,0
2021-05-05 00:30,7,5,2,0,0,0
2021-05-05 00:45,8,4,4,0,0,0
2021-05-05 01:00,2,0,2,0,0,0
2021-05-05 01:15,2,0,2,0,0,0
2021-05-05 01:30,1,0,1,0,0,0
2021-05-05 01:45,2,1,1,0,0,0
2021-05-05 02:00,0,0,0,0,0,0
2021-05-05 02:15,1,0,1,0,0,0
2021-05-05 02:30,1,0,1,0,0,0
2021-05-05 02:45,0,0,0,0,0,0
2021-05-05 03:00,1,0,1,0,0,0
2021-05-05 03:15,4,3,1,0,0,0
2021-05-05 03:30,0,0,0,0,0,0
2021-05-05 03:45,0,0,0,0,0,0
2021-05-05 04:00,2,2,0,0,0,0
2021-05-05 04:15,1,1,0,0,0,0
2021-05-05 04:30,1,1,0,0,0,0
2021-05-05 04:45,0,0,0,0,0,0
2021-05-05 05:00,0,0,0,0,0,0
2021-05-05 05:15,3,3,0,0,0,0
2021-05-05 05:30,12,7,5,0,0,0
2021-05-05 05:45,9,5,4,0,0,0
2021-05-05 06:00,16,9,7,0,0,0
2021-05-05 06:15,19,12,7,0,0,0
2021-05-05 06:30,25,20,5,0,0,0
2021-05-05 06:45,47,32,15,0,0,0
2021-05-05 07:00,84,64,20,0,0,0
2021-05-05 07:15,93,55,38,0,0,0
2021-05-05 07:30,120,78,42,0,0,0
2021-05-05 07:45,227,177,50,0,0,0
2021-05-05 08:00,184,156,28,0,0,0
2021-05-05 08:15,104,79,25,0,0,0
2021-05-05 08:30,136,103,33,0,0,0
2021-05-05 08:45,127,95,32,0,0,0
2021-05-05 09:00,93,67,26,0,0,0
2021-05-05 09:15,82,65,17,0,0,0
2021-05-05 09:30,95,68,27,0,0,0
2021-05-05 09:45,112,75,37,0,0,0
2021-05-05 10:00,95,71,24,0,0,0
2021-05-05 10:15,106,72,34,0,0,0
2021-05-05 10:30,103,69,34,0,0,0
2021-05-05 10:45,101,61,40,0,0,0
2021-05-05 11:00,96,61,35,0,0,0
2021-05-05 11:15,91,52,39,0,0,0
2021-05-05 11:30,108,70,38,0,0,0
2021-05-05 11:45,107,64,43,0,0,0
2021-05-05 12:00,112,66,46,0,0,0
2021-05-05 12:15,95,60,35,0,0,0
2021-05-05 12:30,100,53,47,0,0,0
2021-05-05 12:45,84,41,43,0,0,0
2021-05-05 13:00,110,42,68,0,0,0
2021-05-05 13:15,111,46,65,0,0,0
2021-05-05 13:30,98,48,50,0,0,0
2021-05-05 13:45,81,40,41,0,0,0
2021-05-05 14:00,100,55,45,0,0,0
2021-05-05 14:15,93,45,48,0,0,0
2021-05-05 14:30,77,32,45,0,0,0
2021-05-05 14:45,103,55,48,0,0,0
2021-05-05 15:00,73,31,42,0,0,0
2021-05-05 15:15,89,44,45,0,0,0
2021-05-05 15:30,74,40,34,0,0,0
2021-05-05 15:45,89,49,40,0,0,0
2021-05-05 16:00,116,57,59,0,0,0
2021-05-05 16:15,118,63,55,0,0,0
2021-05-05 16:30,111,59,52,0,0,0
2021-05-05 16:45,114,51,63,0,0,0
2021-05-05 17:00,117,64,53,0,0,0
2021-05-05 17:15,124,58,66,0,0,0
2021-05-05 17:30,85,44,41,0,0,0
2021-05-05 17:45,89,38,51,0,0,0
2021-05-05 18:00,109,43,66,0,0,0
2021-05-05 18:15,75,32,43,0,0,0
2021-05-05 18:30,90,47,43,0,0,0
2021-05-05 18:45,84,44,40,0,0,0
2021-05-05 19:00,73,34,39,0,0,0
2021-05-05 19:15,61,29,32,0,0,0
2021-05-05 19:30,51,24,27,0,0,0
2021-05-05 19:45,45,20,25,0,0,0
2021-05-05 20:00,46,18,28,0,0,0
2021-05-05 20:15,44,22,22,0,0,0
2021-05-05 20:30,50,31,19,0,0,0
2021-05-05 20:45,31,19,12,0,0,0
2021-05-05 21:00,23,15,8,0,0,0
2021-05-05 21:15,19,8,11,0,0,0
2021-05-05 21:30,17,6,11,0,0,0
2021-05-05 21:45,17,6,11,0,0,0
2021-05-05 22:00,14,9,5,0,0,0
2021-05-05 22:15,17,13,4,0,0,0
2021-05-05 22:30,14,4,10,0,0,0
2021-05-05 22:45,18,9,9,0,0,0
2021-05-05 23:00,17,11,6,0,0,0
2021-05-05 23:15,18,10,8,0,0,0
2021-05-05 23:30,10,9,1,0,0,0
2021-05-05 23:45,11,5,6,0,0,0
2021-05-06 00:00,5,2,3,0,0,0
2021-05-06 00:15,6,4,2,0,0,0
2021-05-06 00:30,9,6,3,0,0,0
2021-05-06 00:45,5,3,2,0,0,0
2021-05-06 01:00,5,2,3,0,0,0
2021-05-06 01:15,1,0,1,0,0,0
2021-05-06 01:30,5,2,3,0,0,0
2021-05-06 01:45,2,1,1,0,0,0
2021-05-06 02:00,4,4,0,0,0,0
2021-05-06 02:15,1,0,1,0,0,0
2021-05-06 02:30,2,0,2,0,0,0
2021-05-06 02:45,1,1,0,0,0,0
2021-05-06 03:00,1,0,1,0,0,0
2021-05-06 03:15,4,2,2,0,0,0
2021-05-06 03:30,1,0,1,0,0,0
2021-05-06 03:45,0,0,0,0,0,0
2021-05-06 04:00,0,0,0,0,0,0
2021-05-06 04:15,0,0,0,0,0,0
2021-05-06 04:30,0,0,0,0,0,0
2021-05-06 04:45,1,0,1,0,0,0
2021-05-06 05:00,2,1,1,0,0,0
2021-05-06 05:15,2,2,0,0,0,0
2021-05-06 05:30,10,6,4,0,0,0
2021-05-06 05:45,14,6,8,0,0,0
2021-05-06 06:00,7,5,2,0,0,0
2021-05-06 06:15,23,17,6,0,0,0
2021-05-06 06:30,26,16,10,0,0,0
2021-05-06 06:45,43,32,11,0,0,0
2021-05-06 07:00,67,50,17,0,0,0
2021-05-06 07:15,93,50,43,0,0,0
2021-05-06 07:30,109,71,38,0,0,0
2021-05-06 07:45,185,150,35,0,0,0
2021-05-06 08:00,155,131,24,0,0,0
2021-05-06 08:15,114,87,27,0,0,0
2021-05-06 08:30,125,85,40,0,0,0
2021-05-06 08:45,125,96,29,0,0,0
2021-05-06 09:00,81,57,24,0,0,0
2021-05-06 09:15,86,62,24,0,0,0
2021-05-06 09:30,59,44,15,0,0,0
2021-05-06 09:45,94,71,23,0,0,0
2021-05-06 10:00,59,41,18,0,0,0
2021-05-06 10:15,73,50,23,0,0,0
2021-05-06 10:30,71,49,22,0,0,0
2021-05-06 10:45,91,60,31,0,0,0
2021-05-06 11:00,81,50,31,0,0,0
2021-05-06 11:15,72,45,27,0,0,0
2021-05-06 11:30,111,71,40,0,0,0
2021-05-06 11:45,90,60,30,0,0,0
2021-05-06 12:00,85,45,40,0,0,0
2021-05-06 12:15,87,55,32,0,0,0
2021-05-06 12:30,88,51,37,0,0,0
2021-05-06 12:45,91,57,34,0,0,0
2021-05-06 13:00,110,56,54,0,0,0
2021-05-06 13:15,107,55,52,0,0,0
2021-05-06 13:30,100,45,55,0,0,0
2021-05-06 13:45,93,53,40,0,0,0
2021-05-06 14:00,98,61,37,0,0,0
2021-05-06 14:15,111,67,44,0,0,0
2021-05-06 14:30,110,56,54,0,0,0
2021-05-06 14:45,117,73,44,0,0,0
2021-05-06 15:00,98,43,55,0,0,0
2021-05-06 15:15,103,56,47,0,0,0
2021-05-06 15:30,114,66,48,0,0,0
2021-05-06 15:45,114,58,56,0,0,0
2021-05-06 16:00,130,70,60,0,0,0
2021-05-06 16:15,140,77,63,0,0,0
2021-05-06 16:30,123,62,61,0,0,0
2021-05-06 16:45,143,74,69,0,0,0
2021-05-06 17:00,124,63,61,0,0,0
2021-05-06 17:15,142,79,63,0,0,0
2021-05-06 17:30,109,44,65,0,0,0
2021-05-06 17:45,105,51,54,0,0,0
2021-05-06 18:00,107,55,52,0,0,0
2021-05-06 18:15,94,35,59,0,0,0
2021-05-06 18:30,100,42,58,0,0,0
2021-05-06 18:45,79,40,39,0,0,0
2021-05-06 19:00,74,34,40,0,0,0
2021-05-06 19:15,90,31,59,0,0,0
2021-05-06 19:30,54,28,26,0,0,0
2021-05-06 19:45,45,23,22,0,0,0
2021-05-06 20:00,61,28,33,0,0,0
2021-05-06 20:15,55,27,28,0,0,0
2021-05-06 20:30,26,19,7,0,0,0
2021-05-06 20:45,30,18,12,0,0,0
2021-05-06 21:00,25,6,19,0,0,0
2021-05-06 21:15,17,8,9,0,0,0
2021-05-06 21:30,22,11,11,0,0,0
2021-05-06 21:45,26,15,11,0,0,0
2021-05-06 22:00,17,14,3,0,0,0
2021-05-06 22:15,16,6,10,0,0,0
2021-05-06 22:30,19,12,7,0,0,0
2021-05-06 22:45,12,6,6,0,0,0
2021-05-06 23:00,21,9,12,0,0,0
2021-05-06 23:15,8,1,7,0,0,0
2021-05-06 23:30,9,6,3,0,0,0
2021-05-06 23:45,10,6,4,0,0,0
2021-05-07 00:00,2,1,1,0,0,0
2021-05-07 00:15,5,4,1,0,0,0
2021-05-07 00:30,6,4,2,0,0,0
2021-05-07 00:45,2,2,0,0,0,0
2021-05-07 01:00,2,2,0,0,0,0
2021-05-07 01:15,1,0,1,0,0,0
2021-05-07 01:30,5,1,4,0,0,0
2021-05-07 01:45,2,1,1,0,0,0
2021-05-07 02:00,2,0,2,0,0,0
2021-05-07 02:15,0,0,0,0,0,0
2021-05-07 02:30,1,0,1,0,0,0
2021-05-07 02:45,0,0,0,0,0,0
2021-05-07 03:00,3,2,1,0,0,0
2021-05-07 03:15,4,3,1,0,0,0
2021-05-07 03:30,0,0,0,0,0,0
2021-05-07 03:45,0,0,0,0,0,0
2021-05-07 04:00,0,0,0,0,0,0
2021-05-07 04:15,1,1,0,0,0,0
2021-05-07 04:30,2,2,0,0,0,0
2021-05-07 04:45,1,0,1,0,0,0
2021-05-07 05:00,0,0,0,0,0,0
2021-05-07 05:15,4,4,0,0,0,0
2021-05-07 05:30,7,4,3,0,0,0
2021-05-07 05:45,14,7,7,0,0,0
2021-05-07 06:00,13,9,4,0,0,0
2021-05-07 06:15,20,11,9,0,0,0
2021-05-07 06:30,41,29,12,0,0,0
2021-05-07 06:45,47,30,17,0,0,0
2021-05-07 07:00,68,41,27,0,0,0
2021-05-07 07:15,91,63,28,0,0,0
2021-05-07 07:30,137,97,40,0,0,0
2021-05-07 07:45,206,168,38,0,0,0
2021-05-07 08:00,174,140,34,0,0,0
2021-05-07 08:15,116,86,30,0,0,0
2021-05-07 08:30,103,70,33,0,0,0
2021-05-07 08:45,124,100,24,0,0,0
2021-05-07 09:00,73,55,18,0,0,0
2021-05-07 09:15,78,54,24,0,0,0
2021-05-07 09:30,101,65,36,0,0,0
2021-05-07 09:45,84,58,26,0,0,0
2021-05-07 10:00,69,44,25,0,0,0
2021-05-07 10:15,78,49,29,0,0,0
2021-05-07 10:30,90,58,32,0,0,0
2021-05-07 10:45,79,48,31,0,0,0
2021-05-07 11:00,82,49,33,0,0,0
2021-05-07 11:15,80,46,34,0,0,0
2021-05-07 11:30,103,65,38,0,0,0
2021-05-07 11:45,97,71,26,0,0,0
2021-05-07 12:00,87,46,41,0,0,0
2021-05-07 12:15,111,49,62,0,0,0
2021-05-07 12:30,111,60,51,0,0,0
2021-05-07 12:45,108,54,54,0,0,0
2021-05-07 13:00,110,53,57,0,0,0
2021-05-07 13:15,103,42,61,0,0,0
2021-05-07 13:30,126,60,66,0,0,0
2021-05-07 13:45,125,59,66,0,0,0
2021-05-07 14:00,116,68,48,0,0,0
2021-05-07 14:15,134,72,62,0,0,0
2021-05-07 14:30,120,60,60,0,0,0
2021-05-07 14:45,122,77,45,0,0,0
2021-05-07 15:00,109,58,51,0,0,0
2021-05-07 15:15,122,70,52,0,0,0
2021-05-07 15:30,115,60,55,0,0,0
2021-05-07 15:45,134,74,60,0,0,0
2021-05-07 16:00,116,61,55,0,0,0
2021-05-07 16:15,116,61,55,0,0,0
2021-05-07 16:30,135,89,46,0,0,0
2021-05-07 16:45,118,58,60,0,0,0
2021-05-07 17:00,114,56,58,0,0,0
2021-05-07 17:15,110,56,54,0,0,0
2021-05-07 17:30,96,45,51,0,0,0
2021-05-07 17:45,124,61,63,0,0,0
2021-05-07 18:00,100,47,53,0,0,0
2021-05-07 18:15,86,40,46,0,0,0
2021-05-07 18:30,84,32,52,0,0,0
2021-05-07 18:45,89,42,47,0,0,0
2021-05-07 19:00,80,31,49,0,0,0
2021-05-07 19:15,69,33,36,0,0,0
2021-05-07 19:30,70,33,37,0,0,0
2021-05-07 19:45,66,36,30,0,0,0
2021-05-07 20:00,57,28,29,0,0,0
2021-05-07 20:15,57,33,24,0,0,0
2021-05-07 20:30,28,17,11,0,0,0
2021-05-07 20:45,26,15,11,0,0,0
2021-05-07 21:00,26,12,14,0,0,0
2021-05-07 21:15,23,9,14,0,0,0
2021-05-07 21:30,21,13,8,0,0,0
2021-05-07 21:45,18,11,7,0,0,0
2021-05-07 22:00,19,16,3,0,0,0
2021-05-07 22:15,21,14,7,0,0,0
2021-05-07 22:30,15,6,9,0,0,0
2021-05-07 22:45,16,10,6,0,0,0
2021-05-07 23:00,6,2,4,0,0,0
2021-05-07 23:15,12,6,6,0,0,0
2021-05-07 23:30,16,6,10,0,0,0
2021-05-07 23:45,7,4,3,0,0,0
2021-05-08 00:00,14,9,5,0,0,0
2021-05-08 00:15,22,9,13,0,0,0
2021-05-08 00:30,13,10,3,0,0,0
2021-05-08 00:45,10,8,2,0,0,0
2021-05-08 01:00,11,1,10,0,0,0
2021-05-08 01:15,5,3,2,0,0,0
2021-05-08 01:30,16,7,9,0,0,0
2021-05-08 01:45,10,5,5,0,0,0
2021-05-08 02:00,9,6,3,0,0,0
2021-05-08 02:15,5,3,2,0,0,0
2021-05-08 02:30,5,3,2,0,0,0
2021-05-08 02:45,4,4,0,0,0,0
2021-05-08 03:00,7,5,2,0,0,0
2021-05-08 03:15,0,0,0,0,0,0
2021-05-08 03:30,2,1,1,0,0,0
2021-05-08 03:45,2,0,2,0,0,0
2021-05-08 04:00,4,2,2,0,0,0
2021-05-08 04:15,1,1,0,0,0,0
2021-05-08 04:30,0,0,0,0,0,0
2021-05-08 04:45,2,2,0,0,0,0
2021-05-08 05:00,4,1,3,0,0,0
2021-05-08 05:15,5,3,2,0,0,0
2021-05-08 05:30,9,8,1,0,0,0
2021-05-08 05:45,6,6,0,0,0,0
2021-05-08 06:00,6,4,2,0,0,0
2021-05-08 06:15,7,4,3,0,0,0
2021-05-08 06:30,10,8,2,0,0,0
2021-05-08 06:45,17,12,5,0,0,0
2021-05-08 07:00,18,14,4,0,0,0
2021-05-08 07:15,20,14,6,0,0,0
2021-05-08 07:30,49,36,13,0,0,0
2021-05-08 07:45,36,25,11,0,0,0
2021-05-08 08:00,48,29,19,0,0,0
2021-05-08 08:15,70,54,16,0,0,0
2021-05-08 08:30,73,44,29,0,0,0
2021-05-08 08:45,89,59,30,0,0,0
2021-05-08 09:00,58,44,14,0,0,0
2021-05-08 09:15,90,70,20,0,0,0
2021-05-08 09:30,99,74,25,0,0,0
2021-05-08 09:45,117,84,33,0,0,0
2021-05-08 10:00,99,76,23,0,0,0
2021-05-08 10:15,115,82,33,0,0,0
2021-05-08 10:30,123,82,41,0,0,0
2021-05-08 10:45,166,110,56,0,0,0
2021-05-08 11:00,143,99,44,0,0,0
2021-05-08 11:15,177,139,38,0,0,0
2021-05-08 11:30,140,99,41,0,0,0
2021-05-08 11:45,194,124,70,0,0,0
2021-05-08 12:00,145,91,54,0,0,0
2021-05-08 12:15,145,80,65,0,0,0
2021-05-08 12:30,143,81,62,0,0,0
2021-05-08 12:45,151,96,55,0,0,0
2021-05-08 13:00,135,89,46,0,0,0
2021-05-08 13:15,135,81,54,0,0,0
2021-05-08 13:30,143,66,77,0,0,0
2021-05-08 13:45,161,81,80,0,0,0
2021-05-08 14:00,122,53,69,0,0,0
2021-05-08 14:15,132,54,78,0,0,0
2021-05-08 14:30,124,63,61,0,0,0
2021-05-08 14:45,130,61,69,0,0,0
2021-05-08 15:00,81,39,42,0,0,0
2021-05-08 15:15,83,35,48,0,0,0
2021-05-08 15:30,88,43,45,0,0,0
2021-05-08 15:45,80,51,29,0,0,0
2021-05-08 16:00,88,41,47,0,0,0
2021-05-08 16:15,61,20,41,0,0,0
2021-05-08 16:30,51,29,22,0,0,0
2021-05-08 16:45,45,23,22,0,0,0
2021-05-08 17:00,40,20,20,0,0,0
2021-05-08 17:15,50,24,26,0,0,0
2021-05-08 17:30,60,36,24,0,0,0
2021-05-08 17:45,55,24,31,0,0,0
2021-05-08 18:00,66,27,39,0,0,0
2021-05-08 18:15,65,33,32,0,0,0
2021-05-08 18:30,47,23,24,0,0,0
2021-05-08 18:45,56,39,17,0,0,0
2021-05-08 19:00,62,33,29,0,0,0
2021-05-08 19:15,42,17,25,0,0,0
2021-05-08 19:30,52,21,31,0,0,0
2021-05-08 19:45,45,30,15,0,0,0
2021-05-08 20:00,38,21,17,0,0,0
2021-05-08 20:15,22,13,9,0,0,0
2021-05-08 20:30,33,23,10,0,0,0
2021-05-08 20:45,20,10,10,0,0,0
2021-05-08 21:00,15,6,9,0,0,0
2021-05-08 21:15,32,14,18,0,0,0
2021-05-08 21:30,13,5,8,0,0,0
2021-05-08 21:45,17,8,9,0,0,0
2021-05-08 22:00,30,13,17,0,0,0
2021-05-08 22:15,14,8,6,0,0,0
2021-05-08 22:30,17,6,11,0,0,0
2021-05-08 22:45,13,9,4,0,0,0
2021-05-08 23:00,12,9,3,0,0,0
2021-05-08 23:15,10,5,5,0,0,0
2021-05-08 23:30,16,9,7,0,0,0
2021-05-08 23:45,18,16,2,0,0,0
2021-05-09 00:00,17,14,3,0,0,0
2021-05-09 00:15,13,10,3,0,0,0
2021-05-09 00:30,17,12,5,0,0,0
2021-05-09 00:45,10,6,4,0,0,0
2021-05-09 01:00,7,1,6,0,0,0
2021-05-09 01:15,9,4,5,0,0,0
2021-05-09 01:30,3,1,2,0,0,0
2021-05-09 01:45,1,0,1,0,0,0
2021-05-09 02:00,9,3,6,0,0,0
2021-05-09 02:15,7,2,5,0,0,0
2021-05-09 02:30,9,5,4,0,0,0
2021-05-09 02:45,3,3,0,0,0,0
2021-05-09 03:00,8,7,1,0,0,0
2021-05-09 03:15,5,4,1,0,0,0
2021-05-09 03:30,0,0,0,0,0,0
2021-05-09 03:45,5,3,2,0,0,0
2021-05-09 04:00,3,3,0,0,0,0
2021-05-09 04:15,2,2,0,0,0,0
2021-05-09 04:30,0,0,0,0,0,0
2021-05-09 04:45,1,0,1,0,0,0
2021-05-09 05:00,1,1,0,0,0,0
2021-05-09 05:15,3,2,1,0,0,0
2021-05-09 05:30,1,1,0,0,0,0
2021-05-09 05:45,4,4,0,0,0,0
2021-05-09 06:00,4,3,1,0,0,0
2021-05-09 06:15,2,0,2,0,0,0
2021-05-09 06:30,5,3,2,0,0,0
2021-05-09 06:45,9,2,7,0,0,0
2021-05-09 07:00,3,3,0,0,0,0
2021-05-09 07:15,5,4,1,0,0,0
2021-05-09 07:30,7,5,2,0,0,0
2021-05-09 07:45,10,5,5,0,0,0
2021-05-09 08:00,20,14,6,0,0,0
2021-05-09 08:15,17,14,3,0,0,0
2021-05-09 08:30,10,8,2,0,0,0
2021-05-09 08:45,23,13,10,0,0,0
2021-05-09 09:00,26,18,8,0,0,0
2021-05-09 09:15,35,19,16,0,0,0
2021-05-09 09:30,31,16,15,0,0,0
2021-05-09 09:45,49,32,17,0,0,0
2021-05-09 10:00,48,35,13,0,0,0
2021-05-09 10:15,62,31,31,0,0,0
2021-05-09 10:30,69,54,15,0,0,0
2021-05-09 10:45,95,56,39,0,0,0
2021-05-09 11:00,69,41,28,0,0,0
2021-05-09 11:15,59,30,29,0,0,0
2021-05-09 11:30,65,46,19,0,0,0
2021-05-09 11:45,73,43,30,0,0,0
2021-05-09 12:00,76,47,29,0,0,0
2021-05-09 12:15,84,43,41,0,0,0
2021-05-09 12:30,103,43,60,0,0,0
2021-05-09 12:45,107,61,46,0,0,0
2021-05-09 13:00,84,43,41,0,0,0
2021-05-09 13:15,113,65,48,0,0,0
2021-05-09 13:30,119,71,48,0,0,0
2021-05-09 13:45,103,58,45,0,0,0
2021-05-09 14:00,127,71,56,0,0,0
2021-05-09 14:15,120,71,49,0,0,0
2021-05-09 14:30,126,75,51,0,0,0
2021-05-09 14:45,115,65,50,0,0,0
2021-05-09 15:00,112,74,38,0,0,0
2021-05-09 15:15,104,65,39,0,0,0
2021-05-09 15:30,102,54,48,0,0,0
2021-05-09 15:45,92,53,39,0,0,0
2021-05-09 16:00,97,54,43,0,0,0
2021-05-09 16:15,94,53,41,0,0,0
2021-05-09 16:30,95,58,37,0,0,0
2021-05-09 16:45,97,56,41,0,0,0
2021-05-09 17:00,86,51,35,0,0,0
2021-05-09 17:15,92,48,44,0,0,0
2021-05-09 17:30,95,56,39,0,0,0
2021-05-09 17:45,88,57,31,0,0,0
2021-05-09 18:00,102,66,36,0,0,0
2021-05-09 18:15,77,42,35,0,0,0
2021-05-09 18:30,103,65,38,0,0,0
2021-05-09 18:45,76,58,18,0,0,0
2021-05-09 19:00,66,38,28,0,0,0
2021-05-09 19:15,62,35,27,0,0,0
2021-05-09 19:30,73,48,25,0,0,0
2021-05-09 19:45,68,42,26,0,0,0
2021-05-09 20:00,53,38,15,0,0,0
2021-05-09 20:15,46,28,18,0,0,0
2021-05-09 20:30,56,38,18,0,0,0
2021-05-09 20:45,44,31,13,0,0,0
2021-05-09 21:00,39,17,22,0,0,0
2021-05-09 21:15,37,28,9,0,0,0
2021-05-09 21:30,40,19,21,0,0,0
2021-05-09 21:45,34,26,8,0,0,0
2021-05-09 22:00,28,14,14,0,0,0
2021-05-09 22:15,19,10,9,0,0,0
2021-05-09 22:30,22,12,10,0,0,0
2021-05-09 22:45,18,11,7,0,0,0
2021-05-09 23:00,14,8,6,0,0,0
2021-05-09 23:15,11,10,1,0,0,0
2021-05-09 23:30,6,5,1,0,0,0
2021-05-09 23:45,8,5,3,0,0,0
2021-05-10 00:00,11,6,5,0,0,0
2021-05-10 00:15,4,2,2,0,0,0
2021-05-10 00:30,8,5,3,0,0,0
2021-05-10 00:45,2,2,0,0,0,0
2021-05-10 01:00,4,4,0,0,0,0
2021-05-10 01:15,8,6,2,0,0,0
2021-05-10 01:30,3,1,2,0,0,0
2021-05-10 01:45,6,3,3,0,0,0
2021-05-10 02:00,0,0,0,0,0,0
2021-05-10 02:15,2,1,1,0,0,0
2021-05-10 02:30,1,0,1,0,0,0
2021-05-10 02:45,0,0,0,0,0,0
2021-05-10 03:00,2,2,0,0,0,0
2021-05-10 03:15,0,0,0,0,0,0
2021-05-10 03:30,0,0,0,0,0,0
2021-05-10 03:45,2,2,0,0,0,0
2021-05-10 04:00,2,1,1,0,0,0
2021-05-10 04:15,1,1,0,0,0,0
2021-05-10 04:30,0,0,0,0,0,0
2021-05-10 04:45,4,2,2,0,0,0
2021-05-10 05:00,2,0,2,0,0,0
2021-05-10 05:15,8,6,2,0,0,0
2021-05-10 05:30,13,10,3,0,0,0
2021-05-10 05:45,20,9,11,0,0,0
2021-05-10 06:00,18,10,8,0,0,0
2021-05-10 06:15,24,16,8,0,0,0
2021-05-10 06:30,30,22,8,0,0,0
2021-05-10 06:45,61,48,13,0,0,0
2021-05-10 07:00,91,66,25,0,0,0
2021-05-10 07:15,93,47,46,0,0,0
2021-05-10 07:30,155,104,51,0,0,0
2021-05-10 07:45,214,176,38,0,0,0
2021-05-10 08:00,199,164,35,0,0,0
2021-05-10 08:15,166,130,36,0,0,0
2021-05-10 08:30,134,107,27,0,0,0
2021-05-10 08:45,116,88,28,0,0,0
2021-05-10 09:00,85,59,26,0,0,0
2021-05-10 09:15,91,57,34,0,0,0
2021-05-10 09:30,71,51,20,0,0,0
2021-05-10 09:45,92,65,27,0,0,0
2021-05-10 10:00,86,52,34,0,0,0
2021-05-10 10:15,86,54,32,0,0,0
2021-05-10 10:30,93,62,31,0,0,0
2021-05-10 10:45,89,58,31,0,0,0
2021-05-10 11:00,82,50,32,0,0,0
2021-05-10 11:15,87,55,32,0,0,0
2021-05-10 11:30,82,39,43,0,0,0
2021-05-10 11:45,100,56,44,0,0,0
2021-05-10 12:00,102,58,44,0,0,0
2021-05-10 12:15,100,60,40,0,0,0
2021-05-10 12:30,99,49,50,0,0,0
2021-05-10 12:45,89,45,44,0,0,0
2021-05-10 13:00,110,50,60,0,0,0
2021-05-10 13:15,106,48,58,0,0,0
2021-05-10 13:30,111,48,63,0,0,0
2021-05-10 13:45,103,59,44,0,0,0
2021-05-10 14:00,124,70,54,0,0,0
2021-05-10 14:15,89,51,38,0,0,0
2021-05-10 14:30,112,68,44,0,0,0
2021-05-10 14:45,134,90,44,0,0,0
2021-05-10 15:00,112,68,44,0,0,0
2021-05-10 15:15,132,78,54,0,0,0
2021-05-10 15:30,108,71,37,0,0,0
2021-05-10 15:45,168,101,67,0,0,0
2021-05-10 16:00,133,78,55,0,0,0
2021-05-10 16:15,127,75,52,0,0,0
2021-05-10 16:30,142,90,52,0,0,0
2021-05-10 16:45,146,84,62,0,0,0
2021-05-10 17:00,155,83,72,0,0,0
2021-05-10 17:15,152,87,65,0,0,0
2021-05-10 17:30,124,68,56,0,0,0
2021-05-10 17:45,110,67,43,0,0,0
2021-05-10 18:00,115,61,54,0,0,0
2021-05-10 18:15,120,62,58,0,0,0
2021-05-10 18:30,75,38,37,0,0,0
2021-05-10 18:45,86,54,32,0,0,0
2021-05-10 19:00,77,46,31,0,0,0
2021-05-10 19:15,59,31,28,0,0,0
2021-05-10 19:30,47,19,28,0,0,0
2021-05-10 19:45,51,26,25,0,0,0
2021-05-10 20:00,51,28,23,0,0,0
2021-05-10 20:15,45,28,17,0,0,0
2021-05-10 20:30,31,18,13,0,0,0
2021-05-10 20:45,31,16,15,0,0,0
2021-05-10 21:00,26,15,11,0,0,0
2021-05-10 21:15,17,8,9,0,0,0
2021-05-10 21:30,29,19,10,0,0,0
2021-05-10 21:45,23,12,11,0,0,0
2021-05-10 22:00,23,12,11,0,0,0
2021-05-10 22:15,27,19,8,0,0,0
2021-05-10 22:30,17,9,8,0,0,0
2021-05-10 22:45,8,5,3,0,0,0
2021-05-10 23:00,18,10,8,0,0,0
2021-05-10 23:15,12,5,7,0,0,0
2021-05-10 23:30,8,7,1,0,0,0
2021-05-10 23:45,5,4,1,0,0,0
2021-05-11 00:00,6,4,2,0,0,0
2021-05-11 00:15,6,2,4,0,0,0
2021-05-11 00:30,1,0,1,0,0,0
2021-05-11 00:45,1,0,1,0,0,0
2021-05-11 01:00,6,4,2,0,0,0
2021-05-11 01:15,2,0,2,0,0,0
2021-05-11 01:30,2,0,2,0,0,0
2021-05-11 01:45,3,2,1,0,0,0
2021-05-11 02:00,0,0,0,0,0,0
2021-05-11 02:15,0,0,0,0,0,0
2021-05-11 02:30,1,1,0,0,0,0
2021-05-11 02:45,2,1,1,0,0,0
2021-05-11 03:00,0,0,0,0,0,0
2021-05-11 03:15,0,0,0,0,0,0
2021-05-11 03:30,1,1,0,0,0,0
2021-05-11 03:45,2,2,0,0,0,0
2021-05-11 04:00,0,0,0,0,0,0
2021-05-11 04:15,1,0,1,0,0,0
2021-05-11 04:30,1,1,0,0,0,0
2021-05-11 04:45,1,1,0,0,0,0
2021-05-11 05:00,1,1,0,0,0,0
2021-05-11 05:15,3,2,1,0,0,0
2021-05-11 05:30,12,5,7,0,0,0
2021-05-11 05:45,13,3,10,0,0,0
2021-05-11 06:00,11,4,7,0,0,0
2021-05-11 06:15,22,12,10,0,0,0
2021-05-11 06:30,34,23,11,0,0,0
2021-05-11 06:45,46,25,21,0,0,0
2021-05-11 07:00,68,42,26,0,0,0
2021-05-11 07:15,96,54,42,0,0,0
2021-05-11 07:30,140,101,39,0,0,0
2021-05-11 07:45,189,136,53,0,0,0
2021-05-11 08:00,164,134,30,0,0,0
2021-05-11 08:15,122,90,32,0,0,0
2021-05-11 08:30,103,78,25,0,0,0
2021-05-11 08:45,101,72,29,0,0,0
2021-05-11 09:00,91,63,28,0,0,0
2021-05-11 09:15,99,70,29,0,0,0
2021-05-11 09:30,82,57,25,0,0,0
2021-05-11 09:45,125,92,33,0,0,0
2021-05-11 10:00,72,49,23,0,0,0
2021-05-11 10:15,77,50,27,0,0,0
2021-05-11 10:30,91,57,34,0,0,0
2021-05-11 10:45,80,49,31,0,0,0
2021-05-11 11:00,68,44,24,0,0,0
2021-05-11 11:15,100,59,41,0,0,0
2021-05-11 11:30,85,49,36,0,0,0
2021-05-11 11:45,105,62,43,0,0,0
2021-05-11 12:00,103,57,46,0,0,0
2021-05-11 12:15,92,50,42,0,0,0
2021-05-11 12:30,77,49,28,0,0,0
2021-05-11 12:45,89,54,35,0,0,0
2021-05-11 13:00,85,41,44,0,0,0
2021-05-11 13:15,74,35,39,0,0,0
2021-05-11 13:30,90,52,38,0,0,0
2021-05-11 13:45,71,43,28,0,0,0
2021-05-11 14:00,70,33,37,0,0,0
2021-05-11 14:15,88,47,41,0,0,0
2021-05-11 14:30,80,46,34,0,0,0
2021-05-11 14:45,100,60,40,0,0,0
2021-05-11 15:00,54,33,21,0,0,0
2021-05-11 15:15,67,41,26,0,0,0
2021-05-11 15:30,67,35,32,0,0,0
2021-05-11 15:45,82,46,36,0,0,0
2021-05-11 16:00,96,56,40,0,0,0
2021-05-11 16:15,84,45,39,0,0,0
2021-05-11 16:30,89,48,41,0,0,0
2021-05-11 16:45,111,66,45,0,0,0
2021-05-11 17:00,90,49,41,0,0,0
2021-05-11 17:15,83,60,23,0,0,0
2021-05-11 17:30,99,52,47,0,0,0
2021-05-11 17:45,110,65,45,0,0,0
2021-05-11 18:00,94,47,47,0,0,0
2021-05-11 18:15,64,32,32,0,0,0
2021-05-11 18:30,65,33,32,0,0,0
2021-05-11 18:45,76,41,35,0,0,0
2021-05-11 19:00,62,23,39,0,0,0
2021-05-11 19:15,43,26,17,0,0,0
2021-05-11 19:30,37,21,16,0,0,0
2021-05-11 19:45,47,25,22,0,0,0
2021-05-11 20:00,49,22,27,0,0,0
2021-05-11 20:15,46,30,16,0,0,0
2021-05-11 20:30,23,17,6,0,0,0
2021-05-11 20:45,29,14,15,0,0,0
2021-05-11 21:00,20,12,8,0,0,0
2021-05-11 21:15,22,13,9,0,0,0
2021-05-11 21:30,14,7,7,0,0,0
2021-05-11 21:45,17,11,6,0,0,0
2021-05-11 22:00,19,13,6,0,0,0
2021-05-11 22:15,18,7,11,0,0,0
2021-05-11 22:30,14,5,9,0,0,0
2021-05-11 22:45,14,10,4,0,0,0
2021-05-11 23:00,9,4,5,0,0,0
2021-05-11 23:15,21,12,9,0,0,0
2021-05-11 23:30,12,6,6,0,0,0
2021-05-11 23:45,7,4,3,0,0,0
2021-05-12 00:00,3,2,1,0,0,0
2021-05-12 00:15,9,7,2,0,0,0
2021-05-12 00:30,8,2,6,0,0,0
2021-05-12 00:45,1,1,0,0,0,0
2021-05-12 01:00,3,0,3,0,0,0
2021-05-12 01:15,2,1,1,0,0,0
2021-05-12 01:30,2,2,0,0,0,0
2021-05-12 01:45,4,3,1,0,0,0
2021-05-12 02:00,2,2,0,0,0,0
2021-05-12 02:15,1,1,0,0,0,0
2021-05-12 02:30,1,0,1,0,0,0
2021-05-12 02:45,0,0,0,0,0,0
2021-05-12 03:00,0,0,0,0,0,0
2021-05-12 03:15,0,0,0,0,0,0
2021-05-12 03:30,0,0,0,0,0,0
2021-05-12 03:45,0,0,0,0,0,0
2021-05-12 04:00,1,1,0,0,0,0
2021-05-12 04:15,4,3,1,0,0,0
2021-05-12 04:30,1,1,0,0,0,0
2021-05-12 04:45,1,0,1,0,0,0
2021-05-12 05:00,2,1,1,0,0,0
2021-05-12 05:15,3,3,0,0,0,0
2021-05-12 05:30,11,8,3,0,0,0
2021-05-12 05:45,14,4,10,0,0,0
2021-05-12 06:00,13,9,4,0,0,0
2021-05-12 06:15,31,20,11,0,0,0
2021-05-12 06:30,42,28,14,0,0,0
2021-05-12 06:45,55,40,15,0,0,0
2021-05-12 07:00,95,61,34,0,0,0
2021-05-12 07:15,103,64,39,0,0,0
2021-05-12 07:30,144,98,46,0,0,0
2021-05-12 07:45,223,178,45,0,0,0
2021-05-12 08:00,201,167,34,0,0,0
2021-05-12 08:15,139,99,40,0,0,0
2021-05-12 08:30,155,115,40,0,0,0
2021-05-12 08:45,136,98,38,0,0,0
2021-05-12 09:00,133,94,39,0,0,0
2021-05-12 09:15,157,102,55,0,0,0
2021-05-12 09:30,143,106,37,0,0,0
2021-05-12 09:45,119,80,39,0,0,0
2021-05-12 10:00,117,76,41,0,0,0
2021-05-12 10:15,130,88,42,0,0,0
2021-05-12 10:30,136,90,46,0,0,0
2021-05-12 10:45,148,97,51,0,0,0
2021-05-12 11:00,129,90,39,0,0,0
2021-05-12 11:15,123,76,47,0,0,0
2021-05-12 11:30,151,77,74,0,0,0
2021-05-12 11:45,165,87,78,0,0,0
2021-05-12 12:00,158,87,71,0,0,0
2021-05-12 12:15,134,86,48,0,0,0
2021-05-12 12:30,151,75,76,0,0,0
2021-05-12 12:45,179,72,107,0,0,0
2021-05-12 13:00,129,67,62,0,0,0
2021-05-12 13:15,118,71,47,0,0,0
2021-05-12 13:30,127,76,51,0,0,0
2021-05-12 13:45,141,75,66,0,0,0
2021-05-12 14:00,111,60,51,0,0,0
2021-05-12 14:15,150,73,77,0,0,0
2021-05-12 14:30,129,61,68,0,0,0
2021-05-12 14:45,141,85,56,0,0,0
2021-05-12 15:00,116,64,52,0,0,0
2021-05-12 15:15,100,49,51,0,0,0
2021-05-12 15:30,92,50,42,0,0,0
2021-05-12 15:45,133,67,66,0,0,0
2021-05-12 16:00,122,66,56,0,0,0
2021-05-12 16:15,135,71,64,0,0,0
2021-05-12 16:30,159,101,58,0,0,0
2021-05-12 16:45,153,89,64,0,0,0
2021-05-12 17:00,121,73,48,0,0,0
2021-05-12 17:15,136,78,58,0,0,0
2021-05-12 17:30,131,75,56,0,0,0
2021-05-12 17:45,122,65,57,0,0,0
2021-05-12 18:00,135,72,63,0,0,0
2021-05-12 18:15,103,36,67,0,0,0
2021-05-12 18:30,77,42,35,0,0,0
2021-05-12 18:45,102,55,47,0,0,0
2021-05-12 19:00,80,44,36,0,0,0
2021-05-12 19:15,93,30,63,0,0,0
2021-05-12 19:30,87,50,37,0,0,0
2021-05-12 19:45,83,34,49,0,0,0
2021-05-12 20:00,68,42,26,0,0,0
2021-05-12 20:15,69,35,34,0,0,0
2021-05-12 20:30,54,28,26,0,0,0
2021-05-12 20:45,50,25,25,0,0,0
2021-05-12 21:00,38,19,19,0,0,0
2021-05-12 21:15,40,25,15,0,0,0
2021-05-12 21:30,15,9,6,0,0,0
2021-05-12 21:45,25,13,12,0,0,0
2021-05-12 22:00,22,8,14,0,0,0
2021-05-12 22:15,19,8,11,0,0,0
2021-05-12 22:30,24,8,16,0,0,0
2021-05-12 22:45,12,7,5,0,0,0
2021-05-12 23:00,14,3,11,0,0,0
2021-05-12 23:15,11,2,9,0,0,0
2021-05-12 23:30,10,7,3,0,0,0
2021-05-12 23:45,19,12,7,0,0,0
2021-05-13 00:00,9,5,4,0,0,0
2021-05-13 00:15,32,18,14,0,0,0
2021-05-13 00:30,10,6,4,0,0,0
2021-05-13 00:45,16,9,7,0,0,0
2021-05-13 01:00,19,5,14,0,0,0
2021-05-13 01:15,12,6,6,0,0,0
2021-05-13 01:30,13,9,4,0,0,0
2021-05-13 01:45,17,15,2,0,0,0
2021-05-13 02:00,5,2,3,0,0,0
2021-05-13 02:15,8,3,5,0,0,0
2021-05-13 02:30,1,0,1,0,0,0
2021-05-13 02:45,3,2,1,0,0,0
2021-05-13 03:00,6,4,2,0,0,0
2021-05-13 03:15,5,2,3,0,0,0
2021-05-13 03:30,3,1,2,0,0,0
2021-05-13 03:45,3,1,2,0,0,0
2021-05-13 04:00,2,1,1,0,0,0
2021-05-13 04:15,4,3,1,0,0,0
2021-05-13 04:30,1,1,0,0,0,0
2021-05-13 04:45,1,1,0,0,0,0
2021-05-13 05:00,0,0,0,0,0,0
2021-05-13 05:15,4,4,0,0,0,0
2021-05-13 05:30,4,2,2,0,0,0
2021-05-13 05:45,8,1,7,0,0,0
2021-05-13 06:00,10,9,1,0,0,0
2021-05-13 06:15,10,7,3,0,0,0
2021-05-13 06:30,6,3,3,0,0,0
2021-05-13 06:45,7,3,4,0,0,0
2021-05-13 07:00,1,0,1,0,0,0
2021-05-13 07:15,9,5,4,0,0,0
2021-05-13 07:30,12,9,3,0,0,0
2021-05-13 07:45,16,10,6,0,0,0
2021-05-13 08:00,11,7,4,0,0,0
2021-05-13 08:15,18,10,8,0,0,0
2021-05-13 08:30,15,10,5,0,0,0
2021-05-13 08:45,21,10,11,0,0,0
2021-05-13 09:00,21,12,9,0,0,0
2021-05-13 09:15,32,25,7,0,0,0
2021-05-13 09:30,45,28,17,0,0,0
2021-05-13 09:45,40,23,17,0,0,0
2021-05-13 10:00,40,23,17,0,0,0
2021-05-13 10:15,61,34,27,0,0,0
2021-05-13 10:30,53,34,19,0,0,0
2021-05-13 10:45,89,59,30,0,0,0
2021-05-13 11:00,41,27,14,0,0,0
2021-05-13 11:15,63,36,27,0,0,0
2021-05-13 11:30,72,50,22,0,0,0
2021-05-13 11:45,91,59,32,0,0,0
2021-05-13 12:00,76,31,45,0,0,0
2021-05-13 12:15,87,49,38,0,0,0
2021-05-13 12:30,56,26,30,0,0,0
2021-05-13 12:45,47,27,20,0,0,0
2021-05-13 13:00,62,36,26,0,0,0
2021-05-13 13:15,55,30,25,0,0,0
2021-05-13 13:30,67,40,27,0,0,0
2021-05-13 13:45,83,59,24,0,0,0
2021-05-13 14:00,87,45,42,0,0,0
2021-05-13 14:15,85,49,36,0,0,0
2021-05-13 14:30,84,56,28,0,0,0
2021-05-13 14:45,98,65,33,0,0,0
2021-05-13 15:00,89,57,32,0,0,0
2021-05-13 15:15,93,52,41,0,0,0
2021-05-13 15:30,83,44,39,0,0,0
2021-05-13 15:45,109,72,37,0,0,0
2021-05-13 16:00,92,58,34,0,0,0
2021-05-13 16:15,73,44,29,0,0,0
2021-05-13 16:30,79,52,27,0,0,0
2021-05-13 16:45,85,53,32,0,0,0
2021-05-13 17:00,79,52,27,0,0,0
2021-05-13 17:15,82,51,31,0,0,0
2021-05-13 17:30,81,48,33,0,0,0
2021-05-13 17:45,102,53,49,0,0,0
2021-05-13 18:00,85,48,37,0,0,0
2021-05-13 18:15,71,40,31,0,0,0
2021-05-13 18:30,68,37,31,0,0,0
2021-05-13 18:45,96,63,33,0,0,0
2021-05-13 19:00,85,45,40,0,0,0
2021-05-13 19:15,54,36,18,0,0,0
2021-05-13 19:30,50,25,25,0,0,0
2021-05-13 19:45,55,32,23,0,0,0
2021-05-13 20:00,48,32,16,0,0,0
2021-05-13 20:15,46,17,29,0,0,0
2021-05-13 20:30,41,24,17,0,0,0
2021-05-13 20:45,38,24,14,0,0,0
2021-05-13 21:00,47,26,21,0,0,0
2021-05-13 21:15,33,17,16,0,0,0
2021-05-13 21:30,18,7,11,0,0,0
2021-05-13 21:45,29,15,14,0,0,0
2021-05-13 22:00,24,14,10,0,0,0
2021-05-13 22:15,10,7,3,0,0,0
2021-05-13 22:30,20,12,8,0,0,0
2021-05-13 22:45,28,13,15,0,0,0
2021-05-13 23:00,29,21,8,0,0,0
2021-05-13 23:15,25,16,9,0,0,0
2021-05-13 23:30,20,11,9,0,0,0
2021-05-13 23:45,31,21,10,0,0,0
2021-05-14 00:00,10,6,4,0,0,0
2021-05-14 00:15,15,11,4,0,0,0
2021-05-14 00:30,7,3,4,0,0,0
2021-05-14 00:45,7,4,3,0,0,0
2021-05-14 01:00,10,3,7,0,0,0
2021-05-14 01:15,4,3,1,0,0,0
2021-05-14 01:30,9,2,7,0,0,0
2021-05-14 01:45,4,3,1,0,0,0
2021-05-14 02:00,0,0,0,0,0,0
2021-05-14 02:15,3,0,3,0,0,0
2021-05-14 02:30,0,0,0,0,0,0
2021-05-14 02:45,1,1,0,0,0,0
2021-05-14 03:00,2,2,0,0,0,0
2021-05-14 03:15,0,0,0,0,0,0
2021-05-14 03:30,0,0,0,0,0,0
2021-05-14 03:45,3,1,2,0,0,0
2021-05-14 04:00,0,0,0,0,0,0
2021-05-14 04:15,1,0,1,0,0,0
2021-05-14 04:30,0,0,0,0,0,0
2021-05-14 04:45,0,0,0,0,0,0
2021-05-14 05:00,3,3,0,0,0,0
2021-05-14 05:15,3,2,1,0,0,0
2021-05-14 05:30,6,5,1,0,0,0
2021-05-14 05:45,14,6,8,0,0,0
2021-05-14 06:00,16,10,6,0,0,0
2021-05-14 06:15,18,10,8,0,0,0
2021-05-14 06:30,21,14,7,0,0,0
2021-05-14 06:45,33,21,12,0,0,0
2021-05-14 07:00,41,25,16,0,0,0
2021-05-14 07:15,63,31,32,0,0,0
2021-05-14 07:30,66,50,16,0,0,0
2021-05-14 07:45,75,50,25,0,0,0
2021-05-14 08:00,57,39,18,0,0,0
2021-05-14 08:15,62,41,21,0,0,0
2021-05-14 08:30,73,54,19,0,0,0
2021-05-14 08:45,70,50,20,0,0,0
2021-05-14 09:00,55,37,18,0,0,0
2021-05-14 09:15,48,28,20,0,0,0
2021-05-14 09:30,73,51,22,0,0,0
2021-05-14 09:45,64,44,20,0,0,0
2021-05-14 10:00,62,46,16,0,0,0
2021-05-14 10:15,71,43,28,0,0,0
2021-05-14 10:30,75,54,21,0,0,0
2021-05-14 10:45,98,64,34,0,0,0
2021-05-14 11:00,87,52,35,0,0,0
2021-05-14 11:15,88,63,25,0,0,0
2021-05-14 11:30,103,63,40,0,0,0
2021-05-14 11:45,110,69,41,0,0,0
2021-05-14 12:00,103,64,39,0,0,0
2021-05-14 12:15,126,65,61,0,0,0
2021-05-14 12:30,104,62,42,0,0,0
2021-05-14 12:45,116,67,49,0,0,0
2021-05-14 13:00,135,66,69,0,0,0
2021-05-14 13:15,114,65,49,0,0,0
2021-05-14 13:30,94,56,38,0,0,0
2021-05-14 13:45,115,56,59,0,0,0
2021-05-14 14:00,120,76,44,0,0,0
2021-05-14 14:15,111,64,47,0,0,0
2021-05-14 14:30,109,64,45,0,0,0
2021-05-14 14:45,128,77,51,0,0,0
2021-05-14 15:00,112,73,39,0,0,0
2021-05-14 15:15,121,59,62,0,0,0
2021-05-14 15:30,131,77,54,0,0,0
2021-05-14 15:45,139,79,60,0,0,0
2021-05-14 16:00,141,77,64,0,0,0
2021-05-14 16:15,155,85,70,0,0,0
2021-05-14 16:30,117,67,50,0,0,0
2021-05-14 16:45,163,94,69,0,0,0
2021-05-14 17:00,121,58,63,0,0,0
2021-05-14 17:15,101,49,52,0,0,0
2021-05-14 17:30,123,78,45,0,0,0
2021-05-14 17:45,133,60,73,0,0,0
2021-05-14 18:00,116,39,77,0,0,0
2021-05-14 18:15,116,62,54,0,0,0
2021-05-14 18:30,122,54,68,0,0,0
2021-05-14 18:45,95,47,48,0,0,0
2021-05-14 19:00,82,40,42,0,0,0
2021-05-14 19:15,81,40,41,0,0,0
2021-05-14 19:30,70,37,33,0,0,0
2021-05-14 19:45,42,29,13,0,0,0
2021-05-14 20:00,64,40,24,0,0,0
2021-05-14 20:15,47,21,26,0,0,0
2021-05-14 20:30,44,25,19,0,0,0
2021-05-14 20:45,49,29,20,0,0,0
2021-05-14 21:00,34,11,23,0,0,0
2021-05-14 21:15,33,16,17,0,0,0
2021-05-14 21:30,45,28,17,0,0,0
2021-05-14 21:45,28,18,10,0,0,0
2021-05-14 22:00,21,9,12,0,0,0
2021-05-14 22:15,13,7,6,0,0,0
2021-05-14 22:30,25,15,10,0,0,0
2021-05-14 22:45,19,8,11,0,0,0
2021-05-14 23:00,24,15,9,0,0,0
2021-05-14 23:15,17,14,3,0,0,0
2021-05-14 23:30,19,10,9,0,0,0
2021-05-14 23:45,24,17,7,0,0,0
2021-05-15 00:00,15,7,8,0,0,0
2021-05-15 00:15,10,6,4,0,0,0
2021-05-15 00:30,18,10,8,0,0,0
2021-05-15 00:45,17,14,3,0,0,0
2021-05-15 01:00,14,6,8,0,0,0
2021-05-15 01:15,14,7,7,0,0,0
2021-05-15 01:30,6,3,3,0,0,0
2021-05-15 01:45,8,4,4,0,0,0
2021-05-15 02:00,6,3,3,0,0,0
2021-05-15 02:15,6,2,4,0,0,0
2021-05-15 02:30,3,1,2,0,0,0
2021-05-15 02:45,5,3,2,0,0,0
2021-05-15 03:00,0,0,0,0,0,0
2021-05-15 03:15,7,1,6,0,0,0
2021-05-15 03:30,2,2,0,0,0,0
2021-05-15 03:45,1,1,0,0,0,0
2021-05-15 04:00,3,0,3,0,0,0
2021-05-15 04:15,2,0,2,0,0,0
2021-05-15 04:30,3,3,0,0,0,0
2021-05-15 04:45,0,0,0,0,0,0
2021-05-15 05:00,1,1,0,0,0,0
2021-05-15 05:15,7,6,1,0,0,0
2021-05-15 05:30,6,6,0,0,0,0
2021-05-15 05:45,11,6,5,0,0,0
2021-05-15 06:00,13,9,4,0,0,0
2021-05-15 06:15,7,4,3,0,0,0
2021-05-15 06:30,8,6,2,0,0,0
2021-05-15 06:45,13,10,3,0,0,0
2021-05-15 07:00,10,8,2,0,0,0
2021-05-15 07:15,19,12,7,0,0,0
2021-05-15 07:30,34,24,10,0,0,0
2021-05-15 07:45,44,26,18,0,0,0
2021-05-15 08:00,28,18,10,0,0,0
2021-05-15 08:15,48,30,18,0,0,0
2021-05-15 08:30,60,46,14,0,0,0
2021-05-15 08:45,53,33,20,0,0,0
2021-05-15 09:00,72,58,14,0,0,0
2021-05-15 09:15,69,41,28,0,0,0
2021-05-15 09:30,75,53,22,0,0,0
2021-05-15 09:45,79,52,27,0,0,0
2021-05-15 10:00,58,37,21,0,0,0
2021-05-15 10:15,101,66,35,0,0,0
2021-05-15 10:30,114,96,18,0,0,0
2021-05-15 10:45,130,95,35,0,0,0
2021-05-15 11:00,101,72,29,0,0,0
2021-05-15 11:15,112,56,56,0,0,0
2021-05-15 11:30,100,54,46,0,0,0
2021-05-15 11:45,122,71,51,0,0,0
2021-05-15 12:00,116,78,38,0,0,0
2021-05-15 12:15,96,56,40,0,0,0
2021-05-15 12:30,110,56,54,0,0,0
2021-05-15 12:45,85,49,36,0,0,0
2021-05-15 13:00,123,78,45,0,0,0
2021-05-15 13:15,113,70,43,0,0,0
2021-05-15 13:30,125,79,46,0,0,0
2021-05-15 13:45,127,87,40,0,0,0
2021-05-15 14:00,118,64,54,0,0,0
2021-05-15 14:15,99,49,50,0,0,0
2021-05-15 14:30,109,56,53,0,0,0
2021-05-15 14:45,107,58,49,0,0,0
2021-05-15 15:00,79,31,48,0,0,0
2021-05-15 15:15,63,28,35,0,0,0
2021-05-15 15:30,68,29,39,0,0,0
2021-05-15 15:45,61,38,23,0,0,0
2021-05-15 16:00,74,42,32,0,0,0
2021-05-15 16:15,60,35,25,0,0,0
2021-05-15 16:30,62,34,28,0,0,0
2021-05-15 16:45,63,37,26,0,0,0
2021-05-15 17:00,51,22,29,0,0,0
2021-05-15 17:15,55,34,21,0,0,0
2021-05-15 17:30,79,32,47,0,0,0
2021-05-15 17:45,91,61,30,0,0,0
2021-05-15 18:00,75,23,52,0,0,0
2021-05-15 18:15,33,22,11,0,0,0
2021-05-15 18:30,53,21,32,0,0,0
2021-05-15 18:45,29,13,16,0,0,0
2021-05-15 19:00,42,18,24,0,0,0
2021-05-15 19:15,48,29,19,0,0,0
2021-05-15 19:30,37,25,12,0,0,0
2021-05-15 19:45,37,20,17,0,0,0
2021-05-15 20:00,49,26,23,0,0,0
2021-05-15 20:15,36,22,14,0,0,0
2021-05-15 20:30,38,25,13,0,0,0
2021-05-15 20:45,33,23,10,0,0,0
2021-05-15 21:00,20,12,8,0,0,0
2021-05-15 21:15,18,14,4,0,0,0
2021-05-15 21:30,18,13,5,0,0,0
2021-05-15 21:45,14,4,10,0,0,0
2021-05-15 22:00,19,6,13,0,0,0
2021-05-15 22:15,14,11,3,0,0,0
2021-05-15 22:30,10,9,1,0,0,0
2021-05-15 22:45,23,15,8,0,0,0
2021-05-15 23:00,13,8,5,0,0,0
2021-05-15 23:15,22,10,12,0,0,0
2021-05-15 23:30,24,14,10,0,0,0
2021-05-15 23:45,9,6,3,0,0,0
2021-05-16 00:00,13,6,7,0,0,0
2021-05-16 00:15,10,4,6,0,0,0
2021-05-16 00:30,12,7,5,0,0,0
2021-05-16 00:45,8,4,4,0,0,0
2021-05-16 01:00,14,7,7,0,0,0
2021-05-16 01:15,7,2,5,0,0,0
2021-05-16 01:30,13,10,3,0,0,0
2021-05-16 01:45,3,2,1,0,0,0
2021-05-16 02:00,4,2,2,0,0,0
2021-05-16 02:15,7,6,1,0,0,0
2021-05-16 02:30,5,2,3,0,0,0
2021-05-16 02:45,4,2,2,0,0,0
2021-05-16 03:00,4,0,4,0,0,0
2021-05-16 03:15,12,2,10,0,0,0
2021-05-16 03:30,1,0,1,0,0,0
2021-05-16 03:45,8,4,4,0,0,0
2021-05-16 04:00,1,0,1,0,0,0
2021-05-16 04:15,2,1,1,0,0,0
2021-05-16 04:30,1,1,0,0,0,0
2021-05-16 04:45,0,0,0,0,0,0
2021-05-16 05:00,1,1,0,0,0,0
2021-05-16 05:15,4,3,1,0,0,0
2021-05-16 05:30,4,4,0,0,0,0
2021-05-16 05:45,8,2,6,0,0,0
2021-05-16 06:00,7,3,4,0,0,0
2021-05-16 06:15,7,5,2,0,0,0
2021-05-16 06:30,5,3,2,0,0,0
2021-05-16 06:45,2,1,1,0,0,0
2021-05-16 07:00,5,2,3,0,0,0
2021-05-16 07:15,6,3,3,0,0,0
2021-05-16 07:30,6,4,2,0,0,0
2021-05-16 07:45,5,3,2,0,0,0
2021-05-16 08:00,6,3,3,0,0,0
2021-05-16 08:15,8,5,3,0,0,0
2021-05-16 08:30,13,7,6,0,0,0
2021-05-16 08:45,9,5,4,0,0,0
2021-05-16 09:00,14,10,4,0,0,0
2021-05-16 09:15,20,14,6,0,0,0
2021-05-16 09:30,22,17,5,0,0,0
2021-05-16 09:45,32,21,11,0,0,0
2021-05-16 10:00,29,18,11,0,0,0
2021-05-16 10:15,38,21,17,0,0,0
2021-05-16 10:30,26,16,10,0,0,0
2021-05-16 10:45,35,26,9,0,0,0
2021-05-16 11:00,42,33,9,0,0,0
2021-05-16 11:15,27,14,13,0,0,0
2021-05-16 11:30,35,23,12,0,0,0
2021-05-16 11:45,44,18,26,0,0,0
2021-05-16 12:00,64,33,31,0,0,0
2021-05-16 12:15,49,28,21,0,0,0
2021-05-16 12:30,53,29,24,0,0,0
2021-05-16 12:45,40,20,20,0,0,0
2021-05-16 13:00,44,29,15,0,0,0
2021-05-16 13:15,51,33,18,0,0,0
2021-05-16 13:30,44,18,26,0,0,0
2021-05-16 13:45,64,37,27,0,0,0
2021-05-16 14:00,64,41,23,0,0,0
2021-05-16 14:15,54,34,20,0,0,0
2021-05-16 14:30,76,44,32,0,0,0
2021-05-16 14:45,92,65,27,0,0,0
2021-05-16 15:00,65,44,21,0,0,0
2021-05-16 15:15,60,31,29,0,0,0
2021-05-16 15:30,79,43,36,0,0,0
2021-05-16 15:45,75,46,29,0,0,0
2021-05-16 16:00,78,40,38,0,0,0
2021-05-16 16:15,68,34,34,0,0,0
2021-05-16 16:30,63,30,33,0,0,0
2021-05-16 16:45,64,30,34,0,0,0
2021-05-16 17:00,60,34,26,0,0,0
2021-05-16 17:15,71,42,29,0,0,0
2021-05-16 17:30,61,41,20,0,0,0
2021-05-16 17:45,50,35,15,0,0,0
2021-05-16 18:00,47,22,25,0,0,0
2021-05-16 18:15,37,16,21,0,0,0
2021-05-16 18:30,52,33,19,0,0,0
2021-05-16 18:45,41,28,13,0,0,0
2021-05-16 19:00,34,16,18,0,0,0
2021-05-16 19:15,38,26,12,0,0,0
2021-05-16 19:30,24,20,4,0,0,0
2021-05-16 19:45,37,21,16,0,0,0
2021-05-16 20:00,36,17,19,0,0,0
2021-05-16 20:15,30,20,10,0,0,0
2021-05-16 20:30,23,11,12,0,0,0
2021-05-16 20:45,23,11,12,0,0,0
2021-05-16 21:00,24,21,3,0,0,0
2021-05-16 21:15,14,7,7,0,0,0
2021-05-16 21:30,12,7,5,0,0,0
2021-05-16 21:45,14,10,4,0,0,0
2021-05-16 22:00,18,11,7,0,0,0
2021-05-16 22:15,15,12,3,0,0,0
2021-05-16 22:30,13,7,6,0,0,0
2021-05-16 22:45,7,3,4,0,0,0
2021-05-16 23:00,5,2,3,0,0,0
2021-05-16 23:15,7,4,3,0,0,0
2021-05-16 23:30,10,10,0,0,0,0
2021-05-16 23:45,4,3,1,0,0,0
2021-05-17 00:00,8,5,3,0,0,0
2021-05-17 00:15,4,3,1,0,0,0
2021-05-17 00:30,3,0,3,0,0,0
2021-05-17 00:45,0,0,0,0,0,0
2021-05-17 01:00,1,1,0,0,0,0
2021-05-17 01:15,0,0,0,0,0,0
2021-05-17 01:30,3,3,0,0,0,0
2021-05-17 01:45,6,2,4,0,0,0
2021-05-17 02:00,1,0,1,0,0,0
2021-05-17 02:15,0,0,0,0,0,0
2021-05-17 02:30,1,1,0,0,0,0
2021-05-17 02:45,0,0,0,0,0,0
2021-05-17 03:00,5,1,4,0,0,0
2021-05-17 03:15,0,0,0,0,0,0
2021-05-17 03:30,3,3,0,0,0,0
2021-05-17 03:45,1,1,0,0,0,0
2021-05-17 04:00,0,0,0,0,0,0
2021-05-17 04:15,1,0,1,0,0,0
2021-05-17 04:30,1,1,0,0,0,0
2021-05-17 04:45,0,0,0,0,0,0
2021-05-17 05:00,0,0,0,0,0,0
2021-05-17 05:15,5,5,0,0,0,0
2021-05-17 05:30,8,6,2,0,0,0
2021-05-17 05:45,16,8,8,0,0,0
2021-05-17 06:00,12,8,4,0,0,0
2021-05-17 06:15,26,17,9,0,0,0
2021-05-17 06:30,27,19,8,0,0,0
2021-05-17 06:45,58,40,18,0,0,0
2021-05-17 07:00,66,46,20,0,0,0
2021-05-17 07:15,94,62,32,0,0,0
2021-05-17 07:30,131,83,48,0,0,0
2021-05-17 07:45,189,147,42,0,0,0
2021-05-17 08:00,151,128,23,0,0,0
2021-05-17 08:15,107,83,24,0,0,0
2021-05-17 08:30,118,89,29,0,0,0
2021-05-17 08:45,110,87,23,0,0,0
2021-05-17 09:00,80,55,25,0,0,0
2021-05-17 09:15,85,59,26,0,0,0
2021-05-17 09:30,66,48,18,0,0,0
2021-05-17 09:45,80,59,21,0,0,0
2021-05-17 10:00,63,49,14,0,0,0
2021-05-17 10:15,64,38,26,0,0,0
2021-05-17 10:30,41,27,14,0,0,0
2021-05-17 10:45,73,35,38,0,0,0
2021-05-17 11:00,55,28,27,0,0,0
2021-05-17 11:15,73,48,25,0,0,0
2021-05-17 11:30,56,35,21,0,0,0
2021-05-17 11:45,79,51,28,0,0,0
2021-05-17 12:00,74,40,34,0,0,0
2021-05-17 12:15,99,54,45,0,0,0
2021-05-17 12:30,67,43,24,0,0,0
2021-05-17 12:45,65,27,38,0,0,0
2021-05-17 13:00,80,42,38,0,0,0
2021-05-17 13:15,77,40,37,0,0,0
2021-05-17 13:30,95,40,55,0,0,0
2021-05-17 13:45,112,70,42,0,0,0
2021-05-17 14:00,101,50,51,0,0,0
2021-05-17 14:15,106,50,56,0,0,0
2021-05-17 14:30,64,26,38,0,0,0
2021-05-17 14:45,72,27,45,0,0,0
2021-05-17 15:00,62,19,43,0,0,0
2021-05-17 15:15,80,52,28,0,0,0
2021-05-17 15:30,72,39,33,0,0,0
2021-05-17 15:45,120,55,65,0,0,0
2021-05-17 16:00,118,66,52,0,0,0
2021-05-17 16:15,121,61,60,0,0,0
2021-05-17 16:30,135,66,69,0,0,0
2021-05-17 16:45,120,53,67,0,0,0
2021-05-17 17:00,114,52,62,0,0,0
2021-05-17 17:15,99,50,49,0,0,0
2021-05-17 17:30,113,53,60,0,0,0
2021-05-17 17:45,110,49,61,0,0,0
2021-05-17 18:00,116,54,62,0,0,0
2021-05-17 18:15,76,33,43,0,0,0
2021-05-17 18:30,70,38,32,0,0,0
2021-05-17 18:45,79,32,47,0,0,0
2021-05-17 19:00,52,28,24,0,0,0
2021-05-17 19:15,61,22,39,0,0,0
2021-05-17 19:30,46,21,25,0,0,0
2021-05-17 19:45,56,19,37,0,0,0
2021-05-17 20:00,33,18,15,0,0,0
2021-05-17 20:15,25,12,13,0,0,0
2021-05-17 20:30,29,16,13,0,0,0
2021-05-17 20:45,15,8,7,0,0,0
2021-05-17 21:00,12,8,4,0,0,0
2021-05-17 21:15,17,10,7,0,0,0
2021-05-17 21:30,20,7,13,0,0,0
2021-05-17 21:45,16,6,10,0,0,0
2021-05-17 22:00,20,15,5,0,0,0
2021-05-17 22:15,13,4,9,0,0,0
2021-05-17 22:30,8,3,5,0,0,0
2021-05-17 22:45,18,9,9,0,0,0
2021-05-17 23:00,11,5,6,0,0,0
2021-05-17 23:15,5,0,5,0,0,0
2021-05-17 23:30,14,10,4,0,0,0
2021-05-17 23:45,5,1,4,0,0,0
2021-05-18 00:00,6,4,2,0,0,0
2021-05-18 00:15,4,2,2,0,0,0
2021-05-18 00:30,4,2,2,0,0,0
2021-05-18 00:45,10,2,8,0,0,0
2021-05-18 01:00,3,3,0,0,0,0
2021-05-18 01:15,1,0,1,0,0,0
2021-05-18 01:30,3,1,2,0,0,0
2021-05-18 01:45,2,1,1,0,0,0
2021-05-18 02:00,1,0,1,0,0,0
2021-05-18 02:15,0,0,0,0,0,0
2021-05-18 02:30,1,0,1,0,0,0
2021-05-18 02:45,0,0,0,0,0,0
2021-05-18 03:00,1,0,1,0,0,0
2021-05-18 03:15,0,0,0,0,0,0
2021-05-18 03:30,0,0,0,0,0,0
2021-05-18 03:45,0,0,0,0,0,0
2021-05-18 04:00,0,0,0,0,0,0
2021-05-18 04:15,1,1,0,0,0,0
2021-05-18 04:30,2,2,0,0,0,0
2021-05-18 04:45,1,0,1,0,0,0
2021-05-18 05:00,2,2,0,0,0,0
2021-05-18 05:15,6,5,1,0,0,0
2021-05-18 05:30,17,13,4,0,0,0
2021-05-18 05:45,11,5,6,0,0,0
2021-05-18 06:00,20,14,6,0,0,0
2021-05-18 06:15,29,20,9,0,0,0
2021-05-18 06:30,49,35,14,0,0,0
2021-05-18 06:45,61,43,18,0,0,0
2021-05-18 07:00,79,56,23,0,0,0
2021-05-18 07:15,103,66,37,0,0,0
2021-05-18 07:30,131,89,42,0,0,0
2021-05-18 07:45,188,151,37,0,0,0
2021-05-18 08:00,154,132,22,0,0,0
2021-05-18 08:15,126,91,35,0,0,0
2021-05-18 08:30,115,79,36,0,0,0
2021-05-18 08:45,96,66,30,0,0,0
2021-05-18 09:00,91,69,22,0,0,0
2021-05-18 09:15,91,62,29,0,0,0
2021-05-18 09:30,83,57,26,0,0,0
2021-05-18 09:45,73,52,21,0,0,0
2021-05-18 10:00,59,35,24,0,0,0
2021-05-18 10:15,74,47,27,0,0,0
2021-05-18 10:30,71,46,25,0,0,0
2021-05-18 10:45,95,71,24,0,0,0
2021-05-18 11:00,59,33,26,0,0,0
2021-05-18 11:15,71,38,33,0,0,0
2021-05-18 11:30,84,61,23,0,0,0
2021-05-18 11:45,86,54,32,0,0,0
2021-05-18 12:00,71,37,34,0,0,0
2021-05-18 12:15,82,46,36,0,0,0
2021-05-18 12:30,62,32,30,0,0,0
2021-05-18 12:45,68,27,41,0,0,0
2021-05-18 13:00,112,48,64,0,0,0
2021-05-18 13:15,116,50,66,0,0,0
2021-05-18 13:30,94,43,51,0,0,0
2021-05-18 13:45,107,55,52,0,0,0
2021-05-18 14:00,71,39,32,0,0,0
2021-05-18 14:15,88,51,37,0,0,0
2021-05-18 14:30,100,43,57,0,0,0
2021-05-18 14:45,125,65,60,0,0,0
2021-05-18 15:00,120,68,52,0,0,0
2021-05-18 15:15,105,50,55,0,0,0
2021-05-18 15:30,116,64,52,0,0,0
2021-05-18 15:45,142,73,69,0,0,0
2021-05-18 16:00,124,65,59,0,0,0
2021-05-18 16:15,145,71,74,0,0,0
2021-05-18 16:30,128,64,64,0,0,0
2021-05-18 16:45,133,77,56,0,0,0
2021-05-18 17:00,131,64,67,0,0,0
2021-05-18 17:15,134,65,69,0,0,0
2021-05-18 17:30,136,69,67,0,0,0
2021-05-18 17:45,135,60,75,0,0,0
2021-05-18 18:00,128,59,69,0,0,0
2021-05-18 18:15,100,43,57,0,0,0
2021-05-18 18:30,94,50,44,0,0,0
2021-05-18 18:45,77,45,32,0,0,0
2021-05-18 19:00,98,44,54,0,0,0
2021-05-18 19:15,83,40,43,0,0,0
2021-05-18 19:30,56,28,28,0,0,0
2021-05-18 19:45,62,36,26,0,0,0
2021-05-18 20:00,57,25,32,0,0,0
2021-05-18 20:15,45,20,25,0,0,0
2021-05-18 20:30,33,16,17,0,0,0
2021-05-18 20:45,42,20,22,0,0,0
2021-05-18 21:00,26,11,15,0,0,0
2021-05-18 21:15,41,21,20,0,0,0
2021-05-18 21:30,16,9,7,0,0,0
2021-05-18 21:45,14,9,5,0,0,0
2021-05-18 22:00,22,12,10,0,0,0
2021-05-18 22:15,21,11,10,0,0,0
2021-05-18 22:30,19,9,10,0,0,0
2021-05-18 22:45,13,7,6,0,0,0
2021-05-18 23:00,16,10,6,0,0,0
2021-05-18 23:15,16,9,7,0,0,0
2021-05-18 23:30,16,9,7,0,0,0
2021-05-18 23:45,6,2,4,0,0,0
2021-05-19 00:00,8,4,4,0,0,0
2021-05-19 00:15,11,6,5,0,0,0
2021-05-19 00:30,8,6,2,0,0,0
2021-05-19 00:45,1,0,1,0,0,0
2021-05-19 01:00,3,2,1,0,0,0
2021-05-19 01:15,1,0,1,0,0,0
2021-05-19 01:30,2,2,0,0,0,0
2021-05-19 01:45,3,2,1,0,0,0
2021-05-19 02:00,1,1,0,0,0,0
2021-05-19 02:15,5,3,2,0,0,0
2021-05-19 02:30,1,1,0,0,0,0
2021-05-19 02:45,2,0,2,0,0,0
2021-05-19 03:00,1,1,0,0,0,0
2021-05-19 03:15,0,0,0,0,0,0
2021-05-19 03:30,0,0,0,0,0,0
2021-05-19 03:45,1,0,1,0,0,0
2021-05-19 04:00,0,0,0,0,0,0
2021-05-19 04:15,3,2,1,0,0,0
2021-05-19 04:30,5,4,1,0,0,0
2021-05-19 04:45,2,1,1,0,0,0
2021-05-19 05:00,2,2,0,0,0,0
2021-05-19 05:15,2,2,0,0,0,0
2021-05-19 05:30,17,12,5,0,0,0
2021-05-19 05:45,20,10,10,0,0,0
2021-05-19 06:00,14,8,6,0,0,0
2021-05-19 06:15,29,20,9,0,0,0
2021-05-19 06:30,47,35,12,0,0,0
2021-05-19 06:45,59,46,13,0,0,0
2021-05-19 07:00,78,54,24,0,0,0
2021-05-19 07:15,112,68,44,0,0,0
2021-05-19 07:30,118,94,24,0,0,0
2021-05-19 07:45,231,165,66,0,0,0
2021-05-19 08:00,169,139,30,0,0,0
2021-05-19 08:15,126,89,37,0,0,0
2021-05-19 08:30,155,115,40,0,0,0
2021-05-19 08:45,143,106,37,0,0,0
2021-05-19 09:00,106,71,35,0,0,0
2021-05-19 09:15,116,78,38,0,0,0
2021-05-19 09:30,122,87,35,0,0,0
2021-05-19 09:45,100,71,29,0,0,0
2021-05-19 10:00,91,58,33,0,0,0
2021-05-19 10:15,121,89,32,0,0,0
2021-05-19 10:30,131,84,47,0,0,0
2021-05-19 10:45,137,87,50,0,0,0
2021-05-19 11:00,120,79,41,0,0,0
2021-05-19 11:15,117,76,41,0,0,0
2021-05-19 11:30,114,64,50,0,0,0
2021-05-19 11:45,110,57,53,0,0,0
2021-05-19 12:00,111,63,48,0,0,0
2021-05-19 12:15,153,83,70,0,0,0
2021-05-19 12:30,114,55,59,0,0,0
2021-05-19 12:45,125,74,51,0,0,0
2021-05-19 13:00,91,34,57,0,0,0
2021-05-19 13:15,113,55,58,0,0,0
2021-05-19 13:30,124,55,69,0,0,0
2021-05-19 13:45,134,68,66,0,0,0
2021-05-19 14:00,110,57,53,0,0,0
2021-05-19 14:15,138,72,66,0,0,0
2021-05-19 14:30,125,64,61,0,0,0
2021-05-19 14:45,103,54,49,0,0,0
2021-05-19 15:00,114,54,60,0,0,0
2021-05-19 15:15,113,62,51,0,0,0
2021-05-19 15:30,114,65,49,0,0,0
2021-05-19 15:45,141,77,64,0,0,0
2021-05-19 16:00,122,58,64,0,0,0
2021-05-19 16:15,111,53,58,0,0,0
2021-05-19 16:30,127,58,69,0,0,0
2021-05-19 16:45,100,45,55,0,0,0
2021-05-19 17:00,101,44,57,0,0,0
2021-05-19 17:15,112,55,57,0,0,0
2021-05-19 17:30,121,56,65,0,0,0
2021-05-19 17:45,134,71,63,0,0,0
2021-05-19 18:00,113,58,55,0,0,0
2021-05-19 18:15,96,52,44,0,0,0
2021-05-19 18:30,92,41,51,0,0,0
2021-05-19 18:45,77,33,44,0,0,0
2021-05-19 19:00,88,34,54,0,0,0
2021-05-19 19:15,79,40,39,0,0,0
2021-05-19 19:30,62,39,23,0,0,0
2021-05-19 19:45,60,30,30,0,0,0
2021-05-19 20:00,62,24,38,0,0,0
2021-05-19 20:15,46,21,25,0,0,0
2021-05-19 20:30,37,23,14,0,0,0
2021-05-19 20:45,41,23,18,0,0,0
2021-05-19 21:00,30,16,14,0,0,0
2021-05-19 21:15,30,11,19,0,0,0
2021-05-19 21:30,27,15,12,0,0,0
2021-05-19 21:45,28,11,17,0,0,0
2021-05-19 22:00,21,13,8,0,0,0
2021-05-19 22:15,21,15,6,0,0,0
2021-05-19 22:30,30,11,19,0,0,0
2021-05-19 22:45,23,11,12,0,0,0
2021-05-19 23:00,14,5,9,0,0,0
2021-05-19 23:15,16,9,7,0,0,0
2021-05-19 23:30,13,4,9,0,0,0
2021-05-19 23:45,8,2,6,0,0,0
2021-05-20 00:00,11,4,7,0,0,0
2021-05-20 00:15,13,7,6,0,0,0
2021-05-20 00:30,11,6,5,0,0,0
2021-05-20 00:45,10,5,5,0,0,0
2021-05-20 01:00,5,5,0,0,0,0
2021-05-20 01:15,4,1,3,0,0,0
2021-05-20 01:30,4,2,2,0,0,0
2021-05-20 01:45,3,3,0,0,0,0
2021-05-20 02:00,2,0,2,0,0,0
2021-05-20 02:15,0,0,0,0,0,0
2021-05-20 02:30,1,0,1,0,0,0
2021-05-20 02:45,1,1,0,0,0,0
2021-05-20 03:00,0,0,0,0,0,0
2021-05-20 03:15,1,0,1,0,0,0
2021-05-20 03:30,2,1,1,0,0,0
2021-05-20 03:45,2,2,0,0,0,0
2021-05-20 04:00,0,0,0,0,0,0
2021-05-20 04:15,2,2,0,0,0,0
2021-05-20 04:30,2,2,0,0,0,0
2021-05-20 04:45,1,1,0,0,0,0
2021-05-20 05:00,1,0,1,0,0,0
2021-05-20 05:15,3,2,1,0,0,0
2021-05-20 05:30,12,6,6,0,0,0
2021-05-20 05:45,13,6,7,0,0,0
2021-05-20 06:00,17,11,6,0,0,0
2021-05-20 06:15,33,19,14,0,0,0
2021-05-20 06:30,34,21,13,0,0,0
2021-05-20 06:45,59,46,13,0,0,0
2021-05-20 07:00,88,64,24,0,0,0
2021-05-20 07:15,111,66,45,0,0,0
2021-05-20 07:30,156,105,51,0,0,0
2021-05-20 07:45,220,163,57,0,0,0
2021-05-20 08:00,175,153,22,0,0,0
2021-05-20 08:15,135,104,31,0,0,0
2021-05-20 08:30,119,91,28,0,0,0
2021-05-20 08:45,135,107,28,0,0,0
2021-05-20 09:00,87,69,18,0,0,0
2021-05-20 09:15,99,69,30,0,0,0
2021-05-20 09:30,108,87,21,0,0,0
2021-05-20 09:45,105,75,30,0,0,0
2021-05-20 10:00,79,56,23,0,0,0
2021-05-20 10:15,97,57,40,0,0,0
2021-05-20 10:30,95,55,40,0,0,0
2021-05-20 10:45,131,82,49,0,0,0
2021-05-20 11:00,101,65,36,0,0,0
2021-05-20 11:15,96,51,45,0,0,0
2021-05-20 11:30,125,80,45,0,0,0
2021-05-20 11:45,101,57,44,0,0,0
2021-05-20 12:00,101,52,49,0,0,0
2021-05-20 12:15,98,51,47,0,0,0
2021-05-20 12:30,105,58,47,0,0,0
2021-05-20 12:45,124,76,48,0,0,0
2021-05-20 13:00,131,66,65,0,0,0
2021-05-20 13:15,126,64,62,0,0,0
2021-05-20 13:30,120,66,54,0,0,0
2021-05-20 13:45,109,60,49,0,0,0
2021-05-20 14:00,121,56,65,0,0,0
2021-05-20 14:15,143,70,73,0,0,0
2021-05-20 14:30,157,94,63,0,0,0
2021-05-20 14:45,149,91,58,0,0,0
2021-05-20 15:00,133,69,64,0,0,0
2021-05-20 15:15,120,71,49,0,0,0
2021-05-20 15:30,131,79,52,0,0,0
2021-05-20 15:45,154,93,61,0,0,0
2021-05-20 16:00,160,82,78,0,0,0
2021-05-20 16:15,166,89,77,0,0,0
2021-05-20 16:30,161,93,68,0,0,0
2021-05-20 16:45,172,103,69,0,0,0
2021-05-20 17:00,162,86,76,0,0,0
2021-05-20 17:15,157,84,73,0,0,0
2021-05-20 17:30,161,83,78,0,0,0
2021-05-20 17:45,153,75,78,0,0,0
2021-05-20 18:00,154,72,82,0,0,0
2021-05-20 18:15,133,64,69,0,0,0
2021-05-20 18:30,108,42,66,0,0,0
2021-05-20 18:45,115,45,70,0,0,0
2021-05-20 19:00,107,50,57,0,0,0
2021-05-20 19:15,79,33,46,0,0,0
2021-05-20 19:30,82,39,43,0,0,0
2021-05-20 19:45,82,43,39,0,0,0
2021-05-20 20:00,80,40,40,0,0,0
2021-05-20 20:15,46,21,25,0,0,0
2021-05-20 20:30,33,16,17,0,0,0
2021-05-20 20:45,30,13,17,0,0,0
2021-05-20 21:00,19,7,12,0,0,0
2021-05-20 21:15,31,9,22,0,0,0
2021-05-20 21:30,33,14,19,0,0,0
2021-05-20 21:45,32,15,17,0,0,0
2021-05-20 22:00,26,19,7,0,0,0
2021-05-20 22:15,24,9,15,0,0,0
2021-05-20 22:30,22,14,8,0,0,0
2021-05-20 22:45,24,17,7,0,0,0
2021-05-20 23:00,24,12,12,0,0,0
2021-05-20 23:15,14,7,7,0,0,0
2021-05-20 23:30,18,8,10,0,0,0
2021-05-20 23:45,9,5,4,0,0,0
2021-05-21 00:00,6,2,4,0,0,0
2021-05-21 00:15,9,2,7,0,0,0
2021-05-21 00:30,3,1,2,0,0,0
2021-05-21 00:45,8,6,2,0,0,0
2021-05-21 01:00,3,2,1,0,0,0
2021-05-21 01:15,1,1,0,0,0,0
2021-05-21 01:30,5,2,3,0,0,0
2021-05-21 01:45,4,4,0,0,0,0
2021-05-21 02:00,4,2,2,0,0,0
2021-05-21 02:15,2,1,1,0,0,0
2021-05-21 02:30,3,1,2,0,0,0
2021-05-21 02:45,7,5,2,0,0,0
2021-05-21 03:00,4,0,4,0,0,0
2021-05-21 03:15,0,0,0,0,0,0
2021-05-21 03:30,2,0,2,0,0,0
2021-05-21 03:45,2,1,1,0,0,0
2021-05-21 04:00,0,0,0,0,0,0
2021-05-21 04:15,0,0,0,0,0,0
2021-05-21 04:30,3,3,0,0,0,0
2021-05-21 04:45,2,1,1,0,0,0
2021-05-21 05:00,0,0,0,0,0,0
2021-05-21 05:15,1,0,1,0,0,0
2021-05-21 05:30,17,14,3,0,0,0
2021-05-21 05:45,20,12,8,0,0,0
2021-05-21 06:00,15,8,7,0,0,0
2021-05-21 06:15,26,17,9,0,0,0
2021-05-21 06:30,36,27,9,0,0,0
2021-05-21 06:45,58,40,18,0,0,0
2021-05-21 07:00,58,42,16,0,0,0
2021-05-21 07:15,95,51,44,0,0,0
2021-05-21 07:30,132,90,42,0,0,0
2021-05-21 07:45,198,149,49,0,0,0
2021-05-21 08:00,170,147,23,0,0,0
2021-05-21 08:15,86,64,22,0,0,0
2021-05-21 08:30,87,65,22,0,0,0
2021-05-21 08:45,97,72,25,0,0,0
2021-05-21 09:00,79,62,17,0,0,0
2021-05-21 09:15,96,66,30,0,0,0
2021-05-21 09:30,71,54,17,0,0,0
2021-05-21 09:45,86,63,23,0,0,0
2021-05-21 10:00,82,60,22,0,0,0
2021-05-21 10:15,96,54,42,0,0,0
2021-05-21 10:30,93,54,39,0,0,0
2021-05-21 10:45,97,64,33,0,0,0
2021-05-21 11:00,73,41,32,0,0,0
2021-05-21 11:15,107,50,57,0,0,0
2021-05-21 11:30,105,59,46,0,0,0
2021-05-21 11:45,117,69,48,0,0,0
2021-05-21 12:00,109,72,37,0,0,0
2021-05-21 12:15,111,65,46,0,0,0
2021-05-21 12:30,124,73,51,0,0,0
2021-05-21 12:45,132,78,54,0,0,0
2021-05-21 13:00,122,56,66,0,0,0
2021-05-21 13:15,140,72,68,0,0,0
2021-05-21 13:30,125,60,65,0,0,0
2021-05-21 13:45,140,69,71,0,0,0
2021-05-21 14:00,130,68,62,0,0,0
2021-05-21 14:15,127,60,67,0,0,0
2021-05-21 14:30,136,72,64,0,0,0
2021-05-21 14:45,150,90,60,0,0,0
2021-05-21 15:00,151,97,54,0,0,0
2021-05-21 15:15,144,82,62,0,0,0
2021-05-21 15:30,114,59,55,0,0,0
2021-05-21 15:45,159,90,69,0,0,0
2021-05-21 16:00,127,64,63,0,0,0
2021-05-21 16:15,139,77,62,0,0,0
2021-05-21 16:30,138,75,63,0,0,0
2021-05-21 16:45,131,75,56,0,0,0
2021-05-21 17:00,133,56,77,0,0,0
2021-05-21 17:15,91,49,42,0,0,0
2021-05-21 17:30,122,67,55,0,0,0
2021-05-21 17:45,115,58,57,0,0,0
2021-05-21 18:00,99,44,55,0,0,0
2021-05-21 18:15,89,44,45,0,0,0
2021-05-21 18:30,111,58,53,0,0,0
2021-05-21 18:45,125,68,57,0,0,0
2021-05-21 19:00,104,56,48,0,0,0
2021-05-21 19:15,98,45,53,0,0,0
2021-05-21 19:30,91,47,44,0,0,0
2021-05-21 19:45,80,47,33,0,0,0
2021-05-21 20:00,62,38,24,0,0,0
2021-05-21 20:15,57,37,20,0,0,0
2021-05-21 20:30,38,20,18,0,0,0
2021-05-21 20:45,41,19,22,0,0,0
2021-05-21 21:00,33,21,12,0,0,0
2021-05-21 21:15,38,18,20,0,0,0
2021-05-21 21:30,22,9,13,0,0,0
2021-05-21 21:45,30,11,19,0,0,0
2021-05-21 22:00,43,23,20,0,0,0
2021-05-21 22:15,32,24,8,0,0,0
2021-05-21 22:30,26,12,14,0,0,0
2021-05-21 22:45,23,4,19,0,0,0
2021-05-21 23:00,38,13,25,0,0,0
2021-05-21 23:15,29,14,15,0,0,0
2021-05-21 23:30,26,12,14,0,0,0
2021-05-21 23:45,19,11,8,0,0,0
2021-05-22 00:00,19,7,12,0,0,0
2021-05-22 00:15,18,5,13,0,0,0
2021-05-22 00:30,15,5,10,0,0,0
2021-05-22 00:45,23,9,14,0,0,0
2021-05-22 01:00,12,4,8,0,0,0
2021-05-22 01:15,21,8,13,0,0,0
2021-05-22 01:30,23,13,10,0,0,0
2021-05-22 01:45,19,11,8,0,0,0
2021-05-22 02:00,9,2,7,0,0,0
2021-05-22 02:15,16,6,10,0,0,0
2021-05-22 02:30,8,2,6,0,0,0
2021-05-22 02:45,6,2,4,0,0,0
2021-05-22 03:00,13,6,7,0,0,0
2021-05-22 03:15,6,0,6,0,0,0
2021-05-22 03:30,6,1,5,0,0,0
2021-05-22 03:45,10,1,9,0,0,0
2021-05-22 04:00,1,1,0,0,0,0
2021-05-22 04:15,5,3,2,0,0,0
2021-05-22 04:30,6,1,5,0,0,0
2021-05-22 04:45,2,2,0,0,0,0
2021-05-22 05:00,2,2,0,0,0,0
2021-05-22 05:15,3,2,1,0,0,0
2021-05-22 05:30,11,8,3,0,0,0
2021-05-22 05:45,6,3,3,0,0,0
2021-05-22 06:00,9,4,5,0,0,0
2021-05-22 06:15,7,2,5,0,0,0
2021-05-22 06:30,15,10,5,0,0,0
2021-05-22 06:45,25,17,8,0,0,0
2021-05-22 07:00,15,9,6,0,0,0
2021-05-22 07:15,28,19,9,0,0,0
2021-05-22 07:30,35,26,9,0,0,0
2021-05-22 07:45,37,27,10,0,0,0
2021-05-22 08:00,36,30,6,0,0,0
2021-05-22 08:15,58,37,21,0,0,0
2021-05-22 08:30,41,25,16,0,0,0
2021-05-22 08:45,57,34,23,0,0,0
2021-05-22 09:00,50,35,15,0,0,0
2021-05-22 09:15,78,49,29,0,0,0
2021-05-22 09:30,50,38,12,0,0,0
2021-05-22 09:45,72,47,25,0,0,0
2021-05-22 10:00,67,43,24,0,0,0
2021-05-22 10:15,58,32,26,0,0,0
2021-05-22 10:30,77,49,28,0,0,0
2021-05-22 10:45,76,52,24,0,0,0
2021-05-22 11:00,67,48,19,0,0,0
2021-05-22 11:15,68,40,28,0,0,0
2021-05-22 11:30,75,48,27,0,0,0
2021-05-22 11:45,71,42,29,0,0,0
2021-05-22 12:00,78,53,25,0,0,0
2021-05-22 12:15,101,55,46,0,0,0
2021-05-22 12:30,108,59,49,0,0,0
2021-05-22 12:45,77,33,44,0,0,0
2021-05-22 13:00,58,28,30,0,0,0
2021-05-22 13:15,79,51,28,0,0,0
2021-05-22 13:30,70,44,26,0,0,0
2021-05-22 13:45,87,48,39,0,0,0
2021-05-22 14:00,66,37,29,0,0,0
2021-05-22 14:15,83,43,40,0,0,0
2021-05-22 14:30,83,49,34,0,0,0
2021-05-22 14:45,72,29,43,0,0,0
2021-05-22 15:00,56,20,36,0,0,0
2021-05-22 15:15,61,31,30,0,0,0
2021-05-22 15:30,51,21,30,0,0,0
2021-05-22 15:45,42,22,20,0,0,0
2021-05-22 16:00,38,16,22,0,0,0
2021-05-22 16:15,50,23,27,0,0,0
2021-05-22 16:30,42,23,19,0,0,0
2021-05-22 16:45,37,24,13,0,0,0
2021-05-22 17:00,28,22,6,0,0,0
2021-05-22 17:15,41,19,22,0,0,0
2021-05-22 17:30,45,21,24,0,0,0
2021-05-22 17:45,66,39,27,0,0,0
2021-05-22 18:00,63,36,27,0,0,0
2021-05-22 18:15,43,28,15,0,0,0
2021-05-22 18:30,55,33,22,0,0,0
2021-05-22 18:45,53,32,21,0,0,0
2021-05-22 19:00,37,19,18,0,0,0
2021-05-22 19:15,52,23,29,0,0,0
2021-05-22 19:30,36,20,16,0,0,0
2021-05-22 19:45,46,28,18,0,0,0
2021-05-22 20:00,31,18,13,0,0,0
2021-05-22 20:15,45,29,16,0,0,0
2021-05-22 20:30,29,19,10,0,0,0
2021-05-22 20:45,19,9,10,0,0,0
2021-05-22 21:00,24,15,9,0,0,0
2021-05-22 21:15,23,10,13,0,0,0
2021-05-22 21:30,16,6,10,0,0,0
2021-05-22 21:45,11,6,5,0,0,0
2021-05-22 22:00,17,8,9,0,0,0
2021-05-22 22:15,4,1,3,0,0,0
2021-05-22 22:30,11,5,6,0,0,0
2021-05-22 22:45,26,10,16,0,0,0
2021-05-22 23:00,25,14,11,0,0,0
2021-05-22 23:15,13,8,5,0,0,0
2021-05-22 23:30,22,7,15,0,0,0
2021-05-22 23:45,19,10,9,0,0,0
2021-05-23 00:00,16,13,3,0,0,0
2021-05-23 00:15,16,11,5,0,0,0
2021-05-23 00:30,11,7,4,0,0,0
2021-05-23 00:45,14,7,7,0,0,0
2021-05-23 01:00,15,12,3,0,0,0
2021-05-23 01:15,17,6,11,0,0,0
2021-05-23 01:30,3,1,2,0,0,0
2021-05-23 01:45,10,7,3,0,0,0
2021-05-23 02:00,7,4,3,0,0,0
2021-05-23 02:15,6,2,4,0,0,0
2021-05-23 02:30,10,9,1,0,0,0
2021-05-23 02:45,3,3,0,0,0,0
2021-05-23 03:00,8,4,4,0,0,0
2021-05-23 03:15,6,2,4,0,0,0
2021-05-23 03:30,4,1,3,0,0,0
2021-05-23 03:45,6,3,3,0,0,0
2021-05-23 04:00,8,4,4,0,0,0
2021-05-23 04:15,7,3,4,0,0,0
2021-05-23 04:30,4,4,0,0,0,0
2021-05-23 04:45,1,1,0,0,0,0
2021-05-23 05:00,2,1,1,0,0,0
2021-05-23 05:15,5,1,4,0,0,0
2021-05-23 05:30,8,6,2,0,0,0
2021-05-23 05:45,10,3,7,0,0,0
2021-05-23 06:00,7,4,3,0,0,0
2021-05-23 06:15,7,3,4,0,0,0
2021-05-23 06:30,5,2,3,0,0,0
2021-05-23 06:45,6,3,3,0,0,0
2021-05-23 07:00,5,1,4,0,0,0
2021-05-23 07:15,4,4,0,0,0,0
2021-05-23 07:30,4,3,1,0,0,0
2021-05-23 07:45,2,1,1,0,0,0
2021-05-23 08:00,2,0,2,0,0,0
2021-05-23 08:15,2,0,2,0,0,0
2021-05-23 08:30,4,4,0,0,0,0
2021-05-23 08:45,10,2,8,0,0,0
2021-05-23 09:00,10,8,2,0,0,0
2021-05-23 09:15,13,6,7,0,0,0
2021-05-23 09:30,18,11,7,0,0,0
2021-05-23 09:45,15,14,1,0,0,0
2021-05-23 10:00,12,7,5,0,0,0
2021-05-23 10:15,31,19,12,0,0,0
2021-05-23 10:30,19,12,7,0,0,0
2021-05-23 10:45,16,6,10,0,0,0
2021-05-23 11:00,25,20,5,0,0,0
2021-05-23 11:15,25,14,11,0,0,0
2021-05-23 11:30,24,16,8,0,0,0
2021-05-23 11:45,40,25,15,0,0,0
2021-05-23 12:00,36,24,12,0,0,0
2021-05-23 12:15,55,46,9,0,0,0
2021-05-23 12:30,32,20,12,0,0,0
2021-05-23 12:45,57,36,21,0,0,0
2021-05-23 13:00,43,24,19,0,0,0
2021-05-23 13:15,60,33,27,0,0,0
2021-05-23 13:30,65,41,24,0,0,0
2021-05-23 13:45,69,44,25,0,0,0
2021-05-23 14:00,86,61,25,0,0,0
2021-05-23 14:15,67,38,29,0,0,0
2021-05-23 14:30,80,51,29,0,0,0
2021-05-23 14:45,93,58,35,0,0,0
2021-05-23 15:00,99,65,34,0,0,0
2021-05-23 15:15,91,56,35,0,0,0
2021-05-23 15:30,83,66,17,0,0,0
2021-05-23 15:45,82,46,36,0,0,0
2021-05-23 16:00,76,44,32,0,0,0
2021-05-23 16:15,74,52,22,0,0,0
2021-05-23 16:30,74,49,25,0,0,0
2021-05-23 16:45,85,54,31,0,0,0
2021-05-23 17:00,66,31,35,0,0,0
2021-05-23 17:15,99,57,42,0,0,0
2021-05-23 17:30,95,48,47,0,0,0
2021-05-23 17:45,81,53,28,0,0,0
2021-05-23 18:00,49,28,21,0,0,0
2021-05-23 18:15,64,24,40,0,0,0
2021-05-23 18:30,54,36,18,0,0,0
2021-05-23 18:45,79,50,29,0,0,0
2021-05-23 19:00,64,37,27,0,0,0
2021-05-23 19:15,58,34,24,0,0,0
2021-05-23 19:30,57,35,22,0,0,0
2021-05-23 19:45,58,32,26,0,0,0
2021-05-23 20:00,47,26,21,0,0,0
2021-05-23 20:15,41,30,11,0,0,0
2021-05-23 20:30,34,20,14,0,0,0
2021-05-23 20:45,35,20,15,0,0,0
2021-05-23 21:00,22,16,6,0,0,0
2021-05-23 21:15,29,13,16,0,0,0
2021-05-23 21:30,32,8,24,0,0,0
2021-05-23 21:45,24,10,14,0,0,0
2021-05-23 22:00,17,7,10,0,0,0
2021-05-23 22:15,20,9,11,0,0,0
2021-05-23 22:30,9,2,7,0,0,0
2021-05-23 22:45,17,8,9,0,0,0
2021-05-23 23:00,14,7,7,0,0,0
2021-05-23 23:15,15,5,10,0,0,0
2021-05-23 23:30,23,15,8,0,0,0
2021-05-23 23:45,23,7,16,0,0,0
2021-05-24 00:00,8,5,3,0,0,0
2021-05-24 00:15,12,3,9,0,0,0
2021-05-24 00:30,28,19,9,0,0,0
2021-05-24 00:45,24,9,15,0,0,0
2021-05-24 01:00,16,9,7,0,0,0
2021-05-24 01:15,12,5,7,0,0,0
2021-05-24 01:30,2,2,0,0,0,0
2021-05-24 01:45,3,0,3,0,0,0
2021-05-24 02:00,3,0,3,0,0,0
2021-05-24 02:15,0,0,0,0,0,0
2021-05-24 02:30,5,2,3,0,0,0
2021-05-24 02:45,2,2,0,0,0,0
2021-05-24 03:00,5,2,3,0,0,0
2021-05-24 03:15,2,0,2,0,0,0
2021-05-24 03:30,10,7,3,0,0,0
2021-05-24 03:45,1,0,1,0,0,0
2021-05-24 04:00,0,0,0,0,0,0
2021-05-24 04:15,2,1,1,0,0,0
2021-05-24 04:30,3,2,1,0,0,0
2021-05-24 04:45,0,0,0,0,0,0
2021-05-24 05:00,1,1,0,0,0,0
2021-05-24 05:15,1,1,0,0,0,0
2021-05-24 05:30,7,5,2,0,0,0
2021-05-24 05:45,2,0,2,0,0,0
2021-05-24 06:00,6,4,2,0,0,0
2021-05-24 06:15,4,1,3,0,0,0
2021-05-24 06:30,2,1,1,0,0,0
2021-05-24 06:45,5,3,2,0,0,0
2021-05-24 07:00,4,2,2,0,0,0
2021-05-24 07:15,9,7,2,0,0,0
2021-05-24 07:30,7,4,3,0,0,0
2021-05-24 07:45,18,14,4,0,0,0
2021-05-24 08:00,12,8,4,0,0,0
2021-05-24 08:15,12,6,6,0,0,0
2021-05-24 08:30,11,7,4,0,0,0
2021-05-24 08:45,32,15,17,0,0,0
2021-05-24 09:00,22,14,8,0,0,0
2021-05-24 09:15,43,26,17,0,0,0
2021-05-24 09:30,40,25,15,0,0,0
2021-05-24 09:45,51,35,16,0,0,0
2021-05-24 10:00,41,28,13,0,0,0
2021-05-24 10:15,51,30,21,0,0,0
2021-05-24 10:30,48,32,16,0,0,0
2021-05-24 10:45,64,40,24,0,0,0
2021-05-24 11:00,60,41,19,0,0,0
2021-05-24 11:15,74,43,31,0,0,0
2021-05-24 11:30,75,49,26,0,0,0
2021-05-24 11:45,60,41,19,0,0,0
2021-05-24 12:00,69,38,31,0,0,0
2021-05-24 12:15,56,31,25,0,0,0
2021-05-24 12:30,62,25,37,0,0,0
2021-05-24 12:45,55,29,26,0,0,0
2021-05-24 13:00,57,31,26,0,0,0
2021-05-24 13:15,62,32,30,0,0,0
2021-05-24 13:30,55,24,31,0,0,0
2021-05-24 13:45,72,44,28,0,0,0
2021-05-24 14:00,58,35,23,0,0,0
2021-05-24 14:15,53,42,11,0,0,0
2021-05-24 14:30,49,27,22,0,0,0
2021-05-24 14:45,44,27,17,0,0,0
2021-05-24 15:00,56,41,15,0,0,0
2021-05-24 15:15,35,13,22,0,0,0
2021-05-24 15:30,33,20,13,0,0,0
2021-05-24 15:45,40,24,16,0,0,0
2021-05-24 16:00,28,16,12,0,0,0
2021-05-24 16:15,45,27,18,0,0,0
2021-05-24 16:30,39,26,13,0,0,0
2021-05-24 16:45,64,41,23,0,0,0
2021-05-24 17:00,64,46,18,0,0,0
2021-05-24 17:15,58,33,25,0,0,0
2021-05-24 17:30,34,16,18,0,0,0
2021-05-24 17:45,58,35,23,0,0,0
2021-05-24 18:00,46,28,18,0,0,0
2021-05-24 18:15,27,14,13,0,0,0
2021-05-24 18:30,53,39,14,0,0,0
2021-05-24 18:45,49,20,29,0,0,0
2021-05-24 19:00,43,18,25,0,0,0
2021-05-24 19:15,27,14,13,0,0,0
2021-05-24 19:30,40,19,21,0,0,0
2021-05-24 19:45,42,19,23,0,0,0
2021-05-24 20:00,22,12,10,0,0,0
2021-05-24 20:15,35,19,16,0,0,0
2021-05-24 20:30,21,13,8,0,0,0
2021-05-24 20:45,41,22,19,0,0,0
2021-05-24 21:00,22,10,12,0,0,0
2021-05-24 21:15,27,16,11,0,0,0
2021-05-24 21:30,32,19,13,0,0,0
2021-05-24 21:45,23,13,10,0,0,0
2021-05-24 22:00,14,9,5,0,0,0
2021-05-24 22:15,11,5,6,0,0,0
2021-05-24 22:30,9,3,6,0,0,0
2021-05-24 22:45,13,8,5,0,0,0
2021-05-24 23:00,12,8,4,0,0,0
2021-05-24 23:15,15,8,7,0,0,0
2021-05-24 23:30,14,9,5,0,0,0
2021-05-24 23:45,5,2,3,0,0,0
2021-05-25 00:00,8,7,1,0,0,0
2021-05-25 00:15,5,3,2,0,0,0
2021-05-25 00:30,7,3,4,0,0,0
2021-05-25 00:45,5,3,2,0,0,0
2021-05-25 01:00,5,2,3,0,0,0
2021-05-25 01:15,4,3,1,0,0,0
2021-05-25 01:30,1,0,1,0,0,0
2021-05-25 01:45,2,0,2,0,0,0
2021-05-25 02:00,0,0,0,0,0,0
2021-05-25 02:15,2,2,0,0,0,0
2021-05-25 02:30,3,2,1,0,0,0
2021-05-25 02:45,0,0,0,0,0,0
2021-05-25 03:00,4,3,1,0,0,0
2021-05-25 03:15,5,3,2,0,0,0
2021-05-25 03:30,0,0,0,0,0,0
2021-05-25 03:45,1,0,1,0,0,0
2021-05-25 04:00,0,0,0,0,0,0
2021-05-25 04:15,2,1,1,0,0,0
2021-05-25 04:30,1,1,0,0,0,0
2021-05-25 04:45,2,0,2,0,0,0
2021-05-25 05:00,3,2,1,0,0,0
2021-05-25 05:15,5,3,2,0,0,0
2021-05-25 05:30,14,5,9,0,0,0
2021-05-25 05:45,10,8,2,0,0,0
2021-05-25 06:00,14,8,6,0,0,0
2021-05-25 06:15,26,15,11,0,0,0
2021-05-25 06:30,36,28,8,0,0,0
2021-05-25 06:45,55,42,13,0,0,0
2021-05-25 07:00,69,40,29,0,0,0
2021-05-25 07:15,72,40,32,0,0,0
2021-05-25 07:30,85,62,23,0,0,0
2021-05-25 07:45,120,78,42,0,0,0
2021-05-25 08:00,100,79,21,0,0,0
2021-05-25 08:15,113,76,37,0,0,0
2021-05-25 08:30,98,72,26,0,0,0
2021-05-25 08:45,106,77,29,0,0,0
2021-05-25 09:00,84,51,33,0,0,0
2021-05-25 09:15,49,34,15,0,0,0
2021-05-25 09:30,90,60,30,0,0,0
2021-05-25 09:45,76,54,22,0,0,0
2021-05-25 10:00,47,35,12,0,0,0
2021-05-25 10:15,66,43,23,0,0,0
2021-05-25 10:30,80,56,24,0,0,0
2021-05-25 10:45,100,69,31,0,0,0
2021-05-25 11:00,74,53,21,0,0,0
2021-05-25 11:15,74,40,34,0,0,0
2021-05-25 11:30,96,60,36,0,0,0
2021-05-25 11:45,89,50,39,0,0,0
2021-05-25 12:00,83,49,34,0,0,0
2021-05-25 12:15,86,54,32,0,0,0
2021-05-25 12:30,98,53,45,0,0,0
2021-05-25 12:45,95,50,45,0,0,0
2021-05-25 13:00,75,26,49,0,0,0
2021-05-25 13:15,98,53,45,0,0,0
2021-05-25 13:30,77,33,44,0,0,0
2021-05-25 13:45,53,28,25,0,0,0
2021-05-25 14:00,73,39,34,0,0,0
2021-05-25 14:15,84,46,38,0,0,0
2021-05-25 14:30,87,47,40,0,0,0
2021-05-25 14:45,90,54,36,0,0,0
2021-05-25 15:00,71,35,36,0,0,0
2021-05-25 15:15,96,64,32,0,0,0
2021-05-25 15:30,106,65,41,0,0,0
2021-05-25 15:45,74,48,26,0,0,0
2021-05-25 16:00,85,48,37,0,0,0
2021-05-25 16:15,109,50,59,0,0,0
2021-05-25 16:30,87,38,49,0,0,0
2021-05-25 16:45,117,54,63,0,0,0
2021-05-25 17:00,126,64,62,0,0,0
2021-05-25 17:15,116,56,60,0,0,0
2021-05-25 17:30,91,42,49,0,0,0
2021-05-25 17:45,95,38,57,0,0,0
2021-05-25 18:00,67,24,43,0,0,0
2021-05-25 18:15,74,34,40,0,0,0
2021-05-25 18:30,81,44,37,0,0,0
2021-05-25 18:45,95,46,49,0,0,0
2021-05-25 19:00,59,18,41,0,0,0
2021-05-25 19:15,54,30,24,0,0,0
2021-05-25 19:30,47,21,26,0,0,0
2021-05-25 19:45,57,35,22,0,0,0
2021-05-25 20:00,36,23,13,0,0,0
2021-05-25 20:15,28,11,17,0,0,0
2021-05-25 20:30,30,14,16,0,0,0
2021-05-25 20:45,25,18,7,0,0,0
2021-05-25 21:00,29,9,20,0,0,0
2021-05-25 21:15,16,10,6,0,0,0
2021-05-25 21:30,17,5,12,0,0,0
2021-05-25 21:45,17,10,7,0,0,0
2021-05-25 22:00,21,6,15,0,0,0
2021-05-25 22:15,15,4,11,0,0,0
2021-05-25 22:30,10,3,7,0,0,0
2021-05-25 22:45,19,13,6,0,0,0
2021-05-25 23:00,10,2,8,0,0,0
2021-05-25 23:15,11,6,5,0,0,0
2021-05-25 23:30,10,3,7,0,0,0
2021-05-25 23:45,3,3,0,0,0,0
2021-05-26 00:00,6,2,4,0,0,0
2021-05-26 00:15,5,3,2,0,0,0
2021-05-26 00:30,3,2,1,0,0,0
2021-05-26 00:45,3,2,1,0,0,0
2021-05-26 01:00,2,1,1,0,0,0
2021-05-26 01:15,2,0,2,0,0,0
2021-05-26 01:30,2,1,1,0,0,0
2021-05-26 01:45,4,2,2,0,0,0
2021-05-26 02:00,1,0,1,0,0,0
2021-05-26 02:15,1,0,1,0,0,0
2021-05-26 02:30,3,2,1,0,0,0
2021-05-26 02:45,2,2,0,0,0,0
2021-05-26 03:00,0,0,0,0,0,0
2021-05-26 03:15,2,1,1,0,0,0
2021-05-26 03:30,0,0,0,0,0,0
2021-05-26 03:45,0,0,0,0,0,0
2021-05-26 04:00,1,1,0,0,0,0
2021-05-26 04:15,4,3,1,0,0,0
2021-05-26 04:30,2,2,0,0,0,0
2021-05-26 04:45,1,0,1,0,0,0
2021-05-26 05:00,2,2,0,0,0,0
2021-05-26 05:15,1,1,0,0,0,0
2021-05-26 05:30,11,8,3,0,0,0
2021-05-26 05:45,20,11,9,0,0,0
2021-05-26 06:00,20,12,8,0,0,0
2021-05-26 06:15,26,18,8,0,0,0
2021-05-26 06:30,32,20,12,0,0,0
2021-05-26 06:45,53,39,14,0,0,0
2021-05-26 07:00,82,56,26,0,0,0
2021-05-26 07:15,93,60,33,0,0,0
2021-05-26 07:30,134,91,43,0,0,0
2021-05-26 07:45,218,160,58,0,0,0
2021-05-26 08:00,137,109,28,0,0,0
2021-05-26 08:15,129,101,28,0,0,0
2021-05-26 08:30,137,100,37,0,0,0
2021-05-26 08:45,139,102,37,0,0,0
2021-05-26 09:00,111,71,40,0,0,0
2021-05-26 09:15,113,82,31,0,0,0
2021-05-26 09:30,105,79,26,0,0,0
2021-05-26 09:45,112,80,32,0,0,0
2021-05-26 10:00,105,68,37,0,0,0
2021-05-26 10:15,136,94,42,0,0,0
2021-05-26 10:30,104,71,33,0,0,0
2021-05-26 10:45,113,72,41,0,0,0
2021-05-26 11:00,125,76,49,0,0,0
2021-05-26 11:15,114,71,43,0,0,0
2021-05-26 11:30,117,58,59,0,0,0
2021-05-26 11:45,121,66,55,0,0,0
2021-05-26 12:00,142,75,67,0,0,0
2021-05-26 12:15,104,56,48,0,0,0
2021-05-26 12:30,113,57,56,0,0,0
2021-05-26 12:45,111,55,56,0,0,0
2021-05-26 13:00,139,73,66,0,0,0
2021-05-26 13:15,131,70,61,0,0,0
2021-05-26 13:30,129,59,70,0,0,0
2021-05-26 13:45,111,58,53,0,0,0
2021-05-26 14:00,94,52,42,0,0,0
2021-05-26 14:15,128,61,67,0,0,0
2021-05-26 14:30,141,56,85,0,0,0
2021-05-26 14:45,144,82,62,0,0,0
2021-05-26 15:00,99,47,52,0,0,0
2021-05-26 15:15,107,62,45,0,0,0
2021-05-26 15:30,122,55,67,0,0,0
2021-05-26 15:45,126,66,60,0,0,0
2021-05-26 16:00,139,61,78,0,0,0
2021-05-26 16:15,102,47,55,0,0,0
2021-05-26 16:30,137,75,62,0,0,0
2021-05-26 16:45,136,86,50,0,0,0
2021-05-26 17:00,136,67,69,0,0,0
2021-05-26 17:15,133,74,59,0,0,0
2021-05-26 17:30,119,53,66,0,0,0
2021-05-26 17:45,134,59,75,0,0,0
2021-05-26 18:00,127,52,75,0,0,0
2021-05-26 18:15,120,62,58,0,0,0
2021-05-26 18:30,96,55,41,0,0,0
2021-05-26 18:45,113,64,49,0,0,0
2021-05-26 19:00,103,57,46,0,0,0
2021-05-26 19:15,95,44,51,0,0,0
2021-05-26 19:30,68,39,29,0,0,0
2021-05-26 19:45,79,49,30,0,0,0
2021-05-26 20:00,55,30,25,0,0,0
2021-05-26 20:15,50,26,24,0,0,0
2021-05-26 20:30,34,21,13,0,0,0
2021-05-26 20:45,44,24,20,0,0,0
2021-05-26 21:00,28,18,10,0,0,0
2021-05-26 21:15,29,22,7,0,0,0
2021-05-26 21:30,30,17,13,0,0,0
2021-05-26 21:45,23,12,11,0,0,0
2021-05-26 22:00,24,10,14,0,0,0
2021-05-26 22:15,18,7,11,0,0,0
2021-05-26 22:30,31,17,14,0,0,0
2021-05-26 22:45,24,6,18,0,0,0
2021-05-26 23:00,21,4,17,0,0,0
2021-05-26 23:15,21,8,13,0,0,0
2021-05-26 23:30,15,6,9,0,0,0
2021-05-26 23:45,7,1,6,0,0,0
2021-05-27 00:00,18,7,11,0,0,0
2021-05-27 00:15,11,7,4,0,0,0
2021-05-27 00:30,6,3,3,0,0,0
2021-05-27 00:45,7,4,3,0,0,0
2021-05-27 01:00,6,4,2,0,0,0
2021-05-27 01:15,5,2,3,0,0,0
2021-05-27 01:30,7,2,5,0,0,0
2021-05-27 01:45,5,2,3,0,0,0
2021-05-27 02:00,6,2,4,0,0,0
2021-05-27 02:15,2,1,1,0,0,0
2021-05-27 02:30,4,0,4,0,0,0
2021-05-27 02:45,1,0,1,0,0,0
2021-05-27 03:00,1,0,1,0,0,0
2021-05-27 03:15,1,1,0,0,0,0
2021-05-27 03:30,1,0,1,0,0,0
2021-05-27 03:45,0,0,0,0,0,0
2021-05-27 04:00,0,0,0,0,0,0
2021-05-27 04:15,5,2,3,0,0,0
2021-05-27 04:30,5,2,3,0,0,0
2021-05-27 04:45,1,0,1,0,0,0
2021-05-27 05:00,2,1,1,0,0,0
2021-05-27 05:15,2,0,2,0,0,0
2021-05-27 05:30,14,10,4,0,0,0
2021-05-27 05:45,10,4,6,0,0,0
2021-05-27 06:00,14,4,10,0,0,0
2021-05-27 06:15,19,14,5,0,0,0
2021-05-27 06:30,34,19,15,0,0,0
2021-05-27 06:45,50,34,16,0,0,0
2021-05-27 07:00,79,51,28,0,0,0
2021-05-27 07:15,96,60,36,0,0,0
2021-05-27 07:30,136,83,53,0,0,0
2021-05-27 07:45,180,146,34,0,0,0
2021-05-27 08:00,162,130,32,0,0,0
2021-05-27 08:15,115,81,34,0,0,0
2021-05-27 08:30,99,78,21,0,0,0
2021-05-27 08:45,130,98,32,0,0,0
2021-05-27 09:00,85,57,28,0,0,0
2021-05-27 09:15,75,52,23,0,0,0
2021-05-27 09:30,76,49,27,0,0,0
2021-05-27 09:45,80,56,24,0,0,0
2021-05-27 10:00,66,44,22,0,0,0
2021-05-27 10:15,57,44,13,0,0,0
2021-05-27 10:30,65,49,16,0,0,0
2021-05-27 10:45,85,58,27,0,0,0
2021-05-27 11:00,59,37,22,0,0,0
2021-05-27 11:15,76,43,33,0,0,0
2021-05-27 11:30,76,47,29,0,0,0
2021-05-27 11:45,88,48,40,0,0,0
2021-05-27 12:00,65,35,30,0,0,0
2021-05-27 12:15,72,28,44,0,0,0
2021-05-27 12:30,78,45,33,0,0,0
2021-05-27 12:45,93,52,41,0,0,0
2021-05-27 13:00,104,48,56,0,0,0
2021-05-27 13:15,101,41,60,0,0,0
2021-05-27 13:30,78,43,35,0,0,0
2021-05-27 13:45,107,58,49,0,0,0
2021-05-27 14:00,87,50,37,0,0,0
2021-05-27 14:15,85,47,38,0,0,0
2021-05-27 14:30,94,37,57,0,0,0
2021-05-27 14:45,114,66,48,0,0,0
2021-05-27 15:00,101,56,45,0,0,0
2021-05-27 15:15,96,51,45,0,0,0
2021-05-27 15:30,107,58,49,0,0,0
2021-05-27 15:45,123,58,65,0,0,0
2021-05-27 16:00,105,54,51,0,0,0
2021-05-27 16:15,117,69,48,0,0,0
2021-05-27 16:30,105,53,52,0,0,0
2021-05-27 16:45,140,79,61,0,0,0
2021-05-27 17:00,122,57,65,0,0,0
2021-05-27 17:15,140,68,72,0,0,0
2021-05-27 17:30,107,55,52,0,0,0
2021-05-27 17:45,130,66,64,0,0,0
2021-05-27 18:00,102,47,55,0,0,0
2021-05-27 18:15,99,43,56,0,0,0
2021-05-27 18:30,79,36,43,0,0,0
2021-05-27 18:45,86,38,48,0,0,0
2021-05-27 19:00,74,31,43,0,0,0
2021-05-27 19:15,83,35,48,0,0,0
2021-05-27 19:30,69,30,39,0,0,0
2021-05-27 19:45,54,29,25,0,0,0
2021-05-27 20:00,46,18,28,0,0,0
2021-05-27 20:15,36,15,21,0,0,0
2021-05-27 20:30,28,16,12,0,0,0
2021-05-27 20:45,28,17,11,0,0,0
2021-05-27 21:00,32,11,21,0,0,0
2021-05-27 21:15,28,13,15,0,0,0
2021-05-27 21:30,29,18,11,0,0,0
2021-05-27 21:45,27,13,14,0,0,0
2021-05-27 22:00,39,20,19,0,0,0
2021-05-27 22:15,28,10,18,0,0,0
2021-05-27 22:30,19,9,10,0,0,0
2021-05-27 22:45,27,16,11,0,0,0
2021-05-27 23:00,23,16,7,0,0,0
2021-05-27 23:15,21,13,8,0,0,0
2021-05-27 23:30,10,3,7,0,0,0
2021-05-27 23:45,14,6,8,0,0,0
2021-05-28 00:00,14,10,4,0,0,0
2021-05-28 00:15,8,6,2,0,0,0
2021-05-28 00:30,10,3,7,0,0,0
2021-05-28 00:45,14,8,6,0,0,0
2021-05-28 01:00,6,4,2,0,0,0
2021-05-28 01:15,6,4,2,0,0,0
2021-05-28 01:30,5,2,3,0,0,0
2021-05-28 01:45,1,1,0,0,0,0
2021-05-28 02:00,4,3,1,0,0,0
2021-05-28 02:15,1,1,0,0,0,0
2021-05-28 02:30,0,0,0,0,0,0
2021-05-28 02:45,1,0,1,0,0,0
2021-05-28 03:00,1,1,0,0,0,0
2021-05-28 03:15,1,1,0,0,0,0
2021-05-28 03:30,1,0,1,0,0,0
2021-05-28 03:45,1,1,0,0,0,0
2021-05-28 04:00,1,0,1,0,0,0
2021-05-28 04:15,3,2,1,0,0,0
2021-05-28 04:30,2,0,2,0,0,0
2021-05-28 04:45,3,2,1,0,0,0
2021-05-28 05:00,0,0,0,0,0,0
2021-05-28 05:15,3,2,1,0,0,0
2021-05-28 05:30,11,6,5,0,0,0
2021-05-28 05:45,15,8,7,0,0,0
2021-05-28 06:00,11,9,2,0,0,0
2021-05-28 06:15,26,15,11,0,0,0
2021-05-28 06:30,36,25,11,0,0,0
2021-05-28 06:45,67,48,19,0,0,0
2021-05-28 07:00,70,49,21,0,0,0
2021-05-28 07:15,98,67,31,0,0,0
2021-05-28 07:30,121,82,39,0,0,0
2021-05-28 07:45,171,126,45,0,0,0
2021-05-28 08:00,156,133,23,0,0,0
2021-05-28 08:15,112,87,25,0,0,0
2021-05-28 08:30,108,78,30,0,0,0
2021-05-28 08:45,125,83,42,0,0,0
2021-05-28 09:00,68,46,22,0,0,0
2021-05-28 09:15,103,64,39,0,0,0
2021-05-28 09:30,107,79,28,0,0,0
2021-05-28 09:45,116,86,30,0,0,0
2021-05-28 10:00,96,60,36,0,0,0
2021-05-28 10:15,108,60,48,0,0,0
2021-05-28 10:30,108,68,40,0,0,0
2021-05-28 10:45,124,91,33,0,0,0
2021-05-28 11:00,111,69,42,0,0,0
2021-05-28 11:15,132,72,60,0,0,0
2021-05-28 11:30,119,74,45,0,0,0
2021-05-28 11:45,131,84,47,0,0,0
2021-05-28 12:00,130,75,55,0,0,0
2021-05-28 12:15,148,90,58,0,0,0
2021-05-28 12:30,134,72,62,0,0,0
2021-05-28 12:45,146,84,62,0,0,0
2021-05-28 13:00,143,73,70,0,0,0
2021-05-28 13:15,148,74,74,0,0,0
2021-05-28 13:30,159,84,75,0,0,0
2021-05-28 13:45,141,74,67,0,0,0
2021-05-28 14:00,146,90,56,0,0,0
2021-05-28 14:15,179,82,97,0,0,0
2021-05-28 14:30,166,92,74,0,0,0
2021-05-28 14:45,170,109,61,0,0,0
2021-05-28 15:00,153,73,80,0,0,0
2021-05-28 15:15,175,105,70,0,0,0
2021-05-28 15:30,185,106,79,0,0,0
2021-05-28 15:45,166,80,86,0,0,0
2021-05-28 16:00,133,74,59,0,0,0
2021-05-28 16:15,175,99,76,0,0,0
2021-05-28 16:30,170,98,72,0,0,0
2021-05-28 16:45,148,76,72,0,0,0
2021-05-28 17:00,127,65,62,0,0,0
2021-05-28 17:15,159,87,72,0,0,0
2021-05-28 17:30,145,85,60,0,0,0
2021-05-28 17:45,164,97,67,0,0,0
2021-05-28 18:00,151,71,80,0,0,0
2021-05-28 18:15,135,64,71,0,0,0
2021-05-28 18:30,128,58,70,0,0,0
2021-05-28 18:45,130,72,58,0,0,0
2021-05-28 19:00,124,57,67,0,0,0
2021-05-28 19:15,104,47,57,0,0,0
2021-05-28 19:30,93,52,41,0,0,0
2021-05-28 19:45,96,59,37,0,0,0
2021-05-28 20:00,74,36,38,0,0,0
2021-05-28 20:15,82,45,37,0,0,0
2021-05-28 20:30,60,39,21,0,0,0
2021-05-28 20:45,69,41,28,0,0,0
2021-05-28 21:00,49,16,33,0,0,0
2021-05-28 21:15,53,24,29,0,0,0
2021-05-28 21:30,49,33,16,0,0,0
2021-05-28 21:45,35,21,14,0,0,0
2021-05-28 22:00,38,21,17,0,0,0
2021-05-28 22:15,44,24,20,0,0,0
2021-05-28 22:30,37,22,15,0,0,0
2021-05-28 22:45,40,17,23,0,0,0
2021-05-28 23:00,19,5,14,0,0,0
2021-05-28 23:15,26,11,15,0,0,0
2021-05-28 23:30,15,6,9,0,0,0
2021-05-28 23:45,25,12,13,0,0,0
2021-05-29 00:00,27,12,15,0,0,0
2021-05-29 00:15,31,15,16,0,0,0
2021-05-29 00:30,31,10,21,0,0,0
2021-05-29 00:45,18,8,10,0,0,0
2021-05-29 01:00,29,16,13,0,0,0
2021-05-29 01:15,24,13,11,0,0,0
2021-05-29 01:30,13,6,7,0,0,0
2021-05-29 01:45,14,10,4,0,0,0
2021-05-29 02:00,10,2,8,0,0,0
2021-05-29 02:15,10,3,7,0,0,0
2021-05-29 02:30,16,9,7,0,0,0
2021-05-29 02:45,10,1,9,0,0,0
2021-05-29 03:00,16,2,14,0,0,0
2021-05-29 03:15,6,1,5,0,0,0
2021-05-29 03:30,15,6,9,0,0,0
2021-05-29 03:45,9,2,7,0,0,0
2021-05-29 04:00,6,2,4,0,0,0
2021-05-29 04:15,7,3,4,0,0,0
2021-05-29 04:30,8,3,5,0,0,0
2021-05-29 04:45,0,0,0,0,0,0
2021-05-29 05:00,2,2,0,0,0,0
2021-05-29 05:15,3,3,0,0,0,0
2021-05-29 05:30,12,11,1,0,0,0
2021-05-29 05:45,12,3,9,0,0,0
2021-05-29 06:00,6,4,2,0,0,0
2021-05-29 06:15,5,3,2,0,0,0
2021-05-29 06:30,13,10,3,0,0,0
2021-05-29 06:45,23,19,4,0,0,0
2021-05-29 07:00,17,14,3,0,0,0
2021-05-29 07:15,27,18,9,0,0,0
2021-05-29 07:30,48,33,15,0,0,0
2021-05-29 07:45,36,23,13,0,0,0
2021-05-29 08:00,61,38,23,0,0,0
2021-05-29 08:15,46,33,13,0,0,0
2021-05-29 08:30,56,36,20,0,0,0
2021-05-29 08:45,58,39,19,0,0,0
2021-05-29 09:00,74,57,17,0,0,0
2021-05-29 09:15,96,67,29,0,0,0
2021-05-29 09:30,104,72,32,0,0,0
2021-05-29 09:45,110,80,30,0,0,0
2021-05-29 10:00,123,88,35,0,0,0
2021-05-29 10:15,126,86,40,0,0,0
2021-05-29 10:30,150,105,45,0,0,0
2021-05-29 10:45,141,90,51,0,0,0
2021-05-29 11:00,142,89,53,0,0,0
2021-05-29 11:15,145,77,68,0,0,0
2021-05-29 11:30,128,82,46,0,0,0
2021-05-29 11:45,156,94,62,0,0,0
2021-05-29 12:00,148,99,49,0,0,0
2021-05-29 12:15,158,106,52,0,0,0
2021-05-29 12:30,185,111,74,0,0,0
2021-05-29 12:45,150,85,65,0,0,0
2021-05-29 13:00,183,117,66,0,0,0
2021-05-29 13:15,133,71,62,0,0,0
2021-05-29 13:30,133,81,52,0,0,0
2021-05-29 13:45,135,70,65,0,0,0
2021-05-29 14:00,151,78,73,0,0,0
2021-05-29 14:15,160,75,85,0,0,0
2021-05-29 14:30,129,51,78,0,0,0
2021-05-29 14:45,176,86,90,0,0,0
2021-05-29 15:00,176,88,88,0,0,0
2021-05-29 15:15,142,77,65,0,0,0
2021-05-29 15:30,136,76,60,0,0,0
2021-05-29 15:45,136,77,59,0,0,0
2021-05-29 16:00,136,73,63,0,0,0
2021-05-29 16:15,113,57,56,0,0,0
2021-05-29 16:30,122,66,56,0,0,0
2021-05-29 16:45,146,77,69,0,0,0
2021-05-29 17:00,131,83,48,0,0,0
2021-05-29 17:15,137,81,56,0,0,0
2021-05-29 17:30,126,75,51,0,0,0
2021-05-29 17:45,124,75,49,0,0,0
2021-05-29 18:00,132,80,52,0,0,0
2021-05-29 18:15,91,61,30,0,0,0
2021-05-29 18:30,109,65,44,0,0,0
2021-05-29 18:45,116,71,45,0,0,0
2021-05-29 19:00,127,81,46,0,0,0
2021-05-29 19:15,88,51,37,0,0,0
2021-05-29 19:30,86,45,41,0,0,0
2021-05-29 19:45,103,63,40,0,0,0
2021-05-29 20:00,94,60,34,0,0,0
2021-05-29 20:15,64,40,24,0,0,0
2021-05-29 20:30,77,41,36,0,0,0
2021-05-29 20:45,59,36,23,0,0,0
2021-05-29 21:00,48,27,21,0,0,0
2021-05-29 21:15,48,26,22,0,0,0
2021-05-29 21:30,35,20,15,0,0,0
2021-05-29 21:45,20,9,11,0,0,0
2021-05-29 22:00,34,15,19,0,0,0
2021-05-29 22:15,35,14,21,0,0,0
2021-05-29 22:30,63,47,16,0,0,0
2021-05-29 22:45,41,21,20,0,0,0
2021-05-29 23:00,48,21,27,0,0,0
2021-05-29 23:15,47,26,21,0,0,0
2021-05-29 23:30,27,19,8,0,0,0
2021-05-29 23:45,35,18,17,0,0,0
2021-05-30 00:00,47,26,21,0,0,0
2021-05-30 00:15,31,13,18,0,0,0
2021-05-30 00:30,19,9,10,0,0,0
2021-05-30 00:45,36,14,22,0,0,0
2021-05-30 01:00,34,10,24,0,0,0
2021-05-30 01:15,25,6,19,0,0,0
2021-05-30 01:30,11,5,6,0,0,0
2021-05-30 01:45,13,3,10,0,0,0
2021-05-30 02:00,31,18,13,0,0,0
2021-05-30 02:15,13,3,10,0,0,0
2021-05-30 02:30,13,3,10,0,0,0
2021-05-30 02:45,15,7,8,0,0,0
2021-05-30 03:00,4,3,1,0,0,0
2021-05-30 03:15,9,7,2,0,0,0
2021-05-30 03:30,11,1,10,0,0,0
2021-05-30 03:45,5,4,1,0,0,0
2021-05-30 04:00,5,1,4,0,0,0
2021-05-30 04:15,8,3,5,0,0,0
2021-05-30 04:30,3,0,3,0,0,0
2021-05-30 04:45,7,3,4,0,0,0
2021-05-30 05:00,5,2,3,0,0,0
2021-05-30 05:15,2,2,0,0,0,0
2021-05-30 05:30,8,4,4,0,0,0
2021-05-30 05:45,8,4,4,0,0,0
2021-05-30 06:00,11,5,6,0,0,0
2021-05-30 06:15,7,3,4,0,0,0
2021-05-30 06:30,9,6,3,0,0,0
2021-05-30 06:45,3,1,2,0,0,0
2021-05-30 07:00,4,3,1,0,0,0
2021-05-30 07:15,5,5,0,0,0,0
2021-05-30 07:30,12,10,2,0,0,0
2021-05-30 07:45,9,5,4,0,0,0
2021-05-30 08:00,10,6,4,0,0,0
2021-05-30 08:15,10,6,4,0,0,0
2021-05-30 08:30,13,8,5,0,0,0
2021-05-30 08:45,18,12,6,0,0,0
2021-05-30 09:00,26,14,12,0,0,0
2021-05-30 09:15,26,14,12,0,0,0
2021-05-30 09:30,31,24,7,0,0,0
2021-05-30 09:45,55,30,25,0,0,0
2021-05-30 10:00,47,31,16,0,0,0
2021-05-30 10:15,46,26,20,0,0,0
2021-05-30 10:30,61,40,21,0,0,0
2021-05-30 10:45,76,37,39,0,0,0
2021-05-30 11:00,58,36,22,0,0,0
2021-05-30 11:15,85,65,20,0,0,0
2021-05-30 11:30,71,37,34,0,0,0
2021-05-30 11:45,94,48,46,0,0,0
2021-05-30 12:00,91,48,43,0,0,0
2021-05-30 12:15,92,46,46,0,0,0
2021-05-30 12:30,97,50,47,0,0,0
2021-05-30 12:45,97,46,51,0,0,0
2021-05-30 13:00,108,68,40,0,0,0
2021-05-30 13:15,114,75,39,0,0,0
2021-05-30 13:30,101,55,46,0,0,0
2021-05-30 13:45,129,86,43,0,0,0
2021-05-30 14:00,124,67,57,0,0,0
2021-05-30 14:15,123,69,54,0,0,0
2021-05-30 14:30,123,78,45,0,0,0
2021-05-30 14:45,152,103,49,0,0,0
2021-05-30 15:00,128,77,51,0,0,0
2021-05-30 15:15,122,89,33,0,0,0
2021-05-30 15:30,141,95,46,0,0,0
2021-05-30 15:45,120,86,34,0,0,0
2021-05-30 16:00,133,82,51,0,0,0
2021-05-30 16:15,132,78,54,0,0,0
2021-05-30 16:30,121,78,43,0,0,0
2021-05-30 16:45,115,70,45,0,0,0
2021-05-30 17:00,116,70,46,0,0,0
2021-05-30 17:15,121,78,43,0,0,0
2021-05-30 17:30,112,74,38,0,0,0
2021-05-30 17:45,113,66,47,0,0,0
2021-05-30 18:00,89,58,31,0,0,0
2021-05-30 18:15,102,54,48,0,0,0
2021-05-30 18:30,100,62,38,0,0,0
2021-05-30 18:45,94,60,34,0,0,0
2021-05-30 19:00,93,42,51,0,0,0
2021-05-30 19:15,57,28,29,0,0,0
2021-05-30 19:30,64,45,19,0,0,0
2021-05-30 19:45,80,46,34,0,0,0
2021-05-30 20:00,69,42,27,0,0,0
2021-05-30 20:15,68,28,40,0,0,0
2021-05-30 20:30,53,29,24,0,0,0
2021-05-30 20:45,44,21,23,0,0,0
2021-05-30 21:00,34,19,15,0,0,0
2021-05-30 21:15,42,26,16,0,0,0
2021-05-30 21:30,39,22,17,0,0,0
2021-05-30 21:45,33,18,15,0,0,0
2021-05-30 22:00,32,24,8,0,0,0
2021-05-30 22:15,22,12,10,0,0,0
2021-05-30 22:30,29,16,13,0,0,0
2021-05-30 22:45,18,6,12,0,0,0
2021-05-30 23:00,22,12,10,0,0,0
2021-05-30 23:15,16,8,8,0,0,0
2021-05-30 23:30,11,10,1,0,0,0
2021-05-30 23:45,11,7,4,0,0,0
