Datetime,100034983 (Warendorfer Straße),101034983 (Warendorfer Straße stadteinwärts),102034983 (Warendorfer Straße stadtauswärts),100034983-status,101034983-status,102034983-status
2021-06-01 00:00,21,4,17,0,0,0
2021-06-01 00:15,21,13,8,0,0,0
2021-06-01 00:30,5,1,4,0,0,0
2021-06-01 00:45,4,2,2,0,0,0
2021-06-01 01:00,7,6,1,0,0,0
2021-06-01 01:15,1,1,0,0,0,0
2021-06-01 01:30,3,0,3,0,0,0
2021-06-01 01:45,4,3,1,0,0,0
2021-06-01 02:00,4,0,4,0,0,0
2021-06-01 02:15,3,1,2,0,0,0
2021-06-01 02:30,2,0,2,0,0,0
2021-06-01 02:45,4,3,1,0,0,0
2021-06-01 03:00,1,1,0,0,0,0
2021-06-01 03:15,8,7,1,0,0,0
2021-06-01 03:30,0,0,0,0,0,0
2021-06-01 03:45,1,1,0,0,0,0
2021-06-01 04:00,4,4,0,0,0,0
2021-06-01 04:15,1,1,0,0,0,0
2021-06-01 04:30,1,0,1,0,0,0
2021-06-01 04:45,1,1,0,0,0,0
2021-06-01 05:00,1,1,0,0,0,0
2021-06-01 05:15,3,2,1,0,0,0
2021-06-01 05:30,13,10,3,0,0,0
2021-06-01 05:45,15,7,8,0,0,0
2021-06-01 06:00,20,10,10,0,0,0
2021-06-01 06:15,42,23,19,0,0,0
2021-06-01 06:30,61,42,19,0,0,0
2021-06-01 06:45,56,40,16,0,0,0
2021-06-01 07:00,93,68,25,0,0,0
2021-06-01 07:15,128,82,46,0,0,0
2021-06-01 07:30,205,147,58,0,0,0
2021-06-01 07:45,255,204,51,0,0,0
2021-06-01 08:00,211,174,37,0,0,0
2021-06-01 08:15,163,129,34,0,0,0
2021-06-01 08:30,144,104,40,0,0,0
2021-06-01 08:45,154,94,60,0,0,0
2021-06-01 09:00,128,87,41,0,0,0
2021-06-01 09:15,110,81,29,0,0,0
2021-06-01 09:30,96,57,39,0,0,0
2021-06-01 09:45,137,93,44,0,0,0
2021-06-01 10:00,89,61,28,0,0,0
2021-06-01 10:15,94,62,32,0,0,0
2021-06-01 10:30,108,75,33,0,0,0
2021-06-01 10:45,114,72,42,0,0,0
2021-06-01 11:00,97,62,35,0,0,0
2021-06-01 11:15,114,76,38,0,0,0
2021-06-01 11:30,114,66,48,0,0,0
2021-06-01 11:45,145,90,55,0,0,0
2021-06-01 12:00,141,90,51,0,0,0
2021-06-01 12:15,145,79,66,0,0,0
2021-06-01 12:30,122,67,55,0,0,0
2021-06-01 12:45,120,59,61,0,0,0
2021-06-01 13:00,140,74,66,0,0,0
2021-06-01 13:15,170,82,88,0,0,0
2021-06-01 13:30,159,76,83,0,0,0
2021-06-01 13:45,147,68,79,0,0,0
2021-06-01 14:00,166,85,81,0,0,0
2021-06-01 14:15,180,97,83,0,0,0
2021-06-01 14:30,202,112,90,0,0,0
2021-06-01 14:45,164,94,70,0,0,0
2021-06-01 15:00,168,92,76,0,0,0
2021-06-01 15:15,145,83,62,0,0,0
2021-06-01 15:30,163,88,75,0,0,0
2021-06-01 15:45,173,92,81,0,0,0
2021-06-01 16:00,216,105,111,0,0,0
2021-06-01 16:15,204,106,98,0,0,0
2021-06-01 16:30,191,93,98,0,0,0
2021-06-01 16:45,223,121,102,0,0,0
2021-06-01 17:00,209,107,102,0,0,0
2021-06-01 17:15,208,107,101,0,0,0
2021-06-01 17:30,171,95,76,0,0,0
2021-06-01 17:45,225,133,92,0,0,0
2021-06-01 18:00,192,99,93,0,0,0
2021-06-01 18:15,185,93,92,0,0,0
2021-06-01 18:30,145,68,77,0,0,0
2021-06-01 18:45,168,83,85,0,0,0
2021-06-01 19:00,147,70,77,0,0,0
2021-06-01 19:15,116,73,43,0,0,0
2021-06-01 19:30,88,57,31,0,0,0
2021-06-01 19:45,103,62,41,0,0,0
2021-06-01 20:00,98,66,32,0,0,0
2021-06-01 20:15,88,40,48,0,0,0
2021-06-01 20:30,59,33,26,0,0,0
2021-06-01 20:45,66,43,23,0,0,0
2021-06-01 21:00,67,43,24,0,0,0
2021-06-01 21:15,55,29,26,0,0,0
2021-06-01 21:30,36,21,15,0,0,0
2021-06-01 21:45,67,36,31,0,0,0
2021-06-01 22:00,49,32,17,0,0,0
2021-06-01 22:15,42,26,16,0,0,0
2021-06-01 22:30,33,11,22,0,0,0
2021-06-01 22:45,36,9,27,0,0,0
2021-06-01 23:00,42,16,26,0,0,0
2021-06-01 23:15,15,7,8,0,0,0
2021-06-01 23:30,33,14,19,0,0,0
2021-06-01 23:45,22,8,14,0,0,0
2021-06-02 00:00,14,6,8,0,0,0
2021-06-02 00:15,9,4,5,0,0,0
2021-06-02 00:30,12,7,5,0,0,0
2021-06-02 00:45,8,2,6,0,0,0
2021-06-02 01:00,5,4,1,0,0,0
2021-06-02 01:15,5,2,3,0,0,0
2021-06-02 01:30,5,2,3,0,0,0
2021-06-02 01:45,6,3,3,0,0,0
2021-06-02 02:00,2,1,1,0,0,0
2021-06-02 02:15,4,1,3,0,0,0
2021-06-02 02:30,2,2,0,0,0,0
2021-06-02 02:45,1,0,1,0,0,0
2021-06-02 03:00,0,0,0,0,0,0
2021-06-02 03:15,3,0,3,0,0,0
2021-06-02 03:30,3,3,0,0,0,0
2021-06-02 03:45,0,0,0,0,0,0
2021-06-02 04:00,6,4,2,0,0,0
2021-06-02 04:15,4,2,2,0,0,0
2021-06-02 04:30,3,1,2,0,0,0
2021-06-02 04:45,5,1,4,0,0,0
2021-06-02 05:00,3,2,1,0,0,0
2021-06-02 05:15,6,4,2,0,0,0
2021-06-02 05:30,13,8,5,0,0,0
2021-06-02 05:45,18,8,10,0,0,0
2021-06-02 06:00,14,8,6,0,0,0
2021-06-02 06:15,34,19,15,0,0,0
2021-06-02 06:30,47,35,12,0,0,0
2021-06-02 06:45,65,46,19,0,0,0
2021-06-02 07:00,90,73,17,0,0,0
2021-06-02 07:15,128,78,50,0,0,0
2021-06-02 07:30,165,121,44,0,0,0
2021-06-02 07:45,272,214,58,0,0,0
2021-06-02 08:00,238,201,37,0,0,0
2021-06-02 08:15,199,140,59,0,0,0
2021-06-02 08:30,169,143,26,0,0,0
2021-06-02 08:45,176,126,50,0,0,0
2021-06-02 09:00,121,86,35,0,0,0
2021-06-02 09:15,151,104,47,0,0,0
2021-06-02 09:30,123,89,34,0,0,0
2021-06-02 09:45,150,100,50,0,0,0
2021-06-02 10:00,129,84,45,0,0,0
2021-06-02 10:15,155,101,54,0,0,0
2021-06-02 10:30,142,85,57,0,0,0
2021-06-02 10:45,172,112,60,0,0,0
2021-06-02 11:00,142,93,49,0,0,0
2021-06-02 11:15,145,95,50,0,0,0
2021-06-02 11:30,164,98,66,0,0,0
2021-06-02 11:45,177,101,76,0,0,0
2021-06-02 12:00,181,101,80,0,0,0
2021-06-02 12:15,168,111,57,0,0,0
2021-06-02 12:30,176,104,72,0,0,0
2021-06-02 12:45,158,97,61,0,0,0
2021-06-02 13:00,144,72,72,0,0,0
2021-06-02 13:15,150,74,76,0,0,0
2021-06-02 13:30,149,84,65,0,0,0
2021-06-02 13:45,158,86,72,0,0,0
2021-06-02 14:00,164,93,71,0,0,0
2021-06-02 14:15,130,58,72,0,0,0
2021-06-02 14:30,161,80,81,0,0,0
2021-06-02 14:45,178,101,77,0,0,0
2021-06-02 15:00,164,97,67,0,0,0
2021-06-02 15:15,132,71,61,0,0,0
2021-06-02 15:30,170,102,68,0,0,0
2021-06-02 15:45,163,70,93,0,0,0
2021-06-02 16:00,183,108,75,0,0,0
2021-06-02 16:15,154,95,59,0,0,0
2021-06-02 16:30,139,80,59,0,0,0
2021-06-02 16:45,164,94,70,0,0,0
2021-06-02 17:00,174,95,79,0,0,0
2021-06-02 17:15,201,121,80,0,0,0
2021-06-02 17:30,189,109,80,0,0,0
2021-06-02 17:45,205,111,94,0,0,0
2021-06-02 18:00,172,100,72,0,0,0
2021-06-02 18:15,174,95,79,0,0,0
2021-06-02 18:30,167,98,69,0,0,0
2021-06-02 18:45,164,113,51,0,0,0
2021-06-02 19:00,140,74,66,0,0,0
2021-06-02 19:15,145,97,48,0,0,0
2021-06-02 19:30,112,74,38,0,0,0
2021-06-02 19:45,102,61,41,0,0,0
2021-06-02 20:00,113,71,42,0,0,0
2021-06-02 20:15,98,58,40,0,0,0
2021-06-02 20:30,80,50,30,0,0,0
2021-06-02 20:45,73,47,26,0,0,0
2021-06-02 21:00,80,54,26,0,0,0
2021-06-02 21:15,74,40,34,0,0,0
2021-06-02 21:30,78,47,31,0,0,0
2021-06-02 21:45,58,32,26,0,0,0
2021-06-02 22:00,57,33,24,0,0,0
2021-06-02 22:15,61,36,25,0,0,0
2021-06-02 22:30,46,20,26,0,0,0
2021-06-02 22:45,57,39,18,0,0,0
2021-06-02 23:00,53,26,27,0,0,0
2021-06-02 23:15,40,18,22,0,0,0
2021-06-02 23:30,45,26,19,0,0,0
2021-06-02 23:45,60,38,22,0,0,0
2021-06-03 00:00,58,38,20,0,0,0
2021-06-03 00:15,27,13,14,0,0,0
2021-06-03 00:30,33,20,13,0,0,0
2021-06-03 00:45,29,17,12,0,0,0
2021-06-03 01:00,26,13,13,0,0,0
2021-06-03 01:15,20,13,7,0,0,0
2021-06-03 01:30,27,10,17,0,0,0
2021-06-03 01:45,26,7,19,0,0,0
2021-06-03 02:00,23,5,18,0,0,0
2021-06-03 02:15,24,6,18,0,0,0
2021-06-03 02:30,21,4,17,0,0,0
2021-06-03 02:45,17,7,10,0,0,0
2021-06-03 03:00,9,1,8,0,0,0
2021-06-03 03:15,10,2,8,0,0,0
2021-06-03 03:30,18,3,15,0,0,0
2021-06-03 03:45,15,2,13,0,0,0
2021-06-03 04:00,8,2,6,0,0,0
2021-06-03 04:15,9,2,7,0,0,0
2021-06-03 04:30,7,2,5,0,0,0
2021-06-03 04:45,4,1,3,0,0,0
2021-06-03 05:00,3,1,2,0,0,0
2021-06-03 05:15,1,0,1,0,0,0
2021-06-03 05:30,6,4,2,0,0,0
2021-06-03 05:45,9,5,4,0,0,0
2021-06-03 06:00,11,8,3,0,0,0
2021-06-03 06:15,8,5,3,0,0,0
2021-06-03 06:30,3,1,2,0,0,0
2021-06-03 06:45,8,7,1,0,0,0
2021-06-03 07:00,5,3,2,0,0,0
2021-06-03 07:15,5,4,1,0,0,0
2021-06-03 07:30,9,7,2,0,0,0
2021-06-03 07:45,19,11,8,0,0,0
2021-06-03 08:00,24,14,10,0,0,0
2021-06-03 08:15,17,9,8,0,0,0
2021-06-03 08:30,15,10,5,0,0,0
2021-06-03 08:45,25,14,11,0,0,0
2021-06-03 09:00,37,23,14,0,0,0
2021-06-03 09:15,23,12,11,0,0,0
2021-06-03 09:30,39,30,9,0,0,0
2021-06-03 09:45,40,29,11,0,0,0
2021-06-03 10:00,65,34,31,0,0,0
2021-06-03 10:15,51,34,17,0,0,0
2021-06-03 10:30,58,32,26,0,0,0
2021-06-03 10:45,71,57,14,0,0,0
2021-06-03 11:00,45,29,16,0,0,0
2021-06-03 11:15,51,33,18,0,0,0
2021-06-03 11:30,68,46,22,0,0,0
2021-06-03 11:45,49,29,20,0,0,0
2021-06-03 12:00,57,34,23,0,0,0
2021-06-03 12:15,76,54,22,0,0,0
2021-06-03 12:30,75,43,32,0,0,0
2021-06-03 12:45,61,44,17,0,0,0
2021-06-03 13:00,74,45,29,0,0,0
2021-06-03 13:15,72,49,23,0,0,0
2021-06-03 13:30,71,39,32,0,0,0
2021-06-03 13:45,66,43,23,0,0,0
2021-06-03 14:00,74,52,22,0,0,0
2021-06-03 14:15,53,33,20,0,0,0
2021-06-03 14:30,84,44,40,0,0,0
2021-06-03 14:45,97,57,40,0,0,0
2021-06-03 15:00,84,52,32,0,0,0
2021-06-03 15:15,51,31,20,0,0,0
2021-06-03 15:30,76,41,35,0,0,0
2021-06-03 15:45,85,62,23,0,0,0
2021-06-03 16:00,74,44,30,0,0,0
2021-06-03 16:15,69,47,22,0,0,0
2021-06-03 16:30,59,46,13,0,0,0
2021-06-03 16:45,76,40,36,0,0,0
2021-06-03 17:00,65,45,20,0,0,0
2021-06-03 17:15,61,35,26,0,0,0
2021-06-03 17:30,58,35,23,0,0,0
2021-06-03 17:45,83,52,31,0,0,0
2021-06-03 18:00,73,44,29,0,0,0
2021-06-03 18:15,73,48,25,0,0,0
2021-06-03 18:30,46,26,20,0,0,0
2021-06-03 18:45,30,17,13,0,0,0
2021-06-03 19:00,21,16,5,0,0,0
2021-06-03 19:15,42,12,30,0,0,0
2021-06-03 19:30,38,20,18,0,0,0
2021-06-03 19:45,52,26,26,0,0,0
2021-06-03 20:00,31,20,11,0,0,0
2021-06-03 20:15,37,19,18,0,0,0
2021-06-03 20:30,46,28,18,0,0,0
2021-06-03 20:45,48,36,12,0,0,0
2021-06-03 21:00,40,29,11,0,0,0
2021-06-03 21:15,15,5,10,0,0,0
2021-06-03 21:30,25,14,11,0,0,0
2021-06-03 21:45,22,12,10,0,0,0
2021-06-03 22:00,14,6,8,0,0,0
2021-06-03 22:15,24,12,12,0,0,0
2021-06-03 22:30,23,12,11,0,0,0
2021-06-03 22:45,28,20,8,0,0,0
2021-06-03 23:00,17,9,8,0,0,0
2021-06-03 23:15,7,3,4,0,0,0
2021-06-03 23:30,9,5,4,0,0,0
2021-06-03 23:45,7,2,5,0,0,0
2021-06-04 00:00,16,7,9,0,0,0
2021-06-04 00:15,10,5,5,0,0,0
2021-06-04 00:30,12,9,3,0,0,0
2021-06-04 00:45,9,8,1,0,0,0
2021-06-04 01:00,4,1,3,0,0,0
2021-06-04 01:15,6,4,2,0,0,0
2021-06-04 01:30,1,0,1,0,0,0
2021-06-04 01:45,3,2,1,0,0,0
2021-06-04 02:00,0,0,0,0,0,0
2021-06-04 02:15,8,3,5,0,0,0
2021-06-04 02:30,2,0,2,0,0,0
2021-06-04 02:45,0,0,0,0,0,0
2021-06-04 03:00,3,1,2,0,0,0
2021-06-04 03:15,1,0,1,0,0,0
2021-06-04 03:30,1,0,1,0,0,0
2021-06-04 03:45,3,3,0,0,0,0
2021-06-04 04:00,2,1,1,0,0,0
2021-06-04 04:15,3,2,1,0,0,0
2021-06-04 04:30,2,1,1,0,0,0
2021-06-04 04:45,4,2,2,0,0,0
2021-06-04 05:00,1,0,1,0,0,0
2021-06-04 05:15,5,3,2,0,0,0
2021-06-04 05:30,11,8,3,0,0,0
2021-06-04 05:45,14,9,5,0,0,0
2021-06-04 06:00,15,10,5,0,0,0
2021-06-04 06:15,18,11,7,0,0,0
2021-06-04 06:30,35,27,8,0,0,0
2021-06-04 06:45,33,26,7,0,0,0
2021-06-04 07:00,49,37,12,0,0,0
2021-06-04 07:15,59,42,17,0,0,0
2021-06-04 07:30,86,70,16,0,0,0
2021-06-04 07:45,112,86,26,0,0,0
2021-06-04 08:00,86,59,27,0,0,0
2021-06-04 08:15,76,62,14,0,0,0
2021-06-04 08:30,68,47,21,0,0,0
2021-06-04 08:45,105,75,30,0,0,0
2021-06-04 09:00,73,49,24,0,0,0
2021-06-04 09:15,95,78,17,0,0,0
2021-06-04 09:30,103,72,31,0,0,0
2021-06-04 09:45,137,114,23,0,0,0
2021-06-04 10:00,103,91,12,0,0,0
2021-06-04 10:15,121,87,34,0,0,0
2021-06-04 10:30,122,84,38,0,0,0
2021-06-04 10:45,147,102,45,0,0,0
2021-06-04 11:00,112,73,39,0,0,0
2021-06-04 11:15,124,87,37,0,0,0
2021-06-04 11:30,120,77,43,0,0,0
2021-06-04 11:45,144,91,53,0,0,0
2021-06-04 12:00,124,77,47,0,0,0
2021-06-04 12:15,139,76,63,0,0,0
2021-06-04 12:30,129,80,49,0,0,0
2021-06-04 12:45,158,98,60,0,0,0
2021-06-04 13:00,153,87,66,0,0,0
2021-06-04 13:15,146,75,71,0,0,0
2021-06-04 13:30,165,97,68,0,0,0
2021-06-04 13:45,130,78,52,0,0,0
2021-06-04 14:00,139,85,54,0,0,0
2021-06-04 14:15,134,76,58,0,0,0
2021-06-04 14:30,142,76,66,0,0,0
2021-06-04 14:45,135,78,57,0,0,0
2021-06-04 15:00,164,100,64,0,0,0
2021-06-04 15:15,127,91,36,0,0,0
2021-06-04 15:30,149,101,48,0,0,0
2021-06-04 15:45,138,86,52,0,0,0
2021-06-04 16:00,146,83,63,0,0,0
2021-06-04 16:15,130,68,62,0,0,0
2021-06-04 16:30,154,106,48,0,0,0
2021-06-04 16:45,145,83,62,0,0,0
2021-06-04 17:00,130,68,62,0,0,0
2021-06-04 17:15,133,68,65,0,0,0
2021-06-04 17:30,127,81,46,0,0,0
2021-06-04 17:45,159,105,54,0,0,0
2021-06-04 18:00,138,70,68,0,0,0
2021-06-04 18:15,137,68,69,0,0,0
2021-06-04 18:30,110,53,57,0,0,0
2021-06-04 18:45,130,85,45,0,0,0
2021-06-04 19:00,103,55,48,0,0,0
2021-06-04 19:15,120,80,40,0,0,0
2021-06-04 19:30,94,50,44,0,0,0
2021-06-04 19:45,90,58,32,0,0,0
2021-06-04 20:00,98,61,37,0,0,0
2021-06-04 20:15,74,46,28,0,0,0
2021-06-04 20:30,57,35,22,0,0,0
2021-06-04 20:45,61,40,21,0,0,0
2021-06-04 21:00,63,39,24,0,0,0
2021-06-04 21:15,35,23,12,0,0,0
2021-06-04 21:30,46,25,21,0,0,0
2021-06-04 21:45,41,21,20,0,0,0
2021-06-04 22:00,46,32,14,0,0,0
2021-06-04 22:15,47,31,16,0,0,0
2021-06-04 22:30,51,30,21,0,0,0
2021-06-04 22:45,40,22,18,0,0,0
2021-06-04 23:00,28,12,16,0,0,0
2021-06-04 23:15,33,17,16,0,0,0
2021-06-04 23:30,30,14,16,0,0,0
2021-06-04 23:45,32,17,15,0,0,0
2021-06-05 00:00,27,13,14,0,0,0
2021-06-05 00:15,27,8,19,0,0,0
2021-06-05 00:30,20,12,8,0,0,0
2021-06-05 00:45,32,11,21,0,0,0
2021-06-05 01:00,25,10,15,0,0,0
2021-06-05 01:15,27,12,15,0,0,0
2021-06-05 01:30,25,12,13,0,0,0
2021-06-05 01:45,18,6,12,0,0,0
2021-06-05 02:00,23,8,15,0,0,0
2021-06-05 02:15,12,2,10,0,0,0
2021-06-05 02:30,15,6,9,0,0,0
2021-06-05 02:45,14,6,8,0,0,0
2021-06-05 03:00,9,2,7,0,0,0
2021-06-05 03:15,12,2,10,0,0,0
2021-06-05 03:30,10,7,3,0,0,0
2021-06-05 03:45,5,2,3,0,0,0
2021-06-05 04:00,4,1,3,0,0,0
2021-06-05 04:15,6,3,3,0,0,0
2021-06-05 04:30,5,2,3,0,0,0
2021-06-05 04:45,9,6,3,0,0,0
2021-06-05 05:00,3,1,2,0,0,0
2021-06-05 05:15,4,4,0,0,0,0
2021-06-05 05:30,15,13,2,0,0,0
2021-06-05 05:45,6,5,1,0,0,0
2021-06-05 06:00,5,4,1,0,0,0
2021-06-05 06:15,3,1,2,0,0,0
2021-06-05 06:30,10,8,2,0,0,0
2021-06-05 06:45,22,15,7,0,0,0
2021-06-05 07:00,10,10,0,0,0,0
2021-06-05 07:15,23,17,6,0,0,0
2021-06-05 07:30,30,24,6,0,0,0
2021-06-05 07:45,35,23,12,0,0,0
2021-06-05 08:00,58,38,20,0,0,0
2021-06-05 08:15,54,41,13,0,0,0
2021-06-05 08:30,48,40,8,0,0,0
2021-06-05 08:45,54,44,10,0,0,0
2021-06-05 09:00,55,44,11,0,0,0
2021-06-05 09:15,94,71,23,0,0,0
2021-06-05 09:30,111,74,37,0,0,0
2021-06-05 09:45,118,91,27,0,0,0
2021-06-05 10:00,104,77,27,0,0,0
2021-06-05 10:15,132,100,32,0,0,0
2021-06-05 10:30,140,109,31,0,0,0
2021-06-05 10:45,141,102,39,0,0,0
2021-06-05 11:00,125,92,33,0,0,0
2021-06-05 11:15,151,112,39,0,0,0
2021-06-05 11:30,119,78,41,0,0,0
2021-06-05 11:45,133,85,48,0,0,0
2021-06-05 12:00,142,92,50,0,0,0
2021-06-05 12:15,138,95,43,0,0,0
2021-06-05 12:30,134,88,46,0,0,0
2021-06-05 12:45,135,83,52,0,0,0
2021-06-05 13:00,101,72,29,0,0,0
2021-06-05 13:15,108,62,46,0,0,0
2021-06-05 13:30,107,67,40,0,0,0
2021-06-05 13:45,144,88,56,0,0,0
2021-06-05 14:00,104,55,49,0,0,0
2021-06-05 14:15,128,69,59,0,0,0
2021-06-05 14:30,99,51,48,0,0,0
2021-06-05 14:45,136,77,59,0,0,0
2021-06-05 15:00,84,39,45,0,0,0
2021-06-05 15:15,74,39,35,0,0,0
2021-06-05 15:30,67,35,32,0,0,0
2021-06-05 15:45,58,32,26,0,0,0
2021-06-05 16:00,74,36,38,0,0,0
2021-06-05 16:15,77,51,26,0,0,0
2021-06-05 16:30,84,56,28,0,0,0
2021-06-05 16:45,113,66,47,0,0,0
2021-06-05 17:00,75,50,25,0,0,0
2021-06-05 17:15,93,53,40,0,0,0
2021-06-05 17:30,66,40,26,0,0,0
2021-06-05 17:45,86,47,39,0,0,0
2021-06-05 18:00,83,47,36,0,0,0
2021-06-05 18:15,79,46,33,0,0,0
2021-06-05 18:30,79,54,25,0,0,0
2021-06-05 18:45,105,77,28,0,0,0
2021-06-05 19:00,77,41,36,0,0,0
2021-06-05 19:15,87,51,36,0,0,0
2021-06-05 19:30,55,36,19,0,0,0
2021-06-05 19:45,63,44,19,0,0,0
2021-06-05 20:00,58,38,20,0,0,0
2021-06-05 20:15,84,45,39,0,0,0
2021-06-05 20:30,61,36,25,0,0,0
2021-06-05 20:45,36,22,14,0,0,0
2021-06-05 21:00,38,20,18,0,0,0
2021-06-05 21:15,27,6,21,0,0,0
2021-06-05 21:30,29,13,16,0,0,0
2021-06-05 21:45,30,16,14,0,0,0
2021-06-05 22:00,26,12,14,0,0,0
2021-06-05 22:15,24,14,10,0,0,0
2021-06-05 22:30,43,21,22,0,0,0
2021-06-05 22:45,33,17,16,0,0,0
2021-06-05 23:00,48,27,21,0,0,0
2021-06-05 23:15,28,16,12,0,0,0
2021-06-05 23:30,21,12,9,0,0,0
2021-06-05 23:45,32,10,22,0,0,0
2021-06-06 00:00,22,13,9,0,0,0
2021-06-06 00:15,24,8,16,0,0,0
2021-06-06 00:30,17,12,5,0,0,0
2021-06-06 00:45,24,10,14,0,0,0
2021-06-06 01:00,17,8,9,0,0,0
2021-06-06 01:15,14,4,10,0,0,0
2021-06-06 01:30,17,6,11,0,0,0
2021-06-06 01:45,20,8,12,0,0,0
2021-06-06 02:00,12,8,4,0,0,0
2021-06-06 02:15,6,3,3,0,0,0
2021-06-06 02:30,12,6,6,0,0,0
2021-06-06 02:45,7,4,3,0,0,0
2021-06-06 03:00,11,4,7,0,0,0
2021-06-06 03:15,6,1,5,0,0,0
2021-06-06 03:30,5,1,4,0,0,0
2021-06-06 03:45,6,3,3,0,0,0
2021-06-06 04:00,4,3,1,0,0,0
2021-06-06 04:15,2,0,2,0,0,0
2021-06-06 04:30,4,0,4,0,0,0
2021-06-06 04:45,6,4,2,0,0,0
2021-06-06 05:00,1,1,0,0,0,0
2021-06-06 05:15,0,0,0,0,0,0
2021-06-06 05:30,9,4,5,0,0,0
2021-06-06 05:45,4,2,2,0,0,0
2021-06-06 06:00,7,5,2,0,0,0
2021-06-06 06:15,8,5,3,0,0,0
2021-06-06 06:30,0,0,0,0,0,0
2021-06-06 06:45,6,3,3,0,0,0
2021-06-06 07:00,2,0,2,0,0,0
2021-06-06 07:15,5,2,3,0,0,0
2021-06-06 07:30,6,5,1,0,0,0
2021-06-06 07:45,14,4,10,0,0,0
2021-06-06 08:00,5,3,2,0,0,0
2021-06-06 08:15,7,4,3,0,0,0
2021-06-06 08:30,9,7,2,0,0,0
2021-06-06 08:45,16,9,7,0,0,0
2021-06-06 09:00,18,10,8,0,0,0
2021-06-06 09:15,16,13,3,0,0,0
2021-06-06 09:30,33,23,10,0,0,0
2021-06-06 09:45,45,29,16,0,0,0
2021-06-06 10:00,31,14,17,0,0,0
2021-06-06 10:15,31,23,8,0,0,0
2021-06-06 10:30,39,24,15,0,0,0
2021-06-06 10:45,52,29,23,0,0,0
2021-06-06 11:00,50,25,25,0,0,0
2021-06-06 11:15,44,29,15,0,0,0
2021-06-06 11:30,59,45,14,0,0,0
2021-06-06 11:45,63,33,30,0,0,0
2021-06-06 12:00,50,24,26,0,0,0
2021-06-06 12:15,63,29,34,0,0,0
2021-06-06 12:30,56,28,28,0,0,0
2021-06-06 12:45,70,41,29,0,0,0
2021-06-06 13:00,49,27,22,0,0,0
2021-06-06 13:15,62,37,25,0,0,0
2021-06-06 13:30,47,33,14,0,0,0
2021-06-06 13:45,64,52,12,0,0,0
2021-06-06 14:00,73,48,25,0,0,0
2021-06-06 14:15,81,50,31,0,0,0
2021-06-06 14:30,79,50,29,0,0,0
2021-06-06 14:45,81,53,28,0,0,0
2021-06-06 15:00,69,38,31,0,0,0
2021-06-06 15:15,75,52,23,0,0,0
2021-06-06 15:30,81,58,23,0,0,0
2021-06-06 15:45,74,51,23,0,0,0
2021-06-06 16:00,69,40,29,0,0,0
2021-06-06 16:15,57,30,27,0,0,0
2021-06-06 16:30,73,54,19,0,0,0
2021-06-06 16:45,72,36,36,0,0,0
2021-06-06 17:00,84,62,22,0,0,0
2021-06-06 17:15,73,44,29,0,0,0
2021-06-06 17:30,94,64,30,0,0,0
2021-06-06 17:45,70,47,23,0,0,0
2021-06-06 18:00,53,24,29,0,0,0
2021-06-06 18:15,63,43,20,0,0,0
2021-06-06 18:30,50,33,17,0,0,0
2021-06-06 18:45,51,23,28,0,0,0
2021-06-06 19:00,50,28,22,0,0,0
2021-06-06 19:15,41,20,21,0,0,0
2021-06-06 19:30,57,32,25,0,0,0
2021-06-06 19:45,44,24,20,0,0,0
2021-06-06 20:00,42,27,15,0,0,0
2021-06-06 20:15,29,12,17,0,0,0
2021-06-06 20:30,46,27,19,0,0,0
2021-06-06 20:45,27,17,10,0,0,0
2021-06-06 21:00,37,23,14,0,0,0
2021-06-06 21:15,34,20,14,0,0,0
2021-06-06 21:30,22,8,14,0,0,0
2021-06-06 21:45,17,8,9,0,0,0
2021-06-06 22:00,19,10,9,0,0,0
2021-06-06 22:15,21,6,15,0,0,0
2021-06-06 22:30,13,5,8,0,0,0
2021-06-06 22:45,11,5,6,0,0,0
2021-06-06 23:00,16,8,8,0,0,0
2021-06-06 23:15,14,7,7,0,0,0
2021-06-06 23:30,8,5,3,0,0,0
2021-06-06 23:45,9,4,5,0,0,0
2021-06-07 00:00,8,6,2,0,0,0
2021-06-07 00:15,4,2,2,0,0,0
2021-06-07 00:30,4,2,2,0,0,0
2021-06-07 00:45,3,2,1,0,0,0
2021-06-07 01:00,1,0,1,0,0,0
2021-06-07 01:15,1,1,0,0,0,0
2021-06-07 01:30,1,0,1,0,0,0
2021-06-07 01:45,3,2,1,0,0,0
2021-06-07 02:00,3,2,1,0,0,0
2021-06-07 02:15,1,0,1,0,0,0
2021-06-07 02:30,3,3,0,0,0,0
2021-06-07 02:45,4,2,2,0,0,0
2021-06-07 03:00,1,1,0,0,0,0
2021-06-07 03:15,1,0,1,0,0,0
2021-06-07 03:30,0,0,0,0,0,0
2021-06-07 03:45,1,0,1,0,0,0
2021-06-07 04:00,1,1,0,0,0,0
2021-06-07 04:15,3,2,1,0,0,0
2021-06-07 04:30,1,0,1,0,0,0
2021-06-07 04:45,4,1,3,0,0,0
2021-06-07 05:00,0,0,0,0,0,0
2021-06-07 05:15,4,1,3,0,0,0
2021-06-07 05:30,12,7,5,0,0,0
2021-06-07 05:45,17,9,8,0,0,0
2021-06-07 06:00,13,8,5,0,0,0
2021-06-07 06:15,31,17,14,0,0,0
2021-06-07 06:30,39,22,17,0,0,0
2021-06-07 06:45,63,40,23,0,0,0
2021-06-07 07:00,83,58,25,0,0,0
2021-06-07 07:15,113,74,39,0,0,0
2021-06-07 07:30,177,125,52,0,0,0
2021-06-07 07:45,235,182,53,0,0,0
2021-06-07 08:00,240,194,46,0,0,0
2021-06-07 08:15,160,118,42,0,0,0
2021-06-07 08:30,116,86,30,0,0,0
2021-06-07 08:45,160,125,35,0,0,0
2021-06-07 09:00,90,62,28,0,0,0
2021-06-07 09:15,98,71,27,0,0,0
2021-06-07 09:30,90,71,19,0,0,0
2021-06-07 09:45,106,75,31,0,0,0
2021-06-07 10:00,84,53,31,0,0,0
2021-06-07 10:15,103,79,24,0,0,0
2021-06-07 10:30,95,67,28,0,0,0
2021-06-07 10:45,84,54,30,0,0,0
2021-06-07 11:00,89,57,32,0,0,0
2021-06-07 11:15,128,87,41,0,0,0
2021-06-07 11:30,141,88,53,0,0,0
2021-06-07 11:45,101,46,55,0,0,0
2021-06-07 12:00,105,58,47,0,0,0
2021-06-07 12:15,100,55,45,0,0,0
2021-06-07 12:30,134,70,64,0,0,0
2021-06-07 12:45,122,62,60,0,0,0
2021-06-07 13:00,120,66,54,0,0,0
2021-06-07 13:15,123,68,55,0,0,0
2021-06-07 13:30,130,81,49,0,0,0
2021-06-07 13:45,121,67,54,0,0,0
2021-06-07 14:00,126,75,51,0,0,0
2021-06-07 14:15,152,72,80,0,0,0
2021-06-07 14:30,157,86,71,0,0,0
2021-06-07 14:45,126,75,51,0,0,0
2021-06-07 15:00,120,67,53,0,0,0
2021-06-07 15:15,149,89,60,0,0,0
2021-06-07 15:30,132,79,53,0,0,0
2021-06-07 15:45,188,99,89,0,0,0
2021-06-07 16:00,158,94,64,0,0,0
2021-06-07 16:15,190,118,72,0,0,0
2021-06-07 16:30,154,91,63,0,0,0
2021-06-07 16:45,170,104,66,0,0,0
2021-06-07 17:00,166,85,81,0,0,0
2021-06-07 17:15,166,92,74,0,0,0
2021-06-07 17:30,164,97,67,0,0,0
2021-06-07 17:45,137,74,63,0,0,0
2021-06-07 18:00,138,69,69,0,0,0
2021-06-07 18:15,121,64,57,0,0,0
2021-06-07 18:30,149,87,62,0,0,0
2021-06-07 18:45,101,60,41,0,0,0
2021-06-07 19:00,84,40,44,0,0,0
2021-06-07 19:15,91,49,42,0,0,0
2021-06-07 19:30,64,36,28,0,0,0
2021-06-07 19:45,78,43,35,0,0,0
2021-06-07 20:00,58,28,30,0,0,0
2021-06-07 20:15,48,29,19,0,0,0
2021-06-07 20:30,51,16,35,0,0,0
2021-06-07 20:45,46,17,29,0,0,0
2021-06-07 21:00,32,9,23,0,0,0
2021-06-07 21:15,42,23,19,0,0,0
2021-06-07 21:30,37,23,14,0,0,0
2021-06-07 21:45,36,21,15,0,0,0
2021-06-07 22:00,32,15,17,0,0,0
2021-06-07 22:15,27,16,11,0,0,0
2021-06-07 22:30,23,9,14,0,0,0
2021-06-07 22:45,12,6,6,0,0,0
2021-06-07 23:00,20,15,5,0,0,0
2021-06-07 23:15,27,15,12,0,0,0
2021-06-07 23:30,11,1,10,0,0,0
2021-06-07 23:45,15,6,9,0,0,0
2021-06-08 00:00,21,13,8,0,0,0
2021-06-08 00:15,8,2,6,0,0,0
2021-06-08 00:30,4,2,2,0,0,0
2021-06-08 00:45,3,2,1,0,0,0
2021-06-08 01:00,5,1,4,0,0,0
2021-06-08 01:15,6,4,2,0,0,0
2021-06-08 01:30,1,0,1,0,0,0
2021-06-08 01:45,5,2,3,0,0,0
2021-06-08 02:00,0,0,0,0,0,0
2021-06-08 02:15,4,3,1,0,0,0
2021-06-08 02:30,1,0,1,0,0,0
2021-06-08 02:45,0,0,0,0,0,0
2021-06-08 03:00,2,1,1,0,0,0
2021-06-08 03:15,0,0,0,0,0,0
2021-06-08 03:30,0,0,0,0,0,0
2021-06-08 03:45,2,2,0,0,0,0
2021-06-08 04:00,0,0,0,0,0,0
2021-06-08 04:15,5,4,1,0,0,0
2021-06-08 04:30,2,0,2,0,0,0
2021-06-08 04:45,1,1,0,0,0,0
2021-06-08 05:00,0,0,0,0,0,0
2021-06-08 05:15,6,6,0,0,0,0
2021-06-08 05:30,14,9,5,0,0,0
2021-06-08 05:45,16,6,10,0,0,0
2021-06-08 06:00,26,15,11,0,0,0
2021-06-08 06:15,40,25,15,0,0,0
2021-06-08 06:30,52,28,24,0,0,0
2021-06-08 06:45,71,46,25,0,0,0
2021-06-08 07:00,79,46,33,0,0,0
2021-06-08 07:15,131,76,55,0,0,0
2021-06-08 07:30,184,130,54,0,0,0
2021-06-08 07:45,281,214,67,0,0,0
2021-06-08 08:00,218,179,39,0,0,0
2021-06-08 08:15,174,134,40,0,0,0
2021-06-08 08:30,153,116,37,0,0,0
2021-06-08 08:45,139,98,41,0,0,0
2021-06-08 09:00,110,73,37,0,0,0
2021-06-08 09:15,107,73,34,0,0,0
2021-06-08 09:30,96,70,26,0,0,0
2021-06-08 09:45,138,99,39,0,0,0
2021-06-08 10:00,112,80,32,0,0,0
2021-06-08 10:15,97,69,28,0,0,0
2021-06-08 10:30,85,56,29,0,0,0
2021-06-08 10:45,125,79,46,0,0,0
2021-06-08 11:00,115,72,43,0,0,0
2021-06-08 11:15,110,69,41,0,0,0
2021-06-08 11:30,99,60,39,0,0,0
2021-06-08 11:45,142,86,56,0,0,0
2021-06-08 12:00,137,84,53,0,0,0
2021-06-08 12:15,103,61,42,0,0,0
2021-06-08 12:30,118,61,57,0,0,0
2021-06-08 12:45,143,74,69,0,0,0
2021-06-08 13:00,128,71,57,0,0,0
2021-06-08 13:15,139,66,73,0,0,0
2021-06-08 13:30,125,67,58,0,0,0
2021-06-08 13:45,134,71,63,0,0,0
2021-06-08 14:00,124,74,50,0,0,0
2021-06-08 14:15,146,92,54,0,0,0
2021-06-08 14:30,156,98,58,0,0,0
2021-06-08 14:45,159,106,53,0,0,0
2021-06-08 15:00,154,96,58,0,0,0
2021-06-08 15:15,151,101,50,0,0,0
2021-06-08 15:30,131,83,48,0,0,0
2021-06-08 15:45,192,115,77,0,0,0
2021-06-08 16:00,178,105,73,0,0,0
2021-06-08 16:15,168,111,57,0,0,0
2021-06-08 16:30,176,87,89,0,0,0
2021-06-08 16:45,170,97,73,0,0,0
2021-06-08 17:00,172,97,75,0,0,0
2021-06-08 17:15,167,97,70,0,0,0
2021-06-08 17:30,170,111,59,0,0,0
2021-06-08 17:45,178,112,66,0,0,0
2021-06-08 18:00,166,85,81,0,0,0
2021-06-08 18:15,120,71,49,0,0,0
2021-06-08 18:30,155,80,75,0,0,0
2021-06-08 18:45,130,73,57,0,0,0
2021-06-08 19:00,106,56,50,0,0,0
2021-06-08 19:15,116,61,55,0,0,0
2021-06-08 19:30,84,56,28,0,0,0
2021-06-08 19:45,96,50,46,0,0,0
2021-06-08 20:00,91,47,44,0,0,0
2021-06-08 20:15,70,28,42,0,0,0
2021-06-08 20:30,79,45,34,0,0,0
2021-06-08 20:45,58,32,26,0,0,0
2021-06-08 21:00,39,17,22,0,0,0
2021-06-08 21:15,67,42,25,0,0,0
2021-06-08 21:30,65,31,34,0,0,0
2021-06-08 21:45,47,24,23,0,0,0
2021-06-08 22:00,37,19,18,0,0,0
2021-06-08 22:15,35,18,17,0,0,0
2021-06-08 22:30,32,15,17,0,0,0
2021-06-08 22:45,23,10,13,0,0,0
2021-06-08 23:00,35,20,15,0,0,0
2021-06-08 23:15,33,17,16,0,0,0
2021-06-08 23:30,18,8,10,0,0,0
2021-06-08 23:45,25,12,13,0,0,0
2021-06-09 00:00,19,7,12,0,0,0
2021-06-09 00:15,16,11,5,0,0,0
2021-06-09 00:30,5,1,4,0,0,0
2021-06-09 00:45,9,4,5,0,0,0
2021-06-09 01:00,5,3,2,0,0,0
2021-06-09 01:15,3,1,2,0,0,0
2021-06-09 01:30,6,3,3,0,0,0
2021-06-09 01:45,8,4,4,0,0,0
2021-06-09 02:00,1,1,0,0,0,0
2021-06-09 02:15,3,1,2,0,0,0
2021-06-09 02:30,3,0,3,0,0,0
2021-06-09 02:45,2,0,2,0,0,0
2021-06-09 03:00,0,0,0,0,0,0
2021-06-09 03:15,1,1,0,0,0,0
2021-06-09 03:30,2,0,2,0,0,0
2021-06-09 03:45,2,2,0,0,0,0
2021-06-09 04:00,0,0,0,0,0,0
2021-06-09 04:15,6,4,2,0,0,0
2021-06-09 04:30,0,0,0,0,0,0
2021-06-09 04:45,3,0,3,0,0,0
2021-06-09 05:00,1,1,0,0,0,0
2021-06-09 05:15,3,2,1,0,0,0
2021-06-09 05:30,19,13,6,0,0,0
2021-06-09 05:45,18,8,10,0,0,0
2021-06-09 06:00,21,15,6,0,0,0
2021-06-09 06:15,34,21,13,0,0,0
2021-06-09 06:30,58,35,23,0,0,0
2021-06-09 06:45,74,45,29,0,0,0
2021-06-09 07:00,96,66,30,0,0,0
2021-06-09 07:15,142,88,54,0,0,0
2021-06-09 07:30,169,120,49,0,0,0
2021-06-09 07:45,290,218,72,0,0,0
2021-06-09 08:00,264,221,43,0,0,0
2021-06-09 08:15,206,138,68,0,0,0
2021-06-09 08:30,175,127,48,0,0,0
2021-06-09 08:45,172,128,44,0,0,0
2021-06-09 09:00,123,88,35,0,0,0
2021-06-09 09:15,153,108,45,0,0,0
2021-06-09 09:30,162,124,38,0,0,0
2021-06-09 09:45,148,110,38,0,0,0
2021-06-09 10:00,146,107,39,0,0,0
2021-06-09 10:15,133,80,53,0,0,0
2021-06-09 10:30,115,82,33,0,0,0
2021-06-09 10:45,132,98,34,0,0,0
2021-06-09 11:00,133,96,37,0,0,0
2021-06-09 11:15,135,86,49,0,0,0
2021-06-09 11:30,131,88,43,0,0,0
2021-06-09 11:45,162,108,54,0,0,0
2021-06-09 12:00,143,95,48,0,0,0
2021-06-09 12:15,119,75,44,0,0,0
2021-06-09 12:30,131,85,46,0,0,0
2021-06-09 12:45,144,84,60,0,0,0
2021-06-09 13:00,138,78,60,0,0,0
2021-06-09 13:15,169,92,77,0,0,0
2021-06-09 13:30,153,83,70,0,0,0
2021-06-09 13:45,137,78,59,0,0,0
2021-06-09 14:00,112,69,43,0,0,0
2021-06-09 14:15,152,72,80,0,0,0
2021-06-09 14:30,143,60,83,0,0,0
2021-06-09 14:45,173,104,69,0,0,0
2021-06-09 15:00,132,74,58,0,0,0
2021-06-09 15:15,131,74,57,0,0,0
2021-06-09 15:30,167,108,59,0,0,0
2021-06-09 15:45,171,105,66,0,0,0
2021-06-09 16:00,170,97,73,0,0,0
2021-06-09 16:15,173,97,76,0,0,0
2021-06-09 16:30,167,103,64,0,0,0
2021-06-09 16:45,165,106,59,0,0,0
2021-06-09 17:00,169,103,66,0,0,0
2021-06-09 17:15,160,94,66,0,0,0
2021-06-09 17:30,196,115,81,0,0,0
2021-06-09 17:45,169,89,80,0,0,0
2021-06-09 18:00,143,90,53,0,0,0
2021-06-09 18:15,143,85,58,0,0,0
2021-06-09 18:30,185,114,71,0,0,0
2021-06-09 18:45,135,85,50,0,0,0
2021-06-09 19:00,125,61,64,0,0,0
2021-06-09 19:15,128,73,55,0,0,0
2021-06-09 19:30,121,73,48,0,0,0
2021-06-09 19:45,109,71,38,0,0,0
2021-06-09 20:00,88,43,45,0,0,0
2021-06-09 20:15,81,50,31,0,0,0
2021-06-09 20:30,53,26,27,0,0,0
2021-06-09 20:45,62,38,24,0,0,0
2021-06-09 21:00,56,33,23,0,0,0
2021-06-09 21:15,63,36,27,0,0,0
2021-06-09 21:30,64,37,27,0,0,0
2021-06-09 21:45,61,33,28,0,0,0
2021-06-09 22:00,55,31,24,0,0,0
2021-06-09 22:15,58,27,31,0,0,0
2021-06-09 22:30,33,9,24,0,0,0
2021-06-09 22:45,31,16,15,0,0,0
2021-06-09 23:00,47,23,24,0,0,0
2021-06-09 23:15,41,22,19,0,0,0
2021-06-09 23:30,24,12,12,0,0,0
2021-06-09 23:45,25,12,13,0,0,0
2021-06-10 00:00,20,9,11,0,0,0
2021-06-10 00:15,18,5,13,0,0,0
2021-06-10 00:30,3,0,3,0,0,0
2021-06-10 00:45,6,1,5,0,0,0
2021-06-10 01:00,6,1,5,0,0,0
2021-06-10 01:15,6,1,5,0,0,0
2021-06-10 01:30,3,1,2,0,0,0
2021-06-10 01:45,9,3,6,0,0,0
2021-06-10 02:00,9,3,6,0,0,0
2021-06-10 02:15,3,1,2,0,0,0
2021-06-10 02:30,6,4,2,0,0,0
2021-06-10 02:45,3,0,3,0,0,0
2021-06-10 03:00,2,0,2,0,0,0
2021-06-10 03:15,3,2,1,0,0,0
2021-06-10 03:30,2,0,2,0,0,0
2021-06-10 03:45,2,0,2,0,0,0
2021-06-10 04:00,2,0,2,0,0,0
2021-06-10 04:15,3,1,2,0,0,0
2021-06-10 04:30,1,1,0,0,0,0
2021-06-10 04:45,1,0,1,0,0,0
2021-06-10 05:00,0,0,0,0,0,0
2021-06-10 05:15,4,3,1,0,0,0
2021-06-10 05:30,8,7,1,0,0,0
2021-06-10 05:45,16,8,8,0,0,0
2021-06-10 06:00,23,19,4,0,0,0
2021-06-10 06:15,34,20,14,0,0,0
2021-06-10 06:30,43,23,20,0,0,0
2021-06-10 06:45,67,45,22,0,0,0
2021-06-10 07:00,84,58,26,0,0,0
2021-06-10 07:15,110,64,46,0,0,0
2021-06-10 07:30,208,140,68,0,0,0
2021-06-10 07:45,274,208,66,0,0,0
2021-06-10 08:00,232,185,47,0,0,0
2021-06-10 08:15,192,154,38,0,0,0
2021-06-10 08:30,151,109,42,0,0,0
2021-06-10 08:45,173,126,47,0,0,0
2021-06-10 09:00,113,83,30,0,0,0
2021-06-10 09:15,117,71,46,0,0,0
2021-06-10 09:30,107,74,33,0,0,0
2021-06-10 09:45,151,111,40,0,0,0
2021-06-10 10:00,116,81,35,0,0,0
2021-06-10 10:15,67,45,22,0,0,0
2021-06-10 10:30,121,83,38,0,0,0
2021-06-10 10:45,103,75,28,0,0,0
2021-06-10 11:00,111,68,43,0,0,0
2021-06-10 11:15,116,76,40,0,0,0
2021-06-10 11:30,103,72,31,0,0,0
2021-06-10 11:45,130,79,51,0,0,0
2021-06-10 12:00,123,74,49,0,0,0
2021-06-10 12:15,116,71,45,0,0,0
2021-06-10 12:30,123,61,62,0,0,0
2021-06-10 12:45,113,62,51,0,0,0
2021-06-10 13:00,122,76,46,0,0,0
2021-06-10 13:15,151,76,75,0,0,0
2021-06-10 13:30,141,63,78,0,0,0
2021-06-10 13:45,121,60,61,0,0,0
2021-06-10 14:00,118,55,63,0,0,0
2021-06-10 14:15,131,76,55,0,0,0
2021-06-10 14:30,141,66,75,0,0,0
2021-06-10 14:45,147,90,57,0,0,0
2021-06-10 15:00,130,73,57,0,0,0
2021-06-10 15:15,152,86,66,0,0,0
2021-06-10 15:30,144,82,62,0,0,0
2021-06-10 15:45,176,115,61,0,0,0
2021-06-10 16:00,171,107,64,0,0,0
2021-06-10 16:15,186,111,75,0,0,0
2021-06-10 16:30,164,103,61,0,0,0
2021-06-10 16:45,197,112,85,0,0,0
2021-06-10 17:00,153,73,80,0,0,0
2021-06-10 17:15,199,97,102,0,0,0
2021-06-10 17:30,138,82,56,0,0,0
2021-06-10 17:45,179,103,76,0,0,0
2021-06-10 18:00,163,83,80,0,0,0
2021-06-10 18:15,120,65,55,0,0,0
2021-06-10 18:30,147,91,56,0,0,0
2021-06-10 18:45,115,72,43,0,0,0
2021-06-10 19:00,116,55,61,0,0,0
2021-06-10 19:15,135,76,59,0,0,0
2021-06-10 19:30,95,61,34,0,0,0
2021-06-10 19:45,103,64,39,0,0,0
2021-06-10 20:00,105,57,48,0,0,0
2021-06-10 20:15,83,52,31,0,0,0
2021-06-10 20:30,76,44,32,0,0,0
2021-06-10 20:45,74,42,32,0,0,0
2021-06-10 21:00,60,40,20,0,0,0
2021-06-10 21:15,59,40,19,0,0,0
2021-06-10 21:30,79,57,22,0,0,0
2021-06-10 21:45,52,25,27,0,0,0
2021-06-10 22:00,57,23,34,0,0,0
2021-06-10 22:15,52,28,24,0,0,0
2021-06-10 22:30,50,30,20,0,0,0
2021-06-10 22:45,50,29,21,0,0,0
2021-06-10 23:00,57,36,21,0,0,0
2021-06-10 23:15,38,22,16,0,0,0
2021-06-10 23:30,29,14,15,0,0,0
2021-06-10 23:45,17,10,7,0,0,0
2021-06-11 00:00,14,7,7,0,0,0
2021-06-11 00:15,15,10,5,0,0,0
2021-06-11 00:30,10,6,4,0,0,0
2021-06-11 00:45,8,2,6,0,0,0
2021-06-11 01:00,6,2,4,0,0,0
2021-06-11 01:15,7,4,3,0,0,0
2021-06-11 01:30,4,2,2,0,0,0
2021-06-11 01:45,6,3,3,0,0,0
2021-06-11 02:00,2,0,2,0,0,0
2021-06-11 02:15,2,1,1,0,0,0
2021-06-11 02:30,4,4,0,0,0,0
2021-06-11 02:45,3,2,1,0,0,0
2021-06-11 03:00,1,1,0,0,0,0
2021-06-11 03:15,0,0,0,0,0,0
2021-06-11 03:30,0,0,0,0,0,0
2021-06-11 03:45,0,0,0,0,0,0
2021-06-11 04:00,1,1,0,0,0,0
2021-06-11 04:15,1,1,0,0,0,0
2021-06-11 04:30,1,1,0,0,0,0
2021-06-11 04:45,1,0,1,0,0,0
2021-06-11 05:00,1,1,0,0,0,0
2021-06-11 05:15,3,3,0,0,0,0
2021-06-11 05:30,12,7,5,0,0,0
2021-06-11 05:45,22,13,9,0,0,0
2021-06-11 06:00,30,21,9,0,0,0
2021-06-11 06:15,27,15,12,0,0,0
2021-06-11 06:30,38,27,11,0,0,0
2021-06-11 06:45,70,46,24,0,0,0
2021-06-11 07:00,74,51,23,0,0,0
2021-06-11 07:15,104,63,41,0,0,0
2021-06-11 07:30,195,133,62,0,0,0
2021-06-11 07:45,246,197,49,0,0,0
2021-06-11 08:00,211,182,29,0,0,0
2021-06-11 08:15,168,124,44,0,0,0
2021-06-11 08:30,132,105,27,0,0,0
2021-06-11 08:45,135,104,31,0,0,0
2021-06-11 09:00,109,69,40,0,0,0
2021-06-11 09:15,98,73,25,0,0,0
2021-06-11 09:30,120,89,31,0,0,0
2021-06-11 09:45,110,88,22,0,0,0
2021-06-11 10:00,89,69,20,0,0,0
2021-06-11 10:15,106,67,39,0,0,0
2021-06-11 10:30,113,79,34,0,0,0
2021-06-11 10:45,125,90,35,0,0,0
2021-06-11 11:00,116,80,36,0,0,0
2021-06-11 11:15,114,82,32,0,0,0
2021-06-11 11:30,117,79,38,0,0,0
2021-06-11 11:45,149,104,45,0,0,0
2021-06-11 12:00,111,71,40,0,0,0
2021-06-11 12:15,142,86,56,0,0,0
2021-06-11 12:30,137,78,59,0,0,0
2021-06-11 12:45,154,79,75,0,0,0
2021-06-11 13:00,154,86,68,0,0,0
2021-06-11 13:15,184,97,87,0,0,0
2021-06-11 13:30,146,84,62,0,0,0
2021-06-11 13:45,163,82,81,0,0,0
2021-06-11 14:00,183,101,82,0,0,0
2021-06-11 14:15,190,90,100,0,0,0
2021-06-11 14:30,188,105,83,0,0,0
2021-06-11 14:45,194,102,92,0,0,0
2021-06-11 15:00,182,93,89,0,0,0
2021-06-11 15:15,193,121,72,0,0,0
2021-06-11 15:30,160,90,70,0,0,0
2021-06-11 15:45,188,123,65,0,0,0
2021-06-11 16:00,190,106,84,0,0,0
2021-06-11 16:15,157,93,64,0,0,0
2021-06-11 16:30,141,84,57,0,0,0
2021-06-11 16:45,187,102,85,0,0,0
2021-06-11 17:00,144,80,64,0,0,0
2021-06-11 17:15,130,78,52,0,0,0
2021-06-11 17:30,158,100,58,0,0,0
2021-06-11 17:45,167,103,64,0,0,0
2021-06-11 18:00,180,101,79,0,0,0
2021-06-11 18:15,152,83,69,0,0,0
2021-06-11 18:30,144,88,56,0,0,0
2021-06-11 18:45,160,105,55,0,0,0
2021-06-11 19:00,130,81,49,0,0,0
2021-06-11 19:15,126,66,60,0,0,0
2021-06-11 19:30,94,52,42,0,0,0
2021-06-11 19:45,128,84,44,0,0,0
2021-06-11 20:00,128,77,51,0,0,0
2021-06-11 20:15,118,70,48,0,0,0
2021-06-11 20:30,89,66,23,0,0,0
2021-06-11 20:45,93,61,32,0,0,0
2021-06-11 21:00,56,34,22,0,0,0
2021-06-11 21:15,64,37,27,0,0,0
2021-06-11 21:30,65,42,23,0,0,0
2021-06-11 21:45,43,23,20,0,0,0
2021-06-11 22:00,49,25,24,0,0,0
2021-06-11 22:15,66,37,29,0,0,0
2021-06-11 22:30,37,17,20,0,0,0
2021-06-11 22:45,50,37,13,0,0,0
2021-06-11 23:00,56,32,24,0,0,0
2021-06-11 23:15,37,20,17,0,0,0
2021-06-11 23:30,55,29,26,0,0,0
2021-06-11 23:45,32,15,17,0,0,0
2021-06-12 00:00,49,28,21,0,0,0
2021-06-12 00:15,37,20,17,0,0,0
2021-06-12 00:30,31,8,23,0,0,0
2021-06-12 00:45,38,21,17,0,0,0
2021-06-12 01:00,37,14,23,0,0,0
2021-06-12 01:15,19,11,8,0,0,0
2021-06-12 01:30,24,15,9,0,0,0
2021-06-12 01:45,18,8,10,0,0,0
2021-06-12 02:00,22,10,12,0,0,0
2021-06-12 02:15,7,5,2,0,0,0
2021-06-12 02:30,17,6,11,0,0,0
2021-06-12 02:45,13,8,5,0,0,0
2021-06-12 03:00,11,2,9,0,0,0
2021-06-12 03:15,15,4,11,0,0,0
2021-06-12 03:30,11,6,5,0,0,0
2021-06-12 03:45,11,6,5,0,0,0
2021-06-12 04:00,9,7,2,0,0,0
2021-06-12 04:15,4,0,4,0,0,0
2021-06-12 04:30,4,3,1,0,0,0
2021-06-12 04:45,0,0,0,0,0,0
2021-06-12 05:00,0,0,0,0,0,0
2021-06-12 05:15,6,5,1,0,0,0
2021-06-12 05:30,12,8,4,0,0,0
2021-06-12 05:45,12,8,4,0,0,0
2021-06-12 06:00,8,6,2,0,0,0
2021-06-12 06:15,10,8,2,0,0,0
2021-06-12 06:30,17,14,3,0,0,0
2021-06-12 06:45,26,19,7,0,0,0
2021-06-12 07:00,10,6,4,0,0,0
2021-06-12 07:15,25,19,6,0,0,0
2021-06-12 07:30,38,27,11,0,0,0
2021-06-12 07:45,48,29,19,0,0,0
2021-06-12 08:00,54,37,17,0,0,0
2021-06-12 08:15,54,42,12,0,0,0
2021-06-12 08:30,60,40,20,0,0,0
2021-06-12 08:45,66,49,17,0,0,0
2021-06-12 09:00,70,43,27,0,0,0
2021-06-12 09:15,72,53,19,0,0,0
2021-06-12 09:30,96,76,20,0,0,0
2021-06-12 09:45,124,96,28,0,0,0
2021-06-12 10:00,114,69,45,0,0,0
2021-06-12 10:15,118,92,26,0,0,0
2021-06-12 10:30,142,95,47,0,0,0
2021-06-12 10:45,121,88,33,0,0,0
2021-06-12 11:00,154,114,40,0,0,0
2021-06-12 11:15,155,99,56,0,0,0
2021-06-12 11:30,151,109,42,0,0,0
2021-06-12 11:45,124,79,45,0,0,0
2021-06-12 12:00,137,86,51,0,0,0
2021-06-12 12:15,133,82,51,0,0,0
2021-06-12 12:30,159,91,68,0,0,0
2021-06-12 12:45,145,89,56,0,0,0
2021-06-12 13:00,154,89,65,0,0,0
2021-06-12 13:15,129,81,48,0,0,0
2021-06-12 13:30,133,77,56,0,0,0
2021-06-12 13:45,158,93,65,0,0,0
2021-06-12 14:00,148,83,65,0,0,0
2021-06-12 14:15,139,75,64,0,0,0
2021-06-12 14:30,132,65,67,0,0,0
2021-06-12 14:45,137,67,70,0,0,0
2021-06-12 15:00,122,64,58,0,0,0
2021-06-12 15:15,106,50,56,0,0,0
2021-06-12 15:30,113,65,48,0,0,0
2021-06-12 15:45,137,79,58,0,0,0
2021-06-12 16:00,145,87,58,0,0,0
2021-06-12 16:15,77,49,28,0,0,0
2021-06-12 16:30,138,71,67,0,0,0
2021-06-12 16:45,148,101,47,0,0,0
2021-06-12 17:00,118,82,36,0,0,0
2021-06-12 17:15,127,84,43,0,0,0
2021-06-12 17:30,124,89,35,0,0,0
2021-06-12 17:45,140,94,46,0,0,0
2021-06-12 18:00,115,61,54,0,0,0
2021-06-12 18:15,132,83,49,0,0,0
2021-06-12 18:30,121,76,45,0,0,0
2021-06-12 18:45,93,60,33,0,0,0
2021-06-12 19:00,106,52,54,0,0,0
2021-06-12 19:15,91,59,32,0,0,0
2021-06-12 19:30,80,48,32,0,0,0
2021-06-12 19:45,82,41,41,0,0,0
2021-06-12 20:00,109,62,47,0,0,0
2021-06-12 20:15,71,51,20,0,0,0
2021-06-12 20:30,58,28,30,0,0,0
2021-06-12 20:45,62,40,22,0,0,0
2021-06-12 21:00,61,36,25,0,0,0
2021-06-12 21:15,46,32,14,0,0,0
2021-06-12 21:30,41,18,23,0,0,0
2021-06-12 21:45,67,35,32,0,0,0
2021-06-12 22:00,46,24,22,0,0,0
2021-06-12 22:15,37,22,15,0,0,0
2021-06-12 22:30,34,15,19,0,0,0
2021-06-12 22:45,33,16,17,0,0,0
2021-06-12 23:00,51,32,19,0,0,0
2021-06-12 23:15,28,16,12,0,0,0
2021-06-12 23:30,35,16,19,0,0,0
2021-06-12 23:45,43,24,19,0,0,0
2021-06-13 00:00,36,21,15,0,0,0
2021-06-13 00:15,17,5,12,0,0,0
2021-06-13 00:30,30,15,15,0,0,0
2021-06-13 00:45,34,12,22,0,0,0
2021-06-13 01:00,31,13,18,0,0,0
2021-06-13 01:15,23,10,13,0,0,0
2021-06-13 01:30,19,7,12,0,0,0
2021-06-13 01:45,19,13,6,0,0,0
2021-06-13 02:00,23,3,20,0,0,0
2021-06-13 02:15,25,7,18,0,0,0
2021-06-13 02:30,18,7,11,0,0,0
2021-06-13 02:45,5,4,1,0,0,0
2021-06-13 03:00,11,6,5,0,0,0
2021-06-13 03:15,12,0,12,0,0,0
2021-06-13 03:30,9,1,8,0,0,0
2021-06-13 03:45,11,5,6,0,0,0
2021-06-13 04:00,0,0,0,0,0,0
2021-06-13 04:15,13,5,8,0,0,0
2021-06-13 04:30,8,4,4,0,0,0
2021-06-13 04:45,4,2,2,0,0,0
2021-06-13 05:00,3,0,3,0,0,0
2021-06-13 05:15,3,1,2,0,0,0
2021-06-13 05:30,13,9,4,0,0,0
2021-06-13 05:45,4,2,2,0,0,0
2021-06-13 06:00,10,5,5,0,0,0
2021-06-13 06:15,10,6,4,0,0,0
2021-06-13 06:30,3,3,0,0,0,0
2021-06-13 06:45,7,4,3,0,0,0
2021-06-13 07:00,7,5,2,0,0,0
2021-06-13 07:15,6,6,0,0,0,0
2021-06-13 07:30,5,3,2,0,0,0
2021-06-13 07:45,15,12,3,0,0,0
2021-06-13 08:00,8,5,3,0,0,0
2021-06-13 08:15,12,7,5,0,0,0
2021-06-13 08:30,11,4,7,0,0,0
2021-06-13 08:45,24,12,12,0,0,0
2021-06-13 09:00,22,16,6,0,0,0
2021-06-13 09:15,26,9,17,0,0,0
2021-06-13 09:30,29,19,10,0,0,0
2021-06-13 09:45,50,35,15,0,0,0
2021-06-13 10:00,57,34,23,0,0,0
2021-06-13 10:15,39,27,12,0,0,0
2021-06-13 10:30,60,43,17,0,0,0
2021-06-13 10:45,82,42,40,0,0,0
2021-06-13 11:00,75,44,31,0,0,0
2021-06-13 11:15,59,39,20,0,0,0
2021-06-13 11:30,69,32,37,0,0,0
2021-06-13 11:45,60,37,23,0,0,0
2021-06-13 12:00,78,44,34,0,0,0
2021-06-13 12:15,81,41,40,0,0,0
2021-06-13 12:30,80,39,41,0,0,0
2021-06-13 12:45,93,59,34,0,0,0
2021-06-13 13:00,75,48,27,0,0,0
2021-06-13 13:15,79,49,30,0,0,0
2021-06-13 13:30,95,66,29,0,0,0
2021-06-13 13:45,123,83,40,0,0,0
2021-06-13 14:00,110,71,39,0,0,0
2021-06-13 14:15,107,67,40,0,0,0
2021-06-13 14:30,108,78,30,0,0,0
2021-06-13 14:45,109,69,40,0,0,0
2021-06-13 15:00,107,56,51,0,0,0
2021-06-13 15:15,94,57,37,0,0,0
2021-06-13 15:30,113,67,46,0,0,0
2021-06-13 15:45,87,55,32,0,0,0
2021-06-13 16:00,125,74,51,0,0,0
2021-06-13 16:15,113,72,41,0,0,0
2021-06-13 16:30,72,46,26,0,0,0
2021-06-13 16:45,117,90,27,0,0,0
2021-06-13 17:00,117,79,38,0,0,0
2021-06-13 17:15,104,65,39,0,0,0
2021-06-13 17:30,123,84,39,0,0,0
2021-06-13 17:45,96,64,32,0,0,0
2021-06-13 18:00,99,62,37,0,0,0
2021-06-13 18:15,99,60,39,0,0,0
2021-06-13 18:30,96,69,27,0,0,0
2021-06-13 18:45,105,72,33,0,0,0
2021-06-13 19:00,78,56,22,0,0,0
2021-06-13 19:15,49,29,20,0,0,0
2021-06-13 19:30,84,48,36,0,0,0
2021-06-13 19:45,54,40,14,0,0,0
2021-06-13 20:00,74,49,25,0,0,0
2021-06-13 20:15,59,38,21,0,0,0
2021-06-13 20:30,58,36,22,0,0,0
2021-06-13 20:45,50,34,16,0,0,0
2021-06-13 21:00,44,26,18,0,0,0
2021-06-13 21:15,25,19,6,0,0,0
2021-06-13 21:30,47,16,31,0,0,0
2021-06-13 21:45,38,25,13,0,0,0
2021-06-13 22:00,31,24,7,0,0,0
2021-06-13 22:15,22,14,8,0,0,0
2021-06-13 22:30,20,7,13,0,0,0
2021-06-13 22:45,13,7,6,0,0,0
2021-06-13 23:00,32,17,15,0,0,0
2021-06-13 23:15,21,14,7,0,0,0
2021-06-13 23:30,15,14,1,0,0,0
2021-06-13 23:45,9,5,4,0,0,0
2021-06-14 00:00,8,5,3,0,0,0
2021-06-14 00:15,4,4,0,0,0,0
2021-06-14 00:30,5,4,1,0,0,0
2021-06-14 00:45,6,2,4,0,0,0
2021-06-14 01:00,4,0,4,0,0,0
2021-06-14 01:15,2,1,1,0,0,0
2021-06-14 01:30,2,1,1,0,0,0
2021-06-14 01:45,5,0,5,0,0,0
2021-06-14 02:00,2,2,0,0,0,0
2021-06-14 02:15,1,0,1,0,0,0
2021-06-14 02:30,1,0,1,0,0,0
2021-06-14 02:45,0,0,0,0,0,0
2021-06-14 03:00,1,0,1,0,0,0
2021-06-14 03:15,0,0,0,0,0,0
2021-06-14 03:30,0,0,0,0,0,0
2021-06-14 03:45,0,0,0,0,0,0
2021-06-14 04:00,0,0,0,0,0,0
2021-06-14 04:15,1,0,1,0,0,0
2021-06-14 04:30,0,0,0,0,0,0
2021-06-14 04:45,3,2,1,0,0,0
2021-06-14 05:00,3,3,0,0,0,0
2021-06-14 05:15,4,1,3,0,0,0
2021-06-14 05:30,23,14,9,0,0,0
2021-06-14 05:45,23,14,9,0,0,0
2021-06-14 06:00,23,17,6,0,0,0
2021-06-14 06:15,31,18,13,0,0,0
2021-06-14 06:30,51,26,25,0,0,0
2021-06-14 06:45,81,61,20,0,0,0
2021-06-14 07:00,81,48,33,0,0,0
2021-06-14 07:15,128,83,45,0,0,0
2021-06-14 07:30,183,136,47,0,0,0
2021-06-14 07:45,255,195,60,0,0,0
2021-06-14 08:00,262,218,44,0,0,0
2021-06-14 08:15,168,120,48,0,0,0
2021-06-14 08:30,150,115,35,0,0,0
2021-06-14 08:45,158,117,41,0,0,0
2021-06-14 09:00,96,69,27,0,0,0
2021-06-14 09:15,85,61,24,0,0,0
2021-06-14 09:30,107,73,34,0,0,0
2021-06-14 09:45,127,83,44,0,0,0
2021-06-14 10:00,88,64,24,0,0,0
2021-06-14 10:15,114,77,37,0,0,0
2021-06-14 10:30,109,73,36,0,0,0
2021-06-14 10:45,112,73,39,0,0,0
2021-06-14 11:00,111,65,46,0,0,0
2021-06-14 11:15,103,72,31,0,0,0
2021-06-14 11:30,97,75,22,0,0,0
2021-06-14 11:45,113,70,43,0,0,0
2021-06-14 12:00,108,68,40,0,0,0
2021-06-14 12:15,112,76,36,0,0,0
2021-06-14 12:30,126,80,46,0,0,0
2021-06-14 12:45,107,77,30,0,0,0
2021-06-14 13:00,145,69,76,0,0,0
2021-06-14 13:15,125,60,65,0,0,0
2021-06-14 13:30,137,71,66,0,0,0
2021-06-14 13:45,148,78,70,0,0,0
2021-06-14 14:00,123,55,68,0,0,0
2021-06-14 14:15,144,74,70,0,0,0
2021-06-14 14:30,142,90,52,0,0,0
2021-06-14 14:45,180,116,64,0,0,0
2021-06-14 15:00,156,85,71,0,0,0
2021-06-14 15:15,144,79,65,0,0,0
2021-06-14 15:30,137,69,68,0,0,0
2021-06-14 15:45,186,112,74,0,0,0
2021-06-14 16:00,199,108,91,0,0,0
2021-06-14 16:15,165,80,85,0,0,0
2021-06-14 16:30,163,100,63,0,0,0
2021-06-14 16:45,227,127,100,0,0,0
2021-06-14 17:00,163,87,76,0,0,0
2021-06-14 17:15,174,106,68,0,0,0
2021-06-14 17:30,184,123,61,0,0,0
2021-06-14 17:45,170,82,88,0,0,0
2021-06-14 18:00,183,103,80,0,0,0
2021-06-14 18:15,153,74,79,0,0,0
2021-06-14 18:30,147,80,67,0,0,0
2021-06-14 18:45,140,78,62,0,0,0
2021-06-14 19:00,109,63,46,0,0,0
2021-06-14 19:15,125,59,66,0,0,0
2021-06-14 19:30,93,65,28,0,0,0
2021-06-14 19:45,107,70,37,0,0,0
2021-06-14 20:00,96,67,29,0,0,0
2021-06-14 20:15,77,46,31,0,0,0
2021-06-14 20:30,81,55,26,0,0,0
2021-06-14 20:45,68,49,19,0,0,0
2021-06-14 21:00,52,28,24,0,0,0
2021-06-14 21:15,63,36,27,0,0,0
2021-06-14 21:30,47,23,24,0,0,0
2021-06-14 21:45,63,39,24,0,0,0
2021-06-14 22:00,43,20,23,0,0,0
2021-06-14 22:15,43,20,23,0,0,0
2021-06-14 22:30,43,24,19,0,0,0
2021-06-14 22:45,50,28,22,0,0,0
2021-06-14 23:00,22,15,7,0,0,0
2021-06-14 23:15,22,13,9,0,0,0
2021-06-14 23:30,25,16,9,0,0,0
2021-06-14 23:45,20,11,9,0,0,0
2021-06-15 00:00,12,4,8,0,0,0
2021-06-15 00:15,7,4,3,0,0,0
2021-06-15 00:30,7,2,5,0,0,0
2021-06-15 00:45,5,1,4,0,0,0
2021-06-15 01:00,6,4,2,0,0,0
2021-06-15 01:15,2,0,2,0,0,0
2021-06-15 01:30,1,1,0,0,0,0
2021-06-15 01:45,4,2,2,0,0,0
2021-06-15 02:00,3,3,0,0,0,0
2021-06-15 02:15,2,0,2,0,0,0
2021-06-15 02:30,4,2,2,0,0,0
2021-06-15 02:45,2,0,2,0,0,0
2021-06-15 03:00,1,1,0,0,0,0
2021-06-15 03:15,1,0,1,0,0,0
2021-06-15 03:30,1,1,0,0,0,0
2021-06-15 03:45,1,0,1,0,0,0
2021-06-15 04:00,1,1,0,0,0,0
2021-06-15 04:15,3,1,2,0,0,0
2021-06-15 04:30,0,0,0,0,0,0
2021-06-15 04:45,8,4,4,0,0,0
2021-06-15 05:00,3,2,1,0,0,0
2021-06-15 05:15,5,5,0,0,0,0
2021-06-15 05:30,25,10,15,0,0,0
2021-06-15 05:45,25,11,14,0,0,0
2021-06-15 06:00,23,14,9,0,0,0
2021-06-15 06:15,48,27,21,0,0,0
2021-06-15 06:30,48,27,21,0,0,0
2021-06-15 06:45,72,47,25,0,0,0
2021-06-15 07:00,88,65,23,0,0,0
2021-06-15 07:15,139,92,47,0,0,0
2021-06-15 07:30,174,121,53,0,0,0
2021-06-15 07:45,276,214,62,0,0,0
2021-06-15 08:00,225,184,41,0,0,0
2021-06-15 08:15,191,138,53,0,0,0
2021-06-15 08:30,146,113,33,0,0,0
2021-06-15 08:45,154,110,44,0,0,0
2021-06-15 09:00,100,72,28,0,0,0
2021-06-15 09:15,112,81,31,0,0,0
2021-06-15 09:30,121,83,38,0,0,0
2021-06-15 09:45,124,100,24,0,0,0
2021-06-15 10:00,109,73,36,0,0,0
2021-06-15 10:15,111,78,33,0,0,0
2021-06-15 10:30,100,65,35,0,0,0
2021-06-15 10:45,131,83,48,0,0,0
2021-06-15 11:00,81,54,27,0,0,0
2021-06-15 11:15,117,81,36,0,0,0
2021-06-15 11:30,133,95,38,0,0,0
2021-06-15 11:45,139,91,48,0,0,0
2021-06-15 12:00,92,57,35,0,0,0
2021-06-15 12:15,114,66,48,0,0,0
2021-06-15 12:30,112,77,35,0,0,0
2021-06-15 12:45,156,91,65,0,0,0
2021-06-15 13:00,146,82,64,0,0,0
2021-06-15 13:15,138,69,69,0,0,0
2021-06-15 13:30,114,62,52,0,0,0
2021-06-15 13:45,160,94,66,0,0,0
2021-06-15 14:00,122,84,38,0,0,0
2021-06-15 14:15,145,81,64,0,0,0
2021-06-15 14:30,169,86,83,0,0,0
2021-06-15 14:45,176,122,54,0,0,0
2021-06-15 15:00,145,89,56,0,0,0
2021-06-15 15:15,131,73,58,0,0,0
2021-06-15 15:30,139,70,69,0,0,0
2021-06-15 15:45,168,115,53,0,0,0
2021-06-15 16:00,146,83,63,0,0,0
2021-06-15 16:15,188,109,79,0,0,0
2021-06-15 16:30,169,107,62,0,0,0
2021-06-15 16:45,207,109,98,0,0,0
2021-06-15 17:00,160,98,62,0,0,0
2021-06-15 17:15,165,90,75,0,0,0
2021-06-15 17:30,203,128,75,0,0,0
2021-06-15 17:45,203,116,87,0,0,0
2021-06-15 18:00,177,93,84,0,0,0
2021-06-15 18:15,130,77,53,0,0,0
2021-06-15 18:30,147,81,66,0,0,0
2021-06-15 18:45,138,70,68,0,0,0
2021-06-15 19:00,128,78,50,0,0,0
2021-06-15 19:15,118,66,52,0,0,0
2021-06-15 19:30,97,54,43,0,0,0
2021-06-15 19:45,102,63,39,0,0,0
2021-06-15 20:00,114,68,46,0,0,0
2021-06-15 20:15,109,63,46,0,0,0
2021-06-15 20:30,109,69,40,0,0,0
2021-06-15 20:45,84,31,53,0,0,0
2021-06-15 21:00,49,24,25,0,0,0
2021-06-15 21:15,45,25,20,0,0,0
2021-06-15 21:30,45,18,27,0,0,0
2021-06-15 21:45,37,19,18,0,0,0
2021-06-15 22:00,50,19,31,0,0,0
2021-06-15 22:15,25,14,11,0,0,0
2021-06-15 22:30,35,13,22,0,0,0
2021-06-15 22:45,19,8,11,0,0,0
2021-06-15 23:00,124,75,49,0,0,0
2021-06-15 23:15,116,71,45,0,0,0
2021-06-15 23:30,82,34,48,0,0,0
2021-06-15 23:45,41,17,24,0,0,0
2021-06-16 00:00,25,14,11,0,0,0
2021-06-16 00:15,29,10,19,0,0,0
2021-06-16 00:30,15,5,10,0,0,0
2021-06-16 00:45,21,12,9,0,0,0
2021-06-16 01:00,11,6,5,0,0,0
2021-06-16 01:15,7,4,3,0,0,0
2021-06-16 01:30,7,5,2,0,0,0
2021-06-16 01:45,8,3,5,0,0,0
2021-06-16 02:00,2,2,0,0,0,0
2021-06-16 02:15,5,2,3,0,0,0
2021-06-16 02:30,4,3,1,0,0,0
2021-06-16 02:45,6,4,2,0,0,0
2021-06-16 03:00,1,0,1,0,0,0
2021-06-16 03:15,1,0,1,0,0,0
2021-06-16 03:30,1,1,0,0,0,0
2021-06-16 03:45,0,0,0,0,0,0
2021-06-16 04:00,1,0,1,0,0,0
2021-06-16 04:15,2,1,1,0,0,0
2021-06-16 04:30,3,3,0,0,0,0
2021-06-16 04:45,1,0,1,0,0,0
2021-06-16 05:00,2,1,1,0,0,0
2021-06-16 05:15,7,6,1,0,0,0
2021-06-16 05:30,22,13,9,0,0,0
2021-06-16 05:45,29,15,14,0,0,0
2021-06-16 06:00,16,10,6,0,0,0
2021-06-16 06:15,35,23,12,0,0,0
2021-06-16 06:30,55,35,20,0,0,0
2021-06-16 06:45,84,61,23,0,0,0
2021-06-16 07:00,93,65,28,0,0,0
2021-06-16 07:15,150,105,45,0,0,0
2021-06-16 07:30,191,121,70,0,0,0
2021-06-16 07:45,281,220,61,0,0,0
2021-06-16 08:00,244,202,42,0,0,0
2021-06-16 08:15,203,147,56,0,0,0
2021-06-16 08:30,180,142,38,0,0,0
2021-06-16 08:45,190,147,43,0,0,0
2021-06-16 09:00,126,87,39,0,0,0
2021-06-16 09:15,140,98,42,0,0,0
2021-06-16 09:30,130,104,26,0,0,0
2021-06-16 09:45,146,108,38,0,0,0
2021-06-16 10:00,117,86,31,0,0,0
2021-06-16 10:15,157,100,57,0,0,0
2021-06-16 10:30,174,122,52,0,0,0
2021-06-16 10:45,143,101,42,0,0,0
2021-06-16 11:00,98,67,31,0,0,0
2021-06-16 11:15,132,88,44,0,0,0
2021-06-16 11:30,137,94,43,0,0,0
2021-06-16 11:45,134,78,56,0,0,0
2021-06-16 12:00,146,88,58,0,0,0
2021-06-16 12:15,138,87,51,0,0,0
2021-06-16 12:30,128,78,50,0,0,0
2021-06-16 12:45,135,83,52,0,0,0
2021-06-16 13:00,131,71,60,0,0,0
2021-06-16 13:15,155,89,66,0,0,0
2021-06-16 13:30,171,80,91,0,0,0
2021-06-16 13:45,144,85,59,0,0,0
2021-06-16 14:00,154,75,79,0,0,0
2021-06-16 14:15,157,64,93,0,0,0
2021-06-16 14:30,170,82,88,0,0,0
2021-06-16 14:45,163,84,79,0,0,0
2021-06-16 15:00,133,69,64,0,0,0
2021-06-16 15:15,104,62,42,0,0,0
2021-06-16 15:30,148,88,60,0,0,0
2021-06-16 15:45,159,84,75,0,0,0
2021-06-16 16:00,156,86,70,0,0,0
2021-06-16 16:15,145,83,62,0,0,0
2021-06-16 16:30,168,89,79,0,0,0
2021-06-16 16:45,163,88,75,0,0,0
2021-06-16 17:00,136,68,68,0,0,0
2021-06-16 17:15,189,87,102,0,0,0
2021-06-16 17:30,196,108,88,0,0,0
2021-06-16 17:45,177,105,72,0,0,0
2021-06-16 18:00,163,83,80,0,0,0
2021-06-16 18:15,169,90,79,0,0,0
2021-06-16 18:30,151,87,64,0,0,0
2021-06-16 18:45,149,92,57,0,0,0
2021-06-16 19:00,156,95,61,0,0,0
2021-06-16 19:15,159,96,63,0,0,0
2021-06-16 19:30,104,67,37,0,0,0
2021-06-16 19:45,126,76,50,0,0,0
2021-06-16 20:00,133,73,60,0,0,0
2021-06-16 20:15,116,74,42,0,0,0
2021-06-16 20:30,112,70,42,0,0,0
2021-06-16 20:45,77,53,24,0,0,0
2021-06-16 21:00,88,65,23,0,0,0
2021-06-16 21:15,78,57,21,0,0,0
2021-06-16 21:30,76,46,30,0,0,0
2021-06-16 21:45,61,36,25,0,0,0
2021-06-16 22:00,48,26,22,0,0,0
2021-06-16 22:15,54,29,25,0,0,0
2021-06-16 22:30,63,33,30,0,0,0
2021-06-16 22:45,66,37,29,0,0,0
2021-06-16 23:00,47,33,14,0,0,0
2021-06-16 23:15,36,20,16,0,0,0
2021-06-16 23:30,14,4,10,0,0,0
2021-06-16 23:45,21,14,7,0,0,0
2021-06-17 00:00,24,14,10,0,0,0
2021-06-17 00:15,21,9,12,0,0,0
2021-06-17 00:30,11,4,7,0,0,0
2021-06-17 00:45,10,4,6,0,0,0
2021-06-17 01:00,7,3,4,0,0,0
2021-06-17 01:15,8,5,3,0,0,0
2021-06-17 01:30,8,3,5,0,0,0
2021-06-17 01:45,9,5,4,0,0,0
2021-06-17 02:00,12,6,6,0,0,0
2021-06-17 02:15,5,2,3,0,0,0
2021-06-17 02:30,6,3,3,0,0,0
2021-06-17 02:45,4,2,2,0,0,0
2021-06-17 03:00,6,0,6,0,0,0
2021-06-17 03:15,1,1,0,0,0,0
2021-06-17 03:30,2,1,1,0,0,0
2021-06-17 03:45,2,0,2,0,0,0
2021-06-17 04:00,1,0,1,0,0,0
2021-06-17 04:15,5,0,5,0,0,0
2021-06-17 04:30,3,2,1,0,0,0
2021-06-17 04:45,0,0,0,0,0,0
2021-06-17 05:00,5,3,2,0,0,0
2021-06-17 05:15,6,4,2,0,0,0
2021-06-17 05:30,18,13,5,0,0,0
2021-06-17 05:45,22,11,11,0,0,0
2021-06-17 06:00,19,12,7,0,0,0
2021-06-17 06:15,32,22,10,0,0,0
2021-06-17 06:30,41,27,14,0,0,0
2021-06-17 06:45,72,52,20,0,0,0
2021-06-17 07:00,79,59,20,0,0,0
2021-06-17 07:15,105,66,39,0,0,0
2021-06-17 07:30,175,126,49,0,0,0
2021-06-17 07:45,266,207,59,0,0,0
2021-06-17 08:00,211,187,24,0,0,0
2021-06-17 08:15,173,139,34,0,0,0
2021-06-17 08:30,156,121,35,0,0,0
2021-06-17 08:45,126,96,30,0,0,0
2021-06-17 09:00,116,86,30,0,0,0
2021-06-17 09:15,111,77,34,0,0,0
2021-06-17 09:30,93,64,29,0,0,0
2021-06-17 09:45,136,98,38,0,0,0
2021-06-17 10:00,95,65,30,0,0,0
2021-06-17 10:15,86,56,30,0,0,0
2021-06-17 10:30,96,66,30,0,0,0
2021-06-17 10:45,98,68,30,0,0,0
2021-06-17 11:00,92,57,35,0,0,0
2021-06-17 11:15,99,62,37,0,0,0
2021-06-17 11:30,126,79,47,0,0,0
2021-06-17 11:45,131,60,71,0,0,0
2021-06-17 12:00,145,67,78,0,0,0
2021-06-17 12:15,115,62,53,0,0,0
2021-06-17 12:30,130,77,53,0,0,0
2021-06-17 12:45,157,82,75,0,0,0
2021-06-17 13:00,127,71,56,0,0,0
2021-06-17 13:15,112,58,54,0,0,0
2021-06-17 13:30,130,57,73,0,0,0
2021-06-17 13:45,125,62,63,0,0,0
2021-06-17 14:00,111,59,52,0,0,0
2021-06-17 14:15,137,72,65,0,0,0
2021-06-17 14:30,141,67,74,0,0,0
2021-06-17 14:45,164,97,67,0,0,0
2021-06-17 15:00,127,69,58,0,0,0
2021-06-17 15:15,140,78,62,0,0,0
2021-06-17 15:30,151,82,69,0,0,0
2021-06-17 15:45,167,101,66,0,0,0
2021-06-17 16:00,178,89,89,0,0,0
2021-06-17 16:15,159,79,80,0,0,0
2021-06-17 16:30,178,113,65,0,0,0
2021-06-17 16:45,178,90,88,0,0,0
2021-06-17 17:00,143,76,67,0,0,0
2021-06-17 17:15,187,104,83,0,0,0
2021-06-17 17:30,154,84,70,0,0,0
2021-06-17 17:45,180,94,86,0,0,0
2021-06-17 18:00,221,113,108,0,0,0
2021-06-17 18:15,169,88,81,0,0,0
2021-06-17 18:30,167,91,76,0,0,0
2021-06-17 18:45,170,92,78,0,0,0
2021-06-17 19:00,141,83,58,0,0,0
2021-06-17 19:15,170,108,62,0,0,0
2021-06-17 19:30,115,62,53,0,0,0
2021-06-17 19:45,124,71,53,0,0,0
2021-06-17 20:00,115,72,43,0,0,0
2021-06-17 20:15,119,79,40,0,0,0
2021-06-17 20:30,100,61,39,0,0,0
2021-06-17 20:45,98,74,24,0,0,0
2021-06-17 21:00,85,58,27,0,0,0
2021-06-17 21:15,129,91,38,0,0,0
2021-06-17 21:30,87,67,20,0,0,0
2021-06-17 21:45,79,47,32,0,0,0
2021-06-17 22:00,58,34,24,0,0,0
2021-06-17 22:15,67,43,24,0,0,0
2021-06-17 22:30,61,43,18,0,0,0
2021-06-17 22:45,62,43,19,0,0,0
2021-06-17 23:00,71,49,22,0,0,0
2021-06-17 23:15,38,22,16,0,0,0
2021-06-17 23:30,33,22,11,0,0,0
2021-06-17 23:45,25,21,4,0,0,0
2021-06-18 00:00,37,23,14,0,0,0
2021-06-18 00:15,20,15,5,0,0,0
2021-06-18 00:30,16,11,5,0,0,0
2021-06-18 00:45,22,14,8,0,0,0
2021-06-18 01:00,10,6,4,0,0,0
2021-06-18 01:15,9,5,4,0,0,0
2021-06-18 01:30,8,3,5,0,0,0
2021-06-18 01:45,9,8,1,0,0,0
2021-06-18 02:00,1,0,1,0,0,0
2021-06-18 02:15,9,6,3,0,0,0
2021-06-18 02:30,4,1,3,0,0,0
2021-06-18 02:45,4,2,2,0,0,0
2021-06-18 03:00,4,0,4,0,0,0
2021-06-18 03:15,3,3,0,0,0,0
2021-06-18 03:30,0,0,0,0,0,0
2021-06-18 03:45,0,0,0,0,0,0
2021-06-18 04:00,5,1,4,0,0,0
2021-06-18 04:15,2,1,1,0,0,0
2021-06-18 04:30,2,2,0,0,0,0
2021-06-18 04:45,2,0,2,0,0,0
2021-06-18 05:00,3,2,1,0,0,0
2021-06-18 05:15,6,4,2,0,0,0
2021-06-18 05:30,14,14,0,0,0,0
2021-06-18 05:45,20,12,8,0,0,0
2021-06-18 06:00,23,12,11,0,0,0
2021-06-18 06:15,26,17,9,0,0,0
2021-06-18 06:30,36,25,11,0,0,0
2021-06-18 06:45,51,34,17,0,0,0
2021-06-18 07:00,69,47,22,0,0,0
2021-06-18 07:15,114,82,32,0,0,0
2021-06-18 07:30,155,119,36,0,0,0
2021-06-18 07:45,219,175,44,0,0,0
2021-06-18 08:00,220,192,28,0,0,0
2021-06-18 08:15,162,129,33,0,0,0
2021-06-18 08:30,129,95,34,0,0,0
2021-06-18 08:45,147,116,31,0,0,0
2021-06-18 09:00,87,67,20,0,0,0
2021-06-18 09:15,107,74,33,0,0,0
2021-06-18 09:30,107,79,28,0,0,0
2021-06-18 09:45,113,91,22,0,0,0
2021-06-18 10:00,87,61,26,0,0,0
2021-06-18 10:15,102,65,37,0,0,0
2021-06-18 10:30,86,60,26,0,0,0
2021-06-18 10:45,111,71,40,0,0,0
2021-06-18 11:00,101,57,44,0,0,0
2021-06-18 11:15,96,57,39,0,0,0
2021-06-18 11:30,95,50,45,0,0,0
2021-06-18 11:45,141,82,59,0,0,0
2021-06-18 12:00,118,71,47,0,0,0
2021-06-18 12:15,119,70,49,0,0,0
2021-06-18 12:30,120,78,42,0,0,0
2021-06-18 12:45,121,62,59,0,0,0
2021-06-18 13:00,156,77,79,0,0,0
2021-06-18 13:15,158,64,94,0,0,0
2021-06-18 13:30,157,99,58,0,0,0
2021-06-18 13:45,138,77,61,0,0,0
2021-06-18 14:00,156,86,70,0,0,0
2021-06-18 14:15,155,90,65,0,0,0
2021-06-18 14:30,140,71,69,0,0,0
2021-06-18 14:45,149,78,71,0,0,0
2021-06-18 15:00,125,67,58,0,0,0
2021-06-18 15:15,154,90,64,0,0,0
2021-06-18 15:30,155,88,67,0,0,0
2021-06-18 15:45,121,74,47,0,0,0
2021-06-18 16:00,126,66,60,0,0,0
2021-06-18 16:15,146,77,69,0,0,0
2021-06-18 16:30,137,78,59,0,0,0
2021-06-18 16:45,107,61,46,0,0,0
2021-06-18 17:00,115,67,48,0,0,0
2021-06-18 17:15,121,57,64,0,0,0
2021-06-18 17:30,124,79,45,0,0,0
2021-06-18 17:45,167,90,77,0,0,0
2021-06-18 18:00,127,69,58,0,0,0
2021-06-18 18:15,102,49,53,0,0,0
2021-06-18 18:30,129,75,54,0,0,0
2021-06-18 18:45,125,85,40,0,0,0
2021-06-18 19:00,134,85,49,0,0,0
2021-06-18 19:15,116,71,45,0,0,0
2021-06-18 19:30,94,62,32,0,0,0
2021-06-18 19:45,106,64,42,0,0,0
2021-06-18 20:00,75,40,35,0,0,0
2021-06-18 20:15,96,51,45,0,0,0
2021-06-18 20:30,71,46,25,0,0,0
2021-06-18 20:45,60,37,23,0,0,0
2021-06-18 21:00,63,33,30,0,0,0
2021-06-18 21:15,71,50,21,0,0,0
2021-06-18 21:30,59,37,22,0,0,0
2021-06-18 21:45,50,35,15,0,0,0
2021-06-18 22:00,51,30,21,0,0,0
2021-06-18 22:15,41,21,20,0,0,0
2021-06-18 22:30,50,29,21,0,0,0
2021-06-18 22:45,63,39,24,0,0,0
2021-06-18 23:00,55,25,30,0,0,0
2021-06-18 23:15,47,26,21,0,0,0
2021-06-18 23:30,44,26,18,0,0,0
2021-06-18 23:45,51,24,27,0,0,0
2021-06-19 00:00,42,24,18,0,0,0
2021-06-19 00:15,30,20,10,0,0,0
2021-06-19 00:30,35,17,18,0,0,0
2021-06-19 00:45,30,13,17,0,0,0
2021-06-19 01:00,26,12,14,0,0,0
2021-06-19 01:15,27,16,11,0,0,0
2021-06-19 01:30,24,13,11,0,0,0
2021-06-19 01:45,17,9,8,0,0,0
2021-06-19 02:00,17,9,8,0,0,0
2021-06-19 02:15,15,2,13,0,0,0
2021-06-19 02:30,20,11,9,0,0,0
2021-06-19 02:45,11,7,4,0,0,0
2021-06-19 03:00,4,2,2,0,0,0
2021-06-19 03:15,12,6,6,0,0,0
2021-06-19 03:30,6,1,5,0,0,0
2021-06-19 03:45,4,1,3,0,0,0
2021-06-19 04:00,5,1,4,0,0,0
2021-06-19 04:15,10,5,5,0,0,0
2021-06-19 04:30,7,4,3,0,0,0
2021-06-19 04:45,8,5,3,0,0,0
2021-06-19 05:00,3,1,2,0,0,0
2021-06-19 05:15,10,7,3,0,0,0
2021-06-19 05:30,11,7,4,0,0,0
2021-06-19 05:45,11,7,4,0,0,0
2021-06-19 06:00,14,9,5,0,0,0
2021-06-19 06:15,11,6,5,0,0,0
2021-06-19 06:30,16,13,3,0,0,0
2021-06-19 06:45,20,11,9,0,0,0
2021-06-19 07:00,25,18,7,0,0,0
2021-06-19 07:15,37,32,5,0,0,0
2021-06-19 07:30,39,26,13,0,0,0
2021-06-19 07:45,38,25,13,0,0,0
2021-06-19 08:00,53,36,17,0,0,0
2021-06-19 08:15,51,39,12,0,0,0
2021-06-19 08:30,60,40,20,0,0,0
2021-06-19 08:45,73,53,20,0,0,0
2021-06-19 09:00,78,50,28,0,0,0
2021-06-19 09:15,113,80,33,0,0,0
2021-06-19 09:30,127,97,30,0,0,0
2021-06-19 09:45,140,112,28,0,0,0
2021-06-19 10:00,119,91,28,0,0,0
2021-06-19 10:15,148,105,43,0,0,0
2021-06-19 10:30,145,112,33,0,0,0
2021-06-19 10:45,164,106,58,0,0,0
2021-06-19 11:00,153,106,47,0,0,0
2021-06-19 11:15,161,106,55,0,0,0
2021-06-19 11:30,146,110,36,0,0,0
2021-06-19 11:45,172,112,60,0,0,0
2021-06-19 12:00,163,113,50,0,0,0
2021-06-19 12:15,130,81,49,0,0,0
2021-06-19 12:30,147,85,62,0,0,0
2021-06-19 12:45,130,68,62,0,0,0
2021-06-19 13:00,154,95,59,0,0,0
2021-06-19 13:15,140,63,77,0,0,0
2021-06-19 13:30,134,76,58,0,0,0
2021-06-19 13:45,144,85,59,0,0,0
2021-06-19 14:00,128,59,69,0,0,0
2021-06-19 14:15,139,75,64,0,0,0
2021-06-19 14:30,104,57,47,0,0,0
2021-06-19 14:45,125,52,73,0,0,0
2021-06-19 15:00,115,56,59,0,0,0
2021-06-19 15:15,128,64,64,0,0,0
2021-06-19 15:30,94,42,52,0,0,0
2021-06-19 15:45,105,58,47,0,0,0
2021-06-19 16:00,121,63,58,0,0,0
2021-06-19 16:15,117,61,56,0,0,0
2021-06-19 16:30,97,59,38,0,0,0
2021-06-19 16:45,148,95,53,0,0,0
2021-06-19 17:00,139,79,60,0,0,0
2021-06-19 17:15,167,116,51,0,0,0
2021-06-19 17:30,142,99,43,0,0,0
2021-06-19 17:45,160,105,55,0,0,0
2021-06-19 18:00,100,58,42,0,0,0
2021-06-19 18:15,86,50,36,0,0,0
2021-06-19 18:30,44,22,22,0,0,0
2021-06-19 18:45,69,47,22,0,0,0
2021-06-19 19:00,44,24,20,0,0,0
2021-06-19 19:15,46,27,19,0,0,0
2021-06-19 19:30,57,31,26,0,0,0
2021-06-19 19:45,67,34,33,0,0,0
2021-06-19 20:00,70,45,25,0,0,0
2021-06-19 20:15,78,42,36,0,0,0
2021-06-19 20:30,74,35,39,0,0,0
2021-06-19 20:45,61,43,18,0,0,0
2021-06-19 21:00,55,23,32,0,0,0
2021-06-19 21:15,43,27,16,0,0,0
2021-06-19 21:30,54,30,24,0,0,0
2021-06-19 21:45,51,30,21,0,0,0
2021-06-19 22:00,19,12,7,0,0,0
2021-06-19 22:15,60,39,21,0,0,0
2021-06-19 22:30,30,13,17,0,0,0
2021-06-19 22:45,34,23,11,0,0,0
2021-06-19 23:00,76,22,54,0,0,0
2021-06-19 23:15,55,31,24,0,0,0
2021-06-19 23:30,51,31,20,0,0,0
2021-06-19 23:45,59,37,22,0,0,0
2021-06-20 00:00,44,30,14,0,0,0
2021-06-20 00:15,42,26,16,0,0,0
2021-06-20 00:30,43,26,17,0,0,0
2021-06-20 00:45,64,38,26,0,0,0
2021-06-20 01:00,54,39,15,0,0,0
2021-06-20 01:15,27,15,12,0,0,0
2021-06-20 01:30,22,6,16,0,0,0
2021-06-20 01:45,18,6,12,0,0,0
2021-06-20 02:00,17,10,7,0,0,0
2021-06-20 02:15,20,5,15,0,0,0
2021-06-20 02:30,16,3,13,0,0,0
2021-06-20 02:45,18,10,8,0,0,0
2021-06-20 03:00,2,0,2,0,0,0
2021-06-20 03:15,6,4,2,0,0,0
2021-06-20 03:30,12,1,11,0,0,0
2021-06-20 03:45,6,2,4,0,0,0
2021-06-20 04:00,4,2,2,0,0,0
2021-06-20 04:15,4,3,1,0,0,0
2021-06-20 04:30,2,0,2,0,0,0
2021-06-20 04:45,2,0,2,0,0,0
2021-06-20 05:00,6,4,2,0,0,0
2021-06-20 05:15,0,0,0,0,0,0
2021-06-20 05:30,7,4,3,0,0,0
2021-06-20 05:45,3,1,2,0,0,0
2021-06-20 06:00,7,4,3,0,0,0
2021-06-20 06:15,4,1,3,0,0,0
2021-06-20 06:30,7,5,2,0,0,0
2021-06-20 06:45,6,3,3,0,0,0
2021-06-20 07:00,3,3,0,0,0,0
2021-06-20 07:15,5,3,2,0,0,0
2021-06-20 07:30,8,8,0,0,0,0
2021-06-20 07:45,16,13,3,0,0,0
2021-06-20 08:00,9,5,4,0,0,0
2021-06-20 08:15,13,11,2,0,0,0
2021-06-20 08:30,20,13,7,0,0,0
2021-06-20 08:45,15,8,7,0,0,0
2021-06-20 09:00,21,14,7,0,0,0
2021-06-20 09:15,39,33,6,0,0,0
2021-06-20 09:30,42,29,13,0,0,0
2021-06-20 09:45,46,33,13,0,0,0
2021-06-20 10:00,45,37,8,0,0,0
2021-06-20 10:15,44,30,14,0,0,0
2021-06-20 10:30,30,17,13,0,0,0
2021-06-20 10:45,45,22,23,0,0,0
2021-06-20 11:00,33,17,16,0,0,0
2021-06-20 11:15,50,33,17,0,0,0
2021-06-20 11:30,47,30,17,0,0,0
2021-06-20 11:45,61,41,20,0,0,0
2021-06-20 12:00,62,43,19,0,0,0
2021-06-20 12:15,59,46,13,0,0,0
2021-06-20 12:30,79,54,25,0,0,0
2021-06-20 12:45,63,33,30,0,0,0
2021-06-20 13:00,69,42,27,0,0,0
2021-06-20 13:15,62,33,29,0,0,0
2021-06-20 13:30,64,37,27,0,0,0
2021-06-20 13:45,106,61,45,0,0,0
2021-06-20 14:00,71,46,25,0,0,0
2021-06-20 14:15,87,41,46,0,0,0
2021-06-20 14:30,98,43,55,0,0,0
2021-06-20 14:45,108,82,26,0,0,0
2021-06-20 15:00,90,48,42,0,0,0
2021-06-20 15:15,78,48,30,0,0,0
2021-06-20 15:30,122,90,32,0,0,0
2021-06-20 15:45,86,63,23,0,0,0
2021-06-20 16:00,67,36,31,0,0,0
2021-06-20 16:15,95,59,36,0,0,0
2021-06-20 16:30,88,56,32,0,0,0
2021-06-20 16:45,118,89,29,0,0,0
2021-06-20 17:00,106,72,34,0,0,0
2021-06-20 17:15,101,70,31,0,0,0
2021-06-20 17:30,95,53,42,0,0,0
2021-06-20 17:45,125,84,41,0,0,0
2021-06-20 18:00,97,63,34,0,0,0
2021-06-20 18:15,97,68,29,0,0,0
2021-06-20 18:30,74,60,14,0,0,0
2021-06-20 18:45,74,38,36,0,0,0
2021-06-20 19:00,87,47,40,0,0,0
2021-06-20 19:15,86,61,25,0,0,0
2021-06-20 19:30,45,33,12,0,0,0
2021-06-20 19:45,53,32,21,0,0,0
2021-06-20 20:00,76,47,29,0,0,0
2021-06-20 20:15,37,16,21,0,0,0
2021-06-20 20:30,46,29,17,0,0,0
2021-06-20 20:45,33,9,24,0,0,0
2021-06-20 21:00,45,23,22,0,0,0
2021-06-20 21:15,68,43,25,0,0,0
2021-06-20 21:30,30,15,15,0,0,0
2021-06-20 21:45,38,30,8,0,0,0
2021-06-20 22:00,31,13,18,0,0,0
2021-06-20 22:15,37,19,18,0,0,0
2021-06-20 22:30,17,8,9,0,0,0
2021-06-20 22:45,17,15,2,0,0,0
2021-06-20 23:00,12,4,8,0,0,0
2021-06-20 23:15,11,8,3,0,0,0
2021-06-20 23:30,6,0,6,0,0,0
2021-06-20 23:45,4,1,3,0,0,0
2021-06-21 00:00,14,11,3,0,0,0
2021-06-21 00:15,6,3,3,0,0,0
2021-06-21 00:30,3,2,1,0,0,0
2021-06-21 00:45,5,2,3,0,0,0
2021-06-21 01:00,4,3,1,0,0,0
2021-06-21 01:15,1,1,0,0,0,0
2021-06-21 01:30,1,1,0,0,0,0
2021-06-21 01:45,4,2,2,0,0,0
2021-06-21 02:00,1,0,1,0,0,0
2021-06-21 02:15,0,0,0,0,0,0
2021-06-21 02:30,1,0,1,0,0,0
2021-06-21 02:45,0,0,0,0,0,0
2021-06-21 03:00,1,0,1,0,0,0
2021-06-21 03:15,1,1,0,0,0,0
2021-06-21 03:30,1,1,0,0,0,0
2021-06-21 03:45,1,1,0,0,0,0
2021-06-21 04:00,0,0,0,0,0,0
2021-06-21 04:15,2,2,0,0,0,0
2021-06-21 04:30,0,0,0,0,0,0
2021-06-21 04:45,1,1,0,0,0,0
2021-06-21 05:00,1,1,0,0,0,0
2021-06-21 05:15,3,2,1,0,0,0
2021-06-21 05:30,12,8,4,0,0,0
2021-06-21 05:45,11,4,7,0,0,0
2021-06-21 06:00,8,6,2,0,0,0
2021-06-21 06:15,18,11,7,0,0,0
2021-06-21 06:30,22,12,10,0,0,0
2021-06-21 06:45,45,28,17,0,0,0
2021-06-21 07:00,58,41,17,0,0,0
2021-06-21 07:15,79,43,36,0,0,0
2021-06-21 07:30,119,76,43,0,0,0
2021-06-21 07:45,208,146,62,0,0,0
2021-06-21 08:00,216,181,35,0,0,0
2021-06-21 08:15,136,113,23,0,0,0
2021-06-21 08:30,111,78,33,0,0,0
2021-06-21 08:45,108,86,22,0,0,0
2021-06-21 09:00,76,57,19,0,0,0
2021-06-21 09:15,74,54,20,0,0,0
2021-06-21 09:30,70,54,16,0,0,0
2021-06-21 09:45,82,57,25,0,0,0
2021-06-21 10:00,69,54,15,0,0,0
2021-06-21 10:15,78,54,24,0,0,0
2021-06-21 10:30,57,45,12,0,0,0
2021-06-21 10:45,80,50,30,0,0,0
2021-06-21 11:00,65,43,22,0,0,0
2021-06-21 11:15,66,45,21,0,0,0
2021-06-21 11:30,83,46,37,0,0,0
2021-06-21 11:45,90,59,31,0,0,0
2021-06-21 12:00,78,53,25,0,0,0
2021-06-21 12:15,73,42,31,0,0,0
2021-06-21 12:30,92,38,54,0,0,0
2021-06-21 12:45,80,49,31,0,0,0
2021-06-21 13:00,98,46,52,0,0,0
2021-06-21 13:15,101,57,44,0,0,0
2021-06-21 13:30,103,53,50,0,0,0
2021-06-21 13:45,92,50,42,0,0,0
2021-06-21 14:00,105,68,37,0,0,0
2021-06-21 14:15,108,47,61,0,0,0
2021-06-21 14:30,140,82,58,0,0,0
2021-06-21 14:45,122,70,52,0,0,0
2021-06-21 15:00,94,52,42,0,0,0
2021-06-21 15:15,101,65,36,0,0,0
2021-06-21 15:30,107,69,38,0,0,0
2021-06-21 15:45,126,58,68,0,0,0
2021-06-21 16:00,110,66,44,0,0,0
2021-06-21 16:15,110,53,57,0,0,0
2021-06-21 16:30,127,78,49,0,0,0
2021-06-21 16:45,135,83,52,0,0,0
2021-06-21 17:00,125,81,44,0,0,0
2021-06-21 17:15,111,59,52,0,0,0
2021-06-21 17:30,115,65,50,0,0,0
2021-06-21 17:45,119,70,49,0,0,0
2021-06-21 18:00,114,55,59,0,0,0
2021-06-21 18:15,97,42,55,0,0,0
2021-06-21 18:30,92,49,43,0,0,0
2021-06-21 18:45,96,48,48,0,0,0
2021-06-21 19:00,89,37,52,0,0,0
2021-06-21 19:15,78,36,42,0,0,0
2021-06-21 19:30,53,25,28,0,0,0
2021-06-21 19:45,53,29,24,0,0,0
2021-06-21 20:00,53,26,27,0,0,0
2021-06-21 20:15,40,27,13,0,0,0
2021-06-21 20:30,42,24,18,0,0,0
2021-06-21 20:45,35,14,21,0,0,0
2021-06-21 21:00,37,16,21,0,0,0
2021-06-21 21:15,24,11,13,0,0,0
2021-06-21 21:30,28,15,13,0,0,0
2021-06-21 21:45,36,25,11,0,0,0
2021-06-21 22:00,30,13,17,0,0,0
2021-06-21 22:15,30,20,10,0,0,0
2021-06-21 22:30,18,8,10,0,0,0
2021-06-21 22:45,27,14,13,0,0,0
2021-06-21 23:00,14,4,10,0,0,0
2021-06-21 23:15,25,17,8,0,0,0
2021-06-21 23:30,7,2,5,0,0,0
2021-06-21 23:45,7,0,7,0,0,0
2021-06-22 00:00,16,9,7,0,0,0
2021-06-22 00:15,1,1,0,0,0,0
2021-06-22 00:30,3,1,2,0,0,0
2021-06-22 00:45,4,2,2,0,0,0
2021-06-22 01:00,7,6,1,0,0,0
2021-06-22 01:15,8,5,3,0,0,0
2021-06-22 01:30,2,0,2,0,0,0
2021-06-22 01:45,1,1,0,0,0,0
2021-06-22 02:00,6,3,3,0,0,0
2021-06-22 02:15,2,0,2,0,0,0
2021-06-22 02:30,0,0,0,0,0,0
2021-06-22 02:45,1,1,0,0,0,0
2021-06-22 03:00,4,1,3,0,0,0
2021-06-22 03:15,2,0,2,0,0,0
2021-06-22 03:30,0,0,0,0,0,0
2021-06-22 03:45,0,0,0,0,0,0
2021-06-22 04:00,0,0,0,0,0,0
2021-06-22 04:15,1,0,1,0,0,0
2021-06-22 04:30,1,1,0,0,0,0
2021-06-22 04:45,3,3,0,0,0,0
2021-06-22 05:00,2,2,0,0,0,0
2021-06-22 05:15,4,3,1,0,0,0
2021-06-22 05:30,12,8,4,0,0,0
2021-06-22 05:45,14,6,8,0,0,0
2021-06-22 06:00,20,12,8,0,0,0
2021-06-22 06:15,39,23,16,0,0,0
2021-06-22 06:30,42,24,18,0,0,0
2021-06-22 06:45,65,45,20,0,0,0
2021-06-22 07:00,72,42,30,0,0,0
2021-06-22 07:15,110,71,39,0,0,0
2021-06-22 07:30,185,139,46,0,0,0
2021-06-22 07:45,245,173,72,0,0,0
2021-06-22 08:00,217,185,32,0,0,0
2021-06-22 08:15,166,132,34,0,0,0
2021-06-22 08:30,128,102,26,0,0,0
2021-06-22 08:45,140,110,30,0,0,0
2021-06-22 09:00,97,67,30,0,0,0
2021-06-22 09:15,114,83,31,0,0,0
2021-06-22 09:30,104,80,24,0,0,0
2021-06-22 09:45,114,83,31,0,0,0
2021-06-22 10:00,96,75,21,0,0,0
2021-06-22 10:15,89,61,28,0,0,0
2021-06-22 10:30,89,64,25,0,0,0
2021-06-22 10:45,103,73,30,0,0,0
2021-06-22 11:00,95,55,40,0,0,0
2021-06-22 11:15,102,67,35,0,0,0
2021-06-22 11:30,124,80,44,0,0,0
2021-06-22 11:45,102,73,29,0,0,0
2021-06-22 12:00,100,59,41,0,0,0
2021-06-22 12:15,95,60,35,0,0,0
2021-06-22 12:30,103,59,44,0,0,0
2021-06-22 12:45,113,64,49,0,0,0
2021-06-22 13:00,143,72,71,0,0,0
2021-06-22 13:15,132,64,68,0,0,0
2021-06-22 13:30,114,73,41,0,0,0
2021-06-22 13:45,151,86,65,0,0,0
2021-06-22 14:00,129,75,54,0,0,0
2021-06-22 14:15,133,85,48,0,0,0
2021-06-22 14:30,120,66,54,0,0,0
2021-06-22 14:45,177,116,61,0,0,0
2021-06-22 15:00,136,79,57,0,0,0
2021-06-22 15:15,126,70,56,0,0,0
2021-06-22 15:30,128,77,51,0,0,0
2021-06-22 15:45,169,101,68,0,0,0
2021-06-22 16:00,172,106,66,0,0,0
2021-06-22 16:15,166,93,73,0,0,0
2021-06-22 16:30,164,90,74,0,0,0
2021-06-22 16:45,169,93,76,0,0,0
2021-06-22 17:00,179,104,75,0,0,0
2021-06-22 17:15,179,107,72,0,0,0
2021-06-22 17:30,155,88,67,0,0,0
2021-06-22 17:45,211,110,101,0,0,0
2021-06-22 18:00,161,96,65,0,0,0
2021-06-22 18:15,151,87,64,0,0,0
2021-06-22 18:30,144,68,76,0,0,0
2021-06-22 18:45,171,94,77,0,0,0
2021-06-22 19:00,117,73,44,0,0,0
2021-06-22 19:15,122,60,62,0,0,0
2021-06-22 19:30,89,46,43,0,0,0
2021-06-22 19:45,89,62,27,0,0,0
2021-06-22 20:00,58,33,25,0,0,0
2021-06-22 20:15,70,43,27,0,0,0
2021-06-22 20:30,44,15,29,0,0,0
2021-06-22 20:45,46,27,19,0,0,0
2021-06-22 21:00,39,20,19,0,0,0
2021-06-22 21:15,37,12,25,0,0,0
2021-06-22 21:30,29,7,22,0,0,0
2021-06-22 21:45,42,23,19,0,0,0
2021-06-22 22:00,49,27,22,0,0,0
2021-06-22 22:15,35,17,18,0,0,0
2021-06-22 22:30,29,15,14,0,0,0
2021-06-22 22:45,34,19,15,0,0,0
2021-06-22 23:00,22,14,8,0,0,0
2021-06-22 23:15,28,15,13,0,0,0
2021-06-22 23:30,20,11,9,0,0,0
2021-06-22 23:45,16,10,6,0,0,0
2021-06-23 00:00,13,7,6,0,0,0
2021-06-23 00:15,10,1,9,0,0,0
2021-06-23 00:30,5,3,2,0,0,0
2021-06-23 00:45,4,4,0,0,0,0
2021-06-23 01:00,2,2,0,0,0,0
2021-06-23 01:15,4,1,3,0,0,0
2021-06-23 01:30,3,1,2,0,0,0
2021-06-23 01:45,6,4,2,0,0,0
2021-06-23 02:00,3,1,2,0,0,0
2021-06-23 02:15,1,0,1,0,0,0
2021-06-23 02:30,2,1,1,0,0,0
2021-06-23 02:45,1,0,1,0,0,0
2021-06-23 03:00,0,0,0,0,0,0
2021-06-23 03:15,2,2,0,0,0,0
2021-06-23 03:30,1,0,1,0,0,0
2021-06-23 03:45,2,0,2,0,0,0
2021-06-23 04:00,0,0,0,0,0,0
2021-06-23 04:15,3,2,1,0,0,0
2021-06-23 04:30,1,1,0,0,0,0
2021-06-23 04:45,3,2,1,0,0,0
2021-06-23 05:00,1,1,0,0,0,0
2021-06-23 05:15,4,4,0,0,0,0
2021-06-23 05:30,16,8,8,0,0,0
2021-06-23 05:45,24,12,12,0,0,0
2021-06-23 06:00,19,13,6,0,0,0
2021-06-23 06:15,26,17,9,0,0,0
2021-06-23 06:30,59,32,27,0,0,0
2021-06-23 06:45,72,56,16,0,0,0
2021-06-23 07:00,89,62,27,0,0,0
2021-06-23 07:15,116,78,38,0,0,0
2021-06-23 07:30,175,112,63,0,0,0
2021-06-23 07:45,258,194,64,0,0,0
2021-06-23 08:00,237,191,46,0,0,0
2021-06-23 08:15,158,121,37,0,0,0
2021-06-23 08:30,149,113,36,0,0,0
2021-06-23 08:45,172,136,36,0,0,0
2021-06-23 09:00,117,80,37,0,0,0
2021-06-23 09:15,131,99,32,0,0,0
2021-06-23 09:30,129,99,30,0,0,0
2021-06-23 09:45,134,98,36,0,0,0
2021-06-23 10:00,130,83,47,0,0,0
2021-06-23 10:15,127,95,32,0,0,0
2021-06-23 10:30,120,99,21,0,0,0
2021-06-23 10:45,112,80,32,0,0,0
2021-06-23 11:00,132,90,42,0,0,0
2021-06-23 11:15,99,61,38,0,0,0
2021-06-23 11:30,132,83,49,0,0,0
2021-06-23 11:45,139,98,41,0,0,0
2021-06-23 12:00,143,96,47,0,0,0
2021-06-23 12:15,145,83,62,0,0,0
2021-06-23 12:30,130,72,58,0,0,0
2021-06-23 12:45,169,99,70,0,0,0
2021-06-23 13:00,137,63,74,0,0,0
2021-06-23 13:15,164,85,79,0,0,0
2021-06-23 13:30,158,93,65,0,0,0
2021-06-23 13:45,130,71,59,0,0,0
2021-06-23 14:00,150,83,67,0,0,0
2021-06-23 14:15,134,77,57,0,0,0
2021-06-23 14:30,139,68,71,0,0,0
2021-06-23 14:45,177,105,72,0,0,0
2021-06-23 15:00,142,75,67,0,0,0
2021-06-23 15:15,113,60,53,0,0,0
2021-06-23 15:30,135,76,59,0,0,0
2021-06-23 15:45,162,91,71,0,0,0
2021-06-23 16:00,171,90,81,0,0,0
2021-06-23 16:15,151,85,66,0,0,0
2021-06-23 16:30,159,91,68,0,0,0
2021-06-23 16:45,163,85,78,0,0,0
2021-06-23 17:00,147,86,61,0,0,0
2021-06-23 17:15,173,98,75,0,0,0
2021-06-23 17:30,175,106,69,0,0,0
2021-06-23 17:45,169,101,68,0,0,0
2021-06-23 18:00,139,72,67,0,0,0
2021-06-23 18:15,150,85,65,0,0,0
2021-06-23 18:30,103,54,49,0,0,0
2021-06-23 18:45,140,80,60,0,0,0
2021-06-23 19:00,115,60,55,0,0,0
2021-06-23 19:15,125,70,55,0,0,0
2021-06-23 19:30,108,62,46,0,0,0
2021-06-23 19:45,137,89,48,0,0,0
2021-06-23 20:00,110,66,44,0,0,0
2021-06-23 20:15,139,92,47,0,0,0
2021-06-23 20:30,102,56,46,0,0,0
2021-06-23 20:45,87,34,53,0,0,0
2021-06-23 21:00,52,26,26,0,0,0
2021-06-23 21:15,32,19,13,0,0,0
2021-06-23 21:30,38,15,23,0,0,0
2021-06-23 21:45,34,10,24,0,0,0
2021-06-23 22:00,43,28,15,0,0,0
2021-06-23 22:15,19,10,9,0,0,0
2021-06-23 22:30,22,10,12,0,0,0
2021-06-23 22:45,11,2,9,0,0,0
2021-06-23 23:00,108,63,45,0,0,0
2021-06-23 23:15,127,78,49,0,0,0
2021-06-23 23:30,86,50,36,0,0,0
2021-06-23 23:45,50,25,25,0,0,0
2021-06-24 00:00,44,22,22,0,0,0
2021-06-24 00:15,41,18,23,0,0,0
2021-06-24 00:30,19,13,6,0,0,0
2021-06-24 00:45,16,7,9,0,0,0
2021-06-24 01:00,14,3,11,0,0,0
2021-06-24 01:15,8,0,8,0,0,0
2021-06-24 01:30,8,3,5,0,0,0
2021-06-24 01:45,8,3,5,0,0,0
2021-06-24 02:00,7,2,5,0,0,0
2021-06-24 02:15,5,0,5,0,0,0
2021-06-24 02:30,6,1,5,0,0,0
2021-06-24 02:45,6,0,6,0,0,0
2021-06-24 03:00,6,0,6,0,0,0
2021-06-24 03:15,5,1,4,0,0,0
2021-06-24 03:30,2,0,2,0,0,0
2021-06-24 03:45,2,0,2,0,0,0
2021-06-24 04:00,2,1,1,0,0,0
2021-06-24 04:15,9,3,6,0,0,0
2021-06-24 04:30,5,3,2,0,0,0
2021-06-24 04:45,5,2,3,0,0,0
2021-06-24 05:00,1,1,0,0,0,0
2021-06-24 05:15,5,3,2,0,0,0
2021-06-24 05:30,16,9,7,0,0,0
2021-06-24 05:45,15,8,7,0,0,0
2021-06-24 06:00,18,10,8,0,0,0
2021-06-24 06:15,40,21,19,0,0,0
2021-06-24 06:30,34,24,10,0,0,0
2021-06-24 06:45,54,31,23,0,0,0
2021-06-24 07:00,81,53,28,0,0,0
2021-06-24 07:15,110,71,39,0,0,0
2021-06-24 07:30,167,114,53,0,0,0
2021-06-24 07:45,249,181,68,0,0,0
2021-06-24 08:00,211,165,46,0,0,0
2021-06-24 08:15,165,136,29,0,0,0
2021-06-24 08:30,129,91,38,0,0,0
2021-06-24 08:45,151,112,39,0,0,0
2021-06-24 09:00,116,78,38,0,0,0
2021-06-24 09:15,114,78,36,0,0,0
2021-06-24 09:30,105,71,34,0,0,0
2021-06-24 09:45,120,80,40,0,0,0
2021-06-24 10:00,75,55,20,0,0,0
2021-06-24 10:15,97,58,39,0,0,0
2021-06-24 10:30,126,90,36,0,0,0
2021-06-24 10:45,95,65,30,0,0,0
2021-06-24 11:00,90,53,37,0,0,0
2021-06-24 11:15,94,59,35,0,0,0
2021-06-24 11:30,83,56,27,0,0,0
2021-06-24 11:45,124,86,38,0,0,0
2021-06-24 12:00,102,70,32,0,0,0
2021-06-24 12:15,95,53,42,0,0,0
2021-06-24 12:30,133,86,47,0,0,0
2021-06-24 12:45,102,64,38,0,0,0
2021-06-24 13:00,101,58,43,0,0,0
2021-06-24 13:15,121,71,50,0,0,0
2021-06-24 13:30,120,59,61,0,0,0
2021-06-24 13:45,121,71,50,0,0,0
2021-06-24 14:00,137,78,59,0,0,0
2021-06-24 14:15,150,89,61,0,0,0
2021-06-24 14:30,158,100,58,0,0,0
2021-06-24 14:45,165,90,75,0,0,0
2021-06-24 15:00,139,78,61,0,0,0
2021-06-24 15:15,150,80,70,0,0,0
2021-06-24 15:30,141,88,53,0,0,0
2021-06-24 15:45,196,114,82,0,0,0
2021-06-24 16:00,178,112,66,0,0,0
2021-06-24 16:15,187,104,83,0,0,0
2021-06-24 16:30,170,94,76,0,0,0
2021-06-24 16:45,175,112,63,0,0,0
2021-06-24 17:00,175,94,81,0,0,0
2021-06-24 17:15,164,100,64,0,0,0
2021-06-24 17:30,153,83,70,0,0,0
2021-06-24 17:45,208,124,84,0,0,0
2021-06-24 18:00,184,85,99,0,0,0
2021-06-24 18:15,148,78,70,0,0,0
2021-06-24 18:30,130,64,66,0,0,0
2021-06-24 18:45,144,84,60,0,0,0
2021-06-24 19:00,137,73,64,0,0,0
2021-06-24 19:15,120,58,62,0,0,0
2021-06-24 19:30,92,53,39,0,0,0
2021-06-24 19:45,96,52,44,0,0,0
2021-06-24 20:00,83,46,37,0,0,0
2021-06-24 20:15,68,29,39,0,0,0
2021-06-24 20:30,60,29,31,0,0,0
2021-06-24 20:45,72,40,32,0,0,0
2021-06-24 21:00,52,27,25,0,0,0
2021-06-24 21:15,46,28,18,0,0,0
2021-06-24 21:30,58,29,29,0,0,0
2021-06-24 21:45,46,23,23,0,0,0
2021-06-24 22:00,63,28,35,0,0,0
2021-06-24 22:15,58,26,32,0,0,0
2021-06-24 22:30,35,13,22,0,0,0
2021-06-24 22:45,46,25,21,0,0,0
2021-06-24 23:00,41,20,21,0,0,0
2021-06-24 23:15,33,16,17,0,0,0
2021-06-24 23:30,21,7,14,0,0,0
2021-06-24 23:45,18,7,11,0,0,0
2021-06-25 00:00,9,3,6,0,0,0
2021-06-25 00:15,10,6,4,0,0,0
2021-06-25 00:30,5,2,3,0,0,0
2021-06-25 00:45,7,5,2,0,0,0
2021-06-25 01:00,6,5,1,0,0,0
2021-06-25 01:15,4,2,2,0,0,0
2021-06-25 01:30,5,3,2,0,0,0
2021-06-25 01:45,3,1,2,0,0,0
2021-06-25 02:00,4,2,2,0,0,0
2021-06-25 02:15,6,2,4,0,0,0
2021-06-25 02:30,1,0,1,0,0,0
2021-06-25 02:45,2,0,2,0,0,0
2021-06-25 03:00,0,0,0,0,0,0
2021-06-25 03:15,1,0,1,0,0,0
2021-06-25 03:30,0,0,0,0,0,0
2021-06-25 03:45,3,0,3,0,0,0
2021-06-25 04:00,0,0,0,0,0,0
2021-06-25 04:15,1,1,0,0,0,0
2021-06-25 04:30,2,1,1,0,0,0
2021-06-25 04:45,4,1,3,0,0,0
2021-06-25 05:00,1,1,0,0,0,0
2021-06-25 05:15,5,5,0,0,0,0
2021-06-25 05:30,8,5,3,0,0,0
2021-06-25 05:45,14,5,9,0,0,0
2021-06-25 06:00,17,12,5,0,0,0
2021-06-25 06:15,27,12,15,0,0,0
2021-06-25 06:30,41,28,13,0,0,0
2021-06-25 06:45,79,48,31,0,0,0
2021-06-25 07:00,65,47,18,0,0,0
2021-06-25 07:15,106,68,38,0,0,0
2021-06-25 07:30,159,109,50,0,0,0
2021-06-25 07:45,238,174,64,0,0,0
2021-06-25 08:00,220,177,43,0,0,0
2021-06-25 08:15,152,115,37,0,0,0
2021-06-25 08:30,117,80,37,0,0,0
2021-06-25 08:45,141,98,43,0,0,0
2021-06-25 09:00,103,76,27,0,0,0
2021-06-25 09:15,106,68,38,0,0,0
2021-06-25 09:30,94,68,26,0,0,0
2021-06-25 09:45,132,100,32,0,0,0
2021-06-25 10:00,114,77,37,0,0,0
2021-06-25 10:15,110,76,34,0,0,0
2021-06-25 10:30,100,59,41,0,0,0
2021-06-25 10:45,124,90,34,0,0,0
2021-06-25 11:00,93,69,24,0,0,0
2021-06-25 11:15,112,68,44,0,0,0
2021-06-25 11:30,120,79,41,0,0,0
2021-06-25 11:45,125,85,40,0,0,0
2021-06-25 12:00,132,88,44,0,0,0
2021-06-25 12:15,137,86,51,0,0,0
2021-06-25 12:30,116,71,45,0,0,0
2021-06-25 12:45,148,89,59,0,0,0
2021-06-25 13:00,149,85,64,0,0,0
2021-06-25 13:15,143,77,66,0,0,0
2021-06-25 13:30,137,73,64,0,0,0
2021-06-25 13:45,178,112,66,0,0,0
2021-06-25 14:00,160,98,62,0,0,0
2021-06-25 14:15,164,77,87,0,0,0
2021-06-25 14:30,171,96,75,0,0,0
2021-06-25 14:45,170,97,73,0,0,0
2021-06-25 15:00,151,92,59,0,0,0
2021-06-25 15:15,167,108,59,0,0,0
2021-06-25 15:30,172,111,61,0,0,0
2021-06-25 15:45,158,90,68,0,0,0
2021-06-25 16:00,148,80,68,0,0,0
2021-06-25 16:15,153,82,71,0,0,0
2021-06-25 16:30,135,74,61,0,0,0
2021-06-25 16:45,125,73,52,0,0,0
2021-06-25 17:00,125,71,54,0,0,0
2021-06-25 17:15,133,65,68,0,0,0
2021-06-25 17:30,155,90,65,0,0,0
2021-06-25 17:45,145,91,54,0,0,0
2021-06-25 18:00,124,85,39,0,0,0
2021-06-25 18:15,135,66,69,0,0,0
2021-06-25 18:30,102,54,48,0,0,0
2021-06-25 18:45,154,89,65,0,0,0
2021-06-25 19:00,111,62,49,0,0,0
2021-06-25 19:15,124,67,57,0,0,0
2021-06-25 19:30,94,49,45,0,0,0
2021-06-25 19:45,92,46,46,0,0,0
2021-06-25 20:00,108,65,43,0,0,0
2021-06-25 20:15,78,37,41,0,0,0
2021-06-25 20:30,57,30,27,0,0,0
2021-06-25 20:45,57,31,26,0,0,0
2021-06-25 21:00,60,24,36,0,0,0
2021-06-25 21:15,43,22,21,0,0,0
2021-06-25 21:30,44,27,17,0,0,0
2021-06-25 21:45,38,21,17,0,0,0
2021-06-25 22:00,41,19,22,0,0,0
2021-06-25 22:15,40,24,16,0,0,0
2021-06-25 22:30,47,25,22,0,0,0
2021-06-25 22:45,34,21,13,0,0,0
2021-06-25 23:00,50,30,20,0,0,0
2021-06-25 23:15,51,23,28,0,0,0
2021-06-25 23:30,43,19,24,0,0,0
2021-06-25 23:45,27,11,16,0,0,0
2021-06-26 00:00,27,18,9,0,0,0
2021-06-26 00:15,48,32,16,0,0,0
2021-06-26 00:30,23,12,11,0,0,0
2021-06-26 00:45,30,14,16,0,0,0
2021-06-26 01:00,31,19,12,0,0,0
2021-06-26 01:15,7,7,0,0,0,0
2021-06-26 01:30,15,5,10,0,0,0
2021-06-26 01:45,22,8,14,0,0,0
2021-06-26 02:00,23,6,17,0,0,0
2021-06-26 02:15,13,3,10,0,0,0
2021-06-26 02:30,8,5,3,0,0,0
2021-06-26 02:45,13,7,6,0,0,0
2021-06-26 03:00,7,2,5,0,0,0
2021-06-26 03:15,13,9,4,0,0,0
2021-06-26 03:30,7,1,6,0,0,0
2021-06-26 03:45,14,6,8,0,0,0
2021-06-26 04:00,15,6,9,0,0,0
2021-06-26 04:15,5,2,3,0,0,0
2021-06-26 04:30,2,0,2,0,0,0
2021-06-26 04:45,4,1,3,0,0,0
2021-06-26 05:00,3,3,0,0,0,0
2021-06-26 05:15,5,5,0,0,0,0
2021-06-26 05:30,12,8,4,0,0,0
2021-06-26 05:45,10,6,4,0,0,0
2021-06-26 06:00,11,5,6,0,0,0
2021-06-26 06:15,9,7,2,0,0,0
2021-06-26 06:30,8,3,5,0,0,0
2021-06-26 06:45,19,14,5,0,0,0
2021-06-26 07:00,16,14,2,0,0,0
2021-06-26 07:15,21,13,8,0,0,0
2021-06-26 07:30,36,21,15,0,0,0
2021-06-26 07:45,48,31,17,0,0,0
2021-06-26 08:00,35,26,9,0,0,0
2021-06-26 08:15,45,30,15,0,0,0
2021-06-26 08:30,45,30,15,0,0,0
2021-06-26 08:45,72,59,13,0,0,0
2021-06-26 09:00,75,56,19,0,0,0
2021-06-26 09:15,89,69,20,0,0,0
2021-06-26 09:30,97,75,22,0,0,0
2021-06-26 09:45,106,83,23,0,0,0
2021-06-26 10:00,104,89,15,0,0,0
2021-06-26 10:15,136,107,29,0,0,0
2021-06-26 10:30,142,111,31,0,0,0
2021-06-26 10:45,133,99,34,0,0,0
2021-06-26 11:00,156,104,52,0,0,0
2021-06-26 11:15,167,116,51,0,0,0
2021-06-26 11:30,163,119,44,0,0,0
2021-06-26 11:45,154,105,49,0,0,0
2021-06-26 12:00,155,110,45,0,0,0
2021-06-26 12:15,172,101,71,0,0,0
2021-06-26 12:30,136,92,44,0,0,0
2021-06-26 12:45,138,89,49,0,0,0
2021-06-26 13:00,161,82,79,0,0,0
2021-06-26 13:15,182,105,77,0,0,0
2021-06-26 13:30,149,85,64,0,0,0
2021-06-26 13:45,152,93,59,0,0,0
2021-06-26 14:00,137,70,67,0,0,0
2021-06-26 14:15,164,82,82,0,0,0
2021-06-26 14:30,156,89,67,0,0,0
2021-06-26 14:45,146,76,70,0,0,0
2021-06-26 15:00,106,56,50,0,0,0
2021-06-26 15:15,166,92,74,0,0,0
2021-06-26 15:30,115,68,47,0,0,0
2021-06-26 15:45,103,62,41,0,0,0
2021-06-26 16:00,155,94,61,0,0,0
2021-06-26 16:15,109,54,55,0,0,0
2021-06-26 16:30,117,77,40,0,0,0
2021-06-26 16:45,130,84,46,0,0,0
2021-06-26 17:00,91,57,34,0,0,0
2021-06-26 17:15,111,66,45,0,0,0
2021-06-26 17:30,109,69,40,0,0,0
2021-06-26 17:45,113,69,44,0,0,0
2021-06-26 18:00,129,80,49,0,0,0
2021-06-26 18:15,97,55,42,0,0,0
2021-06-26 18:30,104,61,43,0,0,0
2021-06-26 18:45,130,84,46,0,0,0
2021-06-26 19:00,90,57,33,0,0,0
2021-06-26 19:15,93,68,25,0,0,0
2021-06-26 19:30,105,75,30,0,0,0
2021-06-26 19:45,92,63,29,0,0,0
2021-06-26 20:00,93,47,46,0,0,0
2021-06-26 20:15,72,38,34,0,0,0
2021-06-26 20:30,53,31,22,0,0,0
2021-06-26 20:45,69,41,28,0,0,0
2021-06-26 21:00,49,32,17,0,0,0
2021-06-26 21:15,46,21,25,0,0,0
2021-06-26 21:30,38,24,14,0,0,0
2021-06-26 21:45,40,27,13,0,0,0
2021-06-26 22:00,52,27,25,0,0,0
2021-06-26 22:15,34,17,17,0,0,0
2021-06-26 22:30,44,31,13,0,0,0
2021-06-26 22:45,32,15,17,0,0,0
2021-06-26 23:00,33,16,17,0,0,0
2021-06-26 23:15,39,27,12,0,0,0
2021-06-26 23:30,43,23,20,0,0,0
2021-06-26 23:45,36,24,12,0,0,0
2021-06-27 00:00,25,15,10,0,0,0
2021-06-27 00:15,30,16,14,0,0,0
2021-06-27 00:30,31,15,16,0,0,0
2021-06-27 00:45,15,3,12,0,0,0
2021-06-27 01:00,24,13,11,0,0,0
2021-06-27 01:15,19,11,8,0,0,0
2021-06-27 01:30,13,9,4,0,0,0
2021-06-27 01:45,17,8,9,0,0,0
2021-06-27 02:00,20,9,11,0,0,0
2021-06-27 02:15,13,5,8,0,0,0
2021-06-27 02:30,12,2,10,0,0,0
2021-06-27 02:45,15,7,8,0,0,0
2021-06-27 03:00,8,0,8,0,0,0
2021-06-27 03:15,6,3,3,0,0,0
2021-06-27 03:30,15,9,6,0,0,0
2021-06-27 03:45,16,9,7,0,0,0
2021-06-27 04:00,5,2,3,0,0,0
2021-06-27 04:15,15,9,6,0,0,0
2021-06-27 04:30,12,7,5,0,0,0
2021-06-27 04:45,4,3,1,0,0,0
2021-06-27 05:00,6,0,6,0,0,0
2021-06-27 05:15,3,1,2,0,0,0
2021-06-27 05:30,14,12,2,0,0,0
2021-06-27 05:45,6,0,6,0,0,0
2021-06-27 06:00,5,3,2,0,0,0
2021-06-27 06:15,4,3,1,0,0,0
2021-06-27 06:30,8,8,0,0,0,0
2021-06-27 06:45,7,5,2,0,0,0
2021-06-27 07:00,11,8,3,0,0,0
2021-06-27 07:15,5,4,1,0,0,0
2021-06-27 07:30,4,3,1,0,0,0
2021-06-27 07:45,7,6,1,0,0,0
2021-06-27 08:00,15,10,5,0,0,0
2021-06-27 08:15,19,16,3,0,0,0
2021-06-27 08:30,14,9,5,0,0,0
2021-06-27 08:45,15,11,4,0,0,0
2021-06-27 09:00,18,14,4,0,0,0
2021-06-27 09:15,26,20,6,0,0,0
2021-06-27 09:30,32,19,13,0,0,0
2021-06-27 09:45,40,26,14,0,0,0
2021-06-27 10:00,66,44,22,0,0,0
2021-06-27 10:15,52,33,19,0,0,0
2021-06-27 10:30,40,21,19,0,0,0
2021-06-27 10:45,70,46,24,0,0,0
2021-06-27 11:00,67,49,18,0,0,0
2021-06-27 11:15,57,38,19,0,0,0
2021-06-27 11:30,51,38,13,0,0,0
2021-06-27 11:45,71,42,29,0,0,0
2021-06-27 12:00,54,29,25,0,0,0
2021-06-27 12:15,64,38,26,0,0,0
2021-06-27 12:30,52,26,26,0,0,0
2021-06-27 12:45,86,42,44,0,0,0
2021-06-27 13:00,71,45,26,0,0,0
2021-06-27 13:15,54,27,27,0,0,0
2021-06-27 13:30,74,39,35,0,0,0
2021-06-27 13:45,99,60,39,0,0,0
2021-06-27 14:00,80,46,34,0,0,0
2021-06-27 14:15,105,61,44,0,0,0
2021-06-27 14:30,111,68,43,0,0,0
2021-06-27 14:45,111,62,49,0,0,0
2021-06-27 15:00,99,52,47,0,0,0
2021-06-27 15:15,84,42,42,0,0,0
2021-06-27 15:30,86,45,41,0,0,0
2021-06-27 15:45,99,60,39,0,0,0
2021-06-27 16:00,99,64,35,0,0,0
2021-06-27 16:15,85,60,25,0,0,0
2021-06-27 16:30,99,61,38,0,0,0
2021-06-27 16:45,86,57,29,0,0,0
2021-06-27 17:00,114,76,38,0,0,0
2021-06-27 17:15,121,89,32,0,0,0
2021-06-27 17:30,91,61,30,0,0,0
2021-06-27 17:45,136,84,52,0,0,0
2021-06-27 18:00,109,73,36,0,0,0
2021-06-27 18:15,134,107,27,0,0,0
2021-06-27 18:30,104,80,24,0,0,0
2021-06-27 18:45,112,82,30,0,0,0
2021-06-27 19:00,74,47,27,0,0,0
2021-06-27 19:15,65,37,28,0,0,0
2021-06-27 19:30,62,41,21,0,0,0
2021-06-27 19:45,76,43,33,0,0,0
2021-06-27 20:00,67,41,26,0,0,0
2021-06-27 20:15,60,36,24,0,0,0
2021-06-27 20:30,64,39,25,0,0,0
2021-06-27 20:45,52,32,20,0,0,0
2021-06-27 21:00,49,29,20,0,0,0
2021-06-27 21:15,30,21,9,0,0,0
2021-06-27 21:30,23,9,14,0,0,0
2021-06-27 21:45,15,7,8,0,0,0
2021-06-27 22:00,15,11,4,0,0,0
2021-06-27 22:15,14,5,9,0,0,0
2021-06-27 22:30,7,4,3,0,0,0
2021-06-27 22:45,10,4,6,0,0,0
2021-06-27 23:00,17,5,12,0,0,0
2021-06-27 23:15,21,16,5,0,0,0
2021-06-27 23:30,14,11,3,0,0,0
2021-06-27 23:45,10,7,3,0,0,0
2021-06-28 00:00,7,3,4,0,0,0
2021-06-28 00:15,1,0,1,0,0,0
2021-06-28 00:30,3,1,2,0,0,0
2021-06-28 00:45,3,1,2,0,0,0
2021-06-28 01:00,6,5,1,0,0,0
2021-06-28 01:15,4,3,1,0,0,0
2021-06-28 01:30,5,4,1,0,0,0
2021-06-28 01:45,1,1,0,0,0,0
2021-06-28 02:00,3,0,3,0,0,0
2021-06-28 02:15,1,0,1,0,0,0
2021-06-28 02:30,1,0,1,0,0,0
2021-06-28 02:45,3,0,3,0,0,0
2021-06-28 03:00,1,0,1,0,0,0
2021-06-28 03:15,0,0,0,0,0,0
2021-06-28 03:30,1,1,0,0,0,0
2021-06-28 03:45,0,0,0,0,0,0
2021-06-28 04:00,0,0,0,0,0,0
2021-06-28 04:15,0,0,0,0,0,0
2021-06-28 04:30,0,0,0,0,0,0
2021-06-28 04:45,1,1,0,0,0,0
2021-06-28 05:00,2,2,0,0,0,0
2021-06-28 05:15,9,8,1,0,0,0
2021-06-28 05:30,14,7,7,0,0,0
2021-06-28 05:45,20,13,7,0,0,0
2021-06-28 06:00,14,8,6,0,0,0
2021-06-28 06:15,28,11,17,0,0,0
2021-06-28 06:30,36,24,12,0,0,0
2021-06-28 06:45,54,34,20,0,0,0
2021-06-28 07:00,88,68,20,0,0,0
2021-06-28 07:15,114,72,42,0,0,0
2021-06-28 07:30,162,118,44,0,0,0
2021-06-28 07:45,244,193,51,0,0,0
2021-06-28 08:00,196,159,37,0,0,0
2021-06-28 08:15,149,109,40,0,0,0
2021-06-28 08:30,122,99,23,0,0,0
2021-06-28 08:45,131,97,34,0,0,0
2021-06-28 09:00,102,76,26,0,0,0
2021-06-28 09:15,69,52,17,0,0,0
2021-06-28 09:30,75,57,18,0,0,0
2021-06-28 09:45,136,102,34,0,0,0
2021-06-28 10:00,94,64,30,0,0,0
2021-06-28 10:15,107,80,27,0,0,0
2021-06-28 10:30,115,87,28,0,0,0
2021-06-28 10:45,108,73,35,0,0,0
2021-06-28 11:00,94,55,39,0,0,0
2021-06-28 11:15,95,67,28,0,0,0
2021-06-28 11:30,118,77,41,0,0,0
2021-06-28 11:45,106,69,37,0,0,0
2021-06-28 12:00,125,69,56,0,0,0
2021-06-28 12:15,107,66,41,0,0,0
2021-06-28 12:30,100,60,40,0,0,0
2021-06-28 12:45,118,62,56,0,0,0
2021-06-28 13:00,113,56,57,0,0,0
2021-06-28 13:15,124,55,69,0,0,0
2021-06-28 13:30,127,62,65,0,0,0
2021-06-28 13:45,125,70,55,0,0,0
2021-06-28 14:00,120,64,56,0,0,0
2021-06-28 14:15,150,80,70,0,0,0
2021-06-28 14:30,147,80,67,0,0,0
2021-06-28 14:45,153,81,72,0,0,0
2021-06-28 15:00,85,60,25,0,0,0
2021-06-28 15:15,69,38,31,0,0,0
2021-06-28 15:30,76,42,34,0,0,0
2021-06-28 15:45,104,61,43,0,0,0
2021-06-28 16:00,136,82,54,0,0,0
2021-06-28 16:15,171,108,63,0,0,0
2021-06-28 16:30,138,85,53,0,0,0
2021-06-28 16:45,148,83,65,0,0,0
2021-06-28 17:00,153,97,56,0,0,0
2021-06-28 17:15,139,67,72,0,0,0
2021-06-28 17:30,142,88,54,0,0,0
2021-06-28 17:45,138,74,64,0,0,0
2021-06-28 18:00,84,38,46,0,0,0
2021-06-28 18:15,88,41,47,0,0,0
2021-06-28 18:30,105,43,62,0,0,0
2021-06-28 18:45,87,43,44,0,0,0
2021-06-28 19:00,83,39,44,0,0,0
2021-06-28 19:15,87,40,47,0,0,0
2021-06-28 19:30,68,29,39,0,0,0
2021-06-28 19:45,80,42,38,0,0,0
2021-06-28 20:00,55,25,30,0,0,0
2021-06-28 20:15,57,26,31,0,0,0
2021-06-28 20:30,60,28,32,0,0,0
2021-06-28 20:45,38,22,16,0,0,0
2021-06-28 21:00,35,24,11,0,0,0
2021-06-28 21:15,43,23,20,0,0,0
2021-06-28 21:30,36,16,20,0,0,0
2021-06-28 21:45,51,32,19,0,0,0
2021-06-28 22:00,47,27,20,0,0,0
2021-06-28 22:15,23,12,11,0,0,0
2021-06-28 22:30,25,13,12,0,0,0
2021-06-28 22:45,29,21,8,0,0,0
2021-06-28 23:00,23,12,11,0,0,0
2021-06-28 23:15,15,4,11,0,0,0
2021-06-28 23:30,7,3,4,0,0,0
2021-06-28 23:45,19,11,8,0,0,0
2021-06-29 00:00,26,17,9,0,0,0
2021-06-29 00:15,11,6,5,0,0,0
2021-06-29 00:30,13,3,10,0,0,0
2021-06-29 00:45,5,1,4,0,0,0
2021-06-29 01:00,8,7,1,0,0,0
2021-06-29 01:15,1,1,0,0,0,0
2021-06-29 01:30,2,1,1,0,0,0
2021-06-29 01:45,4,3,1,0,0,0
2021-06-29 02:00,1,0,1,0,0,0
2021-06-29 02:15,2,1,1,0,0,0
2021-06-29 02:30,3,0,3,0,0,0
2021-06-29 02:45,2,0,2,0,0,0
2021-06-29 03:00,0,0,0,0,0,0
2021-06-29 03:15,0,0,0,0,0,0
2021-06-29 03:30,2,2,0,0,0,0
2021-06-29 03:45,1,0,1,0,0,0
2021-06-29 04:00,0,0,0,0,0,0
2021-06-29 04:15,2,1,1,0,0,0
2021-06-29 04:30,4,2,2,0,0,0
2021-06-29 04:45,2,1,1,0,0,0
2021-06-29 05:00,1,0,1,0,0,0
2021-06-29 05:15,3,2,1,0,0,0
2021-06-29 05:30,13,10,3,0,0,0
2021-06-29 05:45,17,10,7,0,0,0
2021-06-29 06:00,20,11,9,0,0,0
2021-06-29 06:15,24,18,6,0,0,0
2021-06-29 06:30,51,30,21,0,0,0
2021-06-29 06:45,53,36,17,0,0,0
2021-06-29 07:00,68,48,20,0,0,0
2021-06-29 07:15,101,68,33,0,0,0
2021-06-29 07:30,167,130,37,0,0,0
2021-06-29 07:45,256,187,69,0,0,0
2021-06-29 08:00,198,162,36,0,0,0
2021-06-29 08:15,136,100,36,0,0,0
2021-06-29 08:30,131,100,31,0,0,0
2021-06-29 08:45,175,129,46,0,0,0
2021-06-29 09:00,98,65,33,0,0,0
2021-06-29 09:15,88,65,23,0,0,0
2021-06-29 09:30,115,86,29,0,0,0
2021-06-29 09:45,114,78,36,0,0,0
2021-06-29 10:00,75,60,15,0,0,0
2021-06-29 10:15,72,51,21,0,0,0
2021-06-29 10:30,73,54,19,0,0,0
2021-06-29 10:45,104,64,40,0,0,0
2021-06-29 11:00,101,53,48,0,0,0
2021-06-29 11:15,93,59,34,0,0,0
2021-06-29 11:30,102,69,33,0,0,0
2021-06-29 11:45,114,70,44,0,0,0
2021-06-29 12:00,119,68,51,0,0,0
2021-06-29 12:15,129,82,47,0,0,0
2021-06-29 12:30,118,75,43,0,0,0
2021-06-29 12:45,116,65,51,0,0,0
2021-06-29 13:00,152,100,52,0,0,0
2021-06-29 13:15,135,69,66,0,0,0
2021-06-29 13:30,127,58,69,0,0,0
2021-06-29 13:45,123,58,65,0,0,0
2021-06-29 14:00,137,85,52,0,0,0
2021-06-29 14:15,137,80,57,0,0,0
2021-06-29 14:30,140,79,61,0,0,0
2021-06-29 14:45,124,70,54,0,0,0
2021-06-29 15:00,134,75,59,0,0,0
2021-06-29 15:15,152,101,51,0,0,0
2021-06-29 15:30,139,82,57,0,0,0
2021-06-29 15:45,144,90,54,0,0,0
2021-06-29 16:00,180,101,79,0,0,0
2021-06-29 16:15,163,102,61,0,0,0
2021-06-29 16:30,175,97,78,0,0,0
2021-06-29 16:45,183,104,79,0,0,0
2021-06-29 17:00,181,105,76,0,0,0
2021-06-29 17:15,234,133,101,0,0,0
2021-06-29 17:30,264,128,136,0,0,0
2021-06-29 17:45,247,134,113,0,0,0
2021-06-29 18:00,167,77,90,0,0,0
2021-06-29 18:15,103,54,49,0,0,0
2021-06-29 18:30,59,34,25,0,0,0
2021-06-29 18:45,74,37,37,0,0,0
2021-06-29 19:00,54,32,22,0,0,0
2021-06-29 19:15,47,20,27,0,0,0
2021-06-29 19:30,50,24,26,0,0,0
2021-06-29 19:45,56,34,22,0,0,0
2021-06-29 20:00,102,46,56,0,0,0
2021-06-29 20:15,111,74,37,0,0,0
2021-06-29 20:30,99,64,35,0,0,0
2021-06-29 20:45,88,51,37,0,0,0
2021-06-29 21:00,62,28,34,0,0,0
2021-06-29 21:15,50,22,28,0,0,0
2021-06-29 21:30,71,41,30,0,0,0
2021-06-29 21:45,75,44,31,0,0,0
2021-06-29 22:00,61,25,36,0,0,0
2021-06-29 22:15,65,43,22,0,0,0
2021-06-29 22:30,58,40,18,0,0,0
2021-06-29 22:45,46,26,20,0,0,0
2021-06-29 23:00,40,15,25,0,0,0
2021-06-29 23:15,31,11,20,0,0,0
2021-06-29 23:30,33,17,16,0,0,0
2021-06-29 23:45,23,10,13,0,0,0
