Datetime,100034983 (Warendorfer Straße),101034983 (Warendorfer Straße stadteinwärts),102034983 (Warendorfer Straße stadtauswärts),100034983-status,101034983-status,102034983-status
2021-07-01 00:00,8,6,2,0,0,0
2021-07-01 00:15,5,2,3,0,0,0
2021-07-01 00:30,9,8,1,0,0,0
2021-07-01 00:45,8,2,6,0,0,0
2021-07-01 01:00,5,3,2,0,0,0
2021-07-01 01:15,0,0,0,0,0,0
2021-07-01 01:30,4,3,1,0,0,0
2021-07-01 01:45,5,2,3,0,0,0
2021-07-01 02:00,6,3,3,0,0,0
2021-07-01 02:15,6,0,6,0,0,0
2021-07-01 02:30,2,1,1,0,0,0
2021-07-01 02:45,6,2,4,0,0,0
2021-07-01 03:00,4,2,2,0,0,0
2021-07-01 03:15,5,3,2,0,0,0
2021-07-01 03:30,1,1,0,0,0,0
2021-07-01 03:45,2,1,1,0,0,0
2021-07-01 04:00,2,1,1,0,0,0
2021-07-01 04:15,3,1,2,0,0,0
2021-07-01 04:30,1,1,0,0,0,0
2021-07-01 04:45,2,0,2,0,0,0
2021-07-01 05:00,1,0,1,0,0,0
2021-07-01 05:15,3,2,1,0,0,0
2021-07-01 05:30,16,10,6,0,0,0
2021-07-01 05:45,14,5,9,0,0,0
2021-07-01 06:00,19,10,9,0,0,0
2021-07-01 06:15,37,23,14,0,0,0
2021-07-01 06:30,45,26,19,0,0,0
2021-07-01 06:45,49,32,17,0,0,0
2021-07-01 07:00,76,47,29,0,0,0
2021-07-01 07:15,92,56,36,0,0,0
2021-07-01 07:30,142,90,52,0,0,0
2021-07-01 07:45,238,171,67,0,0,0
2021-07-01 08:00,201,161,40,0,0,0
2021-07-01 08:15,148,107,41,0,0,0
2021-07-01 08:30,140,94,46,0,0,0
2021-07-01 08:45,146,100,46,0,0,0
2021-07-01 09:00,95,67,28,0,0,0
2021-07-01 09:15,95,70,25,0,0,0
2021-07-01 09:30,114,80,34,0,0,0
2021-07-01 09:45,115,77,38,0,0,0
2021-07-01 10:00,80,55,25,0,0,0
2021-07-01 10:15,81,58,23,0,0,0
2021-07-01 10:30,68,47,21,0,0,0
2021-07-01 10:45,68,40,28,0,0,0
2021-07-01 11:00,71,38,33,0,0,0
2021-07-01 11:15,69,39,30,0,0,0
2021-07-01 11:30,79,44,35,0,0,0
2021-07-01 11:45,70,40,30,0,0,0
2021-07-01 12:00,81,48,33,0,0,0
2021-07-01 12:15,85,41,44,0,0,0
2021-07-01 12:30,74,47,27,0,0,0
2021-07-01 12:45,100,56,44,0,0,0
2021-07-01 13:00,90,47,43,0,0,0
2021-07-01 13:15,85,30,55,0,0,0
2021-07-01 13:30,108,31,77,0,0,0
2021-07-01 13:45,99,61,38,0,0,0
2021-07-01 14:00,73,44,29,0,0,0
2021-07-01 14:15,106,60,46,0,0,0
2021-07-01 14:30,106,50,56,0,0,0
2021-07-01 14:45,104,72,32,0,0,0
2021-07-01 15:00,108,51,57,0,0,0
2021-07-01 15:15,93,56,37,0,0,0
2021-07-01 15:30,89,49,40,0,0,0
2021-07-01 15:45,127,79,48,0,0,0
2021-07-01 16:00,131,73,58,0,0,0
2021-07-01 16:15,141,83,58,0,0,0
2021-07-01 16:30,155,75,80,0,0,0
2021-07-01 16:45,141,88,53,0,0,0
2021-07-01 17:00,116,60,56,0,0,0
2021-07-01 17:15,148,84,64,0,0,0
2021-07-01 17:30,135,66,69,0,0,0
2021-07-01 17:45,153,79,74,0,0,0
2021-07-01 18:00,151,72,79,0,0,0
2021-07-01 18:15,118,68,50,0,0,0
2021-07-01 18:30,105,51,54,0,0,0
2021-07-01 18:45,94,49,45,0,0,0
2021-07-01 19:00,93,43,50,0,0,0
2021-07-01 19:15,85,39,46,0,0,0
2021-07-01 19:30,74,37,37,0,0,0
2021-07-01 19:45,68,32,36,0,0,0
2021-07-01 20:00,68,27,41,0,0,0
2021-07-01 20:15,68,29,39,0,0,0
2021-07-01 20:30,55,25,30,0,0,0
2021-07-01 20:45,42,20,22,0,0,0
2021-07-01 21:00,43,21,22,0,0,0
2021-07-01 21:15,30,8,22,0,0,0
2021-07-01 21:30,28,16,12,0,0,0
2021-07-01 21:45,36,13,23,0,0,0
2021-07-01 22:00,38,20,18,0,0,0
2021-07-01 22:15,45,28,17,0,0,0
2021-07-01 22:30,42,23,19,0,0,0
2021-07-01 22:45,35,19,16,0,0,0
2021-07-01 23:00,45,24,21,0,0,0
2021-07-01 23:15,27,12,15,0,0,0
2021-07-01 23:30,24,9,15,0,0,0
2021-07-01 23:45,15,6,9,0,0,0
2021-07-02 00:00,24,6,18,0,0,0
2021-07-02 00:15,8,4,4,0,0,0
2021-07-02 00:30,10,6,4,0,0,0
2021-07-02 00:45,13,6,7,0,0,0
2021-07-02 01:00,7,3,4,0,0,0
2021-07-02 01:15,5,4,1,0,0,0
2021-07-02 01:30,8,1,7,0,0,0
2021-07-02 01:45,3,2,1,0,0,0
2021-07-02 02:00,2,0,2,0,0,0
2021-07-02 02:15,7,0,7,0,0,0
2021-07-02 02:30,2,2,0,0,0,0
2021-07-02 02:45,2,0,2,0,0,0
2021-07-02 03:00,0,0,0,0,0,0
2021-07-02 03:15,0,0,0,0,0,0
2021-07-02 03:30,1,0,1,0,0,0
2021-07-02 03:45,0,0,0,0,0,0
2021-07-02 04:00,1,1,0,0,0,0
2021-07-02 04:15,0,0,0,0,0,0
2021-07-02 04:30,1,1,0,0,0,0
2021-07-02 04:45,4,1,3,0,0,0
2021-07-02 05:00,2,0,2,0,0,0
2021-07-02 05:15,5,5,0,0,0,0
2021-07-02 05:30,16,12,4,0,0,0
2021-07-02 05:45,14,8,6,0,0,0
2021-07-02 06:00,18,7,11,0,0,0
2021-07-02 06:15,25,13,12,0,0,0
2021-07-02 06:30,47,34,13,0,0,0
2021-07-02 06:45,62,38,24,0,0,0
2021-07-02 07:00,63,38,25,0,0,0
2021-07-02 07:15,95,63,32,0,0,0
2021-07-02 07:30,151,101,50,0,0,0
2021-07-02 07:45,248,178,70,0,0,0
2021-07-02 08:00,218,185,33,0,0,0
2021-07-02 08:15,126,86,40,0,0,0
2021-07-02 08:30,117,87,30,0,0,0
2021-07-02 08:45,148,114,34,0,0,0
2021-07-02 09:00,109,71,38,0,0,0
2021-07-02 09:15,98,68,30,0,0,0
2021-07-02 09:30,107,80,27,0,0,0
2021-07-02 09:45,114,78,36,0,0,0
2021-07-02 10:00,103,71,32,0,0,0
2021-07-02 10:15,101,69,32,0,0,0
2021-07-02 10:30,137,72,65,0,0,0
2021-07-02 10:45,141,79,62,0,0,0
2021-07-02 11:00,149,77,72,0,0,0
2021-07-02 11:15,121,67,54,0,0,0
2021-07-02 11:30,148,93,55,0,0,0
2021-07-02 11:45,120,74,46,0,0,0
2021-07-02 12:00,103,66,37,0,0,0
2021-07-02 12:15,131,74,57,0,0,0
2021-07-02 12:30,123,82,41,0,0,0
2021-07-02 12:45,152,91,61,0,0,0
2021-07-02 13:00,129,67,62,0,0,0
2021-07-02 13:15,122,72,50,0,0,0
2021-07-02 13:30,145,100,45,0,0,0
2021-07-02 13:45,128,78,50,0,0,0
2021-07-02 14:00,148,87,61,0,0,0
2021-07-02 14:15,146,98,48,0,0,0
2021-07-02 14:30,163,104,59,0,0,0
2021-07-02 14:45,141,82,59,0,0,0
2021-07-02 15:00,139,69,70,0,0,0
2021-07-02 15:15,137,76,61,0,0,0
2021-07-02 15:30,144,88,56,0,0,0
2021-07-02 15:45,146,93,53,0,0,0
2021-07-02 16:00,121,52,69,0,0,0
2021-07-02 16:15,133,74,59,0,0,0
2021-07-02 16:30,145,84,61,0,0,0
2021-07-02 16:45,124,80,44,0,0,0
2021-07-02 17:00,141,92,49,0,0,0
2021-07-02 17:15,154,87,67,0,0,0
2021-07-02 17:30,168,102,66,0,0,0
2021-07-02 17:45,141,70,71,0,0,0
2021-07-02 18:00,131,61,70,0,0,0
2021-07-02 18:15,110,49,61,0,0,0
2021-07-02 18:30,111,71,40,0,0,0
2021-07-02 18:45,138,79,59,0,0,0
2021-07-02 19:00,106,67,39,0,0,0
2021-07-02 19:15,113,71,42,0,0,0
2021-07-02 19:30,82,46,36,0,0,0
2021-07-02 19:45,85,49,36,0,0,0
2021-07-02 20:00,72,36,36,0,0,0
2021-07-02 20:15,75,41,34,0,0,0
2021-07-02 20:30,67,39,28,0,0,0
2021-07-02 20:45,64,33,31,0,0,0
2021-07-02 21:00,61,40,21,0,0,0
2021-07-02 21:15,50,20,30,0,0,0
2021-07-02 21:30,56,32,24,0,0,0
2021-07-02 21:45,18,7,11,0,0,0
2021-07-02 22:00,34,14,20,0,0,0
2021-07-02 22:15,39,23,16,0,0,0
2021-07-02 22:30,51,31,20,0,0,0
2021-07-02 22:45,36,19,17,0,0,0
2021-07-02 23:00,46,21,25,0,0,0
2021-07-02 23:15,48,22,26,0,0,0
2021-07-02 23:30,61,34,27,0,0,0
2021-07-02 23:45,25,9,16,0,0,0
2021-07-03 00:00,38,17,21,0,0,0
2021-07-03 00:15,29,13,16,0,0,0
2021-07-03 00:30,36,28,8,0,0,0
2021-07-03 00:45,18,10,8,0,0,0
2021-07-03 01:00,24,4,20,0,0,0
2021-07-03 01:15,18,7,11,0,0,0
2021-07-03 01:30,19,5,14,0,0,0
2021-07-03 01:45,15,11,4,0,0,0
2021-07-03 02:00,20,8,12,0,0,0
2021-07-03 02:15,31,18,13,0,0,0
2021-07-03 02:30,15,7,8,0,0,0
2021-07-03 02:45,10,6,4,0,0,0
2021-07-03 03:00,3,2,1,0,0,0
2021-07-03 03:15,4,1,3,0,0,0
2021-07-03 03:30,11,2,9,0,0,0
2021-07-03 03:45,8,4,4,0,0,0
2021-07-03 04:00,5,2,3,0,0,0
2021-07-03 04:15,5,0,5,0,0,0
2021-07-03 04:30,3,1,2,0,0,0
2021-07-03 04:45,2,0,2,0,0,0
2021-07-03 05:00,0,0,0,0,0,0
2021-07-03 05:15,2,1,1,0,0,0
2021-07-03 05:30,11,8,3,0,0,0
2021-07-03 05:45,8,4,4,0,0,0
2021-07-03 06:00,8,6,2,0,0,0
2021-07-03 06:15,4,2,2,0,0,0
2021-07-03 06:30,14,7,7,0,0,0
2021-07-03 06:45,17,9,8,0,0,0
2021-07-03 07:00,7,5,2,0,0,0
2021-07-03 07:15,18,12,6,0,0,0
2021-07-03 07:30,23,16,7,0,0,0
2021-07-03 07:45,43,31,12,0,0,0
2021-07-03 08:00,30,21,9,0,0,0
2021-07-03 08:15,50,29,21,0,0,0
2021-07-03 08:30,54,38,16,0,0,0
2021-07-03 08:45,78,57,21,0,0,0
2021-07-03 09:00,59,40,19,0,0,0
2021-07-03 09:15,83,64,19,0,0,0
2021-07-03 09:30,103,76,27,0,0,0
2021-07-03 09:45,137,108,29,0,0,0
2021-07-03 10:00,109,81,28,0,0,0
2021-07-03 10:15,112,84,28,0,0,0
2021-07-03 10:30,123,95,28,0,0,0
2021-07-03 10:45,156,120,36,0,0,0
2021-07-03 11:00,171,125,46,0,0,0
2021-07-03 11:15,127,79,48,0,0,0
2021-07-03 11:30,134,89,45,0,0,0
2021-07-03 11:45,169,119,50,0,0,0
2021-07-03 12:00,172,126,46,0,0,0
2021-07-03 12:15,162,101,61,0,0,0
2021-07-03 12:30,166,99,67,0,0,0
2021-07-03 12:45,158,103,55,0,0,0
2021-07-03 13:00,158,101,57,0,0,0
2021-07-03 13:15,139,83,56,0,0,0
2021-07-03 13:30,167,91,76,0,0,0
2021-07-03 13:45,136,75,61,0,0,0
2021-07-03 14:00,136,80,56,0,0,0
2021-07-03 14:15,146,74,72,0,0,0
2021-07-03 14:30,122,65,57,0,0,0
2021-07-03 14:45,152,78,74,0,0,0
2021-07-03 15:00,118,63,55,0,0,0
2021-07-03 15:15,130,77,53,0,0,0
2021-07-03 15:30,130,85,45,0,0,0
2021-07-03 15:45,131,75,56,0,0,0
2021-07-03 16:00,140,79,61,0,0,0
2021-07-03 16:15,93,61,32,0,0,0
2021-07-03 16:30,120,81,39,0,0,0
2021-07-03 16:45,125,75,50,0,0,0
2021-07-03 17:00,97,48,49,0,0,0
2021-07-03 17:15,113,67,46,0,0,0
2021-07-03 17:30,108,61,47,0,0,0
2021-07-03 17:45,121,71,50,0,0,0
2021-07-03 18:00,117,66,51,0,0,0
2021-07-03 18:15,122,76,46,0,0,0
2021-07-03 18:30,83,40,43,0,0,0
2021-07-03 18:45,129,88,41,0,0,0
2021-07-03 19:00,83,47,36,0,0,0
2021-07-03 19:15,79,51,28,0,0,0
2021-07-03 19:30,83,53,30,0,0,0
2021-07-03 19:45,82,54,28,0,0,0
2021-07-03 20:00,94,51,43,0,0,0
2021-07-03 20:15,55,30,25,0,0,0
2021-07-03 20:30,70,34,36,0,0,0
2021-07-03 20:45,61,34,27,0,0,0
2021-07-03 21:00,49,22,27,0,0,0
2021-07-03 21:15,34,13,21,0,0,0
2021-07-03 21:30,46,25,21,0,0,0
2021-07-03 21:45,45,28,17,0,0,0
2021-07-03 22:00,51,23,28,0,0,0
2021-07-03 22:15,67,38,29,0,0,0
2021-07-03 22:30,29,20,9,0,0,0
2021-07-03 22:45,37,21,16,0,0,0
2021-07-03 23:00,27,7,20,0,0,0
2021-07-03 23:15,30,16,14,0,0,0
2021-07-03 23:30,37,26,11,0,0,0
2021-07-03 23:45,35,14,21,0,0,0
2021-07-04 00:00,41,27,14,0,0,0
2021-07-04 00:15,33,22,11,0,0,0
2021-07-04 00:30,24,8,16,0,0,0
2021-07-04 00:45,33,17,16,0,0,0
2021-07-04 01:00,29,18,11,0,0,0
2021-07-04 01:15,25,11,14,0,0,0
2021-07-04 01:30,12,5,7,0,0,0
2021-07-04 01:45,12,4,8,0,0,0
2021-07-04 02:00,16,8,8,0,0,0
2021-07-04 02:15,11,7,4,0,0,0
2021-07-04 02:30,18,9,9,0,0,0
2021-07-04 02:45,18,9,9,0,0,0
2021-07-04 03:00,15,6,9,0,0,0
2021-07-04 03:15,14,2,12,0,0,0
2021-07-04 03:30,8,4,4,0,0,0
2021-07-04 03:45,7,3,4,0,0,0
2021-07-04 04:00,2,2,0,0,0,0
2021-07-04 04:15,5,3,2,0,0,0
2021-07-04 04:30,2,2,0,0,0,0
2021-07-04 04:45,10,8,2,0,0,0
2021-07-04 05:00,1,0,1,0,0,0
2021-07-04 05:15,4,4,0,0,0,0
2021-07-04 05:30,5,2,3,0,0,0
2021-07-04 05:45,12,4,8,0,0,0
2021-07-04 06:00,5,2,3,0,0,0
2021-07-04 06:15,5,2,3,0,0,0
2021-07-04 06:30,5,2,3,0,0,0
2021-07-04 06:45,5,2,3,0,0,0
2021-07-04 07:00,0,0,0,0,0,0
2021-07-04 07:15,4,2,2,0,0,0
2021-07-04 07:30,6,6,0,0,0,0
2021-07-04 07:45,9,7,2,0,0,0
2021-07-04 08:00,10,6,4,0,0,0
2021-07-04 08:15,10,7,3,0,0,0
2021-07-04 08:30,17,11,6,0,0,0
2021-07-04 08:45,11,4,7,0,0,0
2021-07-04 09:00,19,11,8,0,0,0
2021-07-04 09:15,26,14,12,0,0,0
2021-07-04 09:30,26,22,4,0,0,0
2021-07-04 09:45,52,41,11,0,0,0
2021-07-04 10:00,38,30,8,0,0,0
2021-07-04 10:15,27,21,6,0,0,0
2021-07-04 10:30,26,20,6,0,0,0
2021-07-04 10:45,30,22,8,0,0,0
2021-07-04 11:00,25,18,7,0,0,0
2021-07-04 11:15,26,18,8,0,0,0
2021-07-04 11:30,53,31,22,0,0,0
2021-07-04 11:45,44,36,8,0,0,0
2021-07-04 12:00,41,25,16,0,0,0
2021-07-04 12:15,76,44,32,0,0,0
2021-07-04 12:30,48,26,22,0,0,0
2021-07-04 12:45,46,22,24,0,0,0
2021-07-04 13:00,52,31,21,0,0,0
2021-07-04 13:15,46,29,17,0,0,0
2021-07-04 13:30,40,23,17,0,0,0
2021-07-04 13:45,65,36,29,0,0,0
2021-07-04 14:00,55,31,24,0,0,0
2021-07-04 14:15,78,44,34,0,0,0
2021-07-04 14:30,39,17,22,0,0,0
2021-07-04 14:45,12,8,4,0,0,0
2021-07-04 15:00,25,11,14,0,0,0
2021-07-04 15:15,13,8,5,0,0,0
2021-07-04 15:30,20,7,13,0,0,0
2021-07-04 15:45,30,16,14,0,0,0
2021-07-04 16:00,35,21,14,0,0,0
2021-07-04 16:15,28,16,12,0,0,0
2021-07-04 16:30,25,18,7,0,0,0
2021-07-04 16:45,19,12,7,0,0,0
2021-07-04 17:00,33,14,19,0,0,0
2021-07-04 17:15,20,7,13,0,0,0
2021-07-04 17:30,25,16,9,0,0,0
2021-07-04 17:45,43,28,15,0,0,0
2021-07-04 18:00,49,32,17,0,0,0
2021-07-04 18:15,53,37,16,0,0,0
2021-07-04 18:30,38,24,14,0,0,0
2021-07-04 18:45,44,30,14,0,0,0
2021-07-04 19:00,46,21,25,0,0,0
2021-07-04 19:15,41,24,17,0,0,0
2021-07-04 19:30,37,20,17,0,0,0
2021-07-04 19:45,60,35,25,0,0,0
2021-07-04 20:00,30,16,14,0,0,0
2021-07-04 20:15,46,24,22,0,0,0
2021-07-04 20:30,18,7,11,0,0,0
2021-07-04 20:45,32,15,17,0,0,0
2021-07-04 21:00,26,17,9,0,0,0
2021-07-04 21:15,18,13,5,0,0,0
2021-07-04 21:30,25,17,8,0,0,0
2021-07-04 21:45,18,9,9,0,0,0
2021-07-04 22:00,25,15,10,0,0,0
2021-07-04 22:15,34,17,17,0,0,0
2021-07-04 22:30,9,5,4,0,0,0
2021-07-04 22:45,14,9,5,0,0,0
2021-07-04 23:00,8,4,4,0,0,0
2021-07-04 23:15,12,6,6,0,0,0
2021-07-04 23:30,10,6,4,0,0,0
2021-07-04 23:45,9,5,4,0,0,0
2021-07-05 00:00,4,0,4,0,0,0
2021-07-05 00:15,5,1,4,0,0,0
2021-07-05 00:30,1,0,1,0,0,0
2021-07-05 00:45,2,1,1,0,0,0
2021-07-05 01:00,4,1,3,0,0,0
2021-07-05 01:15,4,4,0,0,0,0
2021-07-05 01:30,0,0,0,0,0,0
2021-07-05 01:45,2,0,2,0,0,0
2021-07-05 02:00,2,0,2,0,0,0
2021-07-05 02:15,1,1,0,0,0,0
2021-07-05 02:30,4,2,2,0,0,0
2021-07-05 02:45,0,0,0,0,0,0
2021-07-05 03:00,2,1,1,0,0,0
2021-07-05 03:15,1,0,1,0,0,0
2021-07-05 03:30,2,1,1,0,0,0
2021-07-05 03:45,0,0,0,0,0,0
2021-07-05 04:00,1,0,1,0,0,0
2021-07-05 04:15,1,1,0,0,0,0
2021-07-05 04:30,1,0,1,0,0,0
2021-07-05 04:45,1,1,0,0,0,0
2021-07-05 05:00,3,2,1,0,0,0
2021-07-05 05:15,3,3,0,0,0,0
2021-07-05 05:30,10,6,4,0,0,0
2021-07-05 05:45,16,7,9,0,0,0
2021-07-05 06:00,16,8,8,0,0,0
2021-07-05 06:15,28,21,7,0,0,0
2021-07-05 06:30,51,29,22,0,0,0
2021-07-05 06:45,67,44,23,0,0,0
2021-07-05 07:00,78,55,23,0,0,0
2021-07-05 07:15,71,40,31,0,0,0
2021-07-05 07:30,126,77,49,0,0,0
2021-07-05 07:45,182,124,58,0,0,0
2021-07-05 08:00,120,64,56,0,0,0
2021-07-05 08:15,84,59,25,0,0,0
2021-07-05 08:30,64,42,22,0,0,0
2021-07-05 08:45,76,57,19,0,0,0
2021-07-05 09:00,59,46,13,0,0,0
2021-07-05 09:15,55,41,14,0,0,0
2021-07-05 09:30,81,61,20,0,0,0
2021-07-05 09:45,70,44,26,0,0,0
2021-07-05 10:00,63,47,16,0,0,0
2021-07-05 10:15,59,42,17,0,0,0
2021-07-05 10:30,73,53,20,0,0,0
2021-07-05 10:45,80,62,18,0,0,0
2021-07-05 11:00,76,57,19,0,0,0
2021-07-05 11:15,71,52,19,0,0,0
2021-07-05 11:30,78,57,21,0,0,0
2021-07-05 11:45,120,86,34,0,0,0
2021-07-05 12:00,96,59,37,0,0,0
2021-07-05 12:15,91,60,31,0,0,0
2021-07-05 12:30,77,48,29,0,0,0
2021-07-05 12:45,116,70,46,0,0,0
2021-07-05 13:00,101,55,46,0,0,0
2021-07-05 13:15,69,37,32,0,0,0
2021-07-05 13:30,92,61,31,0,0,0
2021-07-05 13:45,93,59,34,0,0,0
2021-07-05 14:00,91,52,39,0,0,0
2021-07-05 14:15,97,56,41,0,0,0
2021-07-05 14:30,100,72,28,0,0,0
2021-07-05 14:45,152,97,55,0,0,0
2021-07-05 15:00,127,80,47,0,0,0
2021-07-05 15:15,132,82,50,0,0,0
2021-07-05 15:30,130,73,57,0,0,0
2021-07-05 15:45,131,93,38,0,0,0
2021-07-05 16:00,146,76,70,0,0,0
2021-07-05 16:15,131,71,60,0,0,0
2021-07-05 16:30,153,99,54,0,0,0
2021-07-05 16:45,167,108,59,0,0,0
2021-07-05 17:00,146,74,72,0,0,0
2021-07-05 17:15,143,90,53,0,0,0
2021-07-05 17:30,139,75,64,0,0,0
2021-07-05 17:45,125,75,50,0,0,0
2021-07-05 18:00,133,79,54,0,0,0
2021-07-05 18:15,132,75,57,0,0,0
2021-07-05 18:30,122,62,60,0,0,0
2021-07-05 18:45,121,74,47,0,0,0
2021-07-05 19:00,83,46,37,0,0,0
2021-07-05 19:15,84,43,41,0,0,0
2021-07-05 19:30,69,36,33,0,0,0
2021-07-05 19:45,73,37,36,0,0,0
2021-07-05 20:00,68,29,39,0,0,0
2021-07-05 20:15,70,44,26,0,0,0
2021-07-05 20:30,42,18,24,0,0,0
2021-07-05 20:45,52,19,33,0,0,0
2021-07-05 21:00,56,34,22,0,0,0
2021-07-05 21:15,59,33,26,0,0,0
2021-07-05 21:30,36,17,19,0,0,0
2021-07-05 21:45,29,13,16,0,0,0
2021-07-05 22:00,39,12,27,0,0,0
2021-07-05 22:15,33,14,19,0,0,0
2021-07-05 22:30,34,12,22,0,0,0
2021-07-05 22:45,20,10,10,0,0,0
2021-07-05 23:00,34,26,8,0,0,0
2021-07-05 23:15,19,9,10,0,0,0
2021-07-05 23:30,23,14,9,0,0,0
2021-07-05 23:45,7,1,6,0,0,0
2021-07-06 00:00,10,4,6,0,0,0
2021-07-06 00:15,14,4,10,0,0,0
2021-07-06 00:30,14,10,4,0,0,0
2021-07-06 00:45,4,1,3,0,0,0
2021-07-06 01:00,5,2,3,0,0,0
2021-07-06 01:15,1,0,1,0,0,0
2021-07-06 01:30,3,2,1,0,0,0
2021-07-06 01:45,1,1,0,0,0,0
2021-07-06 02:00,4,1,3,0,0,0
2021-07-06 02:15,1,0,1,0,0,0
2021-07-06 02:30,2,0,2,0,0,0
2021-07-06 02:45,0,0,0,0,0,0
2021-07-06 03:00,3,1,2,0,0,0
2021-07-06 03:15,1,1,0,0,0,0
2021-07-06 03:30,1,0,1,0,0,0
2021-07-06 03:45,0,0,0,0,0,0
2021-07-06 04:00,0,0,0,0,0,0
2021-07-06 04:15,0,0,0,0,0,0
2021-07-06 04:30,1,1,0,0,0,0
2021-07-06 04:45,2,2,0,0,0,0
2021-07-06 05:00,2,0,2,0,0,0
2021-07-06 05:15,2,1,1,0,0,0
2021-07-06 05:30,14,9,5,0,0,0
2021-07-06 05:45,22,10,12,0,0,0
2021-07-06 06:00,25,16,9,0,0,0
2021-07-06 06:15,30,18,12,0,0,0
2021-07-06 06:30,50,27,23,0,0,0
2021-07-06 06:45,64,48,16,0,0,0
2021-07-06 07:00,85,52,33,0,0,0
2021-07-06 07:15,86,54,32,0,0,0
2021-07-06 07:30,100,76,24,0,0,0
2021-07-06 07:45,152,102,50,0,0,0
2021-07-06 08:00,128,96,32,0,0,0
2021-07-06 08:15,105,72,33,0,0,0
2021-07-06 08:30,101,83,18,0,0,0
2021-07-06 08:45,143,104,39,0,0,0
2021-07-06 09:00,89,71,18,0,0,0
2021-07-06 09:15,67,47,20,0,0,0
2021-07-06 09:30,75,63,12,0,0,0
2021-07-06 09:45,89,71,18,0,0,0
2021-07-06 10:00,46,27,19,0,0,0
2021-07-06 10:15,49,38,11,0,0,0
2021-07-06 10:30,71,52,19,0,0,0
2021-07-06 10:45,80,59,21,0,0,0
2021-07-06 11:00,51,35,16,0,0,0
2021-07-06 11:15,59,39,20,0,0,0
2021-07-06 11:30,77,46,31,0,0,0
2021-07-06 11:45,74,47,27,0,0,0
2021-07-06 12:00,87,56,31,0,0,0
2021-07-06 12:15,91,63,28,0,0,0
2021-07-06 12:30,84,56,28,0,0,0
2021-07-06 12:45,111,70,41,0,0,0
2021-07-06 13:00,97,63,34,0,0,0
2021-07-06 13:15,91,55,36,0,0,0
2021-07-06 13:30,77,40,37,0,0,0
2021-07-06 13:45,115,70,45,0,0,0
2021-07-06 14:00,119,77,42,0,0,0
2021-07-06 14:15,108,64,44,0,0,0
2021-07-06 14:30,118,80,38,0,0,0
2021-07-06 14:45,135,88,47,0,0,0
2021-07-06 15:00,103,60,43,0,0,0
2021-07-06 15:15,119,82,37,0,0,0
2021-07-06 15:30,124,69,55,0,0,0
2021-07-06 15:45,154,90,64,0,0,0
2021-07-06 16:00,150,86,64,0,0,0
2021-07-06 16:15,189,122,67,0,0,0
2021-07-06 16:30,163,84,79,0,0,0
2021-07-06 16:45,147,81,66,0,0,0
2021-07-06 17:00,165,91,74,0,0,0
2021-07-06 17:15,148,73,75,0,0,0
2021-07-06 17:30,158,82,76,0,0,0
2021-07-06 17:45,148,88,60,0,0,0
2021-07-06 18:00,132,75,57,0,0,0
2021-07-06 18:15,143,73,70,0,0,0
2021-07-06 18:30,123,67,56,0,0,0
2021-07-06 18:45,128,83,45,0,0,0
2021-07-06 19:00,99,52,47,0,0,0
2021-07-06 19:15,102,62,40,0,0,0
2021-07-06 19:30,64,35,29,0,0,0
2021-07-06 19:45,91,45,46,0,0,0
2021-07-06 20:00,79,38,41,0,0,0
2021-07-06 20:15,90,47,43,0,0,0
2021-07-06 20:30,59,31,28,0,0,0
2021-07-06 20:45,54,30,24,0,0,0
2021-07-06 21:00,38,24,14,0,0,0
2021-07-06 21:15,63,37,26,0,0,0
2021-07-06 21:30,46,23,23,0,0,0
2021-07-06 21:45,30,13,17,0,0,0
2021-07-06 22:00,44,27,17,0,0,0
2021-07-06 22:15,50,36,14,0,0,0
2021-07-06 22:30,29,16,13,0,0,0
2021-07-06 22:45,21,12,9,0,0,0
2021-07-06 23:00,30,15,15,0,0,0
2021-07-06 23:15,21,9,12,0,0,0
2021-07-06 23:30,13,8,5,0,0,0
2021-07-06 23:45,48,25,23,0,0,0
2021-07-07 00:00,37,14,23,0,0,0
2021-07-07 00:15,19,8,11,0,0,0
2021-07-07 00:30,11,6,5,0,0,0
2021-07-07 00:45,13,5,8,0,0,0
2021-07-07 01:00,11,6,5,0,0,0
2021-07-07 01:15,7,2,5,0,0,0
2021-07-07 01:30,6,2,4,0,0,0
2021-07-07 01:45,6,4,2,0,0,0
2021-07-07 02:00,2,0,2,0,0,0
2021-07-07 02:15,3,1,2,0,0,0
2021-07-07 02:30,9,4,5,0,0,0
2021-07-07 02:45,2,0,2,0,0,0
2021-07-07 03:00,2,0,2,0,0,0
2021-07-07 03:15,1,1,0,0,0,0
2021-07-07 03:30,0,0,0,0,0,0
2021-07-07 03:45,0,0,0,0,0,0
2021-07-07 04:00,4,4,0,0,0,0
2021-07-07 04:15,3,3,0,0,0,0
2021-07-07 04:30,2,2,0,0,0,0
2021-07-07 04:45,6,2,4,0,0,0
2021-07-07 05:00,2,2,0,0,0,0
2021-07-07 05:15,2,2,0,0,0,0
2021-07-07 05:30,18,12,6,0,0,0
2021-07-07 05:45,19,5,14,0,0,0
2021-07-07 06:00,26,17,9,0,0,0
2021-07-07 06:15,31,18,13,0,0,0
2021-07-07 06:30,53,32,21,0,0,0
2021-07-07 06:45,77,47,30,0,0,0
2021-07-07 07:00,91,54,37,0,0,0
2021-07-07 07:15,116,80,36,0,0,0
2021-07-07 07:30,122,77,45,0,0,0
2021-07-07 07:45,153,99,54,0,0,0
2021-07-07 08:00,149,110,39,0,0,0
2021-07-07 08:15,127,80,47,0,0,0
2021-07-07 08:30,168,117,51,0,0,0
2021-07-07 08:45,171,131,40,0,0,0
2021-07-07 09:00,118,80,38,0,0,0
2021-07-07 09:15,105,80,25,0,0,0
2021-07-07 09:30,127,94,33,0,0,0
2021-07-07 09:45,148,106,42,0,0,0
2021-07-07 10:00,116,86,30,0,0,0
2021-07-07 10:15,125,94,31,0,0,0
2021-07-07 10:30,159,111,48,0,0,0
2021-07-07 10:45,135,95,40,0,0,0
2021-07-07 11:00,139,89,50,0,0,0
2021-07-07 11:15,125,89,36,0,0,0
2021-07-07 11:30,140,95,45,0,0,0
2021-07-07 11:45,132,85,47,0,0,0
2021-07-07 12:00,148,98,50,0,0,0
2021-07-07 12:15,129,90,39,0,0,0
2021-07-07 12:30,142,80,62,0,0,0
2021-07-07 12:45,163,92,71,0,0,0
2021-07-07 13:00,147,83,64,0,0,0
2021-07-07 13:15,144,79,65,0,0,0
2021-07-07 13:30,170,112,58,0,0,0
2021-07-07 13:45,147,67,80,0,0,0
2021-07-07 14:00,157,84,73,0,0,0
2021-07-07 14:15,148,90,58,0,0,0
2021-07-07 14:30,166,80,86,0,0,0
2021-07-07 14:45,154,79,75,0,0,0
2021-07-07 15:00,160,91,69,0,0,0
2021-07-07 15:15,133,82,51,0,0,0
2021-07-07 15:30,165,85,80,0,0,0
2021-07-07 15:45,167,79,88,0,0,0
2021-07-07 16:00,167,98,69,0,0,0
2021-07-07 16:15,181,107,74,0,0,0
2021-07-07 16:30,184,114,70,0,0,0
2021-07-07 16:45,168,86,82,0,0,0
2021-07-07 17:00,156,87,69,0,0,0
2021-07-07 17:15,152,81,71,0,0,0
2021-07-07 17:30,144,80,64,0,0,0
2021-07-07 17:45,160,86,74,0,0,0
2021-07-07 18:00,152,82,70,0,0,0
2021-07-07 18:15,141,79,62,0,0,0
2021-07-07 18:30,117,63,54,0,0,0
2021-07-07 18:45,117,73,44,0,0,0
2021-07-07 19:00,129,63,66,0,0,0
2021-07-07 19:15,136,78,58,0,0,0
2021-07-07 19:30,110,51,59,0,0,0
2021-07-07 19:45,88,54,34,0,0,0
2021-07-07 20:00,74,44,30,0,0,0
2021-07-07 20:15,69,46,23,0,0,0
2021-07-07 20:30,66,26,40,0,0,0
2021-07-07 20:45,64,32,32,0,0,0
2021-07-07 21:00,58,36,22,0,0,0
2021-07-07 21:15,66,33,33,0,0,0
2021-07-07 21:30,41,17,24,0,0,0
2021-07-07 21:45,74,46,28,0,0,0
2021-07-07 22:00,48,22,26,0,0,0
2021-07-07 22:15,30,11,19,0,0,0
2021-07-07 22:30,35,23,12,0,0,0
2021-07-07 22:45,33,15,18,0,0,0
2021-07-07 23:00,51,27,24,0,0,0
2021-07-07 23:15,18,9,9,0,0,0
2021-07-07 23:30,33,19,14,0,0,0
2021-07-07 23:45,36,23,13,0,0,0
2021-07-08 00:00,28,13,15,0,0,0
2021-07-08 00:15,15,11,4,0,0,0
2021-07-08 00:30,23,16,7,0,0,0
2021-07-08 00:45,25,20,5,0,0,0
2021-07-08 01:00,8,2,6,0,0,0
2021-07-08 01:15,9,6,3,0,0,0
2021-07-08 01:30,8,2,6,0,0,0
2021-07-08 01:45,6,3,3,0,0,0
2021-07-08 02:00,6,2,4,0,0,0
2021-07-08 02:15,1,0,1,0,0,0
2021-07-08 02:30,14,1,13,0,0,0
2021-07-08 02:45,2,0,2,0,0,0
2021-07-08 03:00,4,2,2,0,0,0
2021-07-08 03:15,1,1,0,0,0,0
2021-07-08 03:30,1,0,1,0,0,0
2021-07-08 03:45,0,0,0,0,0,0
2021-07-08 04:00,6,5,1,0,0,0
2021-07-08 04:15,0,0,0,0,0,0
2021-07-08 04:30,1,1,0,0,0,0
2021-07-08 04:45,2,0,2,0,0,0
2021-07-08 05:00,2,2,0,0,0,0
2021-07-08 05:15,5,5,0,0,0,0
2021-07-08 05:30,12,10,2,0,0,0
2021-07-08 05:45,17,7,10,0,0,0
2021-07-08 06:00,18,11,7,0,0,0
2021-07-08 06:15,28,20,8,0,0,0
2021-07-08 06:30,43,26,17,0,0,0
2021-07-08 06:45,51,34,17,0,0,0
2021-07-08 07:00,84,56,28,0,0,0
2021-07-08 07:15,90,55,35,0,0,0
2021-07-08 07:30,86,63,23,0,0,0
2021-07-08 07:45,172,106,66,0,0,0
2021-07-08 08:00,124,99,25,0,0,0
2021-07-08 08:15,114,80,34,0,0,0
2021-07-08 08:30,121,87,34,0,0,0
2021-07-08 08:45,157,117,40,0,0,0
2021-07-08 09:00,106,79,27,0,0,0
2021-07-08 09:15,97,75,22,0,0,0
2021-07-08 09:30,66,47,19,0,0,0
2021-07-08 09:45,130,95,35,0,0,0
2021-07-08 10:00,85,63,22,0,0,0
2021-07-08 10:15,107,83,24,0,0,0
2021-07-08 10:30,95,76,19,0,0,0
2021-07-08 10:45,124,83,41,0,0,0
2021-07-08 11:00,87,61,26,0,0,0
2021-07-08 11:15,100,72,28,0,0,0
2021-07-08 11:30,88,57,31,0,0,0
2021-07-08 11:45,108,70,38,0,0,0
2021-07-08 12:00,115,79,36,0,0,0
2021-07-08 12:15,122,73,49,0,0,0
2021-07-08 12:30,108,53,55,0,0,0
2021-07-08 12:45,107,65,42,0,0,0
2021-07-08 13:00,90,63,27,0,0,0
2021-07-08 13:15,93,52,41,0,0,0
2021-07-08 13:30,110,70,40,0,0,0
2021-07-08 13:45,120,78,42,0,0,0
2021-07-08 14:00,133,76,57,0,0,0
2021-07-08 14:15,117,65,52,0,0,0
2021-07-08 14:30,137,63,74,0,0,0
2021-07-08 14:45,149,96,53,0,0,0
2021-07-08 15:00,113,67,46,0,0,0
2021-07-08 15:15,142,82,60,0,0,0
2021-07-08 15:30,130,75,55,0,0,0
2021-07-08 15:45,130,73,57,0,0,0
2021-07-08 16:00,157,78,79,0,0,0
2021-07-08 16:15,140,83,57,0,0,0
2021-07-08 16:30,149,73,76,0,0,0
2021-07-08 16:45,115,62,53,0,0,0
2021-07-08 17:00,111,54,57,0,0,0
2021-07-08 17:15,122,72,50,0,0,0
2021-07-08 17:30,135,83,52,0,0,0
2021-07-08 17:45,130,80,50,0,0,0
2021-07-08 18:00,103,46,57,0,0,0
2021-07-08 18:15,113,58,55,0,0,0
2021-07-08 18:30,91,54,37,0,0,0
2021-07-08 18:45,125,69,56,0,0,0
2021-07-08 19:00,71,44,27,0,0,0
2021-07-08 19:15,94,44,50,0,0,0
2021-07-08 19:30,75,45,30,0,0,0
2021-07-08 19:45,70,41,29,0,0,0
2021-07-08 20:00,69,41,28,0,0,0
2021-07-08 20:15,44,27,17,0,0,0
2021-07-08 20:30,37,22,15,0,0,0
2021-07-08 20:45,30,18,12,0,0,0
2021-07-08 21:00,39,24,15,0,0,0
2021-07-08 21:15,24,10,14,0,0,0
2021-07-08 21:30,30,16,14,0,0,0
2021-07-08 21:45,26,7,19,0,0,0
2021-07-08 22:00,49,28,21,0,0,0
2021-07-08 22:15,30,9,21,0,0,0
2021-07-08 22:30,29,13,16,0,0,0
2021-07-08 22:45,41,16,25,0,0,0
2021-07-08 23:00,30,13,17,0,0,0
2021-07-08 23:15,39,24,15,0,0,0
2021-07-08 23:30,16,5,11,0,0,0
2021-07-08 23:45,16,8,8,0,0,0
2021-07-09 00:00,16,4,12,0,0,0
2021-07-09 00:15,16,6,10,0,0,0
2021-07-09 00:30,10,7,3,0,0,0
2021-07-09 00:45,8,2,6,0,0,0
2021-07-09 01:00,5,0,5,0,0,0
2021-07-09 01:15,3,0,3,0,0,0
2021-07-09 01:30,7,3,4,0,0,0
2021-07-09 01:45,7,5,2,0,0,0
2021-07-09 02:00,9,7,2,0,0,0
2021-07-09 02:15,1,0,1,0,0,0
2021-07-09 02:30,2,0,2,0,0,0
2021-07-09 02:45,2,1,1,0,0,0
2021-07-09 03:00,2,1,1,0,0,0
2021-07-09 03:15,4,4,0,0,0,0
2021-07-09 03:30,1,0,1,0,0,0
2021-07-09 03:45,1,1,0,0,0,0
2021-07-09 04:00,2,0,2,0,0,0
2021-07-09 04:15,0,0,0,0,0,0
2021-07-09 04:30,2,1,1,0,0,0
2021-07-09 04:45,0,0,0,0,0,0
2021-07-09 05:00,1,1,0,0,0,0
2021-07-09 05:15,6,5,1,0,0,0
2021-07-09 05:30,14,9,5,0,0,0
2021-07-09 05:45,11,3,8,0,0,0
2021-07-09 06:00,19,14,5,0,0,0
2021-07-09 06:15,28,15,13,0,0,0
2021-07-09 06:30,57,29,28,0,0,0
2021-07-09 06:45,52,34,18,0,0,0
2021-07-09 07:00,67,42,25,0,0,0
2021-07-09 07:15,84,46,38,0,0,0
2021-07-09 07:30,108,71,37,0,0,0
2021-07-09 07:45,129,84,45,0,0,0
2021-07-09 08:00,99,71,28,0,0,0
2021-07-09 08:15,103,73,30,0,0,0
2021-07-09 08:30,97,68,29,0,0,0
2021-07-09 08:45,118,88,30,0,0,0
2021-07-09 09:00,109,75,34,0,0,0
2021-07-09 09:15,98,68,30,0,0,0
2021-07-09 09:30,127,101,26,0,0,0
2021-07-09 09:45,121,84,37,0,0,0
2021-07-09 10:00,100,69,31,0,0,0
2021-07-09 10:15,96,69,27,0,0,0
2021-07-09 10:30,108,68,40,0,0,0
2021-07-09 10:45,147,103,44,0,0,0
2021-07-09 11:00,98,66,32,0,0,0
2021-07-09 11:15,112,66,46,0,0,0
2021-07-09 11:30,105,71,34,0,0,0
2021-07-09 11:45,89,54,35,0,0,0
2021-07-09 12:00,131,84,47,0,0,0
2021-07-09 12:15,136,81,55,0,0,0
2021-07-09 12:30,127,93,34,0,0,0
2021-07-09 12:45,125,71,54,0,0,0
2021-07-09 13:00,142,90,52,0,0,0
2021-07-09 13:15,131,73,58,0,0,0
2021-07-09 13:30,143,102,41,0,0,0
2021-07-09 13:45,132,93,39,0,0,0
2021-07-09 14:00,122,75,47,0,0,0
2021-07-09 14:15,152,99,53,0,0,0
2021-07-09 14:30,124,67,57,0,0,0
2021-07-09 14:45,141,84,57,0,0,0
2021-07-09 15:00,139,84,55,0,0,0
2021-07-09 15:15,133,76,57,0,0,0
2021-07-09 15:30,145,88,57,0,0,0
2021-07-09 15:45,141,79,62,0,0,0
2021-07-09 16:00,139,85,54,0,0,0
2021-07-09 16:15,145,93,52,0,0,0
2021-07-09 16:30,125,79,46,0,0,0
2021-07-09 16:45,117,72,45,0,0,0
2021-07-09 17:00,112,70,42,0,0,0
2021-07-09 17:15,106,66,40,0,0,0
2021-07-09 17:30,153,91,62,0,0,0
2021-07-09 17:45,156,95,61,0,0,0
2021-07-09 18:00,119,71,48,0,0,0
2021-07-09 18:15,143,92,51,0,0,0
2021-07-09 18:30,142,76,66,0,0,0
2021-07-09 18:45,142,86,56,0,0,0
2021-07-09 19:00,105,67,38,0,0,0
2021-07-09 19:15,115,63,52,0,0,0
2021-07-09 19:30,80,47,33,0,0,0
2021-07-09 19:45,76,44,32,0,0,0
2021-07-09 20:00,91,52,39,0,0,0
2021-07-09 20:15,69,48,21,0,0,0
2021-07-09 20:30,89,51,38,0,0,0
2021-07-09 20:45,51,30,21,0,0,0
2021-07-09 21:00,67,29,38,0,0,0
2021-07-09 21:15,71,45,26,0,0,0
2021-07-09 21:30,46,19,27,0,0,0
2021-07-09 21:45,48,25,23,0,0,0
2021-07-09 22:00,56,24,32,0,0,0
2021-07-09 22:15,44,25,19,0,0,0
2021-07-09 22:30,35,17,18,0,0,0
2021-07-09 22:45,27,15,12,0,0,0
2021-07-09 23:00,42,21,21,0,0,0
2021-07-09 23:15,39,21,18,0,0,0
2021-07-09 23:30,29,13,16,0,0,0
2021-07-09 23:45,35,16,19,0,0,0
2021-07-10 00:00,48,33,15,0,0,0
2021-07-10 00:15,30,14,16,0,0,0
2021-07-10 00:30,31,19,12,0,0,0
2021-07-10 00:45,28,15,13,0,0,0
2021-07-10 01:00,22,10,12,0,0,0
2021-07-10 01:15,22,9,13,0,0,0
2021-07-10 01:30,20,12,8,0,0,0
2021-07-10 01:45,11,2,9,0,0,0
2021-07-10 02:00,23,15,8,0,0,0
2021-07-10 02:15,10,1,9,0,0,0
2021-07-10 02:30,16,5,11,0,0,0
2021-07-10 02:45,8,5,3,0,0,0
2021-07-10 03:00,17,6,11,0,0,0
2021-07-10 03:15,15,4,11,0,0,0
2021-07-10 03:30,17,9,8,0,0,0
2021-07-10 03:45,9,3,6,0,0,0
2021-07-10 04:00,12,1,11,0,0,0
2021-07-10 04:15,4,1,3,0,0,0
2021-07-10 04:30,4,2,2,0,0,0
2021-07-10 04:45,5,3,2,0,0,0
2021-07-10 05:00,2,1,1,0,0,0
2021-07-10 05:15,6,3,3,0,0,0
2021-07-10 05:30,11,7,4,0,0,0
2021-07-10 05:45,9,7,2,0,0,0
2021-07-10 06:00,6,5,1,0,0,0
2021-07-10 06:15,6,4,2,0,0,0
2021-07-10 06:30,12,10,2,0,0,0
2021-07-10 06:45,18,13,5,0,0,0
2021-07-10 07:00,14,8,6,0,0,0
2021-07-10 07:15,18,12,6,0,0,0
2021-07-10 07:30,20,17,3,0,0,0
2021-07-10 07:45,35,23,12,0,0,0
2021-07-10 08:00,28,22,6,0,0,0
2021-07-10 08:15,42,26,16,0,0,0
2021-07-10 08:30,61,38,23,0,0,0
2021-07-10 08:45,66,40,26,0,0,0
2021-07-10 09:00,70,44,26,0,0,0
2021-07-10 09:15,62,47,15,0,0,0
2021-07-10 09:30,105,75,30,0,0,0
2021-07-10 09:45,140,112,28,0,0,0
2021-07-10 10:00,123,95,28,0,0,0
2021-07-10 10:15,121,92,29,0,0,0
2021-07-10 10:30,138,100,38,0,0,0
2021-07-10 10:45,146,98,48,0,0,0
2021-07-10 11:00,152,111,41,0,0,0
2021-07-10 11:15,139,93,46,0,0,0
2021-07-10 11:30,149,83,66,0,0,0
2021-07-10 11:45,202,140,62,0,0,0
2021-07-10 12:00,143,101,42,0,0,0
2021-07-10 12:15,177,119,58,0,0,0
2021-07-10 12:30,116,65,51,0,0,0
2021-07-10 12:45,125,75,50,0,0,0
2021-07-10 13:00,150,94,56,0,0,0
2021-07-10 13:15,128,84,44,0,0,0
2021-07-10 13:30,153,97,56,0,0,0
2021-07-10 13:45,141,75,66,0,0,0
2021-07-10 14:00,168,94,74,0,0,0
2021-07-10 14:15,147,82,65,0,0,0
2021-07-10 14:30,104,56,48,0,0,0
2021-07-10 14:45,165,102,63,0,0,0
2021-07-10 15:00,121,64,57,0,0,0
2021-07-10 15:15,102,56,46,0,0,0
2021-07-10 15:30,88,56,32,0,0,0
2021-07-10 15:45,101,57,44,0,0,0
2021-07-10 16:00,110,72,38,0,0,0
2021-07-10 16:15,110,66,44,0,0,0
2021-07-10 16:30,117,79,38,0,0,0
2021-07-10 16:45,84,46,38,0,0,0
2021-07-10 17:00,101,58,43,0,0,0
2021-07-10 17:15,80,39,41,0,0,0
2021-07-10 17:30,108,65,43,0,0,0
2021-07-10 17:45,119,80,39,0,0,0
2021-07-10 18:00,117,67,50,0,0,0
2021-07-10 18:15,93,55,38,0,0,0
2021-07-10 18:30,93,48,45,0,0,0
2021-07-10 18:45,105,67,38,0,0,0
2021-07-10 19:00,92,52,40,0,0,0
2021-07-10 19:15,95,57,38,0,0,0
2021-07-10 19:30,86,54,32,0,0,0
2021-07-10 19:45,104,74,30,0,0,0
2021-07-10 20:00,66,42,24,0,0,0
2021-07-10 20:15,61,37,24,0,0,0
2021-07-10 20:30,63,44,19,0,0,0
2021-07-10 20:45,47,27,20,0,0,0
2021-07-10 21:00,54,36,18,0,0,0
2021-07-10 21:15,36,25,11,0,0,0
2021-07-10 21:30,34,20,14,0,0,0
2021-07-10 21:45,51,30,21,0,0,0
2021-07-10 22:00,33,21,12,0,0,0
2021-07-10 22:15,35,16,19,0,0,0
2021-07-10 22:30,42,21,21,0,0,0
2021-07-10 22:45,50,29,21,0,0,0
2021-07-10 23:00,30,15,15,0,0,0
2021-07-10 23:15,29,13,16,0,0,0
2021-07-10 23:30,22,9,13,0,0,0
2021-07-10 23:45,32,19,13,0,0,0
2021-07-11 00:00,29,15,14,0,0,0
2021-07-11 00:15,20,8,12,0,0,0
2021-07-11 00:30,23,16,7,0,0,0
2021-07-11 00:45,28,11,17,0,0,0
2021-07-11 01:00,25,11,14,0,0,0
2021-07-11 01:15,19,10,9,0,0,0
2021-07-11 01:30,11,1,10,0,0,0
2021-07-11 01:45,17,7,10,0,0,0
2021-07-11 02:00,8,4,4,0,0,0
2021-07-11 02:15,13,4,9,0,0,0
2021-07-11 02:30,17,6,11,0,0,0
2021-07-11 02:45,9,4,5,0,0,0
2021-07-11 03:00,14,4,10,0,0,0
2021-07-11 03:15,11,2,9,0,0,0
2021-07-11 03:30,8,2,6,0,0,0
2021-07-11 03:45,7,3,4,0,0,0
2021-07-11 04:00,7,1,6,0,0,0
2021-07-11 04:15,8,3,5,0,0,0
2021-07-11 04:30,4,3,1,0,0,0
2021-07-11 04:45,5,4,1,0,0,0
2021-07-11 05:00,3,1,2,0,0,0
2021-07-11 05:15,3,0,3,0,0,0
2021-07-11 05:30,5,4,1,0,0,0
2021-07-11 05:45,5,0,5,0,0,0
2021-07-11 06:00,4,2,2,0,0,0
2021-07-11 06:15,6,4,2,0,0,0
2021-07-11 06:30,2,2,0,0,0,0
2021-07-11 06:45,6,4,2,0,0,0
2021-07-11 07:00,3,1,2,0,0,0
2021-07-11 07:15,6,3,3,0,0,0
2021-07-11 07:30,8,5,3,0,0,0
2021-07-11 07:45,13,4,9,0,0,0
2021-07-11 08:00,8,5,3,0,0,0
2021-07-11 08:15,9,7,2,0,0,0
2021-07-11 08:30,6,6,0,0,0,0
2021-07-11 08:45,22,15,7,0,0,0
2021-07-11 09:00,16,9,7,0,0,0
2021-07-11 09:15,16,11,5,0,0,0
2021-07-11 09:30,29,15,14,0,0,0
2021-07-11 09:45,33,24,9,0,0,0
2021-07-11 10:00,20,12,8,0,0,0
2021-07-11 10:15,14,8,6,0,0,0
2021-07-11 10:30,31,21,10,0,0,0
2021-07-11 10:45,47,34,13,0,0,0
2021-07-11 11:00,42,32,10,0,0,0
2021-07-11 11:15,34,25,9,0,0,0
2021-07-11 11:30,30,18,12,0,0,0
2021-07-11 11:45,65,44,21,0,0,0
2021-07-11 12:00,45,28,17,0,0,0
2021-07-11 12:15,46,32,14,0,0,0
2021-07-11 12:30,51,34,17,0,0,0
2021-07-11 12:45,46,31,15,0,0,0
2021-07-11 13:00,53,30,23,0,0,0
2021-07-11 13:15,49,23,26,0,0,0
2021-07-11 13:30,56,37,19,0,0,0
2021-07-11 13:45,75,48,27,0,0,0
2021-07-11 14:00,53,32,21,0,0,0
2021-07-11 14:15,59,45,14,0,0,0
2021-07-11 14:30,67,43,24,0,0,0
2021-07-11 14:45,70,41,29,0,0,0
2021-07-11 15:00,46,26,20,0,0,0
2021-07-11 15:15,77,42,35,0,0,0
2021-07-11 15:30,70,41,29,0,0,0
2021-07-11 15:45,84,69,15,0,0,0
2021-07-11 16:00,75,46,29,0,0,0
2021-07-11 16:15,72,39,33,0,0,0
2021-07-11 16:30,64,37,27,0,0,0
2021-07-11 16:45,107,61,46,0,0,0
2021-07-11 17:00,77,42,35,0,0,0
2021-07-11 17:15,82,48,34,0,0,0
2021-07-11 17:30,72,47,25,0,0,0
2021-07-11 17:45,107,70,37,0,0,0
2021-07-11 18:00,83,57,26,0,0,0
2021-07-11 18:15,100,65,35,0,0,0
2021-07-11 18:30,70,39,31,0,0,0
2021-07-11 18:45,82,51,31,0,0,0
2021-07-11 19:00,63,43,20,0,0,0
2021-07-11 19:15,54,30,24,0,0,0
2021-07-11 19:30,60,43,17,0,0,0
2021-07-11 19:45,66,40,26,0,0,0
2021-07-11 20:00,76,44,32,0,0,0
2021-07-11 20:15,59,24,35,0,0,0
2021-07-11 20:30,73,41,32,0,0,0
2021-07-11 20:45,67,37,30,0,0,0
2021-07-11 21:00,40,22,18,0,0,0
2021-07-11 21:15,19,8,11,0,0,0
2021-07-11 21:30,23,13,10,0,0,0
2021-07-11 21:45,12,7,5,0,0,0
2021-07-11 22:00,15,7,8,0,0,0
2021-07-11 22:15,11,8,3,0,0,0
2021-07-11 22:30,13,8,5,0,0,0
2021-07-11 22:45,6,1,5,0,0,0
2021-07-11 23:00,16,11,5,0,0,0
2021-07-11 23:15,10,4,6,0,0,0
2021-07-11 23:30,8,8,0,0,0,0
2021-07-11 23:45,7,5,2,0,0,0
2021-07-12 00:00,54,32,22,0,0,0
2021-07-12 00:15,59,33,26,0,0,0
2021-07-12 00:30,41,25,16,0,0,0
2021-07-12 00:45,16,8,8,0,0,0
2021-07-12 01:00,13,8,5,0,0,0
2021-07-12 01:15,10,2,8,0,0,0
2021-07-12 01:30,3,2,1,0,0,0
2021-07-12 01:45,4,2,2,0,0,0
2021-07-12 02:00,2,1,1,0,0,0
2021-07-12 02:15,2,1,1,0,0,0
2021-07-12 02:30,2,2,0,0,0,0
2021-07-12 02:45,3,3,0,0,0,0
2021-07-12 03:00,3,2,1,0,0,0
2021-07-12 03:15,0,0,0,0,0,0
2021-07-12 03:30,0,0,0,0,0,0
2021-07-12 03:45,4,3,1,0,0,0
2021-07-12 04:00,0,0,0,0,0,0
2021-07-12 04:15,1,0,1,0,0,0
2021-07-12 04:30,3,0,3,0,0,0
2021-07-12 04:45,2,1,1,0,0,0
2021-07-12 05:00,1,1,0,0,0,0
2021-07-12 05:15,3,2,1,0,0,0
2021-07-12 05:30,10,3,7,0,0,0
2021-07-12 05:45,19,10,9,0,0,0
2021-07-12 06:00,22,14,8,0,0,0
2021-07-12 06:15,24,16,8,0,0,0
2021-07-12 06:30,47,32,15,0,0,0
2021-07-12 06:45,67,47,20,0,0,0
2021-07-12 07:00,74,48,26,0,0,0
2021-07-12 07:15,73,51,22,0,0,0
2021-07-12 07:30,109,78,31,0,0,0
2021-07-12 07:45,136,86,50,0,0,0
2021-07-12 08:00,122,87,35,0,0,0
2021-07-12 08:15,120,92,28,0,0,0
2021-07-12 08:30,98,76,22,0,0,0
2021-07-12 08:45,131,101,30,0,0,0
2021-07-12 09:00,84,59,25,0,0,0
2021-07-12 09:15,89,70,19,0,0,0
2021-07-12 09:30,74,57,17,0,0,0
2021-07-12 09:45,118,91,27,0,0,0
2021-07-12 10:00,102,77,25,0,0,0
2021-07-12 10:15,96,64,32,0,0,0
2021-07-12 10:30,94,73,21,0,0,0
2021-07-12 10:45,88,71,17,0,0,0
2021-07-12 11:00,99,65,34,0,0,0
2021-07-12 11:15,101,69,32,0,0,0
2021-07-12 11:30,88,61,27,0,0,0
2021-07-12 11:45,111,64,47,0,0,0
2021-07-12 12:00,118,71,47,0,0,0
2021-07-12 12:15,93,53,40,0,0,0
2021-07-12 12:30,96,55,41,0,0,0
2021-07-12 12:45,102,62,40,0,0,0
2021-07-12 13:00,89,52,37,0,0,0
2021-07-12 13:15,117,79,38,0,0,0
2021-07-12 13:30,86,54,32,0,0,0
2021-07-12 13:45,108,70,38,0,0,0
2021-07-12 14:00,105,61,44,0,0,0
2021-07-12 14:15,121,80,41,0,0,0
2021-07-12 14:30,125,71,54,0,0,0
2021-07-12 14:45,117,70,47,0,0,0
2021-07-12 15:00,107,56,51,0,0,0
2021-07-12 15:15,141,89,52,0,0,0
2021-07-12 15:30,135,75,60,0,0,0
2021-07-12 15:45,109,71,38,0,0,0
2021-07-12 16:00,138,91,47,0,0,0
2021-07-12 16:15,137,78,59,0,0,0
2021-07-12 16:30,150,83,67,0,0,0
2021-07-12 16:45,167,92,75,0,0,0
2021-07-12 17:00,172,99,73,0,0,0
2021-07-12 17:15,133,67,66,0,0,0
2021-07-12 17:30,143,67,76,0,0,0
2021-07-12 17:45,144,69,75,0,0,0
2021-07-12 18:00,132,69,63,0,0,0
2021-07-12 18:15,106,62,44,0,0,0
2021-07-12 18:30,123,67,56,0,0,0
2021-07-12 18:45,95,44,51,0,0,0
2021-07-12 19:00,99,52,47,0,0,0
2021-07-12 19:15,93,49,44,0,0,0
2021-07-12 19:30,80,43,37,0,0,0
2021-07-12 19:45,85,50,35,0,0,0
2021-07-12 20:00,91,42,49,0,0,0
2021-07-12 20:15,51,29,22,0,0,0
2021-07-12 20:30,43,14,29,0,0,0
2021-07-12 20:45,52,24,28,0,0,0
2021-07-12 21:00,41,24,17,0,0,0
2021-07-12 21:15,38,19,19,0,0,0
2021-07-12 21:30,53,30,23,0,0,0
2021-07-12 21:45,42,29,13,0,0,0
2021-07-12 22:00,41,25,16,0,0,0
2021-07-12 22:15,31,14,17,0,0,0
2021-07-12 22:30,24,19,5,0,0,0
2021-07-12 22:45,20,10,10,0,0,0
2021-07-12 23:00,17,9,8,0,0,0
2021-07-12 23:15,21,12,9,0,0,0
2021-07-12 23:30,13,6,7,0,0,0
2021-07-12 23:45,15,10,5,0,0,0
2021-07-13 00:00,6,4,2,0,0,0
2021-07-13 00:15,8,4,4,0,0,0
2021-07-13 00:30,5,3,2,0,0,0
2021-07-13 00:45,13,7,6,0,0,0
2021-07-13 01:00,7,3,4,0,0,0
2021-07-13 01:15,5,2,3,0,0,0
2021-07-13 01:30,1,0,1,0,0,0
2021-07-13 01:45,6,3,3,0,0,0
2021-07-13 02:00,3,2,1,0,0,0
2021-07-13 02:15,3,0,3,0,0,0
2021-07-13 02:30,2,2,0,0,0,0
2021-07-13 02:45,1,1,0,0,0,0
2021-07-13 03:00,0,0,0,0,0,0
2021-07-13 03:15,2,2,0,0,0,0
2021-07-13 03:30,1,0,1,0,0,0
2021-07-13 03:45,0,0,0,0,0,0
2021-07-13 04:00,1,0,1,0,0,0
2021-07-13 04:15,0,0,0,0,0,0
2021-07-13 04:30,1,1,0,0,0,0
2021-07-13 04:45,9,1,8,0,0,0
2021-07-13 05:00,2,2,0,0,0,0
2021-07-13 05:15,2,1,1,0,0,0
2021-07-13 05:30,11,8,3,0,0,0
2021-07-13 05:45,24,13,11,0,0,0
2021-07-13 06:00,20,15,5,0,0,0
2021-07-13 06:15,39,20,19,0,0,0
2021-07-13 06:30,57,38,19,0,0,0
2021-07-13 06:45,52,36,16,0,0,0
2021-07-13 07:00,65,41,24,0,0,0
2021-07-13 07:15,62,41,21,0,0,0
2021-07-13 07:30,112,82,30,0,0,0
2021-07-13 07:45,104,70,34,0,0,0
2021-07-13 08:00,110,87,23,0,0,0
2021-07-13 08:15,78,62,16,0,0,0
2021-07-13 08:30,78,59,19,0,0,0
2021-07-13 08:45,97,64,33,0,0,0
2021-07-13 09:00,62,47,15,0,0,0
2021-07-13 09:15,60,43,17,0,0,0
2021-07-13 09:30,54,43,11,0,0,0
2021-07-13 09:45,79,59,20,0,0,0
2021-07-13 10:00,49,32,17,0,0,0
2021-07-13 10:15,46,35,11,0,0,0
2021-07-13 10:30,43,30,13,0,0,0
2021-07-13 10:45,58,38,20,0,0,0
2021-07-13 11:00,70,53,17,0,0,0
2021-07-13 11:15,70,45,25,0,0,0
2021-07-13 11:30,62,34,28,0,0,0
2021-07-13 11:45,91,64,27,0,0,0
2021-07-13 12:00,75,57,18,0,0,0
2021-07-13 12:15,76,50,26,0,0,0
2021-07-13 12:30,77,46,31,0,0,0
2021-07-13 12:45,79,45,34,0,0,0
2021-07-13 13:00,63,45,18,0,0,0
2021-07-13 13:15,68,36,32,0,0,0
2021-07-13 13:30,108,59,49,0,0,0
2021-07-13 13:45,93,66,27,0,0,0
2021-07-13 14:00,82,47,35,0,0,0
2021-07-13 14:15,101,53,48,0,0,0
2021-07-13 14:30,123,74,49,0,0,0
2021-07-13 14:45,125,79,46,0,0,0
2021-07-13 15:00,97,62,35,0,0,0
2021-07-13 15:15,100,73,27,0,0,0
2021-07-13 15:30,98,66,32,0,0,0
2021-07-13 15:45,140,88,52,0,0,0
2021-07-13 16:00,124,74,50,0,0,0
2021-07-13 16:15,144,77,67,0,0,0
2021-07-13 16:30,139,84,55,0,0,0
2021-07-13 16:45,140,80,60,0,0,0
2021-07-13 17:00,135,75,60,0,0,0
2021-07-13 17:15,147,73,74,0,0,0
2021-07-13 17:30,126,73,53,0,0,0
2021-07-13 17:45,123,61,62,0,0,0
2021-07-13 18:00,131,73,58,0,0,0
2021-07-13 18:15,135,76,59,0,0,0
2021-07-13 18:30,123,71,52,0,0,0
2021-07-13 18:45,123,62,61,0,0,0
2021-07-13 19:00,111,64,47,0,0,0
2021-07-13 19:15,83,42,41,0,0,0
2021-07-13 19:30,69,41,28,0,0,0
2021-07-13 19:45,67,35,32,0,0,0
2021-07-13 20:00,59,33,26,0,0,0
2021-07-13 20:15,69,44,25,0,0,0
2021-07-13 20:30,40,17,23,0,0,0
2021-07-13 20:45,40,16,24,0,0,0
2021-07-13 21:00,39,19,20,0,0,0
2021-07-13 21:15,51,28,23,0,0,0
2021-07-13 21:30,45,22,23,0,0,0
2021-07-13 21:45,38,20,18,0,0,0
2021-07-13 22:00,44,27,17,0,0,0
2021-07-13 22:15,47,26,21,0,0,0
2021-07-13 22:30,34,19,15,0,0,0
2021-07-13 22:45,20,13,7,0,0,0
2021-07-13 23:00,19,13,6,0,0,0
2021-07-13 23:15,31,19,12,0,0,0
2021-07-13 23:30,20,10,10,0,0,0
2021-07-13 23:45,15,8,7,0,0,0
2021-07-14 00:00,11,4,7,0,0,0
2021-07-14 00:15,17,8,9,0,0,0
2021-07-14 00:30,4,2,2,0,0,0
2021-07-14 00:45,5,1,4,0,0,0
2021-07-14 01:00,2,1,1,0,0,0
2021-07-14 01:15,5,2,3,0,0,0
2021-07-14 01:30,7,5,2,0,0,0
2021-07-14 01:45,3,1,2,0,0,0
2021-07-14 02:00,2,0,2,0,0,0
2021-07-14 02:15,1,0,1,0,0,0
2021-07-14 02:30,2,0,2,0,0,0
2021-07-14 02:45,2,1,1,0,0,0
2021-07-14 03:00,1,0,1,0,0,0
2021-07-14 03:15,1,1,0,0,0,0
2021-07-14 03:30,2,0,2,0,0,0
2021-07-14 03:45,0,0,0,0,0,0
2021-07-14 04:00,1,1,0,0,0,0
2021-07-14 04:15,2,2,0,0,0,0
2021-07-14 04:30,2,2,0,0,0,0
2021-07-14 04:45,0,0,0,0,0,0
2021-07-14 05:00,1,1,0,0,0,0
2021-07-14 05:15,2,2,0,0,0,0
2021-07-14 05:30,12,6,6,0,0,0
2021-07-14 05:45,19,7,12,0,0,0
2021-07-14 06:00,16,13,3,0,0,0
2021-07-14 06:15,20,15,5,0,0,0
2021-07-14 06:30,27,14,13,0,0,0
2021-07-14 06:45,50,37,13,0,0,0
2021-07-14 07:00,62,38,24,0,0,0
2021-07-14 07:15,74,50,24,0,0,0
2021-07-14 07:30,95,67,28,0,0,0
2021-07-14 07:45,108,81,27,0,0,0
2021-07-14 08:00,95,76,19,0,0,0
2021-07-14 08:15,70,50,20,0,0,0
2021-07-14 08:30,107,78,29,0,0,0
2021-07-14 08:45,122,95,27,0,0,0
2021-07-14 09:00,66,49,17,0,0,0
2021-07-14 09:15,68,47,21,0,0,0
2021-07-14 09:30,82,62,20,0,0,0
2021-07-14 09:45,79,60,19,0,0,0
2021-07-14 10:00,56,40,16,0,0,0
2021-07-14 10:15,57,36,21,0,0,0
2021-07-14 10:30,53,31,22,0,0,0
2021-07-14 10:45,76,55,21,0,0,0
2021-07-14 11:00,67,46,21,0,0,0
2021-07-14 11:15,63,39,24,0,0,0
2021-07-14 11:30,76,52,24,0,0,0
2021-07-14 11:45,81,60,21,0,0,0
2021-07-14 12:00,93,64,29,0,0,0
2021-07-14 12:15,82,47,35,0,0,0
2021-07-14 12:30,113,70,43,0,0,0
2021-07-14 12:45,81,45,36,0,0,0
2021-07-14 13:00,89,53,36,0,0,0
2021-07-14 13:15,77,51,26,0,0,0
2021-07-14 13:30,74,42,32,0,0,0
2021-07-14 13:45,79,57,22,0,0,0
2021-07-14 14:00,79,42,37,0,0,0
2021-07-14 14:15,79,49,30,0,0,0
2021-07-14 14:30,96,61,35,0,0,0
2021-07-14 14:45,82,54,28,0,0,0
2021-07-14 15:00,86,55,31,0,0,0
2021-07-14 15:15,70,42,28,0,0,0
2021-07-14 15:30,64,34,30,0,0,0
2021-07-14 15:45,67,28,39,0,0,0
2021-07-14 16:00,42,19,23,0,0,0
2021-07-14 16:15,72,44,28,0,0,0
2021-07-14 16:30,64,25,39,0,0,0
2021-07-14 16:45,85,41,44,0,0,0
2021-07-14 17:00,107,65,42,0,0,0
2021-07-14 17:15,88,59,29,0,0,0
2021-07-14 17:30,94,49,45,0,0,0
2021-07-14 17:45,73,35,38,0,0,0
2021-07-14 18:00,41,9,32,0,0,0
2021-07-14 18:15,43,14,29,0,0,0
2021-07-14 18:30,53,30,23,0,0,0
2021-07-14 18:45,46,16,30,0,0,0
2021-07-14 19:00,49,16,33,0,0,0
2021-07-14 19:15,48,28,20,0,0,0
2021-07-14 19:30,46,33,13,0,0,0
2021-07-14 19:45,51,30,21,0,0,0
2021-07-14 20:00,47,25,22,0,0,0
2021-07-14 20:15,39,23,16,0,0,0
2021-07-14 20:30,32,16,16,0,0,0
2021-07-14 20:45,31,15,16,0,0,0
2021-07-14 21:00,23,10,13,0,0,0
2021-07-14 21:15,23,11,12,0,0,0
2021-07-14 21:30,26,12,14,0,0,0
2021-07-14 21:45,17,11,6,0,0,0
2021-07-14 22:00,14,8,6,0,0,0
2021-07-14 22:15,32,17,15,0,0,0
2021-07-14 22:30,33,24,9,0,0,0
2021-07-14 22:45,27,17,10,0,0,0
2021-07-14 23:00,18,11,7,0,0,0
2021-07-14 23:15,16,7,9,0,0,0
2021-07-14 23:30,13,7,6,0,0,0
2021-07-14 23:45,11,8,3,0,0,0
2021-07-15 00:00,6,2,4,0,0,0
2021-07-15 00:15,7,7,0,0,0,0
2021-07-15 00:30,9,5,4,0,0,0
2021-07-15 00:45,4,2,2,0,0,0
2021-07-15 01:00,4,0,4,0,0,0
2021-07-15 01:15,14,7,7,0,0,0
2021-07-15 01:30,9,4,5,0,0,0
2021-07-15 01:45,3,2,1,0,0,0
2021-07-15 02:00,4,1,3,0,0,0
2021-07-15 02:15,9,3,6,0,0,0
2021-07-15 02:30,3,0,3,0,0,0
2021-07-15 02:45,3,2,1,0,0,0
2021-07-15 03:00,2,0,2,0,0,0
2021-07-15 03:15,3,0,3,0,0,0
2021-07-15 03:30,0,0,0,0,0,0
2021-07-15 03:45,0,0,0,0,0,0
2021-07-15 04:00,0,0,0,0,0,0
2021-07-15 04:15,4,1,3,0,0,0
2021-07-15 04:30,2,2,0,0,0,0
2021-07-15 04:45,4,1,3,0,0,0
2021-07-15 05:00,1,0,1,0,0,0
2021-07-15 05:15,6,3,3,0,0,0
2021-07-15 05:30,10,5,5,0,0,0
2021-07-15 05:45,17,6,11,0,0,0
2021-07-15 06:00,22,15,7,0,0,0
2021-07-15 06:15,25,12,13,0,0,0
2021-07-15 06:30,33,21,12,0,0,0
2021-07-15 06:45,46,31,15,0,0,0
2021-07-15 07:00,66,45,21,0,0,0
2021-07-15 07:15,63,43,20,0,0,0
2021-07-15 07:30,111,77,34,0,0,0
2021-07-15 07:45,125,91,34,0,0,0
2021-07-15 08:00,113,89,24,0,0,0
2021-07-15 08:15,91,66,25,0,0,0
2021-07-15 08:30,96,73,23,0,0,0
2021-07-15 08:45,117,83,34,0,0,0
2021-07-15 09:00,75,57,18,0,0,0
2021-07-15 09:15,74,59,15,0,0,0
2021-07-15 09:30,82,68,14,0,0,0
2021-07-15 09:45,107,76,31,0,0,0
2021-07-15 10:00,80,62,18,0,0,0
2021-07-15 10:15,87,59,28,0,0,0
2021-07-15 10:30,84,56,28,0,0,0
2021-07-15 10:45,106,74,32,0,0,0
2021-07-15 11:00,91,55,36,0,0,0
2021-07-15 11:15,92,63,29,0,0,0
2021-07-15 11:30,99,70,29,0,0,0
2021-07-15 11:45,103,76,27,0,0,0
2021-07-15 12:00,105,69,36,0,0,0
2021-07-15 12:15,106,73,33,0,0,0
2021-07-15 12:30,119,76,43,0,0,0
2021-07-15 12:45,110,61,49,0,0,0
2021-07-15 13:00,100,55,45,0,0,0
2021-07-15 13:15,94,53,41,0,0,0
2021-07-15 13:30,93,55,38,0,0,0
2021-07-15 13:45,115,64,51,0,0,0
2021-07-15 14:00,105,60,45,0,0,0
2021-07-15 14:15,119,73,46,0,0,0
2021-07-15 14:30,107,65,42,0,0,0
2021-07-15 14:45,124,81,43,0,0,0
2021-07-15 15:00,110,67,43,0,0,0
2021-07-15 15:15,105,55,50,0,0,0
2021-07-15 15:30,101,55,46,0,0,0
2021-07-15 15:45,142,95,47,0,0,0
2021-07-15 16:00,136,82,54,0,0,0
2021-07-15 16:15,131,80,51,0,0,0
2021-07-15 16:30,145,92,53,0,0,0
2021-07-15 16:45,125,75,50,0,0,0
2021-07-15 17:00,132,73,59,0,0,0
2021-07-15 17:15,154,85,69,0,0,0
2021-07-15 17:30,161,92,69,0,0,0
2021-07-15 17:45,137,76,61,0,0,0
2021-07-15 18:00,135,65,70,0,0,0
2021-07-15 18:15,124,65,59,0,0,0
2021-07-15 18:30,132,71,61,0,0,0
2021-07-15 18:45,130,80,50,0,0,0
2021-07-15 19:00,87,44,43,0,0,0
2021-07-15 19:15,85,46,39,0,0,0
2021-07-15 19:30,71,39,32,0,0,0
2021-07-15 19:45,75,43,32,0,0,0
2021-07-15 20:00,68,39,29,0,0,0
2021-07-15 20:15,56,30,26,0,0,0
2021-07-15 20:30,41,14,27,0,0,0
2021-07-15 20:45,37,19,18,0,0,0
2021-07-15 21:00,42,17,25,0,0,0
2021-07-15 21:15,36,22,14,0,0,0
2021-07-15 21:30,36,17,19,0,0,0
2021-07-15 21:45,38,23,15,0,0,0
2021-07-15 22:00,34,12,22,0,0,0
2021-07-15 22:15,33,22,11,0,0,0
2021-07-15 22:30,41,17,24,0,0,0
2021-07-15 22:45,37,20,17,0,0,0
2021-07-15 23:00,35,19,16,0,0,0
2021-07-15 23:15,30,17,13,0,0,0
2021-07-15 23:30,26,16,10,0,0,0
2021-07-15 23:45,13,7,6,0,0,0
2021-07-16 00:00,17,4,13,0,0,0
2021-07-16 00:15,20,12,8,0,0,0
2021-07-16 00:30,7,1,6,0,0,0
2021-07-16 00:45,4,2,2,0,0,0
2021-07-16 01:00,4,1,3,0,0,0
2021-07-16 01:15,13,8,5,0,0,0
2021-07-16 01:30,5,4,1,0,0,0
2021-07-16 01:45,3,2,1,0,0,0
2021-07-16 02:00,3,3,0,0,0,0
2021-07-16 02:15,4,1,3,0,0,0
2021-07-16 02:30,4,1,3,0,0,0
2021-07-16 02:45,1,1,0,0,0,0
2021-07-16 03:00,2,1,1,0,0,0
2021-07-16 03:15,1,0,1,0,0,0
2021-07-16 03:30,2,0,2,0,0,0
2021-07-16 03:45,0,0,0,0,0,0
2021-07-16 04:00,2,0,2,0,0,0
2021-07-16 04:15,0,0,0,0,0,0
2021-07-16 04:30,3,1,2,0,0,0
2021-07-16 04:45,2,1,1,0,0,0
2021-07-16 05:00,0,0,0,0,0,0
2021-07-16 05:15,5,4,1,0,0,0
2021-07-16 05:30,11,7,4,0,0,0
2021-07-16 05:45,12,6,6,0,0,0
2021-07-16 06:00,18,15,3,0,0,0
2021-07-16 06:15,20,16,4,0,0,0
2021-07-16 06:30,35,23,12,0,0,0
2021-07-16 06:45,45,25,20,0,0,0
2021-07-16 07:00,60,33,27,0,0,0
2021-07-16 07:15,83,48,35,0,0,0
2021-07-16 07:30,110,78,32,0,0,0
2021-07-16 07:45,118,80,38,0,0,0
2021-07-16 08:00,90,60,30,0,0,0
2021-07-16 08:15,108,65,43,0,0,0
2021-07-16 08:30,108,80,28,0,0,0
2021-07-16 08:45,108,71,37,0,0,0
2021-07-16 09:00,82,53,29,0,0,0
2021-07-16 09:15,92,60,32,0,0,0
2021-07-16 09:30,86,63,23,0,0,0
2021-07-16 09:45,107,77,30,0,0,0
2021-07-16 10:00,74,50,24,0,0,0
2021-07-16 10:15,85,51,34,0,0,0
2021-07-16 10:30,109,72,37,0,0,0
2021-07-16 10:45,109,70,39,0,0,0
2021-07-16 11:00,98,57,41,0,0,0
2021-07-16 11:15,90,54,36,0,0,0
2021-07-16 11:30,95,53,42,0,0,0
2021-07-16 11:45,113,76,37,0,0,0
2021-07-16 12:00,116,70,46,0,0,0
2021-07-16 12:15,110,73,37,0,0,0
2021-07-16 12:30,109,65,44,0,0,0
2021-07-16 12:45,109,62,47,0,0,0
2021-07-16 13:00,110,59,51,0,0,0
2021-07-16 13:15,114,74,40,0,0,0
2021-07-16 13:30,121,68,53,0,0,0
2021-07-16 13:45,133,98,35,0,0,0
2021-07-16 14:00,109,72,37,0,0,0
2021-07-16 14:15,98,62,36,0,0,0
2021-07-16 14:30,99,45,54,0,0,0
2021-07-16 14:45,92,50,42,0,0,0
2021-07-16 15:00,78,50,28,0,0,0
2021-07-16 15:15,99,70,29,0,0,0
2021-07-16 15:30,116,71,45,0,0,0
2021-07-16 15:45,117,69,48,0,0,0
2021-07-16 16:00,117,68,49,0,0,0
2021-07-16 16:15,113,67,46,0,0,0
2021-07-16 16:30,135,91,44,0,0,0
2021-07-16 16:45,111,76,35,0,0,0
2021-07-16 17:00,123,89,34,0,0,0
2021-07-16 17:15,122,58,64,0,0,0
2021-07-16 17:30,117,62,55,0,0,0
2021-07-16 17:45,109,68,41,0,0,0
2021-07-16 18:00,121,61,60,0,0,0
2021-07-16 18:15,99,51,48,0,0,0
2021-07-16 18:30,106,62,44,0,0,0
2021-07-16 18:45,98,68,30,0,0,0
2021-07-16 19:00,99,55,44,0,0,0
2021-07-16 19:15,87,43,44,0,0,0
2021-07-16 19:30,57,40,17,0,0,0
2021-07-16 19:45,97,55,42,0,0,0
2021-07-16 20:00,59,29,30,0,0,0
2021-07-16 20:15,91,58,33,0,0,0
2021-07-16 20:30,36,23,13,0,0,0
2021-07-16 20:45,64,33,31,0,0,0
2021-07-16 21:00,51,30,21,0,0,0
2021-07-16 21:15,43,26,17,0,0,0
2021-07-16 21:30,30,10,20,0,0,0
2021-07-16 21:45,30,17,13,0,0,0
2021-07-16 22:00,40,22,18,0,0,0
2021-07-16 22:15,40,27,13,0,0,0
2021-07-16 22:30,46,26,20,0,0,0
2021-07-16 22:45,34,25,9,0,0,0
2021-07-16 23:00,26,13,13,0,0,0
2021-07-16 23:15,32,14,18,0,0,0
2021-07-16 23:30,30,14,16,0,0,0
2021-07-16 23:45,18,6,12,0,0,0
2021-07-17 00:00,19,5,14,0,0,0
2021-07-17 00:15,20,6,14,0,0,0
2021-07-17 00:30,22,12,10,0,0,0
2021-07-17 00:45,30,10,20,0,0,0
2021-07-17 01:00,17,3,14,0,0,0
2021-07-17 01:15,19,10,9,0,0,0
2021-07-17 01:30,20,7,13,0,0,0
2021-07-17 01:45,4,2,2,0,0,0
2021-07-17 02:00,14,2,12,0,0,0
2021-07-17 02:15,13,7,6,0,0,0
2021-07-17 02:30,14,4,10,0,0,0
2021-07-17 02:45,6,1,5,0,0,0
2021-07-17 03:00,12,3,9,0,0,0
2021-07-17 03:15,4,0,4,0,0,0
2021-07-17 03:30,4,2,2,0,0,0
2021-07-17 03:45,4,1,3,0,0,0
2021-07-17 04:00,5,1,4,0,0,0
2021-07-17 04:15,3,1,2,0,0,0
2021-07-17 04:30,3,1,2,0,0,0
2021-07-17 04:45,5,4,1,0,0,0
2021-07-17 05:00,3,2,1,0,0,0
2021-07-17 05:15,3,3,0,0,0,0
2021-07-17 05:30,8,4,4,0,0,0
2021-07-17 05:45,11,9,2,0,0,0
2021-07-17 06:00,5,4,1,0,0,0
2021-07-17 06:15,12,6,6,0,0,0
2021-07-17 06:30,9,6,3,0,0,0
2021-07-17 06:45,12,7,5,0,0,0
2021-07-17 07:00,24,17,7,0,0,0
2021-07-17 07:15,14,11,3,0,0,0
2021-07-17 07:30,25,18,7,0,0,0
2021-07-17 07:45,28,17,11,0,0,0
2021-07-17 08:00,37,26,11,0,0,0
2021-07-17 08:15,35,23,12,0,0,0
2021-07-17 08:30,50,30,20,0,0,0
2021-07-17 08:45,71,44,27,0,0,0
2021-07-17 09:00,45,35,10,0,0,0
2021-07-17 09:15,60,44,16,0,0,0
2021-07-17 09:30,97,76,21,0,0,0
2021-07-17 09:45,109,86,23,0,0,0
2021-07-17 10:00,114,82,32,0,0,0
2021-07-17 10:15,122,85,37,0,0,0
2021-07-17 10:30,112,66,46,0,0,0
2021-07-17 10:45,153,116,37,0,0,0
2021-07-17 11:00,138,99,39,0,0,0
2021-07-17 11:15,122,77,45,0,0,0
2021-07-17 11:30,181,121,60,0,0,0
2021-07-17 11:45,137,94,43,0,0,0
2021-07-17 12:00,136,94,42,0,0,0
2021-07-17 12:15,144,92,52,0,0,0
2021-07-17 12:30,178,105,73,0,0,0
2021-07-17 12:45,154,82,72,0,0,0
2021-07-17 13:00,140,93,47,0,0,0
2021-07-17 13:15,133,67,66,0,0,0
2021-07-17 13:30,143,91,52,0,0,0
2021-07-17 13:45,142,92,50,0,0,0
2021-07-17 14:00,134,83,51,0,0,0
2021-07-17 14:15,132,89,43,0,0,0
2021-07-17 14:30,119,52,67,0,0,0
2021-07-17 14:45,121,55,66,0,0,0
2021-07-17 15:00,116,54,62,0,0,0
2021-07-17 15:15,129,80,49,0,0,0
2021-07-17 15:30,123,70,53,0,0,0
2021-07-17 15:45,102,69,33,0,0,0
2021-07-17 16:00,113,68,45,0,0,0
2021-07-17 16:15,80,47,33,0,0,0
2021-07-17 16:30,89,48,41,0,0,0
2021-07-17 16:45,103,56,47,0,0,0
2021-07-17 17:00,74,40,34,0,0,0
2021-07-17 17:15,104,61,43,0,0,0
2021-07-17 17:30,98,69,29,0,0,0
2021-07-17 17:45,122,92,30,0,0,0
2021-07-17 18:00,92,52,40,0,0,0
2021-07-17 18:15,115,71,44,0,0,0
2021-07-17 18:30,112,78,34,0,0,0
2021-07-17 18:45,105,76,29,0,0,0
2021-07-17 19:00,95,62,33,0,0,0
2021-07-17 19:15,72,46,26,0,0,0
2021-07-17 19:30,78,34,44,0,0,0
2021-07-17 19:45,97,63,34,0,0,0
2021-07-17 20:00,88,54,34,0,0,0
2021-07-17 20:15,76,42,34,0,0,0
2021-07-17 20:30,41,25,16,0,0,0
2021-07-17 20:45,42,21,21,0,0,0
2021-07-17 21:00,67,33,34,0,0,0
2021-07-17 21:15,45,28,17,0,0,0
2021-07-17 21:30,50,28,22,0,0,0
2021-07-17 21:45,41,26,15,0,0,0
2021-07-17 22:00,39,23,16,0,0,0
2021-07-17 22:15,27,20,7,0,0,0
2021-07-17 22:30,47,26,21,0,0,0
2021-07-17 22:45,41,27,14,0,0,0
2021-07-17 23:00,39,27,12,0,0,0
2021-07-17 23:15,31,21,10,0,0,0
2021-07-17 23:30,33,14,19,0,0,0
2021-07-17 23:45,42,20,22,0,0,0
2021-07-18 00:00,33,16,17,0,0,0
2021-07-18 00:15,24,14,10,0,0,0
2021-07-18 00:30,36,21,15,0,0,0
2021-07-18 00:45,23,11,12,0,0,0
2021-07-18 01:00,21,14,7,0,0,0
2021-07-18 01:15,26,15,11,0,0,0
2021-07-18 01:30,21,11,10,0,0,0
2021-07-18 01:45,13,5,8,0,0,0
2021-07-18 02:00,24,13,11,0,0,0
2021-07-18 02:15,5,3,2,0,0,0
2021-07-18 02:30,12,3,9,0,0,0
2021-07-18 02:45,9,4,5,0,0,0
2021-07-18 03:00,13,5,8,0,0,0
2021-07-18 03:15,13,7,6,0,0,0
2021-07-18 03:30,11,2,9,0,0,0
2021-07-18 03:45,9,2,7,0,0,0
2021-07-18 04:00,5,1,4,0,0,0
2021-07-18 04:15,4,0,4,0,0,0
2021-07-18 04:30,5,2,3,0,0,0
2021-07-18 04:45,6,3,3,0,0,0
2021-07-18 05:00,2,0,2,0,0,0
2021-07-18 05:15,8,5,3,0,0,0
2021-07-18 05:30,12,7,5,0,0,0
2021-07-18 05:45,7,2,5,0,0,0
2021-07-18 06:00,6,5,1,0,0,0
2021-07-18 06:15,10,7,3,0,0,0
2021-07-18 06:30,8,5,3,0,0,0
2021-07-18 06:45,9,6,3,0,0,0
2021-07-18 07:00,5,2,3,0,0,0
2021-07-18 07:15,3,1,2,0,0,0
2021-07-18 07:30,1,1,0,0,0,0
2021-07-18 07:45,16,14,2,0,0,0
2021-07-18 08:00,16,8,8,0,0,0
2021-07-18 08:15,19,9,10,0,0,0
2021-07-18 08:30,24,16,8,0,0,0
2021-07-18 08:45,21,11,10,0,0,0
2021-07-18 09:00,18,6,12,0,0,0
2021-07-18 09:15,29,25,4,0,0,0
2021-07-18 09:30,38,25,13,0,0,0
2021-07-18 09:45,55,36,19,0,0,0
2021-07-18 10:00,50,26,24,0,0,0
2021-07-18 10:15,71,40,31,0,0,0
2021-07-18 10:30,81,50,31,0,0,0
2021-07-18 10:45,65,31,34,0,0,0
2021-07-18 11:00,58,32,26,0,0,0
2021-07-18 11:15,64,42,22,0,0,0
2021-07-18 11:30,76,42,34,0,0,0
2021-07-18 11:45,58,32,26,0,0,0
2021-07-18 12:00,85,50,35,0,0,0
2021-07-18 12:15,73,44,29,0,0,0
2021-07-18 12:30,77,59,18,0,0,0
2021-07-18 12:45,78,35,43,0,0,0
2021-07-18 13:00,82,51,31,0,0,0
2021-07-18 13:15,87,53,34,0,0,0
2021-07-18 13:30,76,45,31,0,0,0
2021-07-18 13:45,90,51,39,0,0,0
2021-07-18 14:00,85,42,43,0,0,0
2021-07-18 14:15,79,59,20,0,0,0
2021-07-18 14:30,82,42,40,0,0,0
2021-07-18 14:45,103,63,40,0,0,0
2021-07-18 15:00,92,60,32,0,0,0
2021-07-18 15:15,98,58,40,0,0,0
2021-07-18 15:30,84,52,32,0,0,0
2021-07-18 15:45,78,51,27,0,0,0
2021-07-18 16:00,86,50,36,0,0,0
2021-07-18 16:15,88,61,27,0,0,0
2021-07-18 16:30,95,62,33,0,0,0
2021-07-18 16:45,82,53,29,0,0,0
2021-07-18 17:00,77,52,25,0,0,0
2021-07-18 17:15,111,81,30,0,0,0
2021-07-18 17:30,88,48,40,0,0,0
2021-07-18 17:45,112,80,32,0,0,0
2021-07-18 18:00,114,72,42,0,0,0
2021-07-18 18:15,69,41,28,0,0,0
2021-07-18 18:30,86,58,28,0,0,0
2021-07-18 18:45,87,63,24,0,0,0
2021-07-18 19:00,105,83,22,0,0,0
2021-07-18 19:15,75,47,28,0,0,0
2021-07-18 19:30,65,45,20,0,0,0
2021-07-18 19:45,64,44,20,0,0,0
2021-07-18 20:00,59,34,25,0,0,0
2021-07-18 20:15,54,28,26,0,0,0
2021-07-18 20:30,48,31,17,0,0,0
2021-07-18 20:45,54,19,35,0,0,0
2021-07-18 21:00,56,31,25,0,0,0
2021-07-18 21:15,36,24,12,0,0,0
2021-07-18 21:30,38,20,18,0,0,0
2021-07-18 21:45,36,25,11,0,0,0
2021-07-18 22:00,37,24,13,0,0,0
2021-07-18 22:15,21,17,4,0,0,0
2021-07-18 22:30,23,12,11,0,0,0
2021-07-18 22:45,20,14,6,0,0,0
2021-07-18 23:00,20,10,10,0,0,0
2021-07-18 23:15,18,9,9,0,0,0
2021-07-18 23:30,10,7,3,0,0,0
2021-07-18 23:45,15,3,12,0,0,0
2021-07-19 00:00,3,3,0,0,0,0
2021-07-19 00:15,4,2,2,0,0,0
2021-07-19 00:30,8,7,1,0,0,0
2021-07-19 00:45,3,1,2,0,0,0
2021-07-19 01:00,4,2,2,0,0,0
2021-07-19 01:15,0,0,0,0,0,0
2021-07-19 01:30,0,0,0,0,0,0
2021-07-19 01:45,3,1,2,0,0,0
2021-07-19 02:00,2,1,1,0,0,0
2021-07-19 02:15,3,2,1,0,0,0
2021-07-19 02:30,2,1,1,0,0,0
2021-07-19 02:45,0,0,0,0,0,0
2021-07-19 03:00,2,2,0,0,0,0
2021-07-19 03:15,1,1,0,0,0,0
2021-07-19 03:30,0,0,0,0,0,0
2021-07-19 03:45,1,1,0,0,0,0
2021-07-19 04:00,0,0,0,0,0,0
2021-07-19 04:15,2,0,2,0,0,0
2021-07-19 04:30,1,0,1,0,0,0
2021-07-19 04:45,0,0,0,0,0,0
2021-07-19 05:00,1,1,0,0,0,0
2021-07-19 05:15,8,6,2,0,0,0
2021-07-19 05:30,15,9,6,0,0,0
2021-07-19 05:45,14,4,10,0,0,0
2021-07-19 06:00,21,14,7,0,0,0
2021-07-19 06:15,33,20,13,0,0,0
2021-07-19 06:30,42,27,15,0,0,0
2021-07-19 06:45,58,39,19,0,0,0
2021-07-19 07:00,65,37,28,0,0,0
2021-07-19 07:15,81,52,29,0,0,0
2021-07-19 07:30,132,86,46,0,0,0
2021-07-19 07:45,131,88,43,0,0,0
2021-07-19 08:00,104,76,28,0,0,0
2021-07-19 08:15,121,86,35,0,0,0
2021-07-19 08:30,110,81,29,0,0,0
2021-07-19 08:45,132,101,31,0,0,0
2021-07-19 09:00,85,56,29,0,0,0
2021-07-19 09:15,77,57,20,0,0,0
2021-07-19 09:30,88,65,23,0,0,0
2021-07-19 09:45,120,84,36,0,0,0
2021-07-19 10:00,79,56,23,0,0,0
2021-07-19 10:15,99,64,35,0,0,0
2021-07-19 10:30,100,60,40,0,0,0
2021-07-19 10:45,105,62,43,0,0,0
2021-07-19 11:00,97,59,38,0,0,0
2021-07-19 11:15,96,63,33,0,0,0
2021-07-19 11:30,96,59,37,0,0,0
2021-07-19 11:45,89,51,38,0,0,0
2021-07-19 12:00,88,46,42,0,0,0
2021-07-19 12:15,135,99,36,0,0,0
2021-07-19 12:30,89,49,40,0,0,0
2021-07-19 12:45,99,67,32,0,0,0
2021-07-19 13:00,83,42,41,0,0,0
2021-07-19 13:15,103,58,45,0,0,0
2021-07-19 13:30,95,55,40,0,0,0
2021-07-19 13:45,93,62,31,0,0,0
2021-07-19 14:00,119,65,54,0,0,0
2021-07-19 14:15,120,67,53,0,0,0
2021-07-19 14:30,103,72,31,0,0,0
2021-07-19 14:45,120,83,37,0,0,0
2021-07-19 15:00,103,69,34,0,0,0
2021-07-19 15:15,115,68,47,0,0,0
2021-07-19 15:30,143,91,52,0,0,0
2021-07-19 15:45,140,89,51,0,0,0
2021-07-19 16:00,155,101,54,0,0,0
2021-07-19 16:15,123,69,54,0,0,0
2021-07-19 16:30,137,79,58,0,0,0
2021-07-19 16:45,131,76,55,0,0,0
2021-07-19 17:00,140,73,67,0,0,0
2021-07-19 17:15,159,84,75,0,0,0
2021-07-19 17:30,150,87,63,0,0,0
2021-07-19 17:45,134,87,47,0,0,0
2021-07-19 18:00,115,59,56,0,0,0
2021-07-19 18:15,139,73,66,0,0,0
2021-07-19 18:30,114,63,51,0,0,0
2021-07-19 18:45,124,67,57,0,0,0
2021-07-19 19:00,98,58,40,0,0,0
2021-07-19 19:15,76,38,38,0,0,0
2021-07-19 19:30,57,21,36,0,0,0
2021-07-19 19:45,73,41,32,0,0,0
2021-07-19 20:00,64,25,39,0,0,0
2021-07-19 20:15,50,19,31,0,0,0
2021-07-19 20:30,74,49,25,0,0,0
2021-07-19 20:45,53,33,20,0,0,0
2021-07-19 21:00,40,24,16,0,0,0
2021-07-19 21:15,43,22,21,0,0,0
2021-07-19 21:30,41,24,17,0,0,0
2021-07-19 21:45,32,22,10,0,0,0
2021-07-19 22:00,38,29,9,0,0,0
2021-07-19 22:15,40,21,19,0,0,0
2021-07-19 22:30,18,6,12,0,0,0
2021-07-19 22:45,24,17,7,0,0,0
2021-07-19 23:00,20,9,11,0,0,0
2021-07-19 23:15,22,18,4,0,0,0
2021-07-19 23:30,13,7,6,0,0,0
2021-07-19 23:45,8,3,5,0,0,0
2021-07-20 00:00,20,15,5,0,0,0
2021-07-20 00:15,12,4,8,0,0,0
2021-07-20 00:30,10,2,8,0,0,0
2021-07-20 00:45,2,1,1,0,0,0
2021-07-20 01:00,4,2,2,0,0,0
2021-07-20 01:15,2,1,1,0,0,0
2021-07-20 01:30,5,5,0,0,0,0
2021-07-20 01:45,8,2,6,0,0,0
2021-07-20 02:00,5,0,5,0,0,0
2021-07-20 02:15,3,2,1,0,0,0
2021-07-20 02:30,0,0,0,0,0,0
2021-07-20 02:45,1,0,1,0,0,0
2021-07-20 03:00,2,2,0,0,0,0
2021-07-20 03:15,1,0,1,0,0,0
2021-07-20 03:30,1,1,0,0,0,0
2021-07-20 03:45,0,0,0,0,0,0
2021-07-20 04:00,4,0,4,0,0,0
2021-07-20 04:15,4,2,2,0,0,0
2021-07-20 04:30,1,1,0,0,0,0
2021-07-20 04:45,2,1,1,0,0,0
2021-07-20 05:00,2,2,0,0,0,0
2021-07-20 05:15,6,5,1,0,0,0
2021-07-20 05:30,14,10,4,0,0,0
2021-07-20 05:45,19,8,11,0,0,0
2021-07-20 06:00,22,11,11,0,0,0
2021-07-20 06:15,27,12,15,0,0,0
2021-07-20 06:30,46,29,17,0,0,0
2021-07-20 06:45,68,45,23,0,0,0
2021-07-20 07:00,84,50,34,0,0,0
2021-07-20 07:15,73,46,27,0,0,0
2021-07-20 07:30,128,94,34,0,0,0
2021-07-20 07:45,156,96,60,0,0,0
2021-07-20 08:00,95,60,35,0,0,0
2021-07-20 08:15,104,71,33,0,0,0
2021-07-20 08:30,117,89,28,0,0,0
2021-07-20 08:45,147,106,41,0,0,0
2021-07-20 09:00,108,69,39,0,0,0
2021-07-20 09:15,92,71,21,0,0,0
2021-07-20 09:30,96,71,25,0,0,0
2021-07-20 09:45,123,83,40,0,0,0
2021-07-20 10:00,108,74,34,0,0,0
2021-07-20 10:15,91,54,37,0,0,0
2021-07-20 10:30,124,87,37,0,0,0
2021-07-20 10:45,116,75,41,0,0,0
2021-07-20 11:00,92,59,33,0,0,0
2021-07-20 11:15,108,52,56,0,0,0
2021-07-20 11:30,114,62,52,0,0,0
2021-07-20 11:45,110,68,42,0,0,0
2021-07-20 12:00,129,80,49,0,0,0
2021-07-20 12:15,114,67,47,0,0,0
2021-07-20 12:30,116,64,52,0,0,0
2021-07-20 12:45,95,56,39,0,0,0
2021-07-20 13:00,118,63,55,0,0,0
2021-07-20 13:15,100,65,35,0,0,0
2021-07-20 13:30,111,69,42,0,0,0
2021-07-20 13:45,79,50,29,0,0,0
2021-07-20 14:00,102,67,35,0,0,0
2021-07-20 14:15,104,55,49,0,0,0
2021-07-20 14:30,127,79,48,0,0,0
2021-07-20 14:45,127,82,45,0,0,0
2021-07-20 15:00,113,72,41,0,0,0
2021-07-20 15:15,150,107,43,0,0,0
2021-07-20 15:30,126,84,42,0,0,0
2021-07-20 15:45,140,88,52,0,0,0
2021-07-20 16:00,148,83,65,0,0,0
2021-07-20 16:15,147,103,44,0,0,0
2021-07-20 16:30,145,97,48,0,0,0
2021-07-20 16:45,145,89,56,0,0,0
2021-07-20 17:00,151,83,68,0,0,0
2021-07-20 17:15,163,90,73,0,0,0
2021-07-20 17:30,154,95,59,0,0,0
2021-07-20 17:45,164,90,74,0,0,0
2021-07-20 18:00,134,62,72,0,0,0
2021-07-20 18:15,150,85,65,0,0,0
2021-07-20 18:30,122,61,61,0,0,0
2021-07-20 18:45,142,87,55,0,0,0
2021-07-20 19:00,105,57,48,0,0,0
2021-07-20 19:15,105,65,40,0,0,0
2021-07-20 19:30,89,46,43,0,0,0
2021-07-20 19:45,92,53,39,0,0,0
2021-07-20 20:00,102,51,51,0,0,0
2021-07-20 20:15,63,33,30,0,0,0
2021-07-20 20:30,50,24,26,0,0,0
2021-07-20 20:45,48,28,20,0,0,0
2021-07-20 21:00,58,35,23,0,0,0
2021-07-20 21:15,60,43,17,0,0,0
2021-07-20 21:30,64,32,32,0,0,0
2021-07-20 21:45,44,29,15,0,0,0
2021-07-20 22:00,35,18,17,0,0,0
2021-07-20 22:15,50,30,20,0,0,0
2021-07-20 22:30,33,14,19,0,0,0
2021-07-20 22:45,25,10,15,0,0,0
2021-07-20 23:00,31,21,10,0,0,0
2021-07-20 23:15,23,6,17,0,0,0
2021-07-20 23:30,16,5,11,0,0,0
2021-07-20 23:45,13,8,5,0,0,0
2021-07-21 00:00,17,4,13,0,0,0
2021-07-21 00:15,33,9,24,0,0,0
2021-07-21 00:30,8,3,5,0,0,0
2021-07-21 00:45,2,2,0,0,0,0
2021-07-21 01:00,3,3,0,0,0,0
2021-07-21 01:15,5,3,2,0,0,0
2021-07-21 01:30,5,4,1,0,0,0
2021-07-21 01:45,5,1,4,0,0,0
2021-07-21 02:00,5,1,4,0,0,0
2021-07-21 02:15,5,1,4,0,0,0
2021-07-21 02:30,2,0,2,0,0,0
2021-07-21 02:45,3,0,3,0,0,0
2021-07-21 03:00,2,0,2,0,0,0
2021-07-21 03:15,3,1,2,0,0,0
2021-07-21 03:30,1,1,0,0,0,0
2021-07-21 03:45,3,0,3,0,0,0
2021-07-21 04:00,1,0,1,0,0,0
2021-07-21 04:15,6,5,1,0,0,0
2021-07-21 04:30,2,2,0,0,0,0
2021-07-21 04:45,3,0,3,0,0,0
2021-07-21 05:00,2,2,0,0,0,0
2021-07-21 05:15,3,2,1,0,0,0
2021-07-21 05:30,12,8,4,0,0,0
2021-07-21 05:45,16,5,11,0,0,0
2021-07-21 06:00,25,18,7,0,0,0
2021-07-21 06:15,17,9,8,0,0,0
2021-07-21 06:30,48,34,14,0,0,0
2021-07-21 06:45,51,32,19,0,0,0
2021-07-21 07:00,73,45,28,0,0,0
2021-07-21 07:15,98,57,41,0,0,0
2021-07-21 07:30,100,67,33,0,0,0
2021-07-21 07:45,155,110,45,0,0,0
2021-07-21 08:00,108,77,31,0,0,0
2021-07-21 08:15,120,84,36,0,0,0
2021-07-21 08:30,136,109,27,0,0,0
2021-07-21 08:45,144,112,32,0,0,0
2021-07-21 09:00,104,70,34,0,0,0
2021-07-21 09:15,110,79,31,0,0,0
2021-07-21 09:30,132,97,35,0,0,0
2021-07-21 09:45,124,94,30,0,0,0
2021-07-21 10:00,102,81,21,0,0,0
2021-07-21 10:15,123,91,32,0,0,0
2021-07-21 10:30,126,86,40,0,0,0
2021-07-21 10:45,182,128,54,0,0,0
2021-07-21 11:00,134,83,51,0,0,0
2021-07-21 11:15,126,78,48,0,0,0
2021-07-21 11:30,132,80,52,0,0,0
2021-07-21 11:45,153,90,63,0,0,0
2021-07-21 12:00,136,83,53,0,0,0
2021-07-21 12:15,123,78,45,0,0,0
2021-07-21 12:30,135,77,58,0,0,0
2021-07-21 12:45,146,89,57,0,0,0
2021-07-21 13:00,112,71,41,0,0,0
2021-07-21 13:15,148,84,64,0,0,0
2021-07-21 13:30,126,69,57,0,0,0
2021-07-21 13:45,124,70,54,0,0,0
2021-07-21 14:00,114,66,48,0,0,0
2021-07-21 14:15,126,80,46,0,0,0
2021-07-21 14:30,150,89,61,0,0,0
2021-07-21 14:45,141,84,57,0,0,0
2021-07-21 15:00,125,68,57,0,0,0
2021-07-21 15:15,126,71,55,0,0,0
2021-07-21 15:30,127,80,47,0,0,0
2021-07-21 15:45,148,100,48,0,0,0
2021-07-21 16:00,125,70,55,0,0,0
2021-07-21 16:15,124,70,54,0,0,0
2021-07-21 16:30,142,73,69,0,0,0
2021-07-21 16:45,184,120,64,0,0,0
2021-07-21 17:00,172,107,65,0,0,0
2021-07-21 17:15,143,75,68,0,0,0
2021-07-21 17:30,164,98,66,0,0,0
2021-07-21 17:45,159,77,82,0,0,0
2021-07-21 18:00,159,78,81,0,0,0
2021-07-21 18:15,139,69,70,0,0,0
2021-07-21 18:30,89,53,36,0,0,0
2021-07-21 18:45,135,72,63,0,0,0
2021-07-21 19:00,100,54,46,0,0,0
2021-07-21 19:15,109,66,43,0,0,0
2021-07-21 19:30,76,44,32,0,0,0
2021-07-21 19:45,80,41,39,0,0,0
2021-07-21 20:00,71,37,34,0,0,0
2021-07-21 20:15,64,32,32,0,0,0
2021-07-21 20:30,49,24,25,0,0,0
2021-07-21 20:45,62,31,31,0,0,0
2021-07-21 21:00,54,30,24,0,0,0
2021-07-21 21:15,39,25,14,0,0,0
2021-07-21 21:30,54,33,21,0,0,0
2021-07-21 21:45,42,28,14,0,0,0
2021-07-21 22:00,48,13,35,0,0,0
2021-07-21 22:15,37,18,19,0,0,0
2021-07-21 22:30,51,27,24,0,0,0
2021-07-21 22:45,31,9,22,0,0,0
2021-07-21 23:00,26,10,16,0,0,0
2021-07-21 23:15,43,30,13,0,0,0
2021-07-21 23:30,20,10,10,0,0,0
2021-07-21 23:45,18,6,12,0,0,0
2021-07-22 00:00,26,6,20,0,0,0
2021-07-22 00:15,15,9,6,0,0,0
2021-07-22 00:30,20,12,8,0,0,0
2021-07-22 00:45,13,10,3,0,0,0
2021-07-22 01:00,7,4,3,0,0,0
2021-07-22 01:15,8,4,4,0,0,0
2021-07-22 01:30,5,2,3,0,0,0
2021-07-22 01:45,2,1,1,0,0,0
2021-07-22 02:00,3,3,0,0,0,0
2021-07-22 02:15,3,1,2,0,0,0
2021-07-22 02:30,4,3,1,0,0,0
2021-07-22 02:45,5,4,1,0,0,0
2021-07-22 03:00,1,1,0,0,0,0
2021-07-22 03:15,1,0,1,0,0,0
2021-07-22 03:30,5,3,2,0,0,0
2021-07-22 03:45,0,0,0,0,0,0
2021-07-22 04:00,4,2,2,0,0,0
2021-07-22 04:15,0,0,0,0,0,0
2021-07-22 04:30,0,0,0,0,0,0
2021-07-22 04:45,1,1,0,0,0,0
2021-07-22 05:00,2,1,1,0,0,0
2021-07-22 05:15,8,6,2,0,0,0
2021-07-22 05:30,14,9,5,0,0,0
2021-07-22 05:45,12,5,7,0,0,0
2021-07-22 06:00,27,17,10,0,0,0
2021-07-22 06:15,20,10,10,0,0,0
2021-07-22 06:30,30,14,16,0,0,0
2021-07-22 06:45,54,36,18,0,0,0
2021-07-22 07:00,64,39,25,0,0,0
2021-07-22 07:15,86,51,35,0,0,0
2021-07-22 07:30,119,88,31,0,0,0
2021-07-22 07:45,144,89,55,0,0,0
2021-07-22 08:00,103,78,25,0,0,0
2021-07-22 08:15,98,70,28,0,0,0
2021-07-22 08:30,110,87,23,0,0,0
2021-07-22 08:45,138,102,36,0,0,0
2021-07-22 09:00,87,58,29,0,0,0
2021-07-22 09:15,99,70,29,0,0,0
2021-07-22 09:30,90,57,33,0,0,0
2021-07-22 09:45,107,81,26,0,0,0
2021-07-22 10:00,78,59,19,0,0,0
2021-07-22 10:15,106,61,45,0,0,0
2021-07-22 10:30,90,64,26,0,0,0
2021-07-22 10:45,94,63,31,0,0,0
2021-07-22 11:00,104,54,50,0,0,0
2021-07-22 11:15,105,70,35,0,0,0
2021-07-22 11:30,112,66,46,0,0,0
2021-07-22 11:45,87,59,28,0,0,0
2021-07-22 12:00,88,54,34,0,0,0
2021-07-22 12:15,110,61,49,0,0,0
2021-07-22 12:30,102,68,34,0,0,0
2021-07-22 12:45,98,70,28,0,0,0
2021-07-22 13:00,114,69,45,0,0,0
2021-07-22 13:15,105,60,45,0,0,0
2021-07-22 13:30,133,78,55,0,0,0
2021-07-22 13:45,123,80,43,0,0,0
2021-07-22 14:00,119,63,56,0,0,0
2021-07-22 14:15,145,91,54,0,0,0
2021-07-22 14:30,122,72,50,0,0,0
2021-07-22 14:45,125,86,39,0,0,0
2021-07-22 15:00,117,70,47,0,0,0
2021-07-22 15:15,152,100,52,0,0,0
2021-07-22 15:30,122,73,49,0,0,0
2021-07-22 15:45,142,86,56,0,0,0
2021-07-22 16:00,167,93,74,0,0,0
2021-07-22 16:15,131,75,56,0,0,0
2021-07-22 16:30,129,75,54,0,0,0
2021-07-22 16:45,149,98,51,0,0,0
2021-07-22 17:00,149,79,70,0,0,0
2021-07-22 17:15,180,119,61,0,0,0
2021-07-22 17:30,161,103,58,0,0,0
2021-07-22 17:45,175,112,63,0,0,0
2021-07-22 18:00,144,75,69,0,0,0
2021-07-22 18:15,159,97,62,0,0,0
2021-07-22 18:30,150,80,70,0,0,0
2021-07-22 18:45,129,77,52,0,0,0
2021-07-22 19:00,123,66,57,0,0,0
2021-07-22 19:15,101,62,39,0,0,0
2021-07-22 19:30,100,59,41,0,0,0
2021-07-22 19:45,80,43,37,0,0,0
2021-07-22 20:00,71,40,31,0,0,0
2021-07-22 20:15,63,35,28,0,0,0
2021-07-22 20:30,52,30,22,0,0,0
2021-07-22 20:45,60,36,24,0,0,0
2021-07-22 21:00,47,22,25,0,0,0
2021-07-22 21:15,49,28,21,0,0,0
2021-07-22 21:30,54,25,29,0,0,0
2021-07-22 21:45,52,27,25,0,0,0
2021-07-22 22:00,43,23,20,0,0,0
2021-07-22 22:15,66,29,37,0,0,0
2021-07-22 22:30,41,19,22,0,0,0
2021-07-22 22:45,36,22,14,0,0,0
2021-07-22 23:00,27,17,10,0,0,0
2021-07-22 23:15,24,11,13,0,0,0
2021-07-22 23:30,16,6,10,0,0,0
2021-07-22 23:45,20,6,14,0,0,0
2021-07-23 00:00,22,15,7,0,0,0
2021-07-23 00:15,15,1,14,0,0,0
2021-07-23 00:30,8,1,7,0,0,0
2021-07-23 00:45,16,5,11,0,0,0
2021-07-23 01:00,7,4,3,0,0,0
2021-07-23 01:15,5,4,1,0,0,0
2021-07-23 01:30,3,1,2,0,0,0
2021-07-23 01:45,6,4,2,0,0,0
2021-07-23 02:00,3,2,1,0,0,0
2021-07-23 02:15,7,3,4,0,0,0
2021-07-23 02:30,6,3,3,0,0,0
2021-07-23 02:45,6,6,0,0,0,0
2021-07-23 03:00,1,0,1,0,0,0
2021-07-23 03:15,2,1,1,0,0,0
2021-07-23 03:30,0,0,0,0,0,0
2021-07-23 03:45,2,0,2,0,0,0
2021-07-23 04:00,1,0,1,0,0,0
2021-07-23 04:15,1,0,1,0,0,0
2021-07-23 04:30,0,0,0,0,0,0
2021-07-23 04:45,3,2,1,0,0,0
2021-07-23 05:00,1,1,0,0,0,0
2021-07-23 05:15,5,5,0,0,0,0
2021-07-23 05:30,20,10,10,0,0,0
2021-07-23 05:45,13,3,10,0,0,0
2021-07-23 06:00,23,18,5,0,0,0
2021-07-23 06:15,21,12,9,0,0,0
2021-07-23 06:30,41,23,18,0,0,0
2021-07-23 06:45,57,32,25,0,0,0
2021-07-23 07:00,69,44,25,0,0,0
2021-07-23 07:15,79,45,34,0,0,0
2021-07-23 07:30,101,81,20,0,0,0
2021-07-23 07:45,136,104,32,0,0,0
2021-07-23 08:00,82,55,27,0,0,0
2021-07-23 08:15,110,80,30,0,0,0
2021-07-23 08:30,104,70,34,0,0,0
2021-07-23 08:45,116,91,25,0,0,0
2021-07-23 09:00,99,64,35,0,0,0
2021-07-23 09:15,102,65,37,0,0,0
2021-07-23 09:30,88,57,31,0,0,0
2021-07-23 09:45,115,84,31,0,0,0
2021-07-23 10:00,132,95,37,0,0,0
2021-07-23 10:15,95,64,31,0,0,0
2021-07-23 10:30,94,66,28,0,0,0
2021-07-23 10:45,101,74,27,0,0,0
2021-07-23 11:00,86,50,36,0,0,0
2021-07-23 11:15,120,73,47,0,0,0
2021-07-23 11:30,118,78,40,0,0,0
2021-07-23 11:45,127,64,63,0,0,0
2021-07-23 12:00,103,67,36,0,0,0
2021-07-23 12:15,145,87,58,0,0,0
2021-07-23 12:30,117,69,48,0,0,0
2021-07-23 12:45,131,73,58,0,0,0
2021-07-23 13:00,146,94,52,0,0,0
2021-07-23 13:15,120,84,36,0,0,0
2021-07-23 13:30,123,91,32,0,0,0
2021-07-23 13:45,123,76,47,0,0,0
2021-07-23 14:00,161,103,58,0,0,0
2021-07-23 14:15,137,75,62,0,0,0
2021-07-23 14:30,125,72,53,0,0,0
2021-07-23 14:45,159,105,54,0,0,0
2021-07-23 15:00,154,87,67,0,0,0
2021-07-23 15:15,170,107,63,0,0,0
2021-07-23 15:30,143,74,69,0,0,0
2021-07-23 15:45,145,93,52,0,0,0
2021-07-23 16:00,142,87,55,0,0,0
2021-07-23 16:15,135,89,46,0,0,0
2021-07-23 16:30,131,79,52,0,0,0
2021-07-23 16:45,126,71,55,0,0,0
2021-07-23 17:00,139,86,53,0,0,0
2021-07-23 17:15,153,89,64,0,0,0
2021-07-23 17:30,143,85,58,0,0,0
2021-07-23 17:45,138,85,53,0,0,0
2021-07-23 18:00,120,71,49,0,0,0
2021-07-23 18:15,143,87,56,0,0,0
2021-07-23 18:30,126,78,48,0,0,0
2021-07-23 18:45,160,91,69,0,0,0
2021-07-23 19:00,113,62,51,0,0,0
2021-07-23 19:15,111,64,47,0,0,0
2021-07-23 19:30,83,51,32,0,0,0
2021-07-23 19:45,98,55,43,0,0,0
2021-07-23 20:00,91,61,30,0,0,0
2021-07-23 20:15,98,63,35,0,0,0
2021-07-23 20:30,63,49,14,0,0,0
2021-07-23 20:45,56,31,25,0,0,0
2021-07-23 21:00,50,32,18,0,0,0
2021-07-23 21:15,48,27,21,0,0,0
2021-07-23 21:30,52,26,26,0,0,0
2021-07-23 21:45,37,19,18,0,0,0
2021-07-23 22:00,63,33,30,0,0,0
2021-07-23 22:15,35,24,11,0,0,0
2021-07-23 22:30,58,35,23,0,0,0
2021-07-23 22:45,53,34,19,0,0,0
2021-07-23 23:00,47,22,25,0,0,0
2021-07-23 23:15,33,18,15,0,0,0
2021-07-23 23:30,37,20,17,0,0,0
2021-07-23 23:45,28,10,18,0,0,0
2021-07-24 00:00,32,19,13,0,0,0
2021-07-24 00:15,29,15,14,0,0,0
2021-07-24 00:30,29,13,16,0,0,0
2021-07-24 00:45,39,23,16,0,0,0
2021-07-24 01:00,19,10,9,0,0,0
2021-07-24 01:15,28,17,11,0,0,0
2021-07-24 01:30,36,18,18,0,0,0
2021-07-24 01:45,35,14,21,0,0,0
2021-07-24 02:00,17,7,10,0,0,0
2021-07-24 02:15,10,2,8,0,0,0
2021-07-24 02:30,20,12,8,0,0,0
2021-07-24 02:45,24,7,17,0,0,0
2021-07-24 03:00,14,3,11,0,0,0
2021-07-24 03:15,8,3,5,0,0,0
2021-07-24 03:30,7,4,3,0,0,0
2021-07-24 03:45,4,1,3,0,0,0
2021-07-24 04:00,6,2,4,0,0,0
2021-07-24 04:15,6,2,4,0,0,0
2021-07-24 04:30,7,6,1,0,0,0
2021-07-24 04:45,5,3,2,0,0,0
2021-07-24 05:00,4,2,2,0,0,0
2021-07-24 05:15,4,2,2,0,0,0
2021-07-24 05:30,11,8,3,0,0,0
2021-07-24 05:45,6,4,2,0,0,0
2021-07-24 06:00,13,8,5,0,0,0
2021-07-24 06:15,13,6,7,0,0,0
2021-07-24 06:30,14,11,3,0,0,0
2021-07-24 06:45,11,6,5,0,0,0
2021-07-24 07:00,17,11,6,0,0,0
2021-07-24 07:15,19,12,7,0,0,0
2021-07-24 07:30,28,18,10,0,0,0
2021-07-24 07:45,37,23,14,0,0,0
2021-07-24 08:00,31,22,9,0,0,0
2021-07-24 08:15,28,18,10,0,0,0
2021-07-24 08:30,36,18,18,0,0,0
2021-07-24 08:45,58,38,20,0,0,0
2021-07-24 09:00,51,38,13,0,0,0
2021-07-24 09:15,86,67,19,0,0,0
2021-07-24 09:30,85,59,26,0,0,0
2021-07-24 09:45,113,69,44,0,0,0
2021-07-24 10:00,97,69,28,0,0,0
2021-07-24 10:15,131,101,30,0,0,0
2021-07-24 10:30,121,82,39,0,0,0
2021-07-24 10:45,133,97,36,0,0,0
2021-07-24 11:00,173,95,78,0,0,0
2021-07-24 11:15,133,102,31,0,0,0
2021-07-24 11:30,169,114,55,0,0,0
2021-07-24 11:45,149,86,63,0,0,0
2021-07-24 12:00,124,91,33,0,0,0
2021-07-24 12:15,143,105,38,0,0,0
2021-07-24 12:30,124,78,46,0,0,0
2021-07-24 12:45,135,86,49,0,0,0
2021-07-24 13:00,101,66,35,0,0,0
2021-07-24 13:15,128,79,49,0,0,0
2021-07-24 13:30,133,72,61,0,0,0
2021-07-24 13:45,140,68,72,0,0,0
2021-07-24 14:00,113,55,58,0,0,0
2021-07-24 14:15,115,55,60,0,0,0
2021-07-24 14:30,116,69,47,0,0,0
2021-07-24 14:45,100,49,51,0,0,0
2021-07-24 15:00,95,62,33,0,0,0
2021-07-24 15:15,109,52,57,0,0,0
2021-07-24 15:30,104,54,50,0,0,0
2021-07-24 15:45,125,80,45,0,0,0
2021-07-24 16:00,63,32,31,0,0,0
2021-07-24 16:15,78,43,35,0,0,0
2021-07-24 16:30,76,41,35,0,0,0
2021-07-24 16:45,69,43,26,0,0,0
2021-07-24 17:00,105,65,40,0,0,0
2021-07-24 17:15,32,18,14,0,0,0
2021-07-24 17:30,31,17,14,0,0,0
2021-07-24 17:45,64,37,27,0,0,0
2021-07-24 18:00,60,38,22,0,0,0
2021-07-24 18:15,43,25,18,0,0,0
2021-07-24 18:30,30,21,9,0,0,0
2021-07-24 18:45,47,30,17,0,0,0
2021-07-24 19:00,30,14,16,0,0,0
2021-07-24 19:15,20,10,10,0,0,0
2021-07-24 19:30,25,15,10,0,0,0
2021-07-24 19:45,24,16,8,0,0,0
2021-07-24 20:00,36,15,21,0,0,0
2021-07-24 20:15,30,9,21,0,0,0
2021-07-24 20:30,26,15,11,0,0,0
2021-07-24 20:45,32,20,12,0,0,0
2021-07-24 21:00,30,21,9,0,0,0
2021-07-24 21:15,22,13,9,0,0,0
2021-07-24 21:30,23,7,16,0,0,0
2021-07-24 21:45,17,8,9,0,0,0
2021-07-24 22:00,15,6,9,0,0,0
2021-07-24 22:15,19,8,11,0,0,0
2021-07-24 22:30,25,14,11,0,0,0
2021-07-24 22:45,15,4,11,0,0,0
2021-07-24 23:00,16,9,7,0,0,0
2021-07-24 23:15,12,8,4,0,0,0
2021-07-24 23:30,12,2,10,0,0,0
2021-07-24 23:45,17,12,5,0,0,0
2021-07-25 00:00,18,11,7,0,0,0
2021-07-25 00:15,13,5,8,0,0,0
2021-07-25 00:30,20,4,16,0,0,0
2021-07-25 00:45,12,8,4,0,0,0
2021-07-25 01:00,14,5,9,0,0,0
2021-07-25 01:15,15,8,7,0,0,0
2021-07-25 01:30,7,7,0,0,0,0
2021-07-25 01:45,7,1,6,0,0,0
2021-07-25 02:00,8,5,3,0,0,0
2021-07-25 02:15,7,5,2,0,0,0
2021-07-25 02:30,5,1,4,0,0,0
2021-07-25 02:45,9,6,3,0,0,0
2021-07-25 03:00,5,3,2,0,0,0
2021-07-25 03:15,11,6,5,0,0,0
2021-07-25 03:30,7,3,4,0,0,0
2021-07-25 03:45,5,2,3,0,0,0
2021-07-25 04:00,8,6,2,0,0,0
2021-07-25 04:15,3,2,1,0,0,0
2021-07-25 04:30,6,5,1,0,0,0
2021-07-25 04:45,4,2,2,0,0,0
2021-07-25 05:00,6,5,1,0,0,0
2021-07-25 05:15,3,3,0,0,0,0
2021-07-25 05:30,6,4,2,0,0,0
2021-07-25 05:45,3,3,0,0,0,0
2021-07-25 06:00,6,4,2,0,0,0
2021-07-25 06:15,7,3,4,0,0,0
2021-07-25 06:30,10,9,1,0,0,0
2021-07-25 06:45,8,3,5,0,0,0
2021-07-25 07:00,8,5,3,0,0,0
2021-07-25 07:15,5,1,4,0,0,0
2021-07-25 07:30,5,3,2,0,0,0
2021-07-25 07:45,12,8,4,0,0,0
2021-07-25 08:00,11,5,6,0,0,0
2021-07-25 08:15,9,6,3,0,0,0
2021-07-25 08:30,6,5,1,0,0,0
2021-07-25 08:45,20,14,6,0,0,0
2021-07-25 09:00,17,7,10,0,0,0
2021-07-25 09:15,23,14,9,0,0,0
2021-07-25 09:30,40,25,15,0,0,0
2021-07-25 09:45,37,24,13,0,0,0
2021-07-25 10:00,47,36,11,0,0,0
2021-07-25 10:15,43,30,13,0,0,0
2021-07-25 10:30,36,27,9,0,0,0
2021-07-25 10:45,52,37,15,0,0,0
2021-07-25 11:00,54,37,17,0,0,0
2021-07-25 11:15,35,25,10,0,0,0
2021-07-25 11:30,51,32,19,0,0,0
2021-07-25 11:45,78,60,18,0,0,0
2021-07-25 12:00,74,50,24,0,0,0
2021-07-25 12:15,89,63,26,0,0,0
2021-07-25 12:30,57,33,24,0,0,0
2021-07-25 12:45,61,30,31,0,0,0
2021-07-25 13:00,61,35,26,0,0,0
2021-07-25 13:15,61,45,16,0,0,0
2021-07-25 13:30,58,30,28,0,0,0
2021-07-25 13:45,62,38,24,0,0,0
2021-07-25 14:00,65,31,34,0,0,0
2021-07-25 14:15,61,42,19,0,0,0
2021-07-25 14:30,90,52,38,0,0,0
2021-07-25 14:45,102,55,47,0,0,0
2021-07-25 15:00,82,48,34,0,0,0
2021-07-25 15:15,86,53,33,0,0,0
2021-07-25 15:30,85,59,26,0,0,0
2021-07-25 15:45,118,94,24,0,0,0
2021-07-25 16:00,89,63,26,0,0,0
2021-07-25 16:15,60,43,17,0,0,0
2021-07-25 16:30,75,50,25,0,0,0
2021-07-25 16:45,90,63,27,0,0,0
2021-07-25 17:00,80,50,30,0,0,0
2021-07-25 17:15,82,53,29,0,0,0
2021-07-25 17:30,99,59,40,0,0,0
2021-07-25 17:45,82,54,28,0,0,0
2021-07-25 18:00,82,43,39,0,0,0
2021-07-25 18:15,91,65,26,0,0,0
2021-07-25 18:30,70,38,32,0,0,0
2021-07-25 18:45,76,43,33,0,0,0
2021-07-25 19:00,75,54,21,0,0,0
2021-07-25 19:15,64,41,23,0,0,0
2021-07-25 19:30,72,54,18,0,0,0
2021-07-25 19:45,63,36,27,0,0,0
2021-07-25 20:00,48,27,21,0,0,0
2021-07-25 20:15,60,34,26,0,0,0
2021-07-25 20:30,46,32,14,0,0,0
2021-07-25 20:45,34,21,13,0,0,0
2021-07-25 21:00,39,25,14,0,0,0
2021-07-25 21:15,31,17,14,0,0,0
2021-07-25 21:30,23,12,11,0,0,0
2021-07-25 21:45,18,11,7,0,0,0
2021-07-25 22:00,28,12,16,0,0,0
2021-07-25 22:15,14,9,5,0,0,0
2021-07-25 22:30,26,14,12,0,0,0
2021-07-25 22:45,9,2,7,0,0,0
2021-07-25 23:00,13,6,7,0,0,0
2021-07-25 23:15,20,10,10,0,0,0
2021-07-25 23:30,8,3,5,0,0,0
2021-07-25 23:45,9,3,6,0,0,0
2021-07-26 00:00,11,9,2,0,0,0
2021-07-26 00:15,5,5,0,0,0,0
2021-07-26 00:30,1,0,1,0,0,0
2021-07-26 00:45,4,3,1,0,0,0
2021-07-26 01:00,7,5,2,0,0,0
2021-07-26 01:15,1,1,0,0,0,0
2021-07-26 01:30,1,1,0,0,0,0
2021-07-26 01:45,1,1,0,0,0,0
2021-07-26 02:00,1,0,1,0,0,0
2021-07-26 02:15,1,1,0,0,0,0
2021-07-26 02:30,0,0,0,0,0,0
2021-07-26 02:45,1,1,0,0,0,0
2021-07-26 03:00,2,2,0,0,0,0
2021-07-26 03:15,3,3,0,0,0,0
2021-07-26 03:30,2,1,1,0,0,0
2021-07-26 03:45,0,0,0,0,0,0
2021-07-26 04:00,0,0,0,0,0,0
2021-07-26 04:15,1,0,1,0,0,0
2021-07-26 04:30,0,0,0,0,0,0
2021-07-26 04:45,1,0,1,0,0,0
2021-07-26 05:00,1,1,0,0,0,0
2021-07-26 05:15,6,5,1,0,0,0
2021-07-26 05:30,11,5,6,0,0,0
2021-07-26 05:45,20,9,11,0,0,0
2021-07-26 06:00,14,12,2,0,0,0
2021-07-26 06:15,31,20,11,0,0,0
2021-07-26 06:30,44,26,18,0,0,0
2021-07-26 06:45,57,35,22,0,0,0
2021-07-26 07:00,76,46,30,0,0,0
2021-07-26 07:15,79,46,33,0,0,0
2021-07-26 07:30,104,72,32,0,0,0
2021-07-26 07:45,137,89,48,0,0,0
2021-07-26 08:00,99,69,30,0,0,0
2021-07-26 08:15,99,67,32,0,0,0
2021-07-26 08:30,104,77,27,0,0,0
2021-07-26 08:45,115,84,31,0,0,0
2021-07-26 09:00,81,59,22,0,0,0
2021-07-26 09:15,100,68,32,0,0,0
2021-07-26 09:30,99,72,27,0,0,0
2021-07-26 09:45,96,68,28,0,0,0
2021-07-26 10:00,93,63,30,0,0,0
2021-07-26 10:15,84,51,33,0,0,0
2021-07-26 10:30,86,63,23,0,0,0
2021-07-26 10:45,93,68,25,0,0,0
2021-07-26 11:00,104,67,37,0,0,0
2021-07-26 11:15,100,61,39,0,0,0
2021-07-26 11:30,67,52,15,0,0,0
2021-07-26 11:45,89,60,29,0,0,0
2021-07-26 12:00,107,64,43,0,0,0
2021-07-26 12:15,90,63,27,0,0,0
2021-07-26 12:30,102,62,40,0,0,0
2021-07-26 12:45,79,52,27,0,0,0
2021-07-26 13:00,95,64,31,0,0,0
2021-07-26 13:15,99,58,41,0,0,0
2021-07-26 13:30,105,69,36,0,0,0
2021-07-26 13:45,114,72,42,0,0,0
2021-07-26 14:00,122,84,38,0,0,0
2021-07-26 14:15,98,54,44,0,0,0
2021-07-26 14:30,106,67,39,0,0,0
2021-07-26 14:45,109,74,35,0,0,0
2021-07-26 15:00,114,62,52,0,0,0
2021-07-26 15:15,140,90,50,0,0,0
2021-07-26 15:30,109,55,54,0,0,0
2021-07-26 15:45,139,88,51,0,0,0
2021-07-26 16:00,176,111,65,0,0,0
2021-07-26 16:15,139,86,53,0,0,0
2021-07-26 16:30,133,79,54,0,0,0
2021-07-26 16:45,125,71,54,0,0,0
2021-07-26 17:00,160,102,58,0,0,0
2021-07-26 17:15,141,80,61,0,0,0
2021-07-26 17:30,141,78,63,0,0,0
2021-07-26 17:45,134,75,59,0,0,0
2021-07-26 18:00,140,73,67,0,0,0
2021-07-26 18:15,102,54,48,0,0,0
2021-07-26 18:30,108,56,52,0,0,0
2021-07-26 18:45,91,44,47,0,0,0
2021-07-26 19:00,119,64,55,0,0,0
2021-07-26 19:15,105,60,45,0,0,0
2021-07-26 19:30,79,46,33,0,0,0
2021-07-26 19:45,67,42,25,0,0,0
2021-07-26 20:00,64,34,30,0,0,0
2021-07-26 20:15,59,36,23,0,0,0
2021-07-26 20:30,52,29,23,0,0,0
2021-07-26 20:45,62,43,19,0,0,0
2021-07-26 21:00,26,17,9,0,0,0
2021-07-26 21:15,48,25,23,0,0,0
2021-07-26 21:30,47,29,18,0,0,0
2021-07-26 21:45,40,22,18,0,0,0
2021-07-26 22:00,46,29,17,0,0,0
2021-07-26 22:15,68,31,37,0,0,0
2021-07-26 22:30,13,4,9,0,0,0
2021-07-26 22:45,5,0,5,0,0,0
2021-07-26 23:00,16,11,5,0,0,0
2021-07-26 23:15,11,7,4,0,0,0
2021-07-26 23:30,17,6,11,0,0,0
2021-07-26 23:45,6,0,6,0,0,0
2021-07-27 00:00,16,9,7,0,0,0
2021-07-27 00:15,6,4,2,0,0,0
2021-07-27 00:30,8,4,4,0,0,0
2021-07-27 00:45,4,2,2,0,0,0
2021-07-27 01:00,7,4,3,0,0,0
2021-07-27 01:15,5,5,0,0,0,0
2021-07-27 01:30,3,2,1,0,0,0
2021-07-27 01:45,8,5,3,0,0,0
2021-07-27 02:00,7,4,3,0,0,0
2021-07-27 02:15,1,0,1,0,0,0
2021-07-27 02:30,5,3,2,0,0,0
2021-07-27 02:45,1,0,1,0,0,0
2021-07-27 03:00,1,0,1,0,0,0
2021-07-27 03:15,1,1,0,0,0,0
2021-07-27 03:30,0,0,0,0,0,0
2021-07-27 03:45,2,2,0,0,0,0
2021-07-27 04:00,1,0,1,0,0,0
2021-07-27 04:15,3,1,2,0,0,0
2021-07-27 04:30,2,2,0,0,0,0
2021-07-27 04:45,1,0,1,0,0,0
2021-07-27 05:00,0,0,0,0,0,0
2021-07-27 05:15,6,5,1,0,0,0
2021-07-27 05:30,12,7,5,0,0,0
2021-07-27 05:45,14,7,7,0,0,0
2021-07-27 06:00,13,11,2,0,0,0
2021-07-27 06:15,37,20,17,0,0,0
2021-07-27 06:30,32,21,11,0,0,0
2021-07-27 06:45,62,40,22,0,0,0
2021-07-27 07:00,72,41,31,0,0,0
2021-07-27 07:15,89,51,38,0,0,0
2021-07-27 07:30,107,74,33,0,0,0
2021-07-27 07:45,142,100,42,0,0,0
2021-07-27 08:00,76,52,24,0,0,0
2021-07-27 08:15,89,52,37,0,0,0
2021-07-27 08:30,110,91,19,0,0,0
2021-07-27 08:45,105,80,25,0,0,0
2021-07-27 09:00,84,59,25,0,0,0
2021-07-27 09:15,97,70,27,0,0,0
2021-07-27 09:30,77,58,19,0,0,0
2021-07-27 09:45,123,92,31,0,0,0
2021-07-27 10:00,71,49,22,0,0,0
2021-07-27 10:15,98,74,24,0,0,0
2021-07-27 10:30,97,69,28,0,0,0
2021-07-27 10:45,116,78,38,0,0,0
2021-07-27 11:00,94,69,25,0,0,0
2021-07-27 11:15,86,53,33,0,0,0
2021-07-27 11:30,109,72,37,0,0,0
2021-07-27 11:45,101,68,33,0,0,0
2021-07-27 12:00,93,67,26,0,0,0
2021-07-27 12:15,114,75,39,0,0,0
2021-07-27 12:30,111,74,37,0,0,0
2021-07-27 12:45,113,76,37,0,0,0
2021-07-27 13:00,96,56,40,0,0,0
2021-07-27 13:15,91,60,31,0,0,0
2021-07-27 13:30,89,57,32,0,0,0
2021-07-27 13:45,115,76,39,0,0,0
2021-07-27 14:00,93,61,32,0,0,0
2021-07-27 14:15,93,58,35,0,0,0
2021-07-27 14:30,137,90,47,0,0,0
2021-07-27 14:45,124,75,49,0,0,0
2021-07-27 15:00,73,38,35,0,0,0
2021-07-27 15:15,76,33,43,0,0,0
2021-07-27 15:30,121,76,45,0,0,0
2021-07-27 15:45,122,80,42,0,0,0
2021-07-27 16:00,121,60,61,0,0,0
2021-07-27 16:15,112,60,52,0,0,0
2021-07-27 16:30,127,71,56,0,0,0
2021-07-27 16:45,145,89,56,0,0,0
2021-07-27 17:00,105,54,51,0,0,0
2021-07-27 17:15,153,90,63,0,0,0
2021-07-27 17:30,154,84,70,0,0,0
2021-07-27 17:45,141,64,77,0,0,0
2021-07-27 18:00,61,21,40,0,0,0
2021-07-27 18:15,60,23,37,0,0,0
2021-07-27 18:30,50,27,23,0,0,0
2021-07-27 18:45,40,25,15,0,0,0
2021-07-27 19:00,30,16,14,0,0,0
2021-07-27 19:15,52,29,23,0,0,0
2021-07-27 19:30,43,17,26,0,0,0
2021-07-27 19:45,43,19,24,0,0,0
2021-07-27 20:00,68,31,37,0,0,0
2021-07-27 20:15,48,30,18,0,0,0
2021-07-27 20:30,39,16,23,0,0,0
2021-07-27 20:45,32,18,14,0,0,0
2021-07-27 21:00,29,15,14,0,0,0
2021-07-27 21:15,20,12,8,0,0,0
2021-07-27 21:30,25,14,11,0,0,0
2021-07-27 21:45,15,5,10,0,0,0
2021-07-27 22:00,18,10,8,0,0,0
2021-07-27 22:15,28,9,19,0,0,0
2021-07-27 22:30,24,11,13,0,0,0
2021-07-27 22:45,13,8,5,0,0,0
2021-07-27 23:00,15,6,9,0,0,0
2021-07-27 23:15,13,4,9,0,0,0
2021-07-27 23:30,9,7,2,0,0,0
2021-07-27 23:45,8,4,4,0,0,0
2021-07-28 00:00,15,7,8,0,0,0
2021-07-28 00:15,4,4,0,0,0,0
2021-07-28 00:30,1,1,0,0,0,0
2021-07-28 00:45,9,4,5,0,0,0
2021-07-28 01:00,7,6,1,0,0,0
2021-07-28 01:15,3,2,1,0,0,0
2021-07-28 01:30,5,0,5,0,0,0
2021-07-28 01:45,11,8,3,0,0,0
2021-07-28 02:00,1,0,1,0,0,0
2021-07-28 02:15,3,1,2,0,0,0
2021-07-28 02:30,2,0,2,0,0,0
2021-07-28 02:45,3,0,3,0,0,0
2021-07-28 03:00,0,0,0,0,0,0
2021-07-28 03:15,0,0,0,0,0,0
2021-07-28 03:30,1,0,1,0,0,0
2021-07-28 03:45,0,0,0,0,0,0
2021-07-28 04:00,0,0,0,0,0,0
2021-07-28 04:15,2,1,1,0,0,0
2021-07-28 04:30,3,1,2,0,0,0
2021-07-28 04:45,3,2,1,0,0,0
2021-07-28 05:00,1,1,0,0,0,0
2021-07-28 05:15,6,4,2,0,0,0
2021-07-28 05:30,15,9,6,0,0,0
2021-07-28 05:45,12,6,6,0,0,0
2021-07-28 06:00,20,14,6,0,0,0
2021-07-28 06:15,20,15,5,0,0,0
2021-07-28 06:30,32,20,12,0,0,0
2021-07-28 06:45,53,42,11,0,0,0
2021-07-28 07:00,55,38,17,0,0,0
2021-07-28 07:15,78,54,24,0,0,0
2021-07-28 07:30,95,81,14,0,0,0
2021-07-28 07:45,132,89,43,0,0,0
2021-07-28 08:00,92,63,29,0,0,0
2021-07-28 08:15,80,60,20,0,0,0
2021-07-28 08:30,96,72,24,0,0,0
2021-07-28 08:45,125,92,33,0,0,0
2021-07-28 09:00,88,68,20,0,0,0
2021-07-28 09:15,74,60,14,0,0,0
2021-07-28 09:30,117,88,29,0,0,0
2021-07-28 09:45,100,79,21,0,0,0
2021-07-28 10:00,94,73,21,0,0,0
2021-07-28 10:15,98,74,24,0,0,0
2021-07-28 10:30,85,58,27,0,0,0
2021-07-28 10:45,60,42,18,0,0,0
2021-07-28 11:00,77,41,36,0,0,0
2021-07-28 11:15,82,52,30,0,0,0
2021-07-28 11:30,49,32,17,0,0,0
2021-07-28 11:45,72,40,32,0,0,0
2021-07-28 12:00,105,72,33,0,0,0
2021-07-28 12:15,109,78,31,0,0,0
2021-07-28 12:30,119,83,36,0,0,0
2021-07-28 12:45,132,89,43,0,0,0
2021-07-28 13:00,95,57,38,0,0,0
2021-07-28 13:15,96,70,26,0,0,0
2021-07-28 13:30,107,65,42,0,0,0
2021-07-28 13:45,103,64,39,0,0,0
2021-07-28 14:00,124,72,52,0,0,0
2021-07-28 14:15,92,48,44,0,0,0
2021-07-28 14:30,135,80,55,0,0,0
2021-07-28 14:45,113,65,48,0,0,0
2021-07-28 15:00,110,70,40,0,0,0
2021-07-28 15:15,100,60,40,0,0,0
2021-07-28 15:30,93,55,38,0,0,0
2021-07-28 15:45,132,95,37,0,0,0
2021-07-28 16:00,138,74,64,0,0,0
2021-07-28 16:15,134,79,55,0,0,0
2021-07-28 16:30,149,96,53,0,0,0
2021-07-28 16:45,160,90,70,0,0,0
2021-07-28 17:00,159,88,71,0,0,0
2021-07-28 17:15,142,81,61,0,0,0
2021-07-28 17:30,146,77,69,0,0,0
2021-07-28 17:45,136,92,44,0,0,0
2021-07-28 18:00,117,62,55,0,0,0
2021-07-28 18:15,116,56,60,0,0,0
2021-07-28 18:30,126,63,63,0,0,0
2021-07-28 18:45,97,54,43,0,0,0
2021-07-28 19:00,85,45,40,0,0,0
2021-07-28 19:15,109,59,50,0,0,0
2021-07-28 19:30,82,36,46,0,0,0
2021-07-28 19:45,104,64,40,0,0,0
2021-07-28 20:00,77,47,30,0,0,0
2021-07-28 20:15,84,48,36,0,0,0
2021-07-28 20:30,46,26,20,0,0,0
2021-07-28 20:45,55,36,19,0,0,0
2021-07-28 21:00,54,35,19,0,0,0
2021-07-28 21:15,29,16,13,0,0,0
2021-07-28 21:30,43,22,21,0,0,0
2021-07-28 21:45,41,20,21,0,0,0
2021-07-28 22:00,39,24,15,0,0,0
2021-07-28 22:15,37,20,17,0,0,0
2021-07-28 22:30,54,34,20,0,0,0
2021-07-28 22:45,39,21,18,0,0,0
2021-07-28 23:00,30,17,13,0,0,0
2021-07-28 23:15,31,20,11,0,0,0
2021-07-28 23:30,25,15,10,0,0,0
2021-07-28 23:45,16,6,10,0,0,0
2021-07-29 00:00,18,4,14,0,0,0
2021-07-29 00:15,15,2,13,0,0,0
2021-07-29 00:30,13,3,10,0,0,0
2021-07-29 00:45,8,2,6,0,0,0
2021-07-29 01:00,16,6,10,0,0,0
2021-07-29 01:15,9,4,5,0,0,0
2021-07-29 01:30,12,9,3,0,0,0
2021-07-29 01:45,6,2,4,0,0,0
2021-07-29 02:00,4,0,4,0,0,0
2021-07-29 02:15,6,0,6,0,0,0
2021-07-29 02:30,5,2,3,0,0,0
2021-07-29 02:45,2,1,1,0,0,0
2021-07-29 03:00,4,0,4,0,0,0
2021-07-29 03:15,2,0,2,0,0,0
2021-07-29 03:30,2,1,1,0,0,0
2021-07-29 03:45,3,0,3,0,0,0
2021-07-29 04:00,0,0,0,0,0,0
2021-07-29 04:15,4,3,1,0,0,0
2021-07-29 04:30,1,0,1,0,0,0
2021-07-29 04:45,3,2,1,0,0,0
2021-07-29 05:00,1,0,1,0,0,0
2021-07-29 05:15,2,2,0,0,0,0
2021-07-29 05:30,15,9,6,0,0,0
2021-07-29 05:45,16,10,6,0,0,0
2021-07-29 06:00,13,7,6,0,0,0
2021-07-29 06:15,38,20,18,0,0,0
2021-07-29 06:30,40,23,17,0,0,0
2021-07-29 06:45,50,27,23,0,0,0
2021-07-29 07:00,71,42,29,0,0,0
2021-07-29 07:15,83,54,29,0,0,0
2021-07-29 07:30,100,76,24,0,0,0
2021-07-29 07:45,108,70,38,0,0,0
2021-07-29 08:00,86,65,21,0,0,0
2021-07-29 08:15,88,62,26,0,0,0
2021-07-29 08:30,96,64,32,0,0,0
2021-07-29 08:45,101,77,24,0,0,0
2021-07-29 09:00,81,60,21,0,0,0
2021-07-29 09:15,82,49,33,0,0,0
2021-07-29 09:30,88,67,21,0,0,0
2021-07-29 09:45,116,86,30,0,0,0
2021-07-29 10:00,83,63,20,0,0,0
2021-07-29 10:15,103,71,32,0,0,0
2021-07-29 10:30,98,61,37,0,0,0
2021-07-29 10:45,92,63,29,0,0,0
2021-07-29 11:00,95,60,35,0,0,0
2021-07-29 11:15,81,41,40,0,0,0
2021-07-29 11:30,97,64,33,0,0,0
2021-07-29 11:45,93,61,32,0,0,0
2021-07-29 12:00,102,57,45,0,0,0
2021-07-29 12:15,106,72,34,0,0,0
2021-07-29 12:30,117,81,36,0,0,0
2021-07-29 12:45,99,61,38,0,0,0
2021-07-29 13:00,99,56,43,0,0,0
2021-07-29 13:15,114,69,45,0,0,0
2021-07-29 13:30,94,63,31,0,0,0
2021-07-29 13:45,97,68,29,0,0,0
2021-07-29 14:00,109,71,38,0,0,0
2021-07-29 14:15,93,52,41,0,0,0
2021-07-29 14:30,108,85,23,0,0,0
2021-07-29 14:45,135,88,47,0,0,0
2021-07-29 15:00,103,65,38,0,0,0
2021-07-29 15:15,113,60,53,0,0,0
2021-07-29 15:30,101,65,36,0,0,0
2021-07-29 15:45,132,75,57,0,0,0
2021-07-29 16:00,113,68,45,0,0,0
2021-07-29 16:15,130,71,59,0,0,0
2021-07-29 16:30,134,96,38,0,0,0
2021-07-29 16:45,120,78,42,0,0,0
2021-07-29 17:00,145,93,52,0,0,0
2021-07-29 17:15,128,71,57,0,0,0
2021-07-29 17:30,116,61,55,0,0,0
2021-07-29 17:45,133,66,67,0,0,0
2021-07-29 18:00,149,92,57,0,0,0
2021-07-29 18:15,120,56,64,0,0,0
2021-07-29 18:30,101,57,44,0,0,0
2021-07-29 18:45,118,68,50,0,0,0
2021-07-29 19:00,92,58,34,0,0,0
2021-07-29 19:15,92,51,41,0,0,0
2021-07-29 19:30,68,34,34,0,0,0
2021-07-29 19:45,86,48,38,0,0,0
2021-07-29 20:00,86,47,39,0,0,0
2021-07-29 20:15,80,47,33,0,0,0
2021-07-29 20:30,70,42,28,0,0,0
2021-07-29 20:45,49,27,22,0,0,0
2021-07-29 21:00,59,34,25,0,0,0
2021-07-29 21:15,36,28,8,0,0,0
2021-07-29 21:30,46,25,21,0,0,0
2021-07-29 21:45,46,22,24,0,0,0
2021-07-29 22:00,27,16,11,0,0,0
2021-07-29 22:15,46,30,16,0,0,0
2021-07-29 22:30,37,18,19,0,0,0
2021-07-29 22:45,60,35,25,0,0,0
2021-07-29 23:00,37,17,20,0,0,0
2021-07-29 23:15,23,9,14,0,0,0
2021-07-29 23:30,11,4,7,0,0,0
2021-07-29 23:45,13,4,9,0,0,0
2021-07-30 00:00,9,4,5,0,0,0
2021-07-30 00:15,18,4,14,0,0,0
2021-07-30 00:30,6,2,4,0,0,0
2021-07-30 00:45,13,7,6,0,0,0
2021-07-30 01:00,7,2,5,0,0,0
2021-07-30 01:15,4,0,4,0,0,0
2021-07-30 01:30,7,2,5,0,0,0
2021-07-30 01:45,7,3,4,0,0,0
2021-07-30 02:00,8,0,8,0,0,0
2021-07-30 02:15,5,4,1,0,0,0
2021-07-30 02:30,4,3,1,0,0,0
2021-07-30 02:45,4,1,3,0,0,0
2021-07-30 03:00,0,0,0,0,0,0
2021-07-30 03:15,2,1,1,0,0,0
2021-07-30 03:30,2,0,2,0,0,0
2021-07-30 03:45,1,0,1,0,0,0
2021-07-30 04:00,3,1,2,0,0,0
2021-07-30 04:15,0,0,0,0,0,0
2021-07-30 04:30,3,3,0,0,0,0
2021-07-30 04:45,1,0,1,0,0,0
2021-07-30 05:00,0,0,0,0,0,0
2021-07-30 05:15,7,6,1,0,0,0
2021-07-30 05:30,5,4,1,0,0,0
2021-07-30 05:45,20,7,13,0,0,0
2021-07-30 06:00,16,12,4,0,0,0
2021-07-30 06:15,25,13,12,0,0,0
2021-07-30 06:30,21,9,12,0,0,0
2021-07-30 06:45,44,25,19,0,0,0
2021-07-30 07:00,62,37,25,0,0,0
2021-07-30 07:15,60,27,33,0,0,0
2021-07-30 07:30,89,70,19,0,0,0
2021-07-30 07:45,116,83,33,0,0,0
2021-07-30 08:00,69,37,32,0,0,0
2021-07-30 08:15,84,60,24,0,0,0
2021-07-30 08:30,90,59,31,0,0,0
2021-07-30 08:45,105,85,20,0,0,0
2021-07-30 09:00,100,70,30,0,0,0
2021-07-30 09:15,89,69,20,0,0,0
2021-07-30 09:30,78,53,25,0,0,0
2021-07-30 09:45,97,76,21,0,0,0
2021-07-30 10:00,95,70,25,0,0,0
2021-07-30 10:15,90,64,26,0,0,0
2021-07-30 10:30,95,71,24,0,0,0
2021-07-30 10:45,108,74,34,0,0,0
2021-07-30 11:00,88,53,35,0,0,0
2021-07-30 11:15,111,73,38,0,0,0
2021-07-30 11:30,136,86,50,0,0,0
2021-07-30 11:45,126,84,42,0,0,0
2021-07-30 12:00,93,61,32,0,0,0
2021-07-30 12:15,129,80,49,0,0,0
2021-07-30 12:30,107,73,34,0,0,0
2021-07-30 12:45,117,71,46,0,0,0
2021-07-30 13:00,121,82,39,0,0,0
2021-07-30 13:15,121,72,49,0,0,0
2021-07-30 13:30,135,84,51,0,0,0
2021-07-30 13:45,132,96,36,0,0,0
2021-07-30 14:00,128,86,42,0,0,0
2021-07-30 14:15,128,71,57,0,0,0
2021-07-30 14:30,147,90,57,0,0,0
2021-07-30 14:45,142,98,44,0,0,0
2021-07-30 15:00,173,114,59,0,0,0
2021-07-30 15:15,124,81,43,0,0,0
2021-07-30 15:30,131,75,56,0,0,0
2021-07-30 15:45,123,62,61,0,0,0
2021-07-30 16:00,104,55,49,0,0,0
2021-07-30 16:15,139,78,61,0,0,0
2021-07-30 16:30,138,98,40,0,0,0
2021-07-30 16:45,128,74,54,0,0,0
2021-07-30 17:00,124,80,44,0,0,0
2021-07-30 17:15,135,87,48,0,0,0
2021-07-30 17:30,121,73,48,0,0,0
2021-07-30 17:45,147,80,67,0,0,0
2021-07-30 18:00,102,54,48,0,0,0
2021-07-30 18:15,103,58,45,0,0,0
2021-07-30 18:30,104,56,48,0,0,0
2021-07-30 18:45,113,74,39,0,0,0
2021-07-30 19:00,90,52,38,0,0,0
2021-07-30 19:15,81,42,39,0,0,0
2021-07-30 19:30,71,43,28,0,0,0
2021-07-30 19:45,86,67,19,0,0,0
2021-07-30 20:00,83,45,38,0,0,0
2021-07-30 20:15,67,41,26,0,0,0
2021-07-30 20:30,70,43,27,0,0,0
2021-07-30 20:45,52,25,27,0,0,0
2021-07-30 21:00,44,17,27,0,0,0
2021-07-30 21:15,54,31,23,0,0,0
2021-07-30 21:30,37,16,21,0,0,0
2021-07-30 21:45,47,25,22,0,0,0
2021-07-30 22:00,48,29,19,0,0,0
2021-07-30 22:15,36,21,15,0,0,0
2021-07-30 22:30,37,9,28,0,0,0
2021-07-30 22:45,27,14,13,0,0,0
2021-07-30 23:00,19,14,5,0,0,0
2021-07-30 23:15,29,14,15,0,0,0
2021-07-30 23:30,35,21,14,0,0,0
2021-07-30 23:45,29,5,24,0,0,0
