Datetime,100031300 (HafenstraÃŸe),101031300 (Channel 1 IN),102031300 (Channel 2 OUT),100031300-status,101031300-status,102031300-status
2020-06-01 00:00,32,9,23,0,0,0
2020-06-01 00:15,19,8,11,0,0,0
2020-06-01 00:30,20,9,11,0,0,0
2020-06-01 00:45,15,5,10,0,0,0
2020-06-01 01:00,10,5,5,0,0,0
2020-06-01 01:15,17,6,11,0,0,0
2020-06-01 01:30,10,1,9,0,0,0
2020-06-01 01:45,10,5,5,0,0,0
2020-06-01 02:00,3,1,2,0,0,0
2020-06-01 02:15,8,4,4,0,0,0
2020-06-01 02:30,6,2,4,0,0,0
2020-06-01 02:45,2,0,2,0,0,0
2020-06-01 03:00,3,0,3,0,0,0
2020-06-01 03:15,6,0,6,0,0,0
2020-06-01 03:30,7,4,3,0,0,0
2020-06-01 03:45,2,0,2,0,0,0
2020-06-01 04:00,3,1,2,0,0,0
2020-06-01 04:15,5,1,4,0,0,0
2020-06-01 04:30,1,1,0,0,0,0
2020-06-01 04:45,7,4,3,0,0,0
2020-06-01 05:00,3,0,3,0,0,0
2020-06-01 05:15,2,1,1,0,0,0
2020-06-01 05:30,10,0,10,0,0,0
2020-06-01 05:45,2,2,0,0,0,0
2020-06-01 06:00,2,1,1,0,0,0
2020-06-01 06:15,2,1,1,0,0,0
2020-06-01 06:30,5,4,1,0,0,0
2020-06-01 06:45,9,4,5,0,0,0
2020-06-01 07:00,5,2,3,0,0,0
2020-06-01 07:15,5,1,4,0,0,0
2020-06-01 07:30,8,2,6,0,0,0
2020-06-01 07:45,8,2,6,0,0,0
2020-06-01 08:00,13,7,6,0,0,0
2020-06-01 08:15,16,10,6,0,0,0
2020-06-01 08:30,19,7,12,0,0,0
2020-06-01 08:45,13,6,7,0,0,0
2020-06-01 09:00,25,9,16,0,0,0
2020-06-01 09:15,27,7,20,0,0,0
2020-06-01 09:30,31,16,15,0,0,0
2020-06-01 09:45,43,22,21,0,0,0
2020-06-01 10:00,46,15,31,0,0,0
2020-06-01 10:15,34,15,19,0,0,0
2020-06-01 10:30,34,11,23,0,0,0
2020-06-01 10:45,37,18,19,0,0,0
2020-06-01 11:00,50,21,29,0,0,0
2020-06-01 11:15,55,20,35,0,0,0
2020-06-01 11:30,73,32,41,0,0,0
2020-06-01 11:45,74,48,26,0,0,0
2020-06-01 12:00,58,33,25,0,0,0
2020-06-01 12:15,70,46,24,0,0,0
2020-06-01 12:30,73,27,46,0,0,0
2020-06-01 12:45,81,46,35,0,0,0
2020-06-01 13:00,67,44,23,0,0,0
2020-06-01 13:15,80,54,26,0,0,0
2020-06-01 13:30,93,46,47,0,0,0
2020-06-01 13:45,108,62,46,0,0,0
2020-06-01 14:00,121,63,58,0,0,0
2020-06-01 14:15,97,62,35,0,0,0
2020-06-01 14:30,101,46,55,0,0,0
2020-06-01 14:45,114,71,43,0,0,0
2020-06-01 15:00,111,66,45,0,0,0
2020-06-01 15:15,115,59,56,0,0,0
2020-06-01 15:30,85,56,29,0,0,0
2020-06-01 15:45,105,46,59,0,0,0
2020-06-01 16:00,119,59,60,0,0,0
2020-06-01 16:15,109,66,43,0,0,0
2020-06-01 16:30,89,30,59,0,0,0
2020-06-01 16:45,123,62,61,0,0,0
2020-06-01 17:00,98,57,41,0,0,0
2020-06-01 17:15,90,46,44,0,0,0
2020-06-01 17:30,115,46,69,0,0,0
2020-06-01 17:45,108,48,60,0,0,0
2020-06-01 18:00,106,40,66,0,0,0
2020-06-01 18:15,116,44,72,0,0,0
2020-06-01 18:30,70,24,46,0,0,0
2020-06-01 18:45,118,56,62,0,0,0
2020-06-01 19:00,93,42,51,0,0,0
2020-06-01 19:15,85,47,38,0,0,0
2020-06-01 19:30,89,26,63,0,0,0
2020-06-01 19:45,89,32,57,0,0,0
2020-06-01 20:00,95,31,64,0,0,0
2020-06-01 20:15,81,29,52,0,0,0
2020-06-01 20:30,100,42,58,0,0,0
2020-06-01 20:45,67,29,38,0,0,0
2020-06-01 21:00,56,21,35,0,0,0
2020-06-01 21:15,57,31,26,0,0,0
2020-06-01 21:30,70,25,45,0,0,0
2020-06-01 21:45,52,21,31,0,0,0
2020-06-01 22:00,59,22,37,0,0,0
2020-06-01 22:15,57,14,43,0,0,0
2020-06-01 22:30,39,12,27,0,0,0
2020-06-01 22:45,30,8,22,0,0,0
2020-06-01 23:00,35,13,22,0,0,0
2020-06-01 23:15,22,4,18,0,0,0
2020-06-01 23:30,21,8,13,0,0,0
2020-06-01 23:45,17,4,13,0,0,0
2020-06-02 00:00,19,8,11,0,0,0
2020-06-02 00:15,11,6,5,0,0,0
2020-06-02 00:30,12,1,11,0,0,0
2020-06-02 00:45,3,1,2,0,0,0
2020-06-02 01:00,13,2,11,0,0,0
2020-06-02 01:15,12,1,11,0,0,0
2020-06-02 01:30,7,3,4,0,0,0
2020-06-02 01:45,4,3,1,0,0,0
2020-06-02 02:00,6,0,6,0,0,0
2020-06-02 02:15,10,1,9,0,0,0
2020-06-02 02:30,2,1,1,0,0,0
2020-06-02 02:45,2,2,0,0,0,0
2020-06-02 03:00,1,1,0,0,0,0
2020-06-02 03:15,2,0,2,0,0,0
2020-06-02 03:30,3,0,3,0,0,0
2020-06-02 03:45,0,0,0,0,0,0
2020-06-02 04:00,6,0,6,0,0,0
2020-06-02 04:15,0,0,0,0,0,0
2020-06-02 04:30,3,1,2,0,0,0
2020-06-02 04:45,4,1,3,0,0,0
2020-06-02 05:00,5,3,2,0,0,0
2020-06-02 05:15,20,6,14,0,0,0
2020-06-02 05:30,13,3,10,0,0,0
2020-06-02 05:45,22,8,14,0,0,0
2020-06-02 06:00,28,12,16,0,0,0
2020-06-02 06:15,26,11,15,0,0,0
2020-06-02 06:30,37,17,20,0,0,0
2020-06-02 06:45,54,29,25,0,0,0
2020-06-02 07:00,75,44,31,0,0,0
2020-06-02 07:15,92,46,46,0,0,0
2020-06-02 07:30,131,70,61,0,0,0
2020-06-02 07:45,133,77,56,0,0,0
2020-06-02 08:00,115,69,46,0,0,0
2020-06-02 08:15,105,50,55,0,0,0
2020-06-02 08:30,126,66,60,0,0,0
2020-06-02 08:45,111,46,65,0,0,0
2020-06-02 09:00,78,34,44,0,0,0
2020-06-02 09:15,102,45,57,0,0,0
2020-06-02 09:30,106,44,62,0,0,0
2020-06-02 09:45,150,44,106,0,0,0
2020-06-02 10:00,108,30,78,0,0,0
2020-06-02 10:15,119,54,65,0,0,0
2020-06-02 10:30,90,46,44,0,0,0
2020-06-02 10:45,122,54,68,0,0,0
2020-06-02 11:00,119,59,60,0,0,0
2020-06-02 11:15,133,58,75,0,0,0
2020-06-02 11:30,99,47,52,0,0,0
2020-06-02 11:45,115,49,66,0,0,0
2020-06-02 12:00,127,62,65,0,0,0
2020-06-02 12:15,121,59,62,0,0,0
2020-06-02 12:30,137,77,60,0,0,0
2020-06-02 12:45,127,73,54,0,0,0
2020-06-02 13:00,116,57,59,0,0,0
2020-06-02 13:15,100,56,44,0,0,0
2020-06-02 13:30,117,68,49,0,0,0
2020-06-02 13:45,140,68,72,0,0,0
2020-06-02 14:00,139,69,70,0,0,0
2020-06-02 14:15,132,61,71,0,0,0
2020-06-02 14:30,132,61,71,0,0,0
2020-06-02 14:45,161,79,82,0,0,0
2020-06-02 15:00,135,61,74,0,0,0
2020-06-02 15:15,125,78,47,0,0,0
2020-06-02 15:30,129,76,53,0,0,0
2020-06-02 15:45,163,94,69,0,0,0
2020-06-02 16:00,156,79,77,0,0,0
2020-06-02 16:15,159,88,71,0,0,0
2020-06-02 16:30,172,90,82,0,0,0
2020-06-02 16:45,190,88,102,0,0,0
2020-06-02 17:00,181,98,83,0,0,0
2020-06-02 17:15,213,117,96,0,0,0
2020-06-02 17:30,196,100,96,0,0,0
2020-06-02 17:45,207,106,101,0,0,0
2020-06-02 18:00,148,81,67,0,0,0
2020-06-02 18:15,154,74,80,0,0,0
2020-06-02 18:30,159,83,76,0,0,0
2020-06-02 18:45,144,82,62,0,0,0
2020-06-02 19:00,113,58,55,0,0,0
2020-06-02 19:15,142,69,73,0,0,0
2020-06-02 19:30,101,47,54,0,0,0
2020-06-02 19:45,118,59,59,0,0,0
2020-06-02 20:00,109,48,61,0,0,0
2020-06-02 20:15,90,39,51,0,0,0
2020-06-02 20:30,83,39,44,0,0,0
2020-06-02 20:45,62,33,29,0,0,0
2020-06-02 21:00,67,26,41,0,0,0
2020-06-02 21:15,82,35,47,0,0,0
2020-06-02 21:30,75,35,40,0,0,0
2020-06-02 21:45,72,28,44,0,0,0
2020-06-02 22:00,68,29,39,0,0,0
2020-06-02 22:15,49,15,34,0,0,0
2020-06-02 22:30,58,17,41,0,0,0
2020-06-02 22:45,48,18,30,0,0,0
2020-06-02 23:00,50,15,35,0,0,0
2020-06-02 23:15,11,2,9,0,0,0
2020-06-02 23:30,17,5,12,0,0,0
2020-06-02 23:45,22,6,16,0,0,0
2020-06-03 00:00,25,9,16,0,0,0
2020-06-03 00:15,14,4,10,0,0,0
2020-06-03 00:30,21,10,11,0,0,0
2020-06-03 00:45,12,4,8,0,0,0
2020-06-03 01:00,5,1,4,0,0,0
2020-06-03 01:15,2,2,0,0,0,0
2020-06-03 01:30,11,3,8,0,0,0
2020-06-03 01:45,12,4,8,0,0,0
2020-06-03 02:00,6,3,3,0,0,0
2020-06-03 02:15,5,1,4,0,0,0
2020-06-03 02:30,0,0,0,0,0,0
2020-06-03 02:45,5,1,4,0,0,0
2020-06-03 03:00,1,1,0,0,0,0
2020-06-03 03:15,2,1,1,0,0,0
2020-06-03 03:30,2,1,1,0,0,0
2020-06-03 03:45,3,1,2,0,0,0
2020-06-03 04:00,2,0,2,0,0,0
2020-06-03 04:15,4,1,3,0,0,0
2020-06-03 04:30,1,0,1,0,0,0
2020-06-03 04:45,15,5,10,0,0,0
2020-06-03 05:00,2,1,1,0,0,0
2020-06-03 05:15,16,5,11,0,0,0
2020-06-03 05:30,16,6,10,0,0,0
2020-06-03 05:45,12,4,8,0,0,0
2020-06-03 06:00,27,10,17,0,0,0
2020-06-03 06:15,44,20,24,0,0,0
2020-06-03 06:30,42,19,23,0,0,0
2020-06-03 06:45,60,38,22,0,0,0
2020-06-03 07:00,84,44,40,0,0,0
2020-06-03 07:15,81,41,40,0,0,0
2020-06-03 07:30,133,71,62,0,0,0
2020-06-03 07:45,153,84,69,0,0,0
2020-06-03 08:00,118,60,58,0,0,0
2020-06-03 08:15,120,61,59,0,0,0
2020-06-03 08:30,125,56,69,0,0,0
2020-06-03 08:45,128,66,62,0,0,0
2020-06-03 09:00,71,37,34,0,0,0
2020-06-03 09:15,90,44,46,0,0,0
2020-06-03 09:30,106,51,55,0,0,0
2020-06-03 09:45,114,48,66,0,0,0
2020-06-03 10:00,91,41,50,0,0,0
2020-06-03 10:15,84,43,41,0,0,0
2020-06-03 10:30,103,46,57,0,0,0
2020-06-03 10:45,117,58,59,0,0,0
2020-06-03 11:00,101,50,51,0,0,0
2020-06-03 11:15,118,58,60,0,0,0
2020-06-03 11:30,105,41,64,0,0,0
2020-06-03 11:45,117,58,59,0,0,0
2020-06-03 12:00,125,66,59,0,0,0
2020-06-03 12:15,131,53,78,0,0,0
2020-06-03 12:30,142,67,75,0,0,0
2020-06-03 12:45,135,78,57,0,0,0
2020-06-03 13:00,134,64,70,0,0,0
2020-06-03 13:15,143,70,73,0,0,0
2020-06-03 13:30,128,64,64,0,0,0
2020-06-03 13:45,130,74,56,0,0,0
2020-06-03 14:00,120,41,79,0,0,0
2020-06-03 14:15,114,62,52,0,0,0
2020-06-03 14:30,127,69,58,0,0,0
2020-06-03 14:45,148,82,66,0,0,0
2020-06-03 15:00,163,92,71,0,0,0
2020-06-03 15:15,140,69,71,0,0,0
2020-06-03 15:30,149,74,75,0,0,0
2020-06-03 15:45,136,77,59,0,0,0
2020-06-03 16:00,155,86,69,0,0,0
2020-06-03 16:15,129,68,61,0,0,0
2020-06-03 16:30,189,95,94,0,0,0
2020-06-03 16:45,156,72,84,0,0,0
2020-06-03 17:00,170,81,89,0,0,0
2020-06-03 17:15,169,83,86,0,0,0
2020-06-03 17:30,168,65,103,0,0,0
2020-06-03 17:45,197,96,101,0,0,0
2020-06-03 18:00,173,102,71,0,0,0
2020-06-03 18:15,181,86,95,0,0,0
2020-06-03 18:30,149,74,75,0,0,0
2020-06-03 18:45,158,85,73,0,0,0
2020-06-03 19:00,142,78,64,0,0,0
2020-06-03 19:15,119,63,56,0,0,0
2020-06-03 19:30,94,43,51,0,0,0
2020-06-03 19:45,100,44,56,0,0,0
2020-06-03 20:00,106,45,61,0,0,0
2020-06-03 20:15,90,44,46,0,0,0
2020-06-03 20:30,88,40,48,0,0,0
2020-06-03 20:45,62,23,39,0,0,0
2020-06-03 21:00,76,31,45,0,0,0
2020-06-03 21:15,64,19,45,0,0,0
2020-06-03 21:30,70,18,52,0,0,0
2020-06-03 21:45,61,31,30,0,0,0
2020-06-03 22:00,49,22,27,0,0,0
2020-06-03 22:15,50,16,34,0,0,0
2020-06-03 22:30,42,20,22,0,0,0
2020-06-03 22:45,52,24,28,0,0,0
2020-06-03 23:00,54,21,33,0,0,0
2020-06-03 23:15,33,17,16,0,0,0
2020-06-03 23:30,30,12,18,0,0,0
2020-06-03 23:45,31,16,15,0,0,0
2020-06-04 00:00,20,6,14,0,0,0
2020-06-04 00:15,21,8,13,0,0,0
2020-06-04 00:30,13,7,6,0,0,0
2020-06-04 00:45,14,3,11,0,0,0
2020-06-04 01:00,12,5,7,0,0,0
2020-06-04 01:15,13,3,10,0,0,0
2020-06-04 01:30,11,2,9,0,0,0
2020-06-04 01:45,2,1,1,0,0,0
2020-06-04 02:00,4,1,3,0,0,0
2020-06-04 02:15,1,1,0,0,0,0
2020-06-04 02:30,3,0,3,0,0,0
2020-06-04 02:45,3,2,1,0,0,0
2020-06-04 03:00,1,0,1,0,0,0
2020-06-04 03:15,8,3,5,0,0,0
2020-06-04 03:30,1,0,1,0,0,0
2020-06-04 03:45,1,0,1,0,0,0
2020-06-04 04:00,4,1,3,0,0,0
2020-06-04 04:15,1,0,1,0,0,0
2020-06-04 04:30,2,1,1,0,0,0
2020-06-04 04:45,9,1,8,0,0,0
2020-06-04 05:00,1,0,1,0,0,0
2020-06-04 05:15,12,6,6,0,0,0
2020-06-04 05:30,17,7,10,0,0,0
2020-06-04 05:45,9,6,3,0,0,0
2020-06-04 06:00,28,6,22,0,0,0
2020-06-04 06:15,35,11,24,0,0,0
2020-06-04 06:30,46,20,26,0,0,0
2020-06-04 06:45,52,30,22,0,0,0
2020-06-04 07:00,79,50,29,0,0,0
2020-06-04 07:15,98,50,48,0,0,0
2020-06-04 07:30,180,107,73,0,0,0
2020-06-04 07:45,143,87,56,0,0,0
2020-06-04 08:00,98,52,46,0,0,0
2020-06-04 08:15,103,55,48,0,0,0
2020-06-04 08:30,101,40,61,0,0,0
2020-06-04 08:45,106,44,62,0,0,0
2020-06-04 09:00,87,37,50,0,0,0
2020-06-04 09:15,61,25,36,0,0,0
2020-06-04 09:30,70,27,43,0,0,0
2020-06-04 09:45,179,50,129,0,0,0
2020-06-04 10:00,113,39,74,0,0,0
2020-06-04 10:15,132,50,82,0,0,0
2020-06-04 10:30,111,56,55,0,0,0
2020-06-04 10:45,138,60,78,0,0,0
2020-06-04 11:00,122,69,53,0,0,0
2020-06-04 11:15,99,45,54,0,0,0
2020-06-04 11:30,96,41,55,0,0,0
2020-06-04 11:45,80,34,46,0,0,0
2020-06-04 12:00,77,32,45,0,0,0
2020-06-04 12:15,118,53,65,0,0,0
2020-06-04 12:30,105,44,61,0,0,0
2020-06-04 12:45,120,56,64,0,0,0
2020-06-04 13:00,104,53,51,0,0,0
2020-06-04 13:15,101,42,59,0,0,0
2020-06-04 13:30,89,36,53,0,0,0
2020-06-04 13:45,96,48,48,0,0,0
2020-06-04 14:00,140,46,94,0,0,0
2020-06-04 14:15,124,50,74,0,0,0
2020-06-04 14:30,117,47,70,0,0,0
2020-06-04 14:45,116,71,45,0,0,0
2020-06-04 15:00,115,46,69,0,0,0
2020-06-04 15:15,129,64,65,0,0,0
2020-06-04 15:30,122,52,70,0,0,0
2020-06-04 15:45,117,60,57,0,0,0
2020-06-04 16:00,129,50,79,0,0,0
2020-06-04 16:15,124,57,67,0,0,0
2020-06-04 16:30,128,61,67,0,0,0
2020-06-04 16:45,137,61,76,0,0,0
2020-06-04 17:00,134,63,71,0,0,0
2020-06-04 17:15,134,57,77,0,0,0
2020-06-04 17:30,151,68,83,0,0,0
2020-06-04 17:45,156,69,87,0,0,0
2020-06-04 18:00,103,49,54,0,0,0
2020-06-04 18:15,106,46,60,0,0,0
2020-06-04 18:30,105,53,52,0,0,0
2020-06-04 18:45,126,66,60,0,0,0
2020-06-04 19:00,86,49,37,0,0,0
2020-06-04 19:15,90,46,44,0,0,0
2020-06-04 19:30,81,35,46,0,0,0
2020-06-04 19:45,74,34,40,0,0,0
2020-06-04 20:00,64,29,35,0,0,0
2020-06-04 20:15,60,24,36,0,0,0
2020-06-04 20:30,51,16,35,0,0,0
2020-06-04 20:45,57,19,38,0,0,0
2020-06-04 21:00,49,22,27,0,0,0
2020-06-04 21:15,39,14,25,0,0,0
2020-06-04 21:30,34,19,15,0,0,0
2020-06-04 21:45,32,15,17,0,0,0
2020-06-04 22:00,28,15,13,0,0,0
2020-06-04 22:15,57,18,39,0,0,0
2020-06-04 22:30,27,6,21,0,0,0
2020-06-04 22:45,14,5,9,0,0,0
2020-06-04 23:00,23,7,16,0,0,0
2020-06-04 23:15,26,5,21,0,0,0
2020-06-04 23:30,15,8,7,0,0,0
2020-06-04 23:45,12,4,8,0,0,0
2020-06-05 00:00,9,1,8,0,0,0
2020-06-05 00:15,11,8,3,0,0,0
2020-06-05 00:30,8,3,5,0,0,0
2020-06-05 00:45,15,3,12,0,0,0
2020-06-05 01:00,5,0,5,0,0,0
2020-06-05 01:15,10,4,6,0,0,0
2020-06-05 01:30,3,2,1,0,0,0
2020-06-05 01:45,2,1,1,0,0,0
2020-06-05 02:00,0,0,0,0,0,0
2020-06-05 02:15,5,3,2,0,0,0
2020-06-05 02:30,1,1,0,0,0,0
2020-06-05 02:45,2,2,0,0,0,0
2020-06-05 03:00,3,1,2,0,0,0
2020-06-05 03:15,1,1,0,0,0,0
2020-06-05 03:30,3,0,3,0,0,0
2020-06-05 03:45,2,1,1,0,0,0
2020-06-05 04:00,2,2,0,0,0,0
2020-06-05 04:15,1,0,1,0,0,0
2020-06-05 04:30,5,1,4,0,0,0
2020-06-05 04:45,5,3,2,0,0,0
2020-06-05 05:00,4,1,3,0,0,0
2020-06-05 05:15,12,9,3,0,0,0
2020-06-05 05:30,15,4,11,0,0,0
2020-06-05 05:45,13,8,5,0,0,0
2020-06-05 06:00,37,9,28,0,0,0
2020-06-05 06:15,33,10,23,0,0,0
2020-06-05 06:30,49,20,29,0,0,0
2020-06-05 06:45,50,23,27,0,0,0
2020-06-05 07:00,49,29,20,0,0,0
2020-06-05 07:15,101,47,54,0,0,0
2020-06-05 07:30,129,64,65,0,0,0
2020-06-05 07:45,127,76,51,0,0,0
2020-06-05 08:00,95,55,40,0,0,0
2020-06-05 08:15,96,50,46,0,0,0
2020-06-05 08:30,86,37,49,0,0,0
2020-06-05 08:45,99,47,52,0,0,0
2020-06-05 09:00,83,36,47,0,0,0
2020-06-05 09:15,60,22,38,0,0,0
2020-06-05 09:30,89,23,66,0,0,0
2020-06-05 09:45,156,50,106,0,0,0
2020-06-05 10:00,79,28,51,0,0,0
2020-06-05 10:15,82,40,42,0,0,0
2020-06-05 10:30,101,36,65,0,0,0
2020-06-05 10:45,133,88,45,0,0,0
2020-06-05 11:00,135,66,69,0,0,0
2020-06-05 11:15,102,58,44,0,0,0
2020-06-05 11:30,126,59,67,0,0,0
2020-06-05 11:45,112,49,63,0,0,0
2020-06-05 12:00,122,56,66,0,0,0
2020-06-05 12:15,124,65,59,0,0,0
2020-06-05 12:30,130,57,73,0,0,0
2020-06-05 12:45,113,52,61,0,0,0
2020-06-05 13:00,105,54,51,0,0,0
2020-06-05 13:15,122,57,65,0,0,0
2020-06-05 13:30,114,44,70,0,0,0
2020-06-05 13:45,136,53,83,0,0,0
2020-06-05 14:00,203,48,155,0,0,0
2020-06-05 14:15,98,30,68,0,0,0
2020-06-05 14:30,91,40,51,0,0,0
2020-06-05 14:45,105,48,57,0,0,0
2020-06-05 15:00,85,31,54,0,0,0
2020-06-05 15:15,96,44,52,0,0,0
2020-06-05 15:30,67,33,34,0,0,0
2020-06-05 15:45,70,25,45,0,0,0
2020-06-05 16:00,99,44,55,0,0,0
2020-06-05 16:15,72,29,43,0,0,0
2020-06-05 16:30,70,31,39,0,0,0
2020-06-05 16:45,92,37,55,0,0,0
2020-06-05 17:00,102,37,65,0,0,0
2020-06-05 17:15,94,37,57,0,0,0
2020-06-05 17:30,90,39,51,0,0,0
2020-06-05 17:45,64,32,32,0,0,0
2020-06-05 18:00,88,40,48,0,0,0
2020-06-05 18:15,62,27,35,0,0,0
2020-06-05 18:30,74,33,41,0,0,0
2020-06-05 18:45,95,57,38,0,0,0
2020-06-05 19:00,85,48,37,0,0,0
2020-06-05 19:15,71,32,39,0,0,0
2020-06-05 19:30,57,32,25,0,0,0
2020-06-05 19:45,73,29,44,0,0,0
2020-06-05 20:00,52,26,26,0,0,0
2020-06-05 20:15,53,26,27,0,0,0
2020-06-05 20:30,62,30,32,0,0,0
2020-06-05 20:45,41,17,24,0,0,0
2020-06-05 21:00,46,17,29,0,0,0
2020-06-05 21:15,51,18,33,0,0,0
2020-06-05 21:30,36,10,26,0,0,0
2020-06-05 21:45,32,9,23,0,0,0
2020-06-05 22:00,37,12,25,0,0,0
2020-06-05 22:15,41,20,21,0,0,0
2020-06-05 22:30,37,11,26,0,0,0
2020-06-05 22:45,31,10,21,0,0,0
2020-06-05 23:00,32,10,22,0,0,0
2020-06-05 23:15,31,16,15,0,0,0
2020-06-05 23:30,30,12,18,0,0,0
2020-06-05 23:45,26,17,9,0,0,0
2020-06-06 00:00,26,7,19,0,0,0
2020-06-06 00:15,20,7,13,0,0,0
2020-06-06 00:30,26,5,21,0,0,0
2020-06-06 00:45,12,3,9,0,0,0
2020-06-06 01:00,19,9,10,0,0,0
2020-06-06 01:15,19,11,8,0,0,0
2020-06-06 01:30,12,4,8,0,0,0
2020-06-06 01:45,13,0,13,0,0,0
2020-06-06 02:00,8,3,5,0,0,0
2020-06-06 02:15,8,3,5,0,0,0
2020-06-06 02:30,8,4,4,0,0,0
2020-06-06 02:45,8,2,6,0,0,0
2020-06-06 03:00,7,6,1,0,0,0
2020-06-06 03:15,6,3,3,0,0,0
2020-06-06 03:30,7,0,7,0,0,0
2020-06-06 03:45,2,1,1,0,0,0
2020-06-06 04:00,6,1,5,0,0,0
2020-06-06 04:15,3,2,1,0,0,0
2020-06-06 04:30,1,0,1,0,0,0
2020-06-06 04:45,5,4,1,0,0,0
2020-06-06 05:00,3,1,2,0,0,0
2020-06-06 05:15,13,4,9,0,0,0
2020-06-06 05:30,15,3,12,0,0,0
2020-06-06 05:45,7,2,5,0,0,0
2020-06-06 06:00,8,1,7,0,0,0
2020-06-06 06:15,14,3,11,0,0,0
2020-06-06 06:30,4,1,3,0,0,0
2020-06-06 06:45,14,3,11,0,0,0
2020-06-06 07:00,13,4,9,0,0,0
2020-06-06 07:15,18,8,10,0,0,0
2020-06-06 07:30,48,36,12,0,0,0
2020-06-06 07:45,68,54,14,0,0,0
2020-06-06 08:00,45,26,19,0,0,0
2020-06-06 08:15,28,13,15,0,0,0
2020-06-06 08:30,34,16,18,0,0,0
2020-06-06 08:45,33,17,16,0,0,0
2020-06-06 09:00,30,8,22,0,0,0
2020-06-06 09:15,39,21,18,0,0,0
2020-06-06 09:30,41,16,25,0,0,0
2020-06-06 09:45,109,23,86,0,0,0
2020-06-06 10:00,51,14,37,0,0,0
2020-06-06 10:15,37,5,32,0,0,0
2020-06-06 10:30,55,17,38,0,0,0
2020-06-06 10:45,64,25,39,0,0,0
2020-06-06 11:00,65,30,35,0,0,0
2020-06-06 11:15,52,28,24,0,0,0
2020-06-06 11:30,84,27,57,0,0,0
2020-06-06 11:45,82,30,52,0,0,0
2020-06-06 12:00,83,28,55,0,0,0
2020-06-06 12:15,66,21,45,0,0,0
2020-06-06 12:30,81,28,53,0,0,0
2020-06-06 12:45,94,36,58,0,0,0
2020-06-06 13:00,89,32,57,0,0,0
2020-06-06 13:15,115,46,69,0,0,0
2020-06-06 13:30,113,33,80,0,0,0
2020-06-06 13:45,170,49,121,0,0,0
2020-06-06 14:00,151,38,113,0,0,0
2020-06-06 14:15,87,39,48,0,0,0
2020-06-06 14:30,97,46,51,0,0,0
2020-06-06 14:45,91,40,51,0,0,0
2020-06-06 15:00,69,42,27,0,0,0
2020-06-06 15:15,107,43,64,0,0,0
2020-06-06 15:30,93,46,47,0,0,0
2020-06-06 15:45,100,65,35,0,0,0
2020-06-06 16:00,131,90,41,0,0,0
2020-06-06 16:15,93,59,34,0,0,0
2020-06-06 16:30,100,53,47,0,0,0
2020-06-06 16:45,85,50,35,0,0,0
2020-06-06 17:00,96,48,48,0,0,0
2020-06-06 17:15,93,42,51,0,0,0
2020-06-06 17:30,93,57,36,0,0,0
2020-06-06 17:45,97,52,45,0,0,0
2020-06-06 18:00,111,65,46,0,0,0
2020-06-06 18:15,108,51,57,0,0,0
2020-06-06 18:30,81,48,33,0,0,0
2020-06-06 18:45,83,42,41,0,0,0
2020-06-06 19:00,92,42,50,0,0,0
2020-06-06 19:15,79,39,40,0,0,0
2020-06-06 19:30,83,46,37,0,0,0
2020-06-06 19:45,82,44,38,0,0,0
2020-06-06 20:00,81,48,33,0,0,0
2020-06-06 20:15,60,39,21,0,0,0
2020-06-06 20:30,42,25,17,0,0,0
2020-06-06 20:45,60,21,39,0,0,0
2020-06-06 21:00,51,25,26,0,0,0
2020-06-06 21:15,50,23,27,0,0,0
2020-06-06 21:30,39,21,18,0,0,0
2020-06-06 21:45,40,12,28,0,0,0
2020-06-06 22:00,74,17,57,0,0,0
2020-06-06 22:15,50,17,33,0,0,0
2020-06-06 22:30,46,12,34,0,0,0
2020-06-06 22:45,35,15,20,0,0,0
2020-06-06 23:00,38,12,26,0,0,0
2020-06-06 23:15,43,10,33,0,0,0
2020-06-06 23:30,45,16,29,0,0,0
2020-06-06 23:45,43,7,36,0,0,0
2020-06-07 00:00,29,14,15,0,0,0
2020-06-07 00:15,44,10,34,0,0,0
2020-06-07 00:30,48,21,27,0,0,0
2020-06-07 00:45,40,10,30,0,0,0
2020-06-07 01:00,26,7,19,0,0,0
2020-06-07 01:15,30,8,22,0,0,0
2020-06-07 01:30,28,11,17,0,0,0
2020-06-07 01:45,17,5,12,0,0,0
2020-06-07 02:00,16,7,9,0,0,0
2020-06-07 02:15,14,5,9,0,0,0
2020-06-07 02:30,10,3,7,0,0,0
2020-06-07 02:45,11,0,11,0,0,0
2020-06-07 03:00,14,7,7,0,0,0
2020-06-07 03:15,7,5,2,0,0,0
2020-06-07 03:30,9,8,1,0,0,0
2020-06-07 03:45,7,2,5,0,0,0
2020-06-07 04:00,18,13,5,0,0,0
2020-06-07 04:15,7,1,6,0,0,0
2020-06-07 04:30,3,1,2,0,0,0
2020-06-07 04:45,4,3,1,0,0,0
2020-06-07 05:00,4,1,3,0,0,0
2020-06-07 05:15,1,1,0,0,0,0
2020-06-07 05:30,8,1,7,0,0,0
2020-06-07 05:45,1,1,0,0,0,0
2020-06-07 06:00,4,0,4,0,0,0
2020-06-07 06:15,6,2,4,0,0,0
2020-06-07 06:30,7,1,6,0,0,0
2020-06-07 06:45,5,4,1,0,0,0
2020-06-07 07:00,2,2,0,0,0,0
2020-06-07 07:15,4,1,3,0,0,0
2020-06-07 07:30,9,5,4,0,0,0
2020-06-07 07:45,4,1,3,0,0,0
2020-06-07 08:00,7,1,6,0,0,0
2020-06-07 08:15,12,9,3,0,0,0
2020-06-07 08:30,11,4,7,0,0,0
2020-06-07 08:45,12,6,6,0,0,0
2020-06-07 09:00,19,5,14,0,0,0
2020-06-07 09:15,19,10,9,0,0,0
2020-06-07 09:30,17,6,11,0,0,0
2020-06-07 09:45,27,12,15,0,0,0
2020-06-07 10:00,29,10,19,0,0,0
2020-06-07 10:15,18,5,13,0,0,0
2020-06-07 10:30,31,9,22,0,0,0
2020-06-07 10:45,36,17,19,0,0,0
2020-06-07 11:00,39,15,24,0,0,0
2020-06-07 11:15,39,14,25,0,0,0
2020-06-07 11:30,54,23,31,0,0,0
2020-06-07 11:45,42,18,24,0,0,0
2020-06-07 12:00,33,14,19,0,0,0
2020-06-07 12:15,44,13,31,0,0,0
2020-06-07 12:30,38,20,18,0,0,0
2020-06-07 12:45,54,22,32,0,0,0
2020-06-07 13:00,59,20,39,0,0,0
2020-06-07 13:15,53,26,27,0,0,0
2020-06-07 13:30,54,11,43,0,0,0
2020-06-07 13:45,57,26,31,0,0,0
2020-06-07 14:00,71,39,32,0,0,0
2020-06-07 14:15,69,30,39,0,0,0
2020-06-07 14:30,46,25,21,0,0,0
2020-06-07 14:45,69,30,39,0,0,0
2020-06-07 15:00,71,33,38,0,0,0
2020-06-07 15:15,74,27,47,0,0,0
2020-06-07 15:30,71,31,40,0,0,0
2020-06-07 15:45,81,30,51,0,0,0
2020-06-07 16:00,67,30,37,0,0,0
2020-06-07 16:15,71,40,31,0,0,0
2020-06-07 16:30,98,51,47,0,0,0
2020-06-07 16:45,79,29,50,0,0,0
2020-06-07 17:00,75,33,42,0,0,0
2020-06-07 17:15,86,28,58,0,0,0
2020-06-07 17:30,82,43,39,0,0,0
2020-06-07 17:45,83,37,46,0,0,0
2020-06-07 18:00,68,32,36,0,0,0
2020-06-07 18:15,87,36,51,0,0,0
2020-06-07 18:30,63,25,38,0,0,0
2020-06-07 18:45,65,31,34,0,0,0
2020-06-07 19:00,60,18,42,0,0,0
2020-06-07 19:15,52,27,25,0,0,0
2020-06-07 19:30,68,32,36,0,0,0
2020-06-07 19:45,45,19,26,0,0,0
2020-06-07 20:00,63,27,36,0,0,0
2020-06-07 20:15,56,25,31,0,0,0
2020-06-07 20:30,49,20,29,0,0,0
2020-06-07 20:45,36,12,24,0,0,0
2020-06-07 21:00,41,19,22,0,0,0
2020-06-07 21:15,36,15,21,0,0,0
2020-06-07 21:30,42,14,28,0,0,0
2020-06-07 21:45,37,14,23,0,0,0
2020-06-07 22:00,31,12,19,0,0,0
2020-06-07 22:15,28,8,20,0,0,0
2020-06-07 22:30,19,8,11,0,0,0
2020-06-07 22:45,16,2,14,0,0,0
2020-06-07 23:00,19,6,13,0,0,0
2020-06-07 23:15,14,5,9,0,0,0
2020-06-07 23:30,10,3,7,0,0,0
2020-06-07 23:45,11,4,7,0,0,0
2020-06-08 00:00,4,2,2,0,0,0
2020-06-08 00:15,14,8,6,0,0,0
2020-06-08 00:30,6,2,4,0,0,0
2020-06-08 00:45,4,2,2,0,0,0
2020-06-08 01:00,10,6,4,0,0,0
2020-06-08 01:15,5,1,4,0,0,0
2020-06-08 01:30,0,0,0,0,0,0
2020-06-08 01:45,4,3,1,0,0,0
2020-06-08 02:00,5,2,3,0,0,0
2020-06-08 02:15,6,4,2,0,0,0
2020-06-08 02:30,2,1,1,0,0,0
2020-06-08 02:45,1,0,1,0,0,0
2020-06-08 03:00,1,0,1,0,0,0
2020-06-08 03:15,1,1,0,0,0,0
2020-06-08 03:30,1,0,1,0,0,0
2020-06-08 03:45,0,0,0,0,0,0
2020-06-08 04:00,2,1,1,0,0,0
2020-06-08 04:15,0,0,0,0,0,0
2020-06-08 04:30,2,0,2,0,0,0
2020-06-08 04:45,9,2,7,0,0,0
2020-06-08 05:00,7,1,6,0,0,0
2020-06-08 05:15,9,4,5,0,0,0
2020-06-08 05:30,19,5,14,0,0,0
2020-06-08 05:45,22,11,11,0,0,0
2020-06-08 06:00,27,12,15,0,0,0
2020-06-08 06:15,35,15,20,0,0,0
2020-06-08 06:30,53,19,34,0,0,0
2020-06-08 06:45,61,27,34,0,0,0
2020-06-08 07:00,71,33,38,0,0,0
2020-06-08 07:15,77,33,44,0,0,0
2020-06-08 07:30,114,51,63,0,0,0
2020-06-08 07:45,124,58,66,0,0,0
2020-06-08 08:00,109,61,48,0,0,0
2020-06-08 08:15,105,51,54,0,0,0
2020-06-08 08:30,103,54,49,0,0,0
2020-06-08 08:45,122,55,67,0,0,0
2020-06-08 09:00,86,46,40,0,0,0
2020-06-08 09:15,92,33,59,0,0,0
2020-06-08 09:30,89,40,49,0,0,0
2020-06-08 09:45,98,35,63,0,0,0
2020-06-08 10:00,90,34,56,0,0,0
2020-06-08 10:15,97,44,53,0,0,0
2020-06-08 10:30,85,36,49,0,0,0
2020-06-08 10:45,88,40,48,0,0,0
2020-06-08 11:00,103,39,64,0,0,0
2020-06-08 11:15,100,42,58,0,0,0
2020-06-08 11:30,101,37,64,0,0,0
2020-06-08 11:45,93,42,51,0,0,0
2020-06-08 12:00,125,46,79,0,0,0
2020-06-08 12:15,97,33,64,0,0,0
2020-06-08 12:30,84,34,50,0,0,0
2020-06-08 12:45,118,52,66,0,0,0
2020-06-08 13:00,116,44,72,0,0,0
2020-06-08 13:15,121,51,70,0,0,0
2020-06-08 13:30,97,46,51,0,0,0
2020-06-08 13:45,115,55,60,0,0,0
2020-06-08 14:00,120,54,66,0,0,0
2020-06-08 14:15,118,58,60,0,0,0
2020-06-08 14:30,88,30,58,0,0,0
2020-06-08 14:45,100,46,54,0,0,0
2020-06-08 15:00,130,54,76,0,0,0
2020-06-08 15:15,115,57,58,0,0,0
2020-06-08 15:30,116,56,60,0,0,0
2020-06-08 15:45,146,70,76,0,0,0
2020-06-08 16:00,126,72,54,0,0,0
2020-06-08 16:15,131,59,72,0,0,0
2020-06-08 16:30,141,65,76,0,0,0
2020-06-08 16:45,159,76,83,0,0,0
2020-06-08 17:00,162,78,84,0,0,0
2020-06-08 17:15,177,90,87,0,0,0
2020-06-08 17:30,172,89,83,0,0,0
2020-06-08 17:45,141,80,61,0,0,0
2020-06-08 18:00,156,84,72,0,0,0
2020-06-08 18:15,129,69,60,0,0,0
2020-06-08 18:30,115,58,57,0,0,0
2020-06-08 18:45,121,72,49,0,0,0
2020-06-08 19:00,101,45,56,0,0,0
2020-06-08 19:15,98,63,35,0,0,0
2020-06-08 19:30,78,40,38,0,0,0
2020-06-08 19:45,78,31,47,0,0,0
2020-06-08 20:00,86,37,49,0,0,0
2020-06-08 20:15,49,23,26,0,0,0
2020-06-08 20:30,69,29,40,0,0,0
2020-06-08 20:45,69,38,31,0,0,0
2020-06-08 21:00,63,35,28,0,0,0
2020-06-08 21:15,57,28,29,0,0,0
2020-06-08 21:30,45,19,26,0,0,0
2020-06-08 21:45,51,20,31,0,0,0
2020-06-08 22:00,40,20,20,0,0,0
2020-06-08 22:15,45,17,28,0,0,0
2020-06-08 22:30,45,21,24,0,0,0
2020-06-08 22:45,35,12,23,0,0,0
2020-06-08 23:00,27,14,13,0,0,0
2020-06-08 23:15,28,12,16,0,0,0
2020-06-08 23:30,17,8,9,0,0,0
2020-06-08 23:45,19,6,13,0,0,0
2020-06-09 00:00,4,1,3,0,0,0
2020-06-09 00:15,7,3,4,0,0,0
2020-06-09 00:30,7,1,6,0,0,0
2020-06-09 00:45,10,8,2,0,0,0
2020-06-09 01:00,7,4,3,0,0,0
2020-06-09 01:15,2,1,1,0,0,0
2020-06-09 01:30,3,0,3,0,0,0
2020-06-09 01:45,3,1,2,0,0,0
2020-06-09 02:00,0,0,0,0,0,0
2020-06-09 02:15,4,0,4,0,0,0
2020-06-09 02:30,1,0,1,0,0,0
2020-06-09 02:45,1,1,0,0,0,0
2020-06-09 03:00,2,0,2,0,0,0
2020-06-09 03:15,0,0,0,0,0,0
2020-06-09 03:30,2,0,2,0,0,0
2020-06-09 03:45,2,0,2,0,0,0
2020-06-09 04:00,5,0,5,0,0,0
2020-06-09 04:15,0,0,0,0,0,0
2020-06-09 04:30,2,1,1,0,0,0
2020-06-09 04:45,8,1,7,0,0,0
2020-06-09 05:00,1,1,0,0,0,0
2020-06-09 05:15,8,2,6,0,0,0
2020-06-09 05:30,23,10,13,0,0,0
2020-06-09 05:45,21,10,11,0,0,0
2020-06-09 06:00,26,12,14,0,0,0
2020-06-09 06:15,23,10,13,0,0,0
2020-06-09 06:30,47,15,32,0,0,0
2020-06-09 06:45,44,25,19,0,0,0
2020-06-09 07:00,50,29,21,0,0,0
2020-06-09 07:15,69,29,40,0,0,0
2020-06-09 07:30,118,54,64,0,0,0
2020-06-09 07:45,129,59,70,0,0,0
2020-06-09 08:00,96,47,49,0,0,0
2020-06-09 08:15,122,58,64,0,0,0
2020-06-09 08:30,102,49,53,0,0,0
2020-06-09 08:45,114,47,67,0,0,0
2020-06-09 09:00,80,36,44,0,0,0
2020-06-09 09:15,78,30,48,0,0,0
2020-06-09 09:30,85,28,57,0,0,0
2020-06-09 09:45,96,29,67,0,0,0
2020-06-09 10:00,98,34,64,0,0,0
2020-06-09 10:15,84,44,40,0,0,0
2020-06-09 10:30,82,44,38,0,0,0
2020-06-09 10:45,86,35,51,0,0,0
2020-06-09 11:00,86,43,43,0,0,0
2020-06-09 11:15,93,40,53,0,0,0
2020-06-09 11:30,86,39,47,0,0,0
2020-06-09 11:45,113,49,64,0,0,0
2020-06-09 12:00,127,49,78,0,0,0
2020-06-09 12:15,111,44,67,0,0,0
2020-06-09 12:30,117,56,61,0,0,0
2020-06-09 12:45,136,59,77,0,0,0
2020-06-09 13:00,111,53,58,0,0,0
2020-06-09 13:15,118,52,66,0,0,0
2020-06-09 13:30,121,55,66,0,0,0
2020-06-09 13:45,135,57,78,0,0,0
2020-06-09 14:00,116,58,58,0,0,0
2020-06-09 14:15,147,63,84,0,0,0
2020-06-09 14:30,123,65,58,0,0,0
2020-06-09 14:45,140,71,69,0,0,0
2020-06-09 15:00,119,55,64,0,0,0
2020-06-09 15:15,118,52,66,0,0,0
2020-06-09 15:30,112,65,47,0,0,0
2020-06-09 15:45,138,65,73,0,0,0
2020-06-09 16:00,150,70,80,0,0,0
2020-06-09 16:15,155,72,83,0,0,0
2020-06-09 16:30,144,84,60,0,0,0
2020-06-09 16:45,170,74,96,0,0,0
2020-06-09 17:00,197,98,99,0,0,0
2020-06-09 17:15,185,80,105,0,0,0
2020-06-09 17:30,150,72,78,0,0,0
2020-06-09 17:45,181,74,107,0,0,0
2020-06-09 18:00,132,70,62,0,0,0
2020-06-09 18:15,165,85,80,0,0,0
2020-06-09 18:30,153,88,65,0,0,0
2020-06-09 18:45,165,82,83,0,0,0
2020-06-09 19:00,109,59,50,0,0,0
2020-06-09 19:15,134,81,53,0,0,0
2020-06-09 19:30,94,47,47,0,0,0
2020-06-09 19:45,98,46,52,0,0,0
2020-06-09 20:00,108,48,60,0,0,0
2020-06-09 20:15,75,31,44,0,0,0
2020-06-09 20:30,54,27,27,0,0,0
2020-06-09 20:45,56,26,30,0,0,0
2020-06-09 21:00,55,23,32,0,0,0
2020-06-09 21:15,58,32,26,0,0,0
2020-06-09 21:30,43,14,29,0,0,0
2020-06-09 21:45,61,27,34,0,0,0
2020-06-09 22:00,44,18,26,0,0,0
2020-06-09 22:15,46,18,28,0,0,0
2020-06-09 22:30,37,19,18,0,0,0
2020-06-09 22:45,25,6,19,0,0,0
2020-06-09 23:00,26,9,17,0,0,0
2020-06-09 23:15,26,9,17,0,0,0
2020-06-09 23:30,18,2,16,0,0,0
2020-06-09 23:45,18,9,9,0,0,0
2020-06-10 00:00,21,2,19,0,0,0
2020-06-10 00:15,10,4,6,0,0,0
2020-06-10 00:30,10,8,2,0,0,0
2020-06-10 00:45,13,4,9,0,0,0
2020-06-10 01:00,9,3,6,0,0,0
2020-06-10 01:15,8,3,5,0,0,0
2020-06-10 01:30,14,4,10,0,0,0
2020-06-10 01:45,1,0,1,0,0,0
2020-06-10 02:00,2,1,1,0,0,0
2020-06-10 02:15,1,1,0,0,0,0
2020-06-10 02:30,2,0,2,0,0,0
2020-06-10 02:45,0,0,0,0,0,0
2020-06-10 03:00,1,0,1,0,0,0
2020-06-10 03:15,8,2,6,0,0,0
2020-06-10 03:30,3,0,3,0,0,0
2020-06-10 03:45,5,0,5,0,0,0
2020-06-10 04:00,1,0,1,0,0,0
2020-06-10 04:15,1,1,0,0,0,0
2020-06-10 04:30,8,6,2,0,0,0
2020-06-10 04:45,8,1,7,0,0,0
2020-06-10 05:00,3,1,2,0,0,0
2020-06-10 05:15,8,3,5,0,0,0
2020-06-10 05:30,22,5,17,0,0,0
2020-06-10 05:45,23,11,12,0,0,0
2020-06-10 06:00,34,13,21,0,0,0
2020-06-10 06:15,24,11,13,0,0,0
2020-06-10 06:30,37,13,24,0,0,0
2020-06-10 06:45,72,31,41,0,0,0
2020-06-10 07:00,69,32,37,0,0,0
2020-06-10 07:15,83,44,39,0,0,0
2020-06-10 07:30,109,45,64,0,0,0
2020-06-10 07:45,129,58,71,0,0,0
2020-06-10 08:00,131,69,62,0,0,0
2020-06-10 08:15,97,39,58,0,0,0
2020-06-10 08:30,115,55,60,0,0,0
2020-06-10 08:45,122,53,69,0,0,0
2020-06-10 09:00,67,22,45,0,0,0
2020-06-10 09:15,86,34,52,0,0,0
2020-06-10 09:30,80,34,46,0,0,0
2020-06-10 09:45,99,42,57,0,0,0
2020-06-10 10:00,81,32,49,0,0,0
2020-06-10 10:15,94,39,55,0,0,0
2020-06-10 10:30,86,47,39,0,0,0
2020-06-10 10:45,114,49,65,0,0,0
2020-06-10 11:00,75,32,43,0,0,0
2020-06-10 11:15,116,49,67,0,0,0
2020-06-10 11:30,121,45,76,0,0,0
2020-06-10 11:45,128,59,69,0,0,0
2020-06-10 12:00,101,39,62,0,0,0
2020-06-10 12:15,150,63,87,0,0,0
2020-06-10 12:30,128,54,74,0,0,0
2020-06-10 12:45,132,73,59,0,0,0
2020-06-10 13:00,139,65,74,0,0,0
2020-06-10 13:15,123,64,59,0,0,0
2020-06-10 13:30,132,73,59,0,0,0
2020-06-10 13:45,115,61,54,0,0,0
2020-06-10 14:00,132,59,73,0,0,0
2020-06-10 14:15,115,59,56,0,0,0
2020-06-10 14:30,123,63,60,0,0,0
2020-06-10 14:45,117,61,56,0,0,0
2020-06-10 15:00,147,61,86,0,0,0
2020-06-10 15:15,140,57,83,0,0,0
2020-06-10 15:30,164,89,75,0,0,0
2020-06-10 15:45,119,49,70,0,0,0
2020-06-10 16:00,139,69,70,0,0,0
2020-06-10 16:15,133,64,69,0,0,0
2020-06-10 16:30,142,67,75,0,0,0
2020-06-10 16:45,140,70,70,0,0,0
2020-06-10 17:00,167,70,97,0,0,0
2020-06-10 17:15,145,70,75,0,0,0
2020-06-10 17:30,159,86,73,0,0,0
2020-06-10 17:45,169,95,74,0,0,0
2020-06-10 18:00,168,86,82,0,0,0
2020-06-10 18:15,150,89,61,0,0,0
2020-06-10 18:30,123,69,54,0,0,0
2020-06-10 18:45,156,87,69,0,0,0
2020-06-10 19:00,140,77,63,0,0,0
2020-06-10 19:15,157,77,80,0,0,0
2020-06-10 19:30,115,55,60,0,0,0
2020-06-10 19:45,101,54,47,0,0,0
2020-06-10 20:00,110,76,34,0,0,0
2020-06-10 20:15,89,59,30,0,0,0
2020-06-10 20:30,63,22,41,0,0,0
2020-06-10 20:45,86,28,58,0,0,0
2020-06-10 21:00,76,35,41,0,0,0
2020-06-10 21:15,75,28,47,0,0,0
2020-06-10 21:30,55,19,36,0,0,0
2020-06-10 21:45,37,13,24,0,0,0
2020-06-10 22:00,58,24,34,0,0,0
2020-06-10 22:15,38,11,27,0,0,0
2020-06-10 22:30,66,22,44,0,0,0
2020-06-10 22:45,52,22,30,0,0,0
2020-06-10 23:00,73,42,31,0,0,0
2020-06-10 23:15,41,18,23,0,0,0
2020-06-10 23:30,36,10,26,0,0,0
2020-06-10 23:45,47,16,31,0,0,0
2020-06-11 00:00,39,9,30,0,0,0
2020-06-11 00:15,36,17,19,0,0,0
2020-06-11 00:30,40,7,33,0,0,0
2020-06-11 00:45,22,2,20,0,0,0
2020-06-11 01:00,26,10,16,0,0,0
2020-06-11 01:15,12,7,5,0,0,0
2020-06-11 01:30,22,8,14,0,0,0
2020-06-11 01:45,22,8,14,0,0,0
2020-06-11 02:00,14,8,6,0,0,0
2020-06-11 02:15,22,10,12,0,0,0
2020-06-11 02:30,12,5,7,0,0,0
2020-06-11 02:45,14,7,7,0,0,0
2020-06-11 03:00,12,2,10,0,0,0
2020-06-11 03:15,12,3,9,0,0,0
2020-06-11 03:30,7,2,5,0,0,0
2020-06-11 03:45,4,2,2,0,0,0
2020-06-11 04:00,10,3,7,0,0,0
2020-06-11 04:15,3,2,1,0,0,0
2020-06-11 04:30,8,0,8,0,0,0
2020-06-11 04:45,2,2,0,0,0,0
2020-06-11 05:00,4,1,3,0,0,0
2020-06-11 05:15,4,1,3,0,0,0
2020-06-11 05:30,9,1,8,0,0,0
2020-06-11 05:45,7,1,6,0,0,0
2020-06-11 06:00,6,1,5,0,0,0
2020-06-11 06:15,4,0,4,0,0,0
2020-06-11 06:30,9,3,6,0,0,0
2020-06-11 06:45,2,1,1,0,0,0
2020-06-11 07:00,2,1,1,0,0,0
2020-06-11 07:15,8,2,6,0,0,0
2020-06-11 07:30,10,6,4,0,0,0
2020-06-11 07:45,12,5,7,0,0,0
2020-06-11 08:00,11,4,7,0,0,0
2020-06-11 08:15,8,3,5,0,0,0
2020-06-11 08:30,9,2,7,0,0,0
2020-06-11 08:45,14,4,10,0,0,0
2020-06-11 09:00,11,4,7,0,0,0
2020-06-11 09:15,16,5,11,0,0,0
2020-06-11 09:30,22,6,16,0,0,0
2020-06-11 09:45,35,10,25,0,0,0
2020-06-11 10:00,17,9,8,0,0,0
2020-06-11 10:15,23,5,18,0,0,0
2020-06-11 10:30,27,6,21,0,0,0
2020-06-11 10:45,30,14,16,0,0,0
2020-06-11 11:00,35,14,21,0,0,0
2020-06-11 11:15,27,11,16,0,0,0
2020-06-11 11:30,47,23,24,0,0,0
2020-06-11 11:45,47,14,33,0,0,0
2020-06-11 12:00,56,26,30,0,0,0
2020-06-11 12:15,56,23,33,0,0,0
2020-06-11 12:30,55,16,39,0,0,0
2020-06-11 12:45,81,48,33,0,0,0
2020-06-11 13:00,54,24,30,0,0,0
2020-06-11 13:15,75,30,45,0,0,0
2020-06-11 13:30,49,26,23,0,0,0
2020-06-11 13:45,79,30,49,0,0,0
2020-06-11 14:00,63,28,35,0,0,0
2020-06-11 14:15,75,34,41,0,0,0
2020-06-11 14:30,65,29,36,0,0,0
2020-06-11 14:45,76,35,41,0,0,0
2020-06-11 15:00,52,28,24,0,0,0
2020-06-11 15:15,71,26,45,0,0,0
2020-06-11 15:30,70,30,40,0,0,0
2020-06-11 15:45,76,40,36,0,0,0
2020-06-11 16:00,90,43,47,0,0,0
2020-06-11 16:15,99,43,56,0,0,0
2020-06-11 16:30,98,44,54,0,0,0
2020-06-11 16:45,97,52,45,0,0,0
2020-06-11 17:00,101,43,58,0,0,0
2020-06-11 17:15,78,40,38,0,0,0
2020-06-11 17:30,102,55,47,0,0,0
2020-06-11 17:45,115,63,52,0,0,0
2020-06-11 18:00,117,56,61,0,0,0
2020-06-11 18:15,93,55,38,0,0,0
2020-06-11 18:30,84,43,41,0,0,0
2020-06-11 18:45,111,58,53,0,0,0
2020-06-11 19:00,104,56,48,0,0,0
2020-06-11 19:15,85,43,42,0,0,0
2020-06-11 19:30,79,32,47,0,0,0
2020-06-11 19:45,97,37,60,0,0,0
2020-06-11 20:00,80,29,51,0,0,0
2020-06-11 20:15,71,39,32,0,0,0
2020-06-11 20:30,70,20,50,0,0,0
2020-06-11 20:45,51,13,38,0,0,0
2020-06-11 21:00,74,36,38,0,0,0
2020-06-11 21:15,63,30,33,0,0,0
2020-06-11 21:30,53,20,33,0,0,0
2020-06-11 21:45,41,14,27,0,0,0
2020-06-11 22:00,47,18,29,0,0,0
2020-06-11 22:15,51,26,25,0,0,0
2020-06-11 22:30,61,16,45,0,0,0
2020-06-11 22:45,45,20,25,0,0,0
2020-06-11 23:00,41,11,30,0,0,0
2020-06-11 23:15,49,14,35,0,0,0
2020-06-11 23:30,30,8,22,0,0,0
2020-06-11 23:45,18,6,12,0,0,0
2020-06-12 00:00,28,8,20,0,0,0
2020-06-12 00:15,26,11,15,0,0,0
2020-06-12 00:30,22,6,16,0,0,0
2020-06-12 00:45,14,2,12,0,0,0
2020-06-12 01:00,6,3,3,0,0,0
2020-06-12 01:15,9,5,4,0,0,0
2020-06-12 01:30,5,2,3,0,0,0
2020-06-12 01:45,7,4,3,0,0,0
2020-06-12 02:00,7,4,3,0,0,0
2020-06-12 02:15,6,1,5,0,0,0
2020-06-12 02:30,6,2,4,0,0,0
2020-06-12 02:45,10,8,2,0,0,0
2020-06-12 03:00,3,1,2,0,0,0
2020-06-12 03:15,3,1,2,0,0,0
2020-06-12 03:30,3,1,2,0,0,0
2020-06-12 03:45,5,0,5,0,0,0
2020-06-12 04:00,0,0,0,0,0,0
2020-06-12 04:15,0,0,0,0,0,0
2020-06-12 04:30,1,1,0,0,0,0
2020-06-12 04:45,9,1,8,0,0,0
2020-06-12 05:00,3,0,3,0,0,0
2020-06-12 05:15,13,6,7,0,0,0
2020-06-12 05:30,18,9,9,0,0,0
2020-06-12 05:45,14,6,8,0,0,0
2020-06-12 06:00,16,3,13,0,0,0
2020-06-12 06:15,33,12,21,0,0,0
2020-06-12 06:30,30,14,16,0,0,0
2020-06-12 06:45,34,15,19,0,0,0
2020-06-12 07:00,45,23,22,0,0,0
2020-06-12 07:15,68,31,37,0,0,0
2020-06-12 07:30,72,36,36,0,0,0
2020-06-12 07:45,92,50,42,0,0,0
2020-06-12 08:00,66,32,34,0,0,0
2020-06-12 08:15,69,36,33,0,0,0
2020-06-12 08:30,89,44,45,0,0,0
2020-06-12 08:45,87,39,48,0,0,0
2020-06-12 09:00,82,31,51,0,0,0
2020-06-12 09:15,89,43,46,0,0,0
2020-06-12 09:30,88,34,54,0,0,0
2020-06-12 09:45,104,42,62,0,0,0
2020-06-12 10:00,88,38,50,0,0,0
2020-06-12 10:15,77,39,38,0,0,0
2020-06-12 10:30,105,50,55,0,0,0
2020-06-12 10:45,121,57,64,0,0,0
2020-06-12 11:00,111,51,60,0,0,0
2020-06-12 11:15,105,51,54,0,0,0
2020-06-12 11:30,118,55,63,0,0,0
2020-06-12 11:45,130,68,62,0,0,0
2020-06-12 12:00,89,49,40,0,0,0
2020-06-12 12:15,145,65,80,0,0,0
2020-06-12 12:30,137,67,70,0,0,0
2020-06-12 12:45,135,59,76,0,0,0
2020-06-12 13:00,172,92,80,0,0,0
2020-06-12 13:15,124,61,63,0,0,0
2020-06-12 13:30,124,57,67,0,0,0
2020-06-12 13:45,135,75,60,0,0,0
2020-06-12 14:00,137,61,76,0,0,0
2020-06-12 14:15,129,63,66,0,0,0
2020-06-12 14:30,133,67,66,0,0,0
2020-06-12 14:45,126,72,54,0,0,0
2020-06-12 15:00,147,73,74,0,0,0
2020-06-12 15:15,157,79,78,0,0,0
2020-06-12 15:30,123,70,53,0,0,0
2020-06-12 15:45,142,75,67,0,0,0
2020-06-12 16:00,139,82,57,0,0,0
2020-06-12 16:15,124,75,49,0,0,0
2020-06-12 16:30,135,72,63,0,0,0
2020-06-12 16:45,164,84,80,0,0,0
2020-06-12 17:00,152,90,62,0,0,0
2020-06-12 17:15,154,99,55,0,0,0
2020-06-12 17:30,156,90,66,0,0,0
2020-06-12 17:45,179,91,88,0,0,0
2020-06-12 18:00,140,65,75,0,0,0
2020-06-12 18:15,159,96,63,0,0,0
2020-06-12 18:30,125,67,58,0,0,0
2020-06-12 18:45,167,102,65,0,0,0
2020-06-12 19:00,130,69,61,0,0,0
2020-06-12 19:15,142,73,69,0,0,0
2020-06-12 19:30,134,61,73,0,0,0
2020-06-12 19:45,128,70,58,0,0,0
2020-06-12 20:00,145,71,74,0,0,0
2020-06-12 20:15,116,58,58,0,0,0
2020-06-12 20:30,106,42,64,0,0,0
2020-06-12 20:45,105,35,70,0,0,0
2020-06-12 21:00,97,46,51,0,0,0
2020-06-12 21:15,94,33,61,0,0,0
2020-06-12 21:30,79,33,46,0,0,0
2020-06-12 21:45,68,29,39,0,0,0
2020-06-12 22:00,94,26,68,0,0,0
2020-06-12 22:15,86,36,50,0,0,0
2020-06-12 22:30,79,29,50,0,0,0
2020-06-12 22:45,62,26,36,0,0,0
2020-06-12 23:00,82,29,53,0,0,0
2020-06-12 23:15,81,22,59,0,0,0
2020-06-12 23:30,49,17,32,0,0,0
2020-06-12 23:45,69,32,37,0,0,0
2020-06-13 00:00,52,20,32,0,0,0
2020-06-13 00:15,60,24,36,0,0,0
2020-06-13 00:30,52,25,27,0,0,0
2020-06-13 00:45,43,13,30,0,0,0
2020-06-13 01:00,51,15,36,0,0,0
2020-06-13 01:15,41,17,24,0,0,0
2020-06-13 01:30,24,4,20,0,0,0
2020-06-13 01:45,28,6,22,0,0,0
2020-06-13 02:00,31,7,24,0,0,0
2020-06-13 02:15,23,10,13,0,0,0
2020-06-13 02:30,20,5,15,0,0,0
2020-06-13 02:45,12,8,4,0,0,0
2020-06-13 03:00,11,3,8,0,0,0
2020-06-13 03:15,6,2,4,0,0,0
2020-06-13 03:30,12,0,12,0,0,0
2020-06-13 03:45,17,1,16,0,0,0
2020-06-13 04:00,13,3,10,0,0,0
2020-06-13 04:15,16,6,10,0,0,0
2020-06-13 04:30,12,3,9,0,0,0
2020-06-13 04:45,10,0,10,0,0,0
2020-06-13 05:00,6,4,2,0,0,0
2020-06-13 05:15,8,3,5,0,0,0
2020-06-13 05:30,12,4,8,0,0,0
2020-06-13 05:45,9,2,7,0,0,0
2020-06-13 06:00,6,5,1,0,0,0
2020-06-13 06:15,5,1,4,0,0,0
2020-06-13 06:30,9,1,8,0,0,0
2020-06-13 06:45,16,5,11,0,0,0
2020-06-13 07:00,21,9,12,0,0,0
2020-06-13 07:15,9,1,8,0,0,0
2020-06-13 07:30,20,12,8,0,0,0
2020-06-13 07:45,19,8,11,0,0,0
2020-06-13 08:00,26,10,16,0,0,0
2020-06-13 08:15,23,12,11,0,0,0
2020-06-13 08:30,34,14,20,0,0,0
2020-06-13 08:45,60,22,38,0,0,0
2020-06-13 09:00,32,8,24,0,0,0
2020-06-13 09:15,45,15,30,0,0,0
2020-06-13 09:30,56,22,34,0,0,0
2020-06-13 09:45,80,31,49,0,0,0
2020-06-13 10:00,57,25,32,0,0,0
2020-06-13 10:15,80,41,39,0,0,0
2020-06-13 10:30,90,37,53,0,0,0
2020-06-13 10:45,81,37,44,0,0,0
2020-06-13 11:00,99,44,55,0,0,0
2020-06-13 11:15,90,52,38,0,0,0
2020-06-13 11:30,108,51,57,0,0,0
2020-06-13 11:45,87,53,34,0,0,0
2020-06-13 12:00,80,48,32,0,0,0
2020-06-13 12:15,96,38,58,0,0,0
2020-06-13 12:30,64,30,34,0,0,0
2020-06-13 12:45,94,48,46,0,0,0
2020-06-13 13:00,107,52,55,0,0,0
2020-06-13 13:15,104,63,41,0,0,0
2020-06-13 13:30,101,50,51,0,0,0
2020-06-13 13:45,112,59,53,0,0,0
2020-06-13 14:00,100,47,53,0,0,0
2020-06-13 14:15,89,53,36,0,0,0
2020-06-13 14:30,86,49,37,0,0,0
2020-06-13 14:45,104,52,52,0,0,0
2020-06-13 15:00,107,60,47,0,0,0
2020-06-13 15:15,132,67,65,0,0,0
2020-06-13 15:30,83,41,42,0,0,0
2020-06-13 15:45,98,54,44,0,0,0
2020-06-13 16:00,105,53,52,0,0,0
2020-06-13 16:15,99,57,42,0,0,0
2020-06-13 16:30,130,80,50,0,0,0
2020-06-13 16:45,107,68,39,0,0,0
2020-06-13 17:00,74,39,35,0,0,0
2020-06-13 17:15,121,62,59,0,0,0
2020-06-13 17:30,107,61,46,0,0,0
2020-06-13 17:45,108,46,62,0,0,0
2020-06-13 18:00,106,58,48,0,0,0
2020-06-13 18:15,126,68,58,0,0,0
2020-06-13 18:30,101,39,62,0,0,0
2020-06-13 18:45,114,61,53,0,0,0
2020-06-13 19:00,88,39,49,0,0,0
2020-06-13 19:15,83,41,42,0,0,0
2020-06-13 19:30,92,51,41,0,0,0
2020-06-13 19:45,80,37,43,0,0,0
2020-06-13 20:00,79,49,30,0,0,0
2020-06-13 20:15,77,33,44,0,0,0
2020-06-13 20:30,67,30,37,0,0,0
2020-06-13 20:45,84,35,49,0,0,0
2020-06-13 21:00,56,27,29,0,0,0
2020-06-13 21:15,81,19,62,0,0,0
2020-06-13 21:30,67,26,41,0,0,0
2020-06-13 21:45,64,28,36,0,0,0
2020-06-13 22:00,56,21,35,0,0,0
2020-06-13 22:15,63,30,33,0,0,0
2020-06-13 22:30,42,14,28,0,0,0
2020-06-13 22:45,45,8,37,0,0,0
2020-06-13 23:00,66,35,31,0,0,0
2020-06-13 23:15,40,9,31,0,0,0
2020-06-13 23:30,40,18,22,0,0,0
2020-06-13 23:45,58,15,43,0,0,0
2020-06-14 00:00,45,22,23,0,0,0
2020-06-14 00:15,30,13,17,0,0,0
2020-06-14 00:30,36,7,29,0,0,0
2020-06-14 00:45,44,22,22,0,0,0
2020-06-14 01:00,40,14,26,0,0,0
2020-06-14 01:15,42,12,30,0,0,0
2020-06-14 01:30,36,13,23,0,0,0
2020-06-14 01:45,22,7,15,0,0,0
2020-06-14 02:00,23,10,13,0,0,0
2020-06-14 02:15,17,6,11,0,0,0
2020-06-14 02:30,14,6,8,0,0,0
2020-06-14 02:45,12,4,8,0,0,0
2020-06-14 03:00,12,3,9,0,0,0
2020-06-14 03:15,10,3,7,0,0,0
2020-06-14 03:30,14,6,8,0,0,0
2020-06-14 03:45,10,3,7,0,0,0
2020-06-14 04:00,2,0,2,0,0,0
2020-06-14 04:15,5,3,2,0,0,0
2020-06-14 04:30,4,1,3,0,0,0
2020-06-14 04:45,7,2,5,0,0,0
2020-06-14 05:00,2,2,0,0,0,0
2020-06-14 05:15,11,2,9,0,0,0
2020-06-14 05:30,4,0,4,0,0,0
2020-06-14 05:45,6,3,3,0,0,0
2020-06-14 06:00,1,0,1,0,0,0
2020-06-14 06:15,2,2,0,0,0,0
2020-06-14 06:30,7,0,7,0,0,0
2020-06-14 06:45,7,1,6,0,0,0
2020-06-14 07:00,3,0,3,0,0,0
2020-06-14 07:15,3,2,1,0,0,0
2020-06-14 07:30,16,5,11,0,0,0
2020-06-14 07:45,8,3,5,0,0,0
2020-06-14 08:00,8,3,5,0,0,0
2020-06-14 08:15,17,8,9,0,0,0
2020-06-14 08:30,9,2,7,0,0,0
2020-06-14 08:45,16,3,13,0,0,0
2020-06-14 09:00,10,5,5,0,0,0
2020-06-14 09:15,24,14,10,0,0,0
2020-06-14 09:30,16,6,10,0,0,0
2020-06-14 09:45,30,21,9,0,0,0
2020-06-14 10:00,35,16,19,0,0,0
2020-06-14 10:15,29,17,12,0,0,0
2020-06-14 10:30,35,14,21,0,0,0
2020-06-14 10:45,36,7,29,0,0,0
2020-06-14 11:00,24,12,12,0,0,0
2020-06-14 11:15,43,18,25,0,0,0
2020-06-14 11:30,48,19,29,0,0,0
2020-06-14 11:45,64,27,37,0,0,0
2020-06-14 12:00,44,25,19,0,0,0
2020-06-14 12:15,60,25,35,0,0,0
2020-06-14 12:30,61,30,31,0,0,0
2020-06-14 12:45,74,30,44,0,0,0
2020-06-14 13:00,56,22,34,0,0,0
2020-06-14 13:15,67,35,32,0,0,0
2020-06-14 13:30,65,34,31,0,0,0
2020-06-14 13:45,88,45,43,0,0,0
2020-06-14 14:00,68,17,51,0,0,0
2020-06-14 14:15,70,34,36,0,0,0
2020-06-14 14:30,56,36,20,0,0,0
2020-06-14 14:45,85,27,58,0,0,0
2020-06-14 15:00,61,25,36,0,0,0
2020-06-14 15:15,71,39,32,0,0,0
2020-06-14 15:30,54,19,35,0,0,0
2020-06-14 15:45,67,34,33,0,0,0
2020-06-14 16:00,78,41,37,0,0,0
2020-06-14 16:15,100,38,62,0,0,0
2020-06-14 16:30,61,25,36,0,0,0
2020-06-14 16:45,85,36,49,0,0,0
2020-06-14 17:00,69,30,39,0,0,0
2020-06-14 17:15,55,24,31,0,0,0
2020-06-14 17:30,67,27,40,0,0,0
2020-06-14 17:45,64,40,24,0,0,0
2020-06-14 18:00,52,17,35,0,0,0
2020-06-14 18:15,42,27,15,0,0,0
2020-06-14 18:30,57,23,34,0,0,0
2020-06-14 18:45,32,8,24,0,0,0
2020-06-14 19:00,57,22,35,0,0,0
2020-06-14 19:15,32,14,18,0,0,0
2020-06-14 19:30,35,15,20,0,0,0
2020-06-14 19:45,27,9,18,0,0,0
2020-06-14 20:00,29,8,21,0,0,0
2020-06-14 20:15,23,11,12,0,0,0
2020-06-14 20:30,40,15,25,0,0,0
2020-06-14 20:45,24,13,11,0,0,0
2020-06-14 21:00,28,14,14,0,0,0
2020-06-14 21:15,22,8,14,0,0,0
2020-06-14 21:30,19,6,13,0,0,0
2020-06-14 21:45,35,21,14,0,0,0
2020-06-14 22:00,19,8,11,0,0,0
2020-06-14 22:15,13,4,9,0,0,0
2020-06-14 22:30,13,1,12,0,0,0
2020-06-14 22:45,10,4,6,0,0,0
2020-06-14 23:00,9,3,6,0,0,0
2020-06-14 23:15,8,0,8,0,0,0
2020-06-14 23:30,8,1,7,0,0,0
2020-06-14 23:45,10,3,7,0,0,0
2020-06-15 00:00,10,5,5,0,0,0
2020-06-15 00:15,5,3,2,0,0,0
2020-06-15 00:30,2,0,2,0,0,0
2020-06-15 00:45,2,2,0,0,0,0
2020-06-15 01:00,3,1,2,0,0,0
2020-06-15 01:15,0,0,0,0,0,0
2020-06-15 01:30,2,1,1,0,0,0
2020-06-15 01:45,3,1,2,0,0,0
2020-06-15 02:00,2,1,1,0,0,0
2020-06-15 02:15,1,1,0,0,0,0
2020-06-15 02:30,0,0,0,0,0,0
2020-06-15 02:45,0,0,0,0,0,0
2020-06-15 03:00,5,5,0,0,0,0
2020-06-15 03:15,1,0,1,0,0,0
2020-06-15 03:30,1,1,0,0,0,0
2020-06-15 03:45,3,0,3,0,0,0
2020-06-15 04:00,0,0,0,0,0,0
2020-06-15 04:15,0,0,0,0,0,0
2020-06-15 04:30,0,0,0,0,0,0
2020-06-15 04:45,6,3,3,0,0,0
2020-06-15 05:00,2,0,2,0,0,0
2020-06-15 05:15,6,1,5,0,0,0
2020-06-15 05:30,22,3,19,0,0,0
2020-06-15 05:45,19,10,9,0,0,0
2020-06-15 06:00,24,14,10,0,0,0
2020-06-15 06:15,34,15,19,0,0,0
2020-06-15 06:30,39,20,19,0,0,0
2020-06-15 06:45,60,32,28,0,0,0
2020-06-15 07:00,57,31,26,0,0,0
2020-06-15 07:15,73,33,40,0,0,0
2020-06-15 07:30,122,62,60,0,0,0
2020-06-15 07:45,135,72,63,0,0,0
2020-06-15 08:00,105,62,43,0,0,0
2020-06-15 08:15,115,51,64,0,0,0
2020-06-15 08:30,90,35,55,0,0,0
2020-06-15 08:45,94,43,51,0,0,0
2020-06-15 09:00,102,54,48,0,0,0
2020-06-15 09:15,93,40,53,0,0,0
2020-06-15 09:30,103,54,49,0,0,0
2020-06-15 09:45,91,45,46,0,0,0
2020-06-15 10:00,84,37,47,0,0,0
2020-06-15 10:15,71,31,40,0,0,0
2020-06-15 10:30,87,48,39,0,0,0
2020-06-15 10:45,101,45,56,0,0,0
2020-06-15 11:00,69,38,31,0,0,0
2020-06-15 11:15,80,31,49,0,0,0
2020-06-15 11:30,94,36,58,0,0,0
2020-06-15 11:45,95,31,64,0,0,0
2020-06-15 12:00,114,51,63,0,0,0
2020-06-15 12:15,114,42,72,0,0,0
2020-06-15 12:30,125,59,66,0,0,0
2020-06-15 12:45,120,62,58,0,0,0
2020-06-15 13:00,127,44,83,0,0,0
2020-06-15 13:15,145,65,80,0,0,0
2020-06-15 13:30,119,59,60,0,0,0
2020-06-15 13:45,134,67,67,0,0,0
2020-06-15 14:00,100,49,51,0,0,0
2020-06-15 14:15,91,46,45,0,0,0
2020-06-15 14:30,126,58,68,0,0,0
2020-06-15 14:45,131,64,67,0,0,0
2020-06-15 15:00,112,50,62,0,0,0
2020-06-15 15:15,97,40,57,0,0,0
2020-06-15 15:30,99,49,50,0,0,0
2020-06-15 15:45,133,72,61,0,0,0
2020-06-15 16:00,137,60,77,0,0,0
2020-06-15 16:15,121,55,66,0,0,0
2020-06-15 16:30,117,55,62,0,0,0
2020-06-15 16:45,167,86,81,0,0,0
2020-06-15 17:00,161,74,87,0,0,0
2020-06-15 17:15,152,76,76,0,0,0
2020-06-15 17:30,145,72,73,0,0,0
2020-06-15 17:45,149,76,73,0,0,0
2020-06-15 18:00,130,65,65,0,0,0
2020-06-15 18:15,111,49,62,0,0,0
2020-06-15 18:30,87,33,54,0,0,0
2020-06-15 18:45,94,49,45,0,0,0
2020-06-15 19:00,87,49,38,0,0,0
2020-06-15 19:15,96,51,45,0,0,0
2020-06-15 19:30,77,31,46,0,0,0
2020-06-15 19:45,73,35,38,0,0,0
2020-06-15 20:00,67,28,39,0,0,0
2020-06-15 20:15,63,44,19,0,0,0
2020-06-15 20:30,37,19,18,0,0,0
2020-06-15 20:45,59,27,32,0,0,0
2020-06-15 21:00,47,17,30,0,0,0
2020-06-15 21:15,47,24,23,0,0,0
2020-06-15 21:30,44,22,22,0,0,0
2020-06-15 21:45,47,26,21,0,0,0
2020-06-15 22:00,38,12,26,0,0,0
2020-06-15 22:15,29,11,18,0,0,0
2020-06-15 22:30,33,13,20,0,0,0
2020-06-15 22:45,46,7,39,0,0,0
2020-06-15 23:00,25,7,18,0,0,0
2020-06-15 23:15,16,5,11,0,0,0
2020-06-15 23:30,18,5,13,0,0,0
2020-06-15 23:45,20,4,16,0,0,0
2020-06-16 00:00,14,8,6,0,0,0
2020-06-16 00:15,15,5,10,0,0,0
2020-06-16 00:30,8,6,2,0,0,0
2020-06-16 00:45,12,4,8,0,0,0
2020-06-16 01:00,4,2,2,0,0,0
2020-06-16 01:15,1,1,0,0,0,0
2020-06-16 01:30,4,1,3,0,0,0
2020-06-16 01:45,6,0,6,0,0,0
2020-06-16 02:00,4,2,2,0,0,0
2020-06-16 02:15,1,0,1,0,0,0
2020-06-16 02:30,5,1,4,0,0,0
2020-06-16 02:45,2,1,1,0,0,0
2020-06-16 03:00,3,2,1,0,0,0
2020-06-16 03:15,0,0,0,0,0,0
2020-06-16 03:30,0,0,0,0,0,0
2020-06-16 03:45,1,0,1,0,0,0
2020-06-16 04:00,2,1,1,0,0,0
2020-06-16 04:15,1,0,1,0,0,0
2020-06-16 04:30,1,0,1,0,0,0
2020-06-16 04:45,8,3,5,0,0,0
2020-06-16 05:00,2,2,0,0,0,0
2020-06-16 05:15,9,4,5,0,0,0
2020-06-16 05:30,24,5,19,0,0,0
2020-06-16 05:45,17,11,6,0,0,0
2020-06-16 06:00,28,13,15,0,0,0
2020-06-16 06:15,40,14,26,0,0,0
2020-06-16 06:30,39,19,20,0,0,0
2020-06-16 06:45,72,41,31,0,0,0
2020-06-16 07:00,79,40,39,0,0,0
2020-06-16 07:15,85,47,38,0,0,0
2020-06-16 07:30,148,64,84,0,0,0
2020-06-16 07:45,149,83,66,0,0,0
2020-06-16 08:00,144,70,74,0,0,0
2020-06-16 08:15,114,56,58,0,0,0
2020-06-16 08:30,113,58,55,0,0,0
2020-06-16 08:45,119,63,56,0,0,0
2020-06-16 09:00,82,38,44,0,0,0
2020-06-16 09:15,86,34,52,0,0,0
2020-06-16 09:30,90,38,52,0,0,0
2020-06-16 09:45,90,48,42,0,0,0
2020-06-16 10:00,80,37,43,0,0,0
2020-06-16 10:15,93,37,56,0,0,0
2020-06-16 10:30,80,37,43,0,0,0
2020-06-16 10:45,109,52,57,0,0,0
2020-06-16 11:00,96,41,55,0,0,0
2020-06-16 11:15,89,39,50,0,0,0
2020-06-16 11:30,103,51,52,0,0,0
2020-06-16 11:45,102,49,53,0,0,0
2020-06-16 12:00,114,52,62,0,0,0
2020-06-16 12:15,116,43,73,0,0,0
2020-06-16 12:30,115,55,60,0,0,0
2020-06-16 12:45,121,71,50,0,0,0
2020-06-16 13:00,107,44,63,0,0,0
2020-06-16 13:15,111,45,66,0,0,0
2020-06-16 13:30,101,48,53,0,0,0
2020-06-16 13:45,164,83,81,0,0,0
2020-06-16 14:00,104,44,60,0,0,0
2020-06-16 14:15,119,52,67,0,0,0
2020-06-16 14:30,130,76,54,0,0,0
2020-06-16 14:45,125,64,61,0,0,0
2020-06-16 15:00,105,50,55,0,0,0
2020-06-16 15:15,119,72,47,0,0,0
2020-06-16 15:30,114,53,61,0,0,0
2020-06-16 15:45,140,63,77,0,0,0
2020-06-16 16:00,138,76,62,0,0,0
2020-06-16 16:15,149,83,66,0,0,0
2020-06-16 16:30,154,75,79,0,0,0
2020-06-16 16:45,189,97,92,0,0,0
2020-06-16 17:00,182,86,96,0,0,0
2020-06-16 17:15,150,63,87,0,0,0
2020-06-16 17:30,151,73,78,0,0,0
2020-06-16 17:45,131,64,67,0,0,0
2020-06-16 18:00,148,72,76,0,0,0
2020-06-16 18:15,122,50,72,0,0,0
2020-06-16 18:30,136,64,72,0,0,0
2020-06-16 18:45,142,72,70,0,0,0
2020-06-16 19:00,114,56,58,0,0,0
2020-06-16 19:15,97,56,41,0,0,0
2020-06-16 19:30,86,37,49,0,0,0
2020-06-16 19:45,78,44,34,0,0,0
2020-06-16 20:00,100,50,50,0,0,0
2020-06-16 20:15,79,31,48,0,0,0
2020-06-16 20:30,51,24,27,0,0,0
2020-06-16 20:45,45,19,26,0,0,0
2020-06-16 21:00,63,31,32,0,0,0
2020-06-16 21:15,60,23,37,0,0,0
2020-06-16 21:30,50,22,28,0,0,0
2020-06-16 21:45,51,19,32,0,0,0
2020-06-16 22:00,37,16,21,0,0,0
2020-06-16 22:15,30,13,17,0,0,0
2020-06-16 22:30,39,16,23,0,0,0
2020-06-16 22:45,31,14,17,0,0,0
2020-06-16 23:00,35,17,18,0,0,0
2020-06-16 23:15,22,12,10,0,0,0
2020-06-16 23:30,23,9,14,0,0,0
2020-06-16 23:45,16,10,6,0,0,0
2020-06-17 00:00,17,4,13,0,0,0
2020-06-17 00:15,19,9,10,0,0,0
2020-06-17 00:30,15,5,10,0,0,0
2020-06-17 00:45,7,2,5,0,0,0
2020-06-17 01:00,5,2,3,0,0,0
2020-06-17 01:15,3,1,2,0,0,0
2020-06-17 01:30,1,1,0,0,0,0
2020-06-17 01:45,5,0,5,0,0,0
2020-06-17 02:00,8,4,4,0,0,0
2020-06-17 02:15,7,0,7,0,0,0
2020-06-17 02:30,6,0,6,0,0,0
2020-06-17 02:45,0,0,0,0,0,0
2020-06-17 03:00,0,0,0,0,0,0
2020-06-17 03:15,3,1,2,0,0,0
2020-06-17 03:30,5,1,4,0,0,0
2020-06-17 03:45,5,1,4,0,0,0
2020-06-17 04:00,3,1,2,0,0,0
2020-06-17 04:15,1,1,0,0,0,0
2020-06-17 04:30,3,1,2,0,0,0
2020-06-17 04:45,7,3,4,0,0,0
2020-06-17 05:00,7,1,6,0,0,0
2020-06-17 05:15,12,3,9,0,0,0
2020-06-17 05:30,19,5,14,0,0,0
2020-06-17 05:45,17,6,11,0,0,0
2020-06-17 06:00,26,8,18,0,0,0
2020-06-17 06:15,32,15,17,0,0,0
2020-06-17 06:30,40,17,23,0,0,0
2020-06-17 06:45,54,33,21,0,0,0
2020-06-17 07:00,66,32,34,0,0,0
2020-06-17 07:15,73,34,39,0,0,0
2020-06-17 07:30,127,67,60,0,0,0
2020-06-17 07:45,140,78,62,0,0,0
2020-06-17 08:00,97,43,54,0,0,0
2020-06-17 08:15,120,70,50,0,0,0
2020-06-17 08:30,109,39,70,0,0,0
2020-06-17 08:45,107,46,61,0,0,0
2020-06-17 09:00,99,47,52,0,0,0
2020-06-17 09:15,84,38,46,0,0,0
2020-06-17 09:30,105,58,47,0,0,0
2020-06-17 09:45,123,49,74,0,0,0
2020-06-17 10:00,87,40,47,0,0,0
2020-06-17 10:15,81,41,40,0,0,0
2020-06-17 10:30,82,37,45,0,0,0
2020-06-17 10:45,104,49,55,0,0,0
2020-06-17 11:00,93,41,52,0,0,0
2020-06-17 11:15,90,40,50,0,0,0
2020-06-17 11:30,92,34,58,0,0,0
2020-06-17 11:45,133,63,70,0,0,0
2020-06-17 12:00,89,39,50,0,0,0
2020-06-17 12:15,140,61,79,0,0,0
2020-06-17 12:30,137,61,76,0,0,0
2020-06-17 12:45,109,43,66,0,0,0
2020-06-17 13:00,126,57,69,0,0,0
2020-06-17 13:15,124,69,55,0,0,0
2020-06-17 13:30,106,53,53,0,0,0
2020-06-17 13:45,150,84,66,0,0,0
2020-06-17 14:00,137,73,64,0,0,0
2020-06-17 14:15,128,67,61,0,0,0
2020-06-17 14:30,103,47,56,0,0,0
2020-06-17 14:45,87,36,51,0,0,0
2020-06-17 15:00,121,62,59,0,0,0
2020-06-17 15:15,105,49,56,0,0,0
2020-06-17 15:30,122,56,66,0,0,0
2020-06-17 15:45,118,60,58,0,0,0
2020-06-17 16:00,144,72,72,0,0,0
2020-06-17 16:15,159,85,74,0,0,0
2020-06-17 16:30,134,69,65,0,0,0
2020-06-17 16:45,190,86,104,0,0,0
2020-06-17 17:00,203,99,104,0,0,0
2020-06-17 17:15,165,86,79,0,0,0
2020-06-17 17:30,120,60,60,0,0,0
2020-06-17 17:45,106,53,53,0,0,0
2020-06-17 18:00,93,35,58,0,0,0
2020-06-17 18:15,116,63,53,0,0,0
2020-06-17 18:30,91,45,46,0,0,0
2020-06-17 18:45,99,51,48,0,0,0
2020-06-17 19:00,102,48,54,0,0,0
2020-06-17 19:15,105,55,50,0,0,0
2020-06-17 19:30,88,33,55,0,0,0
2020-06-17 19:45,80,37,43,0,0,0
2020-06-17 20:00,79,41,38,0,0,0
2020-06-17 20:15,74,42,32,0,0,0
2020-06-17 20:30,67,34,33,0,0,0
2020-06-17 20:45,43,16,27,0,0,0
2020-06-17 21:00,54,25,29,0,0,0
2020-06-17 21:15,58,23,35,0,0,0
2020-06-17 21:30,48,18,30,0,0,0
2020-06-17 21:45,55,27,28,0,0,0
2020-06-17 22:00,50,15,35,0,0,0
2020-06-17 22:15,61,18,43,0,0,0
2020-06-17 22:30,45,19,26,0,0,0
2020-06-17 22:45,35,16,19,0,0,0
2020-06-17 23:00,33,16,17,0,0,0
2020-06-17 23:15,32,7,25,0,0,0
2020-06-17 23:30,21,10,11,0,0,0
2020-06-17 23:45,10,4,6,0,0,0
2020-06-18 00:00,15,6,9,0,0,0
2020-06-18 00:15,16,6,10,0,0,0
2020-06-18 00:30,15,2,13,0,0,0
2020-06-18 00:45,8,2,6,0,0,0
2020-06-18 01:00,13,3,10,0,0,0
2020-06-18 01:15,4,3,1,0,0,0
2020-06-18 01:30,3,1,2,0,0,0
2020-06-18 01:45,3,2,1,0,0,0
2020-06-18 02:00,2,1,1,0,0,0
2020-06-18 02:15,5,2,3,0,0,0
2020-06-18 02:30,2,0,2,0,0,0
2020-06-18 02:45,1,1,0,0,0,0
2020-06-18 03:00,2,1,1,0,0,0
2020-06-18 03:15,1,1,0,0,0,0
2020-06-18 03:30,3,2,1,0,0,0
2020-06-18 03:45,2,0,2,0,0,0
2020-06-18 04:00,1,0,1,0,0,0
2020-06-18 04:15,2,0,2,0,0,0
2020-06-18 04:30,0,0,0,0,0,0
2020-06-18 04:45,12,5,7,0,0,0
2020-06-18 05:00,2,0,2,0,0,0
2020-06-18 05:15,7,4,3,0,0,0
2020-06-18 05:30,20,9,11,0,0,0
2020-06-18 05:45,18,6,12,0,0,0
2020-06-18 06:00,11,5,6,0,0,0
2020-06-18 06:15,32,8,24,0,0,0
2020-06-18 06:30,36,15,21,0,0,0
2020-06-18 06:45,56,28,28,0,0,0
2020-06-18 07:00,76,34,42,0,0,0
2020-06-18 07:15,82,45,37,0,0,0
2020-06-18 07:30,128,60,68,0,0,0
2020-06-18 07:45,155,89,66,0,0,0
2020-06-18 08:00,103,59,44,0,0,0
2020-06-18 08:15,113,43,70,0,0,0
2020-06-18 08:30,97,47,50,0,0,0
2020-06-18 08:45,123,49,74,0,0,0
2020-06-18 09:00,81,40,41,0,0,0
2020-06-18 09:15,98,45,53,0,0,0
2020-06-18 09:30,80,30,50,0,0,0
2020-06-18 09:45,97,51,46,0,0,0
2020-06-18 10:00,82,37,45,0,0,0
2020-06-18 10:15,88,32,56,0,0,0
2020-06-18 10:30,95,43,52,0,0,0
2020-06-18 10:45,85,35,50,0,0,0
2020-06-18 11:00,72,23,49,0,0,0
2020-06-18 11:15,79,41,38,0,0,0
2020-06-18 11:30,110,51,59,0,0,0
2020-06-18 11:45,98,41,57,0,0,0
2020-06-18 12:00,113,50,63,0,0,0
2020-06-18 12:15,99,48,51,0,0,0
2020-06-18 12:30,99,48,51,0,0,0
2020-06-18 12:45,96,50,46,0,0,0
2020-06-18 13:00,125,68,57,0,0,0
2020-06-18 13:15,106,60,46,0,0,0
2020-06-18 13:30,91,49,42,0,0,0
2020-06-18 13:45,127,61,66,0,0,0
2020-06-18 14:00,115,59,56,0,0,0
2020-06-18 14:15,101,42,59,0,0,0
2020-06-18 14:30,120,56,64,0,0,0
2020-06-18 14:45,96,59,37,0,0,0
2020-06-18 15:00,116,53,63,0,0,0
2020-06-18 15:15,110,52,58,0,0,0
2020-06-18 15:30,125,68,57,0,0,0
2020-06-18 15:45,109,54,55,0,0,0
2020-06-18 16:00,124,63,61,0,0,0
2020-06-18 16:15,141,77,64,0,0,0
2020-06-18 16:30,147,82,65,0,0,0
2020-06-18 16:45,157,63,94,0,0,0
2020-06-18 17:00,155,79,76,0,0,0
2020-06-18 17:15,157,80,77,0,0,0
2020-06-18 17:30,145,76,69,0,0,0
2020-06-18 17:45,181,93,88,0,0,0
2020-06-18 18:00,162,85,77,0,0,0
2020-06-18 18:15,135,68,67,0,0,0
2020-06-18 18:30,141,74,67,0,0,0
2020-06-18 18:45,138,82,56,0,0,0
2020-06-18 19:00,149,85,64,0,0,0
2020-06-18 19:15,126,65,61,0,0,0
2020-06-18 19:30,148,80,68,0,0,0
2020-06-18 19:45,117,56,61,0,0,0
2020-06-18 20:00,109,50,59,0,0,0
2020-06-18 20:15,102,38,64,0,0,0
2020-06-18 20:30,91,37,54,0,0,0
2020-06-18 20:45,90,45,45,0,0,0
2020-06-18 21:00,93,39,54,0,0,0
2020-06-18 21:15,59,20,39,0,0,0
2020-06-18 21:30,59,24,35,0,0,0
2020-06-18 21:45,48,24,24,0,0,0
2020-06-18 22:00,68,24,44,0,0,0
2020-06-18 22:15,51,15,36,0,0,0
2020-06-18 22:30,68,26,42,0,0,0
2020-06-18 22:45,42,18,24,0,0,0
2020-06-18 23:00,50,10,40,0,0,0
2020-06-18 23:15,26,5,21,0,0,0
2020-06-18 23:30,30,11,19,0,0,0
2020-06-18 23:45,25,8,17,0,0,0
2020-06-19 00:00,33,12,21,0,0,0
2020-06-19 00:15,17,8,9,0,0,0
2020-06-19 00:30,17,6,11,0,0,0
2020-06-19 00:45,22,7,15,0,0,0
2020-06-19 01:00,5,0,5,0,0,0
2020-06-19 01:15,8,2,6,0,0,0
2020-06-19 01:30,7,3,4,0,0,0
2020-06-19 01:45,5,0,5,0,0,0
2020-06-19 02:00,11,5,6,0,0,0
2020-06-19 02:15,1,0,1,0,0,0
2020-06-19 02:30,7,1,6,0,0,0
2020-06-19 02:45,12,8,4,0,0,0
2020-06-19 03:00,6,2,4,0,0,0
2020-06-19 03:15,2,0,2,0,0,0
2020-06-19 03:30,7,0,7,0,0,0
2020-06-19 03:45,3,2,1,0,0,0
2020-06-19 04:00,1,1,0,0,0,0
2020-06-19 04:15,5,4,1,0,0,0
2020-06-19 04:30,3,1,2,0,0,0
2020-06-19 04:45,10,3,7,0,0,0
2020-06-19 05:00,13,4,9,0,0,0
2020-06-19 05:15,13,2,11,0,0,0
2020-06-19 05:30,17,8,9,0,0,0
2020-06-19 05:45,22,7,15,0,0,0
2020-06-19 06:00,12,3,9,0,0,0
2020-06-19 06:15,35,16,19,0,0,0
2020-06-19 06:30,47,22,25,0,0,0
2020-06-19 06:45,56,29,27,0,0,0
2020-06-19 07:00,54,33,21,0,0,0
2020-06-19 07:15,92,49,43,0,0,0
2020-06-19 07:30,136,64,72,0,0,0
2020-06-19 07:45,117,70,47,0,0,0
2020-06-19 08:00,86,38,48,0,0,0
2020-06-19 08:15,119,61,58,0,0,0
2020-06-19 08:30,111,46,65,0,0,0
2020-06-19 08:45,130,55,75,0,0,0
2020-06-19 09:00,99,44,55,0,0,0
2020-06-19 09:15,99,56,43,0,0,0
2020-06-19 09:30,86,32,54,0,0,0
2020-06-19 09:45,121,39,82,0,0,0
2020-06-19 10:00,83,41,42,0,0,0
2020-06-19 10:15,103,42,61,0,0,0
2020-06-19 10:30,94,43,51,0,0,0
2020-06-19 10:45,104,46,58,0,0,0
2020-06-19 11:00,113,55,58,0,0,0
2020-06-19 11:15,92,44,48,0,0,0
2020-06-19 11:30,90,38,52,0,0,0
2020-06-19 11:45,107,45,62,0,0,0
2020-06-19 12:00,107,50,57,0,0,0
2020-06-19 12:15,124,62,62,0,0,0
2020-06-19 12:30,114,57,57,0,0,0
2020-06-19 12:45,170,80,90,0,0,0
2020-06-19 13:00,138,60,78,0,0,0
2020-06-19 13:15,111,41,70,0,0,0
2020-06-19 13:30,130,75,55,0,0,0
2020-06-19 13:45,128,66,62,0,0,0
2020-06-19 14:00,120,68,52,0,0,0
2020-06-19 14:15,129,61,68,0,0,0
2020-06-19 14:30,123,58,65,0,0,0
2020-06-19 14:45,122,49,73,0,0,0
2020-06-19 15:00,108,45,63,0,0,0
2020-06-19 15:15,117,49,68,0,0,0
2020-06-19 15:30,132,58,74,0,0,0
2020-06-19 15:45,146,69,77,0,0,0
2020-06-19 16:00,141,80,61,0,0,0
2020-06-19 16:15,119,69,50,0,0,0
2020-06-19 16:30,158,68,90,0,0,0
2020-06-19 16:45,140,71,69,0,0,0
2020-06-19 17:00,158,81,77,0,0,0
2020-06-19 17:15,138,66,72,0,0,0
2020-06-19 17:30,159,89,70,0,0,0
2020-06-19 17:45,150,75,75,0,0,0
2020-06-19 18:00,153,96,57,0,0,0
2020-06-19 18:15,133,81,52,0,0,0
2020-06-19 18:30,126,68,58,0,0,0
2020-06-19 18:45,191,126,65,0,0,0
2020-06-19 19:00,143,84,59,0,0,0
2020-06-19 19:15,159,89,70,0,0,0
2020-06-19 19:30,122,79,43,0,0,0
2020-06-19 19:45,124,70,54,0,0,0
2020-06-19 20:00,116,63,53,0,0,0
2020-06-19 20:15,97,57,40,0,0,0
2020-06-19 20:30,108,54,54,0,0,0
2020-06-19 20:45,101,58,43,0,0,0
2020-06-19 21:00,90,40,50,0,0,0
2020-06-19 21:15,67,29,38,0,0,0
2020-06-19 21:30,69,38,31,0,0,0
2020-06-19 21:45,66,20,46,0,0,0
2020-06-19 22:00,63,30,33,0,0,0
2020-06-19 22:15,86,36,50,0,0,0
2020-06-19 22:30,56,13,43,0,0,0
2020-06-19 22:45,58,24,34,0,0,0
2020-06-19 23:00,71,27,44,0,0,0
2020-06-19 23:15,53,16,37,0,0,0
2020-06-19 23:30,72,18,54,0,0,0
2020-06-19 23:45,68,18,50,0,0,0
2020-06-20 00:00,67,33,34,0,0,0
2020-06-20 00:15,74,30,44,0,0,0
2020-06-20 00:30,57,23,34,0,0,0
2020-06-20 00:45,38,11,27,0,0,0
2020-06-20 01:00,39,12,27,0,0,0
2020-06-20 01:15,44,14,30,0,0,0
2020-06-20 01:30,49,8,41,0,0,0
2020-06-20 01:45,39,10,29,0,0,0
2020-06-20 02:00,47,13,34,0,0,0
2020-06-20 02:15,28,11,17,0,0,0
2020-06-20 02:30,19,4,15,0,0,0
2020-06-20 02:45,36,10,26,0,0,0
2020-06-20 03:00,21,1,20,0,0,0
2020-06-20 03:15,31,6,25,0,0,0
2020-06-20 03:30,13,1,12,0,0,0
2020-06-20 03:45,13,2,11,0,0,0
2020-06-20 04:00,14,0,14,0,0,0
2020-06-20 04:15,23,6,17,0,0,0
2020-06-20 04:30,7,1,6,0,0,0
2020-06-20 04:45,14,4,10,0,0,0
2020-06-20 05:00,3,1,2,0,0,0
2020-06-20 05:15,12,1,11,0,0,0
2020-06-20 05:30,7,3,4,0,0,0
2020-06-20 05:45,11,2,9,0,0,0
2020-06-20 06:00,11,1,10,0,0,0
2020-06-20 06:15,6,3,3,0,0,0
2020-06-20 06:30,5,1,4,0,0,0
2020-06-20 06:45,10,2,8,0,0,0
2020-06-20 07:00,16,8,8,0,0,0
2020-06-20 07:15,12,5,7,0,0,0
2020-06-20 07:30,21,11,10,0,0,0
2020-06-20 07:45,12,9,3,0,0,0
2020-06-20 08:00,23,10,13,0,0,0
2020-06-20 08:15,22,12,10,0,0,0
2020-06-20 08:30,27,8,19,0,0,0
2020-06-20 08:45,52,17,35,0,0,0
2020-06-20 09:00,46,17,29,0,0,0
2020-06-20 09:15,60,30,30,0,0,0
2020-06-20 09:30,43,18,25,0,0,0
2020-06-20 09:45,79,34,45,0,0,0
2020-06-20 10:00,64,21,43,0,0,0
2020-06-20 10:15,61,30,31,0,0,0
2020-06-20 10:30,68,30,38,0,0,0
2020-06-20 10:45,91,31,60,0,0,0
2020-06-20 11:00,94,33,61,0,0,0
2020-06-20 11:15,80,37,43,0,0,0
2020-06-20 11:30,80,42,38,0,0,0
2020-06-20 11:45,94,44,50,0,0,0
2020-06-20 12:00,98,58,40,0,0,0
2020-06-20 12:15,102,45,57,0,0,0
2020-06-20 12:30,126,65,61,0,0,0
2020-06-20 12:45,107,50,57,0,0,0
2020-06-20 13:00,118,69,49,0,0,0
2020-06-20 13:15,112,49,63,0,0,0
2020-06-20 13:30,94,51,43,0,0,0
2020-06-20 13:45,100,45,55,0,0,0
2020-06-20 14:00,121,53,68,0,0,0
2020-06-20 14:15,114,47,67,0,0,0
2020-06-20 14:30,110,63,47,0,0,0
2020-06-20 14:45,97,59,38,0,0,0
2020-06-20 15:00,101,56,45,0,0,0
2020-06-20 15:15,106,60,46,0,0,0
2020-06-20 15:30,93,34,59,0,0,0
2020-06-20 15:45,96,48,48,0,0,0
2020-06-20 16:00,98,56,42,0,0,0
2020-06-20 16:15,86,46,40,0,0,0
2020-06-20 16:30,108,47,61,0,0,0
2020-06-20 16:45,100,57,43,0,0,0
2020-06-20 17:00,115,60,55,0,0,0
2020-06-20 17:15,108,49,59,0,0,0
2020-06-20 17:30,113,66,47,0,0,0
2020-06-20 17:45,137,85,52,0,0,0
2020-06-20 18:00,98,55,43,0,0,0
2020-06-20 18:15,150,87,63,0,0,0
2020-06-20 18:30,92,42,50,0,0,0
2020-06-20 18:45,103,61,42,0,0,0
2020-06-20 19:00,107,65,42,0,0,0
2020-06-20 19:15,113,75,38,0,0,0
2020-06-20 19:30,118,63,55,0,0,0
2020-06-20 19:45,125,75,50,0,0,0
2020-06-20 20:00,122,68,54,0,0,0
2020-06-20 20:15,106,50,56,0,0,0
2020-06-20 20:30,95,44,51,0,0,0
2020-06-20 20:45,85,38,47,0,0,0
2020-06-20 21:00,102,41,61,0,0,0
2020-06-20 21:15,77,34,43,0,0,0
2020-06-20 21:30,83,32,51,0,0,0
2020-06-20 21:45,68,38,30,0,0,0
2020-06-20 22:00,65,29,36,0,0,0
2020-06-20 22:15,60,24,36,0,0,0
2020-06-20 22:30,43,20,23,0,0,0
2020-06-20 22:45,54,17,37,0,0,0
2020-06-20 23:00,77,27,50,0,0,0
2020-06-20 23:15,71,25,46,0,0,0
2020-06-20 23:30,62,19,43,0,0,0
2020-06-20 23:45,70,29,41,0,0,0
2020-06-21 00:00,49,19,30,0,0,0
2020-06-21 00:15,70,19,51,0,0,0
2020-06-21 00:30,56,33,23,0,0,0
2020-06-21 00:45,66,19,47,0,0,0
2020-06-21 01:00,52,13,39,0,0,0
2020-06-21 01:15,61,19,42,0,0,0
2020-06-21 01:30,50,18,32,0,0,0
2020-06-21 01:45,35,13,22,0,0,0
2020-06-21 02:00,31,16,15,0,0,0
2020-06-21 02:15,29,7,22,0,0,0
2020-06-21 02:30,25,9,16,0,0,0
2020-06-21 02:45,15,4,11,0,0,0
2020-06-21 03:00,28,6,22,0,0,0
2020-06-21 03:15,24,9,15,0,0,0
2020-06-21 03:30,28,9,19,0,0,0
2020-06-21 03:45,22,10,12,0,0,0
2020-06-21 04:00,16,9,7,0,0,0
2020-06-21 04:15,6,0,6,0,0,0
2020-06-21 04:30,7,4,3,0,0,0
2020-06-21 04:45,7,2,5,0,0,0
2020-06-21 05:00,4,2,2,0,0,0
2020-06-21 05:15,3,0,3,0,0,0
2020-06-21 05:30,7,2,5,0,0,0
2020-06-21 05:45,5,2,3,0,0,0
2020-06-21 06:00,5,2,3,0,0,0
2020-06-21 06:15,11,1,10,0,0,0
2020-06-21 06:30,8,4,4,0,0,0
2020-06-21 06:45,7,2,5,0,0,0
2020-06-21 07:00,7,3,4,0,0,0
2020-06-21 07:15,8,4,4,0,0,0
2020-06-21 07:30,19,6,13,0,0,0
2020-06-21 07:45,8,6,2,0,0,0
2020-06-21 08:00,9,3,6,0,0,0
2020-06-21 08:15,18,4,14,0,0,0
2020-06-21 08:30,12,4,8,0,0,0
2020-06-21 08:45,23,12,11,0,0,0
2020-06-21 09:00,11,5,6,0,0,0
2020-06-21 09:15,19,7,12,0,0,0
2020-06-21 09:30,27,9,18,0,0,0
2020-06-21 09:45,48,23,25,0,0,0
2020-06-21 10:00,44,25,19,0,0,0
2020-06-21 10:15,46,27,19,0,0,0
2020-06-21 10:30,45,22,23,0,0,0
2020-06-21 10:45,52,18,34,0,0,0
2020-06-21 11:00,49,19,30,0,0,0
2020-06-21 11:15,42,14,28,0,0,0
2020-06-21 11:30,67,35,32,0,0,0
2020-06-21 11:45,66,34,32,0,0,0
2020-06-21 12:00,67,37,30,0,0,0
2020-06-21 12:15,70,41,29,0,0,0
2020-06-21 12:30,71,35,36,0,0,0
2020-06-21 12:45,73,43,30,0,0,0
2020-06-21 13:00,59,29,30,0,0,0
2020-06-21 13:15,79,29,50,0,0,0
2020-06-21 13:30,86,35,51,0,0,0
2020-06-21 13:45,77,48,29,0,0,0
2020-06-21 14:00,87,33,54,0,0,0
2020-06-21 14:15,100,43,57,0,0,0
2020-06-21 14:30,86,47,39,0,0,0
2020-06-21 14:45,78,36,42,0,0,0
2020-06-21 15:00,130,71,59,0,0,0
2020-06-21 15:15,76,36,40,0,0,0
2020-06-21 15:30,99,53,46,0,0,0
2020-06-21 15:45,106,60,46,0,0,0
2020-06-21 16:00,83,45,38,0,0,0
2020-06-21 16:15,110,65,45,0,0,0
2020-06-21 16:30,79,39,40,0,0,0
2020-06-21 16:45,93,48,45,0,0,0
2020-06-21 17:00,103,54,49,0,0,0
2020-06-21 17:15,89,42,47,0,0,0
2020-06-21 17:30,80,33,47,0,0,0
2020-06-21 17:45,130,58,72,0,0,0
2020-06-21 18:00,129,52,77,0,0,0
2020-06-21 18:15,100,46,54,0,0,0
2020-06-21 18:30,95,37,58,0,0,0
2020-06-21 18:45,94,33,61,0,0,0
2020-06-21 19:00,96,46,50,0,0,0
2020-06-21 19:15,87,40,47,0,0,0
2020-06-21 19:30,84,39,45,0,0,0
2020-06-21 19:45,80,33,47,0,0,0
2020-06-21 20:00,71,31,40,0,0,0
2020-06-21 20:15,77,25,52,0,0,0
2020-06-21 20:30,86,27,59,0,0,0
2020-06-21 20:45,67,26,41,0,0,0
2020-06-21 21:00,48,20,28,0,0,0
2020-06-21 21:15,38,16,22,0,0,0
2020-06-21 21:30,53,20,33,0,0,0
2020-06-21 21:45,51,21,30,0,0,0
2020-06-21 22:00,44,16,28,0,0,0
2020-06-21 22:15,47,16,31,0,0,0
2020-06-21 22:30,39,17,22,0,0,0
2020-06-21 22:45,22,7,15,0,0,0
2020-06-21 23:00,24,12,12,0,0,0
2020-06-21 23:15,35,18,17,0,0,0
2020-06-21 23:30,19,7,12,0,0,0
2020-06-21 23:45,16,4,12,0,0,0
2020-06-22 00:00,31,15,16,0,0,0
2020-06-22 00:15,12,8,4,0,0,0
2020-06-22 00:30,15,3,12,0,0,0
2020-06-22 00:45,5,1,4,0,0,0
2020-06-22 01:00,7,4,3,0,0,0
2020-06-22 01:15,5,2,3,0,0,0
2020-06-22 01:30,3,0,3,0,0,0
2020-06-22 01:45,2,1,1,0,0,0
2020-06-22 02:00,7,0,7,0,0,0
2020-06-22 02:15,2,1,1,0,0,0
2020-06-22 02:30,0,0,0,0,0,0
2020-06-22 02:45,0,0,0,0,0,0
2020-06-22 03:00,1,0,1,0,0,0
2020-06-22 03:15,4,1,3,0,0,0
2020-06-22 03:30,0,0,0,0,0,0
2020-06-22 03:45,1,0,1,0,0,0
2020-06-22 04:00,3,1,2,0,0,0
2020-06-22 04:15,2,1,1,0,0,0
2020-06-22 04:30,3,2,1,0,0,0
2020-06-22 04:45,5,0,5,0,0,0
2020-06-22 05:00,1,1,0,0,0,0
2020-06-22 05:15,10,4,6,0,0,0
2020-06-22 05:30,17,3,14,0,0,0
2020-06-22 05:45,17,10,7,0,0,0
2020-06-22 06:00,21,10,11,0,0,0
2020-06-22 06:15,29,18,11,0,0,0
2020-06-22 06:30,48,22,26,0,0,0
2020-06-22 06:45,73,34,39,0,0,0
2020-06-22 07:00,69,41,28,0,0,0
2020-06-22 07:15,81,36,45,0,0,0
2020-06-22 07:30,137,61,76,0,0,0
2020-06-22 07:45,135,72,63,0,0,0
2020-06-22 08:00,126,69,57,0,0,0
2020-06-22 08:15,106,51,55,0,0,0
2020-06-22 08:30,123,47,76,0,0,0
2020-06-22 08:45,123,58,65,0,0,0
2020-06-22 09:00,80,39,41,0,0,0
2020-06-22 09:15,81,36,45,0,0,0
2020-06-22 09:30,77,32,45,0,0,0
2020-06-22 09:45,98,42,56,0,0,0
2020-06-22 10:00,100,44,56,0,0,0
2020-06-22 10:15,109,50,59,0,0,0
2020-06-22 10:30,98,50,48,0,0,0
2020-06-22 10:45,112,46,66,0,0,0
2020-06-22 11:00,105,55,50,0,0,0
2020-06-22 11:15,96,39,57,0,0,0
2020-06-22 11:30,117,63,54,0,0,0
2020-06-22 11:45,106,47,59,0,0,0
2020-06-22 12:00,102,43,59,0,0,0
2020-06-22 12:15,102,34,68,0,0,0
2020-06-22 12:30,115,48,67,0,0,0
2020-06-22 12:45,131,57,74,0,0,0
2020-06-22 13:00,130,58,72,0,0,0
2020-06-22 13:15,101,42,59,0,0,0
2020-06-22 13:30,126,56,70,0,0,0
2020-06-22 13:45,128,63,65,0,0,0
2020-06-22 14:00,122,55,67,0,0,0
2020-06-22 14:15,145,87,58,0,0,0
2020-06-22 14:30,130,67,63,0,0,0
2020-06-22 14:45,120,60,60,0,0,0
2020-06-22 15:00,130,68,62,0,0,0
2020-06-22 15:15,129,78,51,0,0,0
2020-06-22 15:30,132,66,66,0,0,0
2020-06-22 15:45,127,57,70,0,0,0
2020-06-22 16:00,140,78,62,0,0,0
2020-06-22 16:15,153,81,72,0,0,0
2020-06-22 16:30,119,69,50,0,0,0
2020-06-22 16:45,154,78,76,0,0,0
2020-06-22 17:00,124,59,65,0,0,0
2020-06-22 17:15,155,78,77,0,0,0
2020-06-22 17:30,162,78,84,0,0,0
2020-06-22 17:45,171,73,98,0,0,0
2020-06-22 18:00,159,95,64,0,0,0
2020-06-22 18:15,149,80,69,0,0,0
2020-06-22 18:30,132,73,59,0,0,0
2020-06-22 18:45,163,106,57,0,0,0
2020-06-22 19:00,106,57,49,0,0,0
2020-06-22 19:15,102,62,40,0,0,0
2020-06-22 19:30,90,44,46,0,0,0
2020-06-22 19:45,86,43,43,0,0,0
2020-06-22 20:00,94,39,55,0,0,0
2020-06-22 20:15,81,39,42,0,0,0
2020-06-22 20:30,86,62,24,0,0,0
2020-06-22 20:45,74,36,38,0,0,0
2020-06-22 21:00,54,27,27,0,0,0
2020-06-22 21:15,70,28,42,0,0,0
2020-06-22 21:30,70,28,42,0,0,0
2020-06-22 21:45,75,20,55,0,0,0
2020-06-22 22:00,41,18,23,0,0,0
2020-06-22 22:15,57,26,31,0,0,0
2020-06-22 22:30,50,20,30,0,0,0
2020-06-22 22:45,38,5,33,0,0,0
2020-06-22 23:00,53,19,34,0,0,0
2020-06-22 23:15,34,12,22,0,0,0
2020-06-22 23:30,39,14,25,0,0,0
2020-06-22 23:45,33,13,20,0,0,0
2020-06-23 00:00,31,10,21,0,0,0
2020-06-23 00:15,24,4,20,0,0,0
2020-06-23 00:30,11,2,9,0,0,0
2020-06-23 00:45,9,5,4,0,0,0
2020-06-23 01:00,14,2,12,0,0,0
2020-06-23 01:15,4,1,3,0,0,0
2020-06-23 01:30,5,2,3,0,0,0
2020-06-23 01:45,4,3,1,0,0,0
2020-06-23 02:00,2,0,2,0,0,0
2020-06-23 02:15,10,2,8,0,0,0
2020-06-23 02:30,8,0,8,0,0,0
2020-06-23 02:45,0,0,0,0,0,0
2020-06-23 03:00,0,0,0,0,0,0
2020-06-23 03:15,3,1,2,0,0,0
2020-06-23 03:30,0,0,0,0,0,0
2020-06-23 03:45,3,3,0,0,0,0
2020-06-23 04:00,2,0,2,0,0,0
2020-06-23 04:15,5,2,3,0,0,0
2020-06-23 04:30,7,1,6,0,0,0
2020-06-23 04:45,8,0,8,0,0,0
2020-06-23 05:00,5,3,2,0,0,0
2020-06-23 05:15,10,3,7,0,0,0
2020-06-23 05:30,14,4,10,0,0,0
2020-06-23 05:45,19,7,12,0,0,0
2020-06-23 06:00,35,17,18,0,0,0
2020-06-23 06:15,38,18,20,0,0,0
2020-06-23 06:30,46,24,22,0,0,0
2020-06-23 06:45,70,37,33,0,0,0
2020-06-23 07:00,69,39,30,0,0,0
2020-06-23 07:15,92,46,46,0,0,0
2020-06-23 07:30,133,62,71,0,0,0
2020-06-23 07:45,159,86,73,0,0,0
2020-06-23 08:00,132,65,67,0,0,0
2020-06-23 08:15,142,66,76,0,0,0
2020-06-23 08:30,123,59,64,0,0,0
2020-06-23 08:45,152,59,93,0,0,0
2020-06-23 09:00,95,39,56,0,0,0
2020-06-23 09:15,88,32,56,0,0,0
2020-06-23 09:30,106,49,57,0,0,0
2020-06-23 09:45,112,39,73,0,0,0
2020-06-23 10:00,84,45,39,0,0,0
2020-06-23 10:15,114,46,68,0,0,0
2020-06-23 10:30,105,44,61,0,0,0
2020-06-23 10:45,92,48,44,0,0,0
2020-06-23 11:00,95,43,52,0,0,0
2020-06-23 11:15,122,53,69,0,0,0
2020-06-23 11:30,128,53,75,0,0,0
2020-06-23 11:45,118,50,68,0,0,0
2020-06-23 12:00,113,49,64,0,0,0
2020-06-23 12:15,97,51,46,0,0,0
2020-06-23 12:30,129,51,78,0,0,0
2020-06-23 12:45,144,68,76,0,0,0
2020-06-23 13:00,124,52,72,0,0,0
2020-06-23 13:15,145,69,76,0,0,0
2020-06-23 13:30,111,60,51,0,0,0
2020-06-23 13:45,144,85,59,0,0,0
2020-06-23 14:00,151,85,66,0,0,0
2020-06-23 14:15,138,73,65,0,0,0
2020-06-23 14:30,136,67,69,0,0,0
2020-06-23 14:45,144,69,75,0,0,0
2020-06-23 15:00,133,72,61,0,0,0
2020-06-23 15:15,142,89,53,0,0,0
2020-06-23 15:30,159,90,69,0,0,0
2020-06-23 15:45,161,84,77,0,0,0
2020-06-23 16:00,191,109,82,0,0,0
2020-06-23 16:15,183,103,80,0,0,0
2020-06-23 16:30,188,93,95,0,0,0
2020-06-23 16:45,179,87,92,0,0,0
2020-06-23 17:00,223,118,105,0,0,0
2020-06-23 17:15,186,78,108,0,0,0
2020-06-23 17:30,184,91,93,0,0,0
2020-06-23 17:45,198,107,91,0,0,0
2020-06-23 18:00,166,85,81,0,0,0
2020-06-23 18:15,194,105,89,0,0,0
2020-06-23 18:30,161,94,67,0,0,0
2020-06-23 18:45,194,107,87,0,0,0
2020-06-23 19:00,138,72,66,0,0,0
2020-06-23 19:15,159,78,81,0,0,0
2020-06-23 19:30,137,85,52,0,0,0
2020-06-23 19:45,153,77,76,0,0,0
2020-06-23 20:00,131,65,66,0,0,0
2020-06-23 20:15,96,41,55,0,0,0
2020-06-23 20:30,119,40,79,0,0,0
2020-06-23 20:45,86,37,49,0,0,0
2020-06-23 21:00,92,32,60,0,0,0
2020-06-23 21:15,101,39,62,0,0,0
2020-06-23 21:30,103,33,70,0,0,0
2020-06-23 21:45,82,35,47,0,0,0
2020-06-23 22:00,85,27,58,0,0,0
2020-06-23 22:15,71,19,52,0,0,0
2020-06-23 22:30,60,25,35,0,0,0
2020-06-23 22:45,61,26,35,0,0,0
2020-06-23 23:00,59,22,37,0,0,0
2020-06-23 23:15,53,27,26,0,0,0
2020-06-23 23:30,41,9,32,0,0,0
2020-06-23 23:45,37,20,17,0,0,0
2020-06-24 00:00,35,15,20,0,0,0
2020-06-24 00:15,24,10,14,0,0,0
2020-06-24 00:30,11,5,6,0,0,0
2020-06-24 00:45,19,8,11,0,0,0
2020-06-24 01:00,12,6,6,0,0,0
2020-06-24 01:15,11,0,11,0,0,0
2020-06-24 01:30,9,5,4,0,0,0
2020-06-24 01:45,6,2,4,0,0,0
2020-06-24 02:00,5,3,2,0,0,0
2020-06-24 02:15,0,0,0,0,0,0
2020-06-24 02:30,1,1,0,0,0,0
2020-06-24 02:45,5,1,4,0,0,0
2020-06-24 03:00,3,1,2,0,0,0
2020-06-24 03:15,2,1,1,0,0,0
2020-06-24 03:30,3,3,0,0,0,0
2020-06-24 03:45,4,3,1,0,0,0
2020-06-24 04:00,3,0,3,0,0,0
2020-06-24 04:15,2,1,1,0,0,0
2020-06-24 04:30,1,0,1,0,0,0
2020-06-24 04:45,10,4,6,0,0,0
2020-06-24 05:00,1,1,0,0,0,0
2020-06-24 05:15,10,3,7,0,0,0
2020-06-24 05:30,14,6,8,0,0,0
2020-06-24 05:45,14,5,9,0,0,0
2020-06-24 06:00,37,13,24,0,0,0
2020-06-24 06:15,39,20,19,0,0,0
2020-06-24 06:30,35,17,18,0,0,0
2020-06-24 06:45,81,36,45,0,0,0
2020-06-24 07:00,85,45,40,0,0,0
2020-06-24 07:15,91,47,44,0,0,0
2020-06-24 07:30,141,58,83,0,0,0
2020-06-24 07:45,168,90,78,0,0,0
2020-06-24 08:00,138,74,64,0,0,0
2020-06-24 08:15,141,74,67,0,0,0
2020-06-24 08:30,127,55,72,0,0,0
2020-06-24 08:45,131,70,61,0,0,0
2020-06-24 09:00,112,46,66,0,0,0
2020-06-24 09:15,109,41,68,0,0,0
2020-06-24 09:30,101,44,57,0,0,0
2020-06-24 09:45,136,51,85,0,0,0
2020-06-24 10:00,81,37,44,0,0,0
2020-06-24 10:15,105,48,57,0,0,0
2020-06-24 10:30,105,64,41,0,0,0
2020-06-24 10:45,119,43,76,0,0,0
2020-06-24 11:00,97,38,59,0,0,0
2020-06-24 11:15,110,51,59,0,0,0
2020-06-24 11:30,127,55,72,0,0,0
2020-06-24 11:45,124,48,76,0,0,0
2020-06-24 12:00,132,70,62,0,0,0
2020-06-24 12:15,146,60,86,0,0,0
2020-06-24 12:30,139,75,64,0,0,0
2020-06-24 12:45,139,75,64,0,0,0
2020-06-24 13:00,143,71,72,0,0,0
2020-06-24 13:15,169,90,79,0,0,0
2020-06-24 13:30,138,75,63,0,0,0
2020-06-24 13:45,149,88,61,0,0,0
2020-06-24 14:00,123,69,54,0,0,0
2020-06-24 14:15,141,79,62,0,0,0
2020-06-24 14:30,157,79,78,0,0,0
2020-06-24 14:45,140,77,63,0,0,0
2020-06-24 15:00,154,96,58,0,0,0
2020-06-24 15:15,157,86,71,0,0,0
2020-06-24 15:30,177,125,52,0,0,0
2020-06-24 15:45,187,105,82,0,0,0
2020-06-24 16:00,167,96,71,0,0,0
2020-06-24 16:15,200,118,82,0,0,0
2020-06-24 16:30,189,116,73,0,0,0
2020-06-24 16:45,190,105,85,0,0,0
2020-06-24 17:00,162,105,57,0,0,0
2020-06-24 17:15,175,90,85,0,0,0
2020-06-24 17:30,198,95,103,0,0,0
2020-06-24 17:45,189,93,96,0,0,0
2020-06-24 18:00,164,93,71,0,0,0
2020-06-24 18:15,190,101,89,0,0,0
2020-06-24 18:30,187,95,92,0,0,0
2020-06-24 18:45,209,122,87,0,0,0
2020-06-24 19:00,164,86,78,0,0,0
2020-06-24 19:15,156,79,77,0,0,0
2020-06-24 19:30,153,65,88,0,0,0
2020-06-24 19:45,145,68,77,0,0,0
2020-06-24 20:00,121,64,57,0,0,0
2020-06-24 20:15,103,51,52,0,0,0
2020-06-24 20:30,88,29,59,0,0,0
2020-06-24 20:45,98,40,58,0,0,0
2020-06-24 21:00,104,48,56,0,0,0
2020-06-24 21:15,104,46,58,0,0,0
2020-06-24 21:30,96,37,59,0,0,0
2020-06-24 21:45,97,30,67,0,0,0
2020-06-24 22:00,75,28,47,0,0,0
2020-06-24 22:15,98,35,63,0,0,0
2020-06-24 22:30,91,35,56,0,0,0
2020-06-24 22:45,73,30,43,0,0,0
2020-06-24 23:00,59,20,39,0,0,0
2020-06-24 23:15,54,16,38,0,0,0
2020-06-24 23:30,44,25,19,0,0,0
2020-06-24 23:45,29,7,22,0,0,0
2020-06-25 00:00,32,7,25,0,0,0
2020-06-25 00:15,32,10,22,0,0,0
2020-06-25 00:30,10,4,6,0,0,0
2020-06-25 00:45,13,5,8,0,0,0
2020-06-25 01:00,12,4,8,0,0,0
2020-06-25 01:15,13,4,9,0,0,0
2020-06-25 01:30,10,3,7,0,0,0
2020-06-25 01:45,12,6,6,0,0,0
2020-06-25 02:00,7,1,6,0,0,0
2020-06-25 02:15,18,1,17,0,0,0
2020-06-25 02:30,5,1,4,0,0,0
2020-06-25 02:45,2,2,0,0,0,0
2020-06-25 03:00,2,0,2,0,0,0
2020-06-25 03:15,9,4,5,0,0,0
2020-06-25 03:30,4,2,2,0,0,0
2020-06-25 03:45,6,5,1,0,0,0
2020-06-25 04:00,4,0,4,0,0,0
2020-06-25 04:15,2,0,2,0,0,0
2020-06-25 04:30,2,2,0,0,0,0
2020-06-25 04:45,6,1,5,0,0,0
2020-06-25 05:00,4,4,0,0,0,0
2020-06-25 05:15,9,3,6,0,0,0
2020-06-25 05:30,20,10,10,0,0,0
2020-06-25 05:45,20,6,14,0,0,0
2020-06-25 06:00,23,7,16,0,0,0
2020-06-25 06:15,25,11,14,0,0,0
2020-06-25 06:30,41,16,25,0,0,0
2020-06-25 06:45,74,34,40,0,0,0
2020-06-25 07:00,78,39,39,0,0,0
2020-06-25 07:15,100,49,51,0,0,0
2020-06-25 07:30,150,74,76,0,0,0
2020-06-25 07:45,162,85,77,0,0,0
2020-06-25 08:00,126,70,56,0,0,0
2020-06-25 08:15,124,62,62,0,0,0
2020-06-25 08:30,135,69,66,0,0,0
2020-06-25 08:45,145,55,90,0,0,0
2020-06-25 09:00,106,54,52,0,0,0
2020-06-25 09:15,108,58,50,0,0,0
2020-06-25 09:30,98,46,52,0,0,0
2020-06-25 09:45,100,39,61,0,0,0
2020-06-25 10:00,102,49,53,0,0,0
2020-06-25 10:15,84,36,48,0,0,0
2020-06-25 10:30,92,41,51,0,0,0
2020-06-25 10:45,123,65,58,0,0,0
2020-06-25 11:00,88,42,46,0,0,0
2020-06-25 11:15,104,55,49,0,0,0
2020-06-25 11:30,119,45,74,0,0,0
2020-06-25 11:45,123,54,69,0,0,0
2020-06-25 12:00,106,54,52,0,0,0
2020-06-25 12:15,132,57,75,0,0,0
2020-06-25 12:30,141,52,89,0,0,0
2020-06-25 12:45,171,79,92,0,0,0
2020-06-25 13:00,124,65,59,0,0,0
2020-06-25 13:15,148,83,65,0,0,0
2020-06-25 13:30,130,51,79,0,0,0
2020-06-25 13:45,147,80,67,0,0,0
2020-06-25 14:00,123,72,51,0,0,0
2020-06-25 14:15,123,62,61,0,0,0
2020-06-25 14:30,141,84,57,0,0,0
2020-06-25 14:45,156,78,78,0,0,0
2020-06-25 15:00,140,69,71,0,0,0
2020-06-25 15:15,130,75,55,0,0,0
2020-06-25 15:30,138,69,69,0,0,0
2020-06-25 15:45,177,99,78,0,0,0
2020-06-25 16:00,194,104,90,0,0,0
2020-06-25 16:15,211,118,93,0,0,0
2020-06-25 16:30,166,92,74,0,0,0
2020-06-25 16:45,179,93,86,0,0,0
2020-06-25 17:00,214,119,95,0,0,0
2020-06-25 17:15,198,110,88,0,0,0
2020-06-25 17:30,174,96,78,0,0,0
2020-06-25 17:45,225,117,108,0,0,0
2020-06-25 18:00,180,96,84,0,0,0
2020-06-25 18:15,170,83,87,0,0,0
2020-06-25 18:30,157,73,84,0,0,0
2020-06-25 18:45,169,87,82,0,0,0
2020-06-25 19:00,138,72,66,0,0,0
2020-06-25 19:15,149,75,74,0,0,0
2020-06-25 19:30,120,49,71,0,0,0
2020-06-25 19:45,122,57,65,0,0,0
2020-06-25 20:00,127,64,63,0,0,0
2020-06-25 20:15,89,38,51,0,0,0
2020-06-25 20:30,78,30,48,0,0,0
2020-06-25 20:45,77,38,39,0,0,0
2020-06-25 21:00,92,30,62,0,0,0
2020-06-25 21:15,100,43,57,0,0,0
2020-06-25 21:30,75,28,47,0,0,0
2020-06-25 21:45,72,22,50,0,0,0
2020-06-25 22:00,83,25,58,0,0,0
2020-06-25 22:15,95,27,68,0,0,0
2020-06-25 22:30,73,21,52,0,0,0
2020-06-25 22:45,68,25,43,0,0,0
2020-06-25 23:00,74,21,53,0,0,0
2020-06-25 23:15,48,13,35,0,0,0
2020-06-25 23:30,46,16,30,0,0,0
2020-06-25 23:45,51,23,28,0,0,0
2020-06-26 00:00,33,14,19,0,0,0
2020-06-26 00:15,26,9,17,0,0,0
2020-06-26 00:30,22,7,15,0,0,0
2020-06-26 00:45,18,10,8,0,0,0
2020-06-26 01:00,17,4,13,0,0,0
2020-06-26 01:15,29,6,23,0,0,0
2020-06-26 01:30,21,8,13,0,0,0
2020-06-26 01:45,10,2,8,0,0,0
2020-06-26 02:00,7,2,5,0,0,0
2020-06-26 02:15,2,1,1,0,0,0
2020-06-26 02:30,5,1,4,0,0,0
2020-06-26 02:45,3,2,1,0,0,0
2020-06-26 03:00,0,0,0,0,0,0
2020-06-26 03:15,1,0,1,0,0,0
2020-06-26 03:30,3,3,0,0,0,0
2020-06-26 03:45,1,1,0,0,0,0
2020-06-26 04:00,1,0,1,0,0,0
2020-06-26 04:15,3,2,1,0,0,0
2020-06-26 04:30,3,1,2,0,0,0
2020-06-26 04:45,7,3,4,0,0,0
2020-06-26 05:00,3,1,2,0,0,0
2020-06-26 05:15,15,3,12,0,0,0
2020-06-26 05:30,16,6,10,0,0,0
2020-06-26 05:45,9,5,4,0,0,0
2020-06-26 06:00,30,9,21,0,0,0
2020-06-26 06:15,39,15,24,0,0,0
2020-06-26 06:30,51,21,30,0,0,0
2020-06-26 06:45,65,32,33,0,0,0
2020-06-26 07:00,75,38,37,0,0,0
2020-06-26 07:15,81,43,38,0,0,0
2020-06-26 07:30,116,65,51,0,0,0
2020-06-26 07:45,144,72,72,0,0,0
2020-06-26 08:00,115,65,50,0,0,0
2020-06-26 08:15,129,58,71,0,0,0
2020-06-26 08:30,91,45,46,0,0,0
2020-06-26 08:45,142,64,78,0,0,0
2020-06-26 09:00,90,40,50,0,0,0
2020-06-26 09:15,97,49,48,0,0,0
2020-06-26 09:30,91,38,53,0,0,0
2020-06-26 09:45,119,49,70,0,0,0
2020-06-26 10:00,117,56,61,0,0,0
2020-06-26 10:15,95,37,58,0,0,0
2020-06-26 10:30,97,53,44,0,0,0
2020-06-26 10:45,103,47,56,0,0,0
2020-06-26 11:00,120,48,72,0,0,0
2020-06-26 11:15,109,48,61,0,0,0
2020-06-26 11:30,106,37,69,0,0,0
2020-06-26 11:45,112,47,65,0,0,0
2020-06-26 12:00,153,77,76,0,0,0
2020-06-26 12:15,142,69,73,0,0,0
2020-06-26 12:30,128,62,66,0,0,0
2020-06-26 12:45,139,63,76,0,0,0
2020-06-26 13:00,153,78,75,0,0,0
2020-06-26 13:15,150,62,88,0,0,0
2020-06-26 13:30,129,72,57,0,0,0
2020-06-26 13:45,182,95,87,0,0,0
2020-06-26 14:00,163,84,79,0,0,0
2020-06-26 14:15,182,97,85,0,0,0
2020-06-26 14:30,142,75,67,0,0,0
2020-06-26 14:45,155,85,70,0,0,0
2020-06-26 15:00,138,81,57,0,0,0
2020-06-26 15:15,147,81,66,0,0,0
2020-06-26 15:30,138,58,80,0,0,0
2020-06-26 15:45,158,94,64,0,0,0
2020-06-26 16:00,121,75,46,0,0,0
2020-06-26 16:15,173,101,72,0,0,0
2020-06-26 16:30,124,63,61,0,0,0
2020-06-26 16:45,165,93,72,0,0,0
2020-06-26 17:00,153,88,65,0,0,0
2020-06-26 17:15,149,83,66,0,0,0
2020-06-26 17:30,168,109,59,0,0,0
2020-06-26 17:45,146,87,59,0,0,0
2020-06-26 18:00,167,99,68,0,0,0
2020-06-26 18:15,176,92,84,0,0,0
2020-06-26 18:30,106,58,48,0,0,0
2020-06-26 18:45,153,87,66,0,0,0
2020-06-26 19:00,170,91,79,0,0,0
2020-06-26 19:15,151,69,82,0,0,0
2020-06-26 19:30,145,68,77,0,0,0
2020-06-26 19:45,129,79,50,0,0,0
2020-06-26 20:00,147,69,78,0,0,0
2020-06-26 20:15,119,54,65,0,0,0
2020-06-26 20:30,116,57,59,0,0,0
2020-06-26 20:45,110,42,68,0,0,0
2020-06-26 21:00,114,53,61,0,0,0
2020-06-26 21:15,85,35,50,0,0,0
2020-06-26 21:30,129,48,81,0,0,0
2020-06-26 21:45,72,32,40,0,0,0
2020-06-26 22:00,112,37,75,0,0,0
2020-06-26 22:15,107,52,55,0,0,0
2020-06-26 22:30,97,43,54,0,0,0
2020-06-26 22:45,99,46,53,0,0,0
2020-06-26 23:00,85,41,44,0,0,0
2020-06-26 23:15,80,32,48,0,0,0
2020-06-26 23:30,72,36,36,0,0,0
2020-06-26 23:45,76,21,55,0,0,0
2020-06-27 00:00,93,31,62,0,0,0
2020-06-27 00:15,90,36,54,0,0,0
2020-06-27 00:30,49,14,35,0,0,0
2020-06-27 00:45,55,11,44,0,0,0
2020-06-27 01:00,46,20,26,0,0,0
2020-06-27 01:15,60,17,43,0,0,0
2020-06-27 01:30,55,15,40,0,0,0
2020-06-27 01:45,39,13,26,0,0,0
2020-06-27 02:00,38,13,25,0,0,0
2020-06-27 02:15,20,4,16,0,0,0
2020-06-27 02:30,33,12,21,0,0,0
2020-06-27 02:45,24,14,10,0,0,0
2020-06-27 03:00,21,10,11,0,0,0
2020-06-27 03:15,33,7,26,0,0,0
2020-06-27 03:30,14,0,14,0,0,0
2020-06-27 03:45,17,5,12,0,0,0
2020-06-27 04:00,19,3,16,0,0,0
2020-06-27 04:15,28,4,24,0,0,0
2020-06-27 04:30,16,1,15,0,0,0
2020-06-27 04:45,12,7,5,0,0,0
2020-06-27 05:00,8,4,4,0,0,0
2020-06-27 05:15,6,1,5,0,0,0
2020-06-27 05:30,14,4,10,0,0,0
2020-06-27 05:45,6,3,3,0,0,0
2020-06-27 06:00,8,4,4,0,0,0
2020-06-27 06:15,6,1,5,0,0,0
2020-06-27 06:30,8,2,6,0,0,0
2020-06-27 06:45,12,4,8,0,0,0
2020-06-27 07:00,12,3,9,0,0,0
2020-06-27 07:15,15,5,10,0,0,0
2020-06-27 07:30,17,6,11,0,0,0
2020-06-27 07:45,15,6,9,0,0,0
2020-06-27 08:00,25,11,14,0,0,0
2020-06-27 08:15,27,8,19,0,0,0
2020-06-27 08:30,42,17,25,0,0,0
2020-06-27 08:45,50,20,30,0,0,0
2020-06-27 09:00,45,19,26,0,0,0
2020-06-27 09:15,56,19,37,0,0,0
2020-06-27 09:30,52,21,31,0,0,0
2020-06-27 09:45,87,40,47,0,0,0
2020-06-27 10:00,65,22,43,0,0,0
2020-06-27 10:15,70,29,41,0,0,0
2020-06-27 10:30,67,23,44,0,0,0
2020-06-27 10:45,70,33,37,0,0,0
2020-06-27 11:00,70,34,36,0,0,0
2020-06-27 11:15,82,32,50,0,0,0
2020-06-27 11:30,80,40,40,0,0,0
2020-06-27 11:45,84,38,46,0,0,0
2020-06-27 12:00,103,51,52,0,0,0
2020-06-27 12:15,104,57,47,0,0,0
2020-06-27 12:30,92,46,46,0,0,0
2020-06-27 12:45,81,36,45,0,0,0
2020-06-27 13:00,100,54,46,0,0,0
2020-06-27 13:15,77,42,35,0,0,0
2020-06-27 13:30,61,26,35,0,0,0
2020-06-27 13:45,96,45,51,0,0,0
2020-06-27 14:00,94,28,66,0,0,0
2020-06-27 14:15,129,65,64,0,0,0
2020-06-27 14:30,83,48,35,0,0,0
2020-06-27 14:45,85,44,41,0,0,0
2020-06-27 15:00,141,77,64,0,0,0
2020-06-27 15:15,122,63,59,0,0,0
2020-06-27 15:30,73,32,41,0,0,0
2020-06-27 15:45,104,56,48,0,0,0
2020-06-27 16:00,85,27,58,0,0,0
2020-06-27 16:15,95,59,36,0,0,0
2020-06-27 16:30,59,37,22,0,0,0
2020-06-27 16:45,97,48,49,0,0,0
2020-06-27 17:00,87,49,38,0,0,0
2020-06-27 17:15,101,44,57,0,0,0
2020-06-27 17:30,82,48,34,0,0,0
2020-06-27 17:45,114,64,50,0,0,0
2020-06-27 18:00,99,43,56,0,0,0
2020-06-27 18:15,94,51,43,0,0,0
2020-06-27 18:30,89,58,31,0,0,0
2020-06-27 18:45,88,54,34,0,0,0
2020-06-27 19:00,102,63,39,0,0,0
2020-06-27 19:15,115,73,42,0,0,0
2020-06-27 19:30,108,40,68,0,0,0
2020-06-27 19:45,103,46,57,0,0,0
2020-06-27 20:00,100,58,42,0,0,0
2020-06-27 20:15,98,56,42,0,0,0
2020-06-27 20:30,81,48,33,0,0,0
2020-06-27 20:45,96,51,45,0,0,0
2020-06-27 21:00,60,24,36,0,0,0
2020-06-27 21:15,67,27,40,0,0,0
2020-06-27 21:30,66,35,31,0,0,0
2020-06-27 21:45,62,21,41,0,0,0
2020-06-27 22:00,81,39,42,0,0,0
2020-06-27 22:15,77,29,48,0,0,0
2020-06-27 22:30,59,19,40,0,0,0
2020-06-27 22:45,61,26,35,0,0,0
2020-06-27 23:00,47,20,27,0,0,0
2020-06-27 23:15,46,18,28,0,0,0
2020-06-27 23:30,52,24,28,0,0,0
2020-06-27 23:45,51,17,34,0,0,0
2020-06-28 00:00,75,24,51,0,0,0
2020-06-28 00:15,58,22,36,0,0,0
2020-06-28 00:30,42,13,29,0,0,0
2020-06-28 00:45,46,16,30,0,0,0
2020-06-28 01:00,32,12,20,0,0,0
2020-06-28 01:15,33,13,20,0,0,0
2020-06-28 01:30,38,20,18,0,0,0
2020-06-28 01:45,42,15,27,0,0,0
2020-06-28 02:00,27,11,16,0,0,0
2020-06-28 02:15,29,10,19,0,0,0
2020-06-28 02:30,21,10,11,0,0,0
2020-06-28 02:45,18,8,10,0,0,0
2020-06-28 03:00,29,13,16,0,0,0
2020-06-28 03:15,28,9,19,0,0,0
2020-06-28 03:30,15,3,12,0,0,0
2020-06-28 03:45,13,7,6,0,0,0
2020-06-28 04:00,18,7,11,0,0,0
2020-06-28 04:15,10,3,7,0,0,0
2020-06-28 04:30,17,9,8,0,0,0
2020-06-28 04:45,8,3,5,0,0,0
2020-06-28 05:00,9,1,8,0,0,0
2020-06-28 05:15,6,0,6,0,0,0
2020-06-28 05:30,11,1,10,0,0,0
2020-06-28 05:45,3,0,3,0,0,0
2020-06-28 06:00,8,0,8,0,0,0
2020-06-28 06:15,5,3,2,0,0,0
2020-06-28 06:30,5,1,4,0,0,0
2020-06-28 06:45,7,2,5,0,0,0
2020-06-28 07:00,5,3,2,0,0,0
2020-06-28 07:15,8,5,3,0,0,0
2020-06-28 07:30,16,7,9,0,0,0
2020-06-28 07:45,5,2,3,0,0,0
2020-06-28 08:00,2,1,1,0,0,0
2020-06-28 08:15,8,4,4,0,0,0
2020-06-28 08:30,9,3,6,0,0,0
2020-06-28 08:45,28,14,14,0,0,0
2020-06-28 09:00,21,10,11,0,0,0
2020-06-28 09:15,14,3,11,0,0,0
2020-06-28 09:30,25,8,17,0,0,0
2020-06-28 09:45,29,16,13,0,0,0
2020-06-28 10:00,35,12,23,0,0,0
2020-06-28 10:15,28,16,12,0,0,0
2020-06-28 10:30,42,21,21,0,0,0
2020-06-28 10:45,28,14,14,0,0,0
2020-06-28 11:00,33,12,21,0,0,0
2020-06-28 11:15,42,27,15,0,0,0
2020-06-28 11:30,50,20,30,0,0,0
2020-06-28 11:45,50,25,25,0,0,0
2020-06-28 12:00,53,26,27,0,0,0
2020-06-28 12:15,52,22,30,0,0,0
2020-06-28 12:30,54,26,28,0,0,0
2020-06-28 12:45,68,37,31,0,0,0
2020-06-28 13:00,72,34,38,0,0,0
2020-06-28 13:15,59,28,31,0,0,0
2020-06-28 13:30,58,28,30,0,0,0
2020-06-28 13:45,65,34,31,0,0,0
2020-06-28 14:00,57,26,31,0,0,0
2020-06-28 14:15,60,23,37,0,0,0
2020-06-28 14:30,82,37,45,0,0,0
2020-06-28 14:45,70,30,40,0,0,0
2020-06-28 15:00,83,43,40,0,0,0
2020-06-28 15:15,86,39,47,0,0,0
2020-06-28 15:30,70,30,40,0,0,0
2020-06-28 15:45,71,32,39,0,0,0
2020-06-28 16:00,83,46,37,0,0,0
2020-06-28 16:15,62,32,30,0,0,0
2020-06-28 16:30,103,46,57,0,0,0
2020-06-28 16:45,100,36,64,0,0,0
2020-06-28 17:00,94,47,47,0,0,0
2020-06-28 17:15,94,38,56,0,0,0
2020-06-28 17:30,62,26,36,0,0,0
2020-06-28 17:45,77,45,32,0,0,0
2020-06-28 18:00,96,41,55,0,0,0
2020-06-28 18:15,76,36,40,0,0,0
2020-06-28 18:30,86,36,50,0,0,0
2020-06-28 18:45,109,55,54,0,0,0
2020-06-28 19:00,82,31,51,0,0,0
2020-06-28 19:15,74,35,39,0,0,0
2020-06-28 19:30,63,39,24,0,0,0
2020-06-28 19:45,73,38,35,0,0,0
2020-06-28 20:00,74,32,42,0,0,0
2020-06-28 20:15,56,19,37,0,0,0
2020-06-28 20:30,48,14,34,0,0,0
2020-06-28 20:45,48,24,24,0,0,0
2020-06-28 21:00,60,28,32,0,0,0
2020-06-28 21:15,42,16,26,0,0,0
2020-06-28 21:30,58,26,32,0,0,0
2020-06-28 21:45,55,20,35,0,0,0
2020-06-28 22:00,58,20,38,0,0,0
2020-06-28 22:15,41,22,19,0,0,0
2020-06-28 22:30,36,16,20,0,0,0
2020-06-28 22:45,40,10,30,0,0,0
2020-06-28 23:00,23,10,13,0,0,0
2020-06-28 23:15,33,12,21,0,0,0
2020-06-28 23:30,20,8,12,0,0,0
2020-06-28 23:45,15,5,10,0,0,0
2020-06-29 00:00,9,3,6,0,0,0
2020-06-29 00:15,12,7,5,0,0,0
2020-06-29 00:30,7,0,7,0,0,0
2020-06-29 00:45,13,1,12,0,0,0
2020-06-29 01:00,4,0,4,0,0,0
2020-06-29 01:15,1,0,1,0,0,0
2020-06-29 01:30,5,1,4,0,0,0
2020-06-29 01:45,3,0,3,0,0,0
2020-06-29 02:00,2,0,2,0,0,0
2020-06-29 02:15,4,2,2,0,0,0
2020-06-29 02:30,1,0,1,0,0,0
2020-06-29 02:45,9,3,6,0,0,0
2020-06-29 03:00,2,0,2,0,0,0
2020-06-29 03:15,0,0,0,0,0,0
2020-06-29 03:30,0,0,0,0,0,0
2020-06-29 03:45,0,0,0,0,0,0
2020-06-29 04:00,3,1,2,0,0,0
2020-06-29 04:15,1,1,0,0,0,0
2020-06-29 04:30,4,2,2,0,0,0
2020-06-29 04:45,12,2,10,0,0,0
2020-06-29 05:00,6,1,5,0,0,0
2020-06-29 05:15,6,2,4,0,0,0
2020-06-29 05:30,20,6,14,0,0,0
2020-06-29 05:45,19,10,9,0,0,0
2020-06-29 06:00,31,9,22,0,0,0
2020-06-29 06:15,34,18,16,0,0,0
2020-06-29 06:30,42,15,27,0,0,0
2020-06-29 06:45,74,33,41,0,0,0
2020-06-29 07:00,77,36,41,0,0,0
2020-06-29 07:15,89,54,35,0,0,0
2020-06-29 07:30,102,44,58,0,0,0
2020-06-29 07:45,130,73,57,0,0,0
2020-06-29 08:00,118,62,56,0,0,0
2020-06-29 08:15,131,76,55,0,0,0
2020-06-29 08:30,92,42,50,0,0,0
2020-06-29 08:45,117,42,75,0,0,0
2020-06-29 09:00,85,39,46,0,0,0
2020-06-29 09:15,76,27,49,0,0,0
2020-06-29 09:30,85,34,51,0,0,0
2020-06-29 09:45,90,37,53,0,0,0
2020-06-29 10:00,80,33,47,0,0,0
2020-06-29 10:15,76,28,48,0,0,0
2020-06-29 10:30,106,42,64,0,0,0
2020-06-29 10:45,118,51,67,0,0,0
2020-06-29 11:00,84,39,45,0,0,0
2020-06-29 11:15,115,54,61,0,0,0
2020-06-29 11:30,105,32,73,0,0,0
2020-06-29 11:45,113,54,59,0,0,0
2020-06-29 12:00,118,60,58,0,0,0
2020-06-29 12:15,128,60,68,0,0,0
2020-06-29 12:30,133,59,74,0,0,0
2020-06-29 12:45,145,75,70,0,0,0
2020-06-29 13:00,104,47,57,0,0,0
2020-06-29 13:15,112,61,51,0,0,0
2020-06-29 13:30,102,47,55,0,0,0
2020-06-29 13:45,94,37,57,0,0,0
2020-06-29 14:00,130,70,60,0,0,0
2020-06-29 14:15,136,60,76,0,0,0
2020-06-29 14:30,117,54,63,0,0,0
2020-06-29 14:45,108,53,55,0,0,0
2020-06-29 15:00,141,60,81,0,0,0
2020-06-29 15:15,129,62,67,0,0,0
2020-06-29 15:30,129,67,62,0,0,0
2020-06-29 15:45,137,59,78,0,0,0
2020-06-29 16:00,158,81,77,0,0,0
2020-06-29 16:15,175,83,92,0,0,0
2020-06-29 16:30,134,64,70,0,0,0
2020-06-29 16:45,147,71,76,0,0,0
2020-06-29 17:00,158,76,82,0,0,0
2020-06-29 17:15,159,67,92,0,0,0
2020-06-29 17:30,148,72,76,0,0,0
2020-06-29 17:45,171,59,112,0,0,0
2020-06-29 18:00,129,71,58,0,0,0
2020-06-29 18:15,143,76,67,0,0,0
2020-06-29 18:30,130,57,73,0,0,0
2020-06-29 18:45,132,70,62,0,0,0
2020-06-29 19:00,106,56,50,0,0,0
2020-06-29 19:15,130,80,50,0,0,0
2020-06-29 19:30,91,44,47,0,0,0
2020-06-29 19:45,98,44,54,0,0,0
2020-06-29 20:00,109,57,52,0,0,0
2020-06-29 20:15,84,47,37,0,0,0
2020-06-29 20:30,81,39,42,0,0,0
2020-06-29 20:45,68,17,51,0,0,0
2020-06-29 21:00,54,29,25,0,0,0
2020-06-29 21:15,63,24,39,0,0,0
2020-06-29 21:30,51,20,31,0,0,0
2020-06-29 21:45,56,26,30,0,0,0
2020-06-29 22:00,43,15,28,0,0,0
2020-06-29 22:15,40,19,21,0,0,0
2020-06-29 22:30,46,11,35,0,0,0
2020-06-29 22:45,32,14,18,0,0,0
2020-06-29 23:00,37,18,19,0,0,0
2020-06-29 23:15,26,12,14,0,0,0
2020-06-29 23:30,23,5,18,0,0,0
2020-06-29 23:45,20,12,8,0,0,0
2020-06-30 00:00,22,11,11,0,0,0
2020-06-30 00:15,12,3,9,0,0,0
2020-06-30 00:30,10,2,8,0,0,0
2020-06-30 00:45,15,9,6,0,0,0
2020-06-30 01:00,12,5,7,0,0,0
2020-06-30 01:15,4,1,3,0,0,0
2020-06-30 01:30,6,0,6,0,0,0
2020-06-30 01:45,5,3,2,0,0,0
2020-06-30 02:00,7,2,5,0,0,0
2020-06-30 02:15,8,1,7,0,0,0
2020-06-30 02:30,2,2,0,0,0,0
2020-06-30 02:45,0,0,0,0,0,0
2020-06-30 03:00,4,2,2,0,0,0
2020-06-30 03:15,1,1,0,0,0,0
2020-06-30 03:30,1,0,1,0,0,0
2020-06-30 03:45,1,0,1,0,0,0
2020-06-30 04:00,6,2,4,0,0,0
2020-06-30 04:15,1,1,0,0,0,0
2020-06-30 04:30,2,0,2,0,0,0
2020-06-30 04:45,6,1,5,0,0,0
2020-06-30 05:00,6,2,4,0,0,0
2020-06-30 05:15,6,6,0,0,0,0
2020-06-30 05:30,21,5,16,0,0,0
2020-06-30 05:45,20,9,11,0,0,0
2020-06-30 06:00,28,10,18,0,0,0
2020-06-30 06:15,29,12,17,0,0,0
2020-06-30 06:30,40,14,26,0,0,0
2020-06-30 06:45,71,32,39,0,0,0
2020-06-30 07:00,86,45,41,0,0,0
2020-06-30 07:15,93,43,50,0,0,0
2020-06-30 07:30,115,60,55,0,0,0
2020-06-30 07:45,121,57,64,0,0,0
2020-06-30 08:00,127,58,69,0,0,0
2020-06-30 08:15,121,59,62,0,0,0
2020-06-30 08:30,109,56,53,0,0,0
2020-06-30 08:45,120,48,72,0,0,0
2020-06-30 09:00,101,48,53,0,0,0
2020-06-30 09:15,71,25,46,0,0,0
2020-06-30 09:30,89,44,45,0,0,0
2020-06-30 09:45,103,40,63,0,0,0
2020-06-30 10:00,75,35,40,0,0,0
2020-06-30 10:15,95,30,65,0,0,0
2020-06-30 10:30,85,28,57,0,0,0
2020-06-30 10:45,94,51,43,0,0,0
2020-06-30 11:00,100,40,60,0,0,0
2020-06-30 11:15,81,40,41,0,0,0
2020-06-30 11:30,111,60,51,0,0,0
2020-06-30 11:45,113,49,64,0,0,0
2020-06-30 12:00,128,58,70,0,0,0
2020-06-30 12:15,134,68,66,0,0,0
2020-06-30 12:30,131,41,90,0,0,0
2020-06-30 12:45,119,59,60,0,0,0
2020-06-30 13:00,112,58,54,0,0,0
2020-06-30 13:15,122,57,65,0,0,0
2020-06-30 13:30,126,67,59,0,0,0
2020-06-30 13:45,134,67,67,0,0,0
2020-06-30 14:00,117,50,67,0,0,0
2020-06-30 14:15,148,73,75,0,0,0
2020-06-30 14:30,119,57,62,0,0,0
2020-06-30 14:45,108,52,56,0,0,0
2020-06-30 15:00,122,59,63,0,0,0
2020-06-30 15:15,121,48,73,0,0,0
2020-06-30 15:30,143,69,74,0,0,0
2020-06-30 15:45,175,89,86,0,0,0
2020-06-30 16:00,160,87,73,0,0,0
2020-06-30 16:15,156,70,86,0,0,0
2020-06-30 16:30,153,77,76,0,0,0
2020-06-30 16:45,168,101,67,0,0,0
2020-06-30 17:00,166,91,75,0,0,0
2020-06-30 17:15,175,75,100,0,0,0
2020-06-30 17:30,176,92,84,0,0,0
2020-06-30 17:45,164,81,83,0,0,0
2020-06-30 18:00,140,79,61,0,0,0
2020-06-30 18:15,154,84,70,0,0,0
2020-06-30 18:30,148,73,75,0,0,0
2020-06-30 18:45,159,96,63,0,0,0
2020-06-30 19:00,107,53,54,0,0,0
2020-06-30 19:15,105,54,51,0,0,0
2020-06-30 19:30,108,58,50,0,0,0
2020-06-30 19:45,120,48,72,0,0,0
2020-06-30 20:00,92,46,46,0,0,0
2020-06-30 20:15,85,35,50,0,0,0
2020-06-30 20:30,76,35,41,0,0,0
2020-06-30 20:45,74,31,43,0,0,0
2020-06-30 21:00,69,22,47,0,0,0
2020-06-30 21:15,61,22,39,0,0,0
2020-06-30 21:30,55,24,31,0,0,0
2020-06-30 21:45,46,17,29,0,0,0
2020-06-30 22:00,56,32,24,0,0,0
2020-06-30 22:15,30,12,18,0,0,0
2020-06-30 22:30,45,19,26,0,0,0
2020-06-30 22:45,32,17,15,0,0,0
2020-06-30 23:00,29,10,19,0,0,0
2020-06-30 23:15,23,12,11,0,0,0
2020-06-30 23:30,23,11,12,0,0,0
2020-06-30 23:45,20,6,14,0,0,0
