Datetime,100034982 (Hüfferstraße),101034982 (Hüfferstraße stadteinwärts),102034982 (Hüfferstraße stadtauswärts),100034982-status,101034982-status,102034982-status
2021-08-01 00:00,22,2,20,0,0,0
2021-08-01 00:15,19,3,16,0,0,0
2021-08-01 00:30,11,1,10,0,0,0
2021-08-01 00:45,10,2,8,0,0,0
2021-08-01 01:00,12,3,9,0,0,0
2021-08-01 01:15,12,0,12,0,0,0
2021-08-01 01:30,18,5,13,0,0,0
2021-08-01 01:45,6,2,4,0,0,0
2021-08-01 02:00,6,0,6,0,0,0
2021-08-01 02:15,4,0,4,0,0,0
2021-08-01 02:30,7,5,2,0,0,0
2021-08-01 02:45,6,6,0,0,0,0
2021-08-01 03:00,5,0,5,0,0,0
2021-08-01 03:15,7,3,4,0,0,0
2021-08-01 03:30,1,0,1,0,0,0
2021-08-01 03:45,2,0,2,0,0,0
2021-08-01 04:00,5,0,5,0,0,0
2021-08-01 04:15,4,0,4,0,0,0
2021-08-01 04:30,9,1,8,0,0,0
2021-08-01 04:45,1,1,0,0,0,0
2021-08-01 05:00,1,0,1,0,0,0
2021-08-01 05:15,2,0,2,0,0,0
2021-08-01 05:30,5,1,4,0,0,0
2021-08-01 05:45,1,0,1,0,0,0
2021-08-01 06:00,2,1,1,0,0,0
2021-08-01 06:15,2,1,1,0,0,0
2021-08-01 06:30,7,5,2,0,0,0
2021-08-01 06:45,8,4,4,0,0,0
2021-08-01 07:00,4,2,2,0,0,0
2021-08-01 07:15,0,0,0,0,0,0
2021-08-01 07:30,4,0,4,0,0,0
2021-08-01 07:45,10,3,7,0,0,0
2021-08-01 08:00,7,3,4,0,0,0
2021-08-01 08:15,7,1,6,0,0,0
2021-08-01 08:30,17,14,3,0,0,0
2021-08-01 08:45,21,15,6,0,0,0
2021-08-01 09:00,12,6,6,0,0,0
2021-08-01 09:15,15,10,5,0,0,0
2021-08-01 09:30,17,10,7,0,0,0
2021-08-01 09:45,25,13,12,0,0,0
2021-08-01 10:00,18,6,12,0,0,0
2021-08-01 10:15,28,11,17,0,0,0
2021-08-01 10:30,45,25,20,0,0,0
2021-08-01 10:45,29,11,18,0,0,0
2021-08-01 11:00,33,15,18,0,0,0
2021-08-01 11:15,29,13,16,0,0,0
2021-08-01 11:30,31,12,19,0,0,0
2021-08-01 11:45,41,21,20,0,0,0
2021-08-01 12:00,48,20,28,0,0,0
2021-08-01 12:15,40,23,17,0,0,0
2021-08-01 12:30,45,15,30,0,0,0
2021-08-01 12:45,46,31,15,0,0,0
2021-08-01 13:00,61,25,36,0,0,0
2021-08-01 13:15,43,16,27,0,0,0
2021-08-01 13:30,69,28,41,0,0,0
2021-08-01 13:45,67,26,41,0,0,0
2021-08-01 14:00,57,36,21,0,0,0
2021-08-01 14:15,58,30,28,0,0,0
2021-08-01 14:30,73,39,34,0,0,0
2021-08-01 14:45,61,26,35,0,0,0
2021-08-01 15:00,59,30,29,0,0,0
2021-08-01 15:15,42,19,23,0,0,0
2021-08-01 15:30,44,19,25,0,0,0
2021-08-01 15:45,41,14,27,0,0,0
2021-08-01 16:00,61,26,35,0,0,0
2021-08-01 16:15,51,15,36,0,0,0
2021-08-01 16:30,51,16,35,0,0,0
2021-08-01 16:45,50,23,27,0,0,0
2021-08-01 17:00,48,12,36,0,0,0
2021-08-01 17:15,26,4,22,0,0,0
2021-08-01 17:30,45,13,32,0,0,0
2021-08-01 17:45,40,21,19,0,0,0
2021-08-01 18:00,58,28,30,0,0,0
2021-08-01 18:15,36,21,15,0,0,0
2021-08-01 18:30,29,12,17,0,0,0
2021-08-01 18:45,34,14,20,0,0,0
2021-08-01 19:00,27,15,12,0,0,0
2021-08-01 19:15,15,3,12,0,0,0
2021-08-01 19:30,28,9,19,0,0,0
2021-08-01 19:45,25,8,17,0,0,0
2021-08-01 20:00,28,9,19,0,0,0
2021-08-01 20:15,20,10,10,0,0,0
2021-08-01 20:30,19,10,9,0,0,0
2021-08-01 20:45,35,17,18,0,0,0
2021-08-01 21:00,20,5,15,0,0,0
2021-08-01 21:15,20,6,14,0,0,0
2021-08-01 21:30,19,8,11,0,0,0
2021-08-01 21:45,17,5,12,0,0,0
2021-08-01 22:00,16,4,12,0,0,0
2021-08-01 22:15,16,7,9,0,0,0
2021-08-01 22:30,22,2,20,0,0,0
2021-08-01 22:45,6,3,3,0,0,0
2021-08-01 23:00,10,5,5,0,0,0
2021-08-01 23:15,7,2,5,0,0,0
2021-08-01 23:30,5,4,1,0,0,0
2021-08-01 23:45,18,3,15,0,0,0
2021-08-02 00:00,6,0,6,0,0,0
2021-08-02 00:15,5,1,4,0,0,0
2021-08-02 00:30,0,0,0,0,0,0
2021-08-02 00:45,1,0,1,0,0,0
2021-08-02 01:00,0,0,0,0,0,0
2021-08-02 01:15,5,1,4,0,0,0
2021-08-02 01:30,0,0,0,0,0,0
2021-08-02 01:45,1,1,0,0,0,0
2021-08-02 02:00,2,1,1,0,0,0
2021-08-02 02:15,1,1,0,0,0,0
2021-08-02 02:30,0,0,0,0,0,0
2021-08-02 02:45,0,0,0,0,0,0
2021-08-02 03:00,0,0,0,0,0,0
2021-08-02 03:15,0,0,0,0,0,0
2021-08-02 03:30,2,0,2,0,0,0
2021-08-02 03:45,1,0,1,0,0,0
2021-08-02 04:00,2,1,1,0,0,0
2021-08-02 04:15,1,0,1,0,0,0
2021-08-02 04:30,0,0,0,0,0,0
2021-08-02 04:45,0,0,0,0,0,0
2021-08-02 05:00,0,0,0,0,0,0
2021-08-02 05:15,3,3,0,0,0,0
2021-08-02 05:30,6,1,5,0,0,0
2021-08-02 05:45,6,1,5,0,0,0
2021-08-02 06:00,6,4,2,0,0,0
2021-08-02 06:15,17,5,12,0,0,0
2021-08-02 06:30,34,11,23,0,0,0
2021-08-02 06:45,50,23,27,0,0,0
2021-08-02 07:00,62,20,42,0,0,0
2021-08-02 07:15,67,26,41,0,0,0
2021-08-02 07:30,83,34,49,0,0,0
2021-08-02 07:45,97,38,59,0,0,0
2021-08-02 08:00,63,29,34,0,0,0
2021-08-02 08:15,99,48,51,0,0,0
2021-08-02 08:30,74,31,43,0,0,0
2021-08-02 08:45,93,51,42,0,0,0
2021-08-02 09:00,61,30,31,0,0,0
2021-08-02 09:15,50,21,29,0,0,0
2021-08-02 09:30,67,39,28,0,0,0
2021-08-02 09:45,64,35,29,0,0,0
2021-08-02 10:00,51,27,24,0,0,0
2021-08-02 10:15,56,35,21,0,0,0
2021-08-02 10:30,51,20,31,0,0,0
2021-08-02 10:45,38,21,17,0,0,0
2021-08-02 11:00,53,24,29,0,0,0
2021-08-02 11:15,50,28,22,0,0,0
2021-08-02 11:30,50,19,31,0,0,0
2021-08-02 11:45,69,26,43,0,0,0
2021-08-02 12:00,65,32,33,0,0,0
2021-08-02 12:15,90,44,46,0,0,0
2021-08-02 12:30,72,29,43,0,0,0
2021-08-02 12:45,65,33,32,0,0,0
2021-08-02 13:00,80,42,38,0,0,0
2021-08-02 13:15,73,36,37,0,0,0
2021-08-02 13:30,68,30,38,0,0,0
2021-08-02 13:45,93,46,47,0,0,0
2021-08-02 14:00,76,32,44,0,0,0
2021-08-02 14:15,84,48,36,0,0,0
2021-08-02 14:30,94,48,46,0,0,0
2021-08-02 14:45,79,40,39,0,0,0
2021-08-02 15:00,75,44,31,0,0,0
2021-08-02 15:15,104,56,48,0,0,0
2021-08-02 15:30,100,59,41,0,0,0
2021-08-02 15:45,97,58,39,0,0,0
2021-08-02 16:00,139,79,60,0,0,0
2021-08-02 16:15,106,55,51,0,0,0
2021-08-02 16:30,127,62,65,0,0,0
2021-08-02 16:45,122,65,57,0,0,0
2021-08-02 17:00,136,75,61,0,0,0
2021-08-02 17:15,117,46,71,0,0,0
2021-08-02 17:30,99,52,47,0,0,0
2021-08-02 17:45,99,38,61,0,0,0
2021-08-02 18:00,92,45,47,0,0,0
2021-08-02 18:15,77,29,48,0,0,0
2021-08-02 18:30,62,21,41,0,0,0
2021-08-02 18:45,67,32,35,0,0,0
2021-08-02 19:00,60,23,37,0,0,0
2021-08-02 19:15,30,16,14,0,0,0
2021-08-02 19:30,58,29,29,0,0,0
2021-08-02 19:45,59,16,43,0,0,0
2021-08-02 20:00,44,16,28,0,0,0
2021-08-02 20:15,48,14,34,0,0,0
2021-08-02 20:30,36,20,16,0,0,0
2021-08-02 20:45,39,20,19,0,0,0
2021-08-02 21:00,47,22,25,0,0,0
2021-08-02 21:15,29,8,21,0,0,0
2021-08-02 21:30,30,7,23,0,0,0
2021-08-02 21:45,17,4,13,0,0,0
2021-08-02 22:00,25,4,21,0,0,0
2021-08-02 22:15,19,8,11,0,0,0
2021-08-02 22:30,19,0,19,0,0,0
2021-08-02 22:45,13,6,7,0,0,0
2021-08-02 23:00,26,6,20,0,0,0
2021-08-02 23:15,10,2,8,0,0,0
2021-08-02 23:30,9,4,5,0,0,0
2021-08-02 23:45,6,2,4,0,0,0
2021-08-03 00:00,19,0,19,0,0,0
2021-08-03 00:15,17,2,15,0,0,0
2021-08-03 00:30,4,1,3,0,0,0
2021-08-03 00:45,6,3,3,0,0,0
2021-08-03 01:00,4,2,2,0,0,0
2021-08-03 01:15,5,1,4,0,0,0
2021-08-03 01:30,3,0,3,0,0,0
2021-08-03 01:45,2,2,0,0,0,0
2021-08-03 02:00,2,1,1,0,0,0
2021-08-03 02:15,1,1,0,0,0,0
2021-08-03 02:30,2,0,2,0,0,0
2021-08-03 02:45,1,0,1,0,0,0
2021-08-03 03:00,2,1,1,0,0,0
2021-08-03 03:15,1,1,0,0,0,0
2021-08-03 03:30,0,0,0,0,0,0
2021-08-03 03:45,0,0,0,0,0,0
2021-08-03 04:00,0,0,0,0,0,0
2021-08-03 04:15,0,0,0,0,0,0
2021-08-03 04:30,3,1,2,0,0,0
2021-08-03 04:45,0,0,0,0,0,0
2021-08-03 05:00,4,3,1,0,0,0
2021-08-03 05:15,3,3,0,0,0,0
2021-08-03 05:30,7,1,6,0,0,0
2021-08-03 05:45,4,0,4,0,0,0
2021-08-03 06:00,4,2,2,0,0,0
2021-08-03 06:15,18,9,9,0,0,0
2021-08-03 06:30,32,11,21,0,0,0
2021-08-03 06:45,55,20,35,0,0,0
2021-08-03 07:00,62,22,40,0,0,0
2021-08-03 07:15,70,31,39,0,0,0
2021-08-03 07:30,79,26,53,0,0,0
2021-08-03 07:45,97,27,70,0,0,0
2021-08-03 08:00,92,46,46,0,0,0
2021-08-03 08:15,94,51,43,0,0,0
2021-08-03 08:30,81,37,44,0,0,0
2021-08-03 08:45,93,49,44,0,0,0
2021-08-03 09:00,66,31,35,0,0,0
2021-08-03 09:15,54,26,28,0,0,0
2021-08-03 09:30,54,24,30,0,0,0
2021-08-03 09:45,84,30,54,0,0,0
2021-08-03 10:00,50,25,25,0,0,0
2021-08-03 10:15,46,27,19,0,0,0
2021-08-03 10:30,56,27,29,0,0,0
2021-08-03 10:45,65,39,26,0,0,0
2021-08-03 11:00,55,26,29,0,0,0
2021-08-03 11:15,87,48,39,0,0,0
2021-08-03 11:30,76,43,33,0,0,0
2021-08-03 11:45,68,27,41,0,0,0
2021-08-03 12:00,77,30,47,0,0,0
2021-08-03 12:15,74,39,35,0,0,0
2021-08-03 12:30,67,33,34,0,0,0
2021-08-03 12:45,64,30,34,0,0,0
2021-08-03 13:00,70,28,42,0,0,0
2021-08-03 13:15,77,36,41,0,0,0
2021-08-03 13:30,65,38,27,0,0,0
2021-08-03 13:45,68,36,32,0,0,0
2021-08-03 14:00,96,43,53,0,0,0
2021-08-03 14:15,66,34,32,0,0,0
2021-08-03 14:30,84,36,48,0,0,0
2021-08-03 14:45,76,51,25,0,0,0
2021-08-03 15:00,108,54,54,0,0,0
2021-08-03 15:15,80,48,32,0,0,0
2021-08-03 15:30,88,50,38,0,0,0
2021-08-03 15:45,94,55,39,0,0,0
2021-08-03 16:00,101,47,54,0,0,0
2021-08-03 16:15,117,77,40,0,0,0
2021-08-03 16:30,123,71,52,0,0,0
2021-08-03 16:45,117,62,55,0,0,0
2021-08-03 17:00,96,39,57,0,0,0
2021-08-03 17:15,119,54,65,0,0,0
2021-08-03 17:30,109,41,68,0,0,0
2021-08-03 17:45,118,49,69,0,0,0
2021-08-03 18:00,132,64,68,0,0,0
2021-08-03 18:15,106,39,67,0,0,0
2021-08-03 18:30,63,29,34,0,0,0
2021-08-03 18:45,80,41,39,0,0,0
2021-08-03 19:00,61,27,34,0,0,0
2021-08-03 19:15,82,35,47,0,0,0
2021-08-03 19:30,59,25,34,0,0,0
2021-08-03 19:45,60,23,37,0,0,0
2021-08-03 20:00,60,26,34,0,0,0
2021-08-03 20:15,48,16,32,0,0,0
2021-08-03 20:30,25,9,16,0,0,0
2021-08-03 20:45,41,14,27,0,0,0
2021-08-03 21:00,29,16,13,0,0,0
2021-08-03 21:15,27,6,21,0,0,0
2021-08-03 21:30,26,9,17,0,0,0
2021-08-03 21:45,37,2,35,0,0,0
2021-08-03 22:00,27,7,20,0,0,0
2021-08-03 22:15,30,11,19,0,0,0
2021-08-03 22:30,14,4,10,0,0,0
2021-08-03 22:45,15,1,14,0,0,0
2021-08-03 23:00,14,1,13,0,0,0
2021-08-03 23:15,18,7,11,0,0,0
2021-08-03 23:30,6,1,5,0,0,0
2021-08-03 23:45,7,1,6,0,0,0
2021-08-04 00:00,4,0,4,0,0,0
2021-08-04 00:15,4,1,3,0,0,0
2021-08-04 00:30,13,3,10,0,0,0
2021-08-04 00:45,4,1,3,0,0,0
2021-08-04 01:00,2,1,1,0,0,0
2021-08-04 01:15,5,0,5,0,0,0
2021-08-04 01:30,5,1,4,0,0,0
2021-08-04 01:45,2,0,2,0,0,0
2021-08-04 02:00,2,2,0,0,0,0
2021-08-04 02:15,0,0,0,0,0,0
2021-08-04 02:30,0,0,0,0,0,0
2021-08-04 02:45,0,0,0,0,0,0
2021-08-04 03:00,1,0,1,0,0,0
2021-08-04 03:15,4,3,1,0,0,0
2021-08-04 03:30,0,0,0,0,0,0
2021-08-04 03:45,1,1,0,0,0,0
2021-08-04 04:00,0,0,0,0,0,0
2021-08-04 04:15,0,0,0,0,0,0
2021-08-04 04:30,2,1,1,0,0,0
2021-08-04 04:45,2,1,1,0,0,0
2021-08-04 05:00,3,2,1,0,0,0
2021-08-04 05:15,1,1,0,0,0,0
2021-08-04 05:30,6,1,5,0,0,0
2021-08-04 05:45,6,1,5,0,0,0
2021-08-04 06:00,4,4,0,0,0,0
2021-08-04 06:15,16,2,14,0,0,0
2021-08-04 06:30,34,14,20,0,0,0
2021-08-04 06:45,51,18,33,0,0,0
2021-08-04 07:00,59,20,39,0,0,0
2021-08-04 07:15,73,29,44,0,0,0
2021-08-04 07:30,72,29,43,0,0,0
2021-08-04 07:45,129,55,74,0,0,0
2021-08-04 08:00,92,35,57,0,0,0
2021-08-04 08:15,89,48,41,0,0,0
2021-08-04 08:30,98,39,59,0,0,0
2021-08-04 08:45,113,53,60,0,0,0
2021-08-04 09:00,68,36,32,0,0,0
2021-08-04 09:15,77,42,35,0,0,0
2021-08-04 09:30,76,56,20,0,0,0
2021-08-04 09:45,80,48,32,0,0,0
2021-08-04 10:00,69,43,26,0,0,0
2021-08-04 10:15,83,49,34,0,0,0
2021-08-04 10:30,60,39,21,0,0,0
2021-08-04 10:45,88,47,41,0,0,0
2021-08-04 11:00,90,53,37,0,0,0
2021-08-04 11:15,107,65,42,0,0,0
2021-08-04 11:30,104,53,51,0,0,0
2021-08-04 11:45,101,66,35,0,0,0
2021-08-04 12:00,88,44,44,0,0,0
2021-08-04 12:15,120,48,72,0,0,0
2021-08-04 12:30,104,32,72,0,0,0
2021-08-04 12:45,114,54,60,0,0,0
2021-08-04 13:00,109,42,67,0,0,0
2021-08-04 13:15,98,43,55,0,0,0
2021-08-04 13:30,110,43,67,0,0,0
2021-08-04 13:45,112,47,65,0,0,0
2021-08-04 14:00,117,55,62,0,0,0
2021-08-04 14:15,119,56,63,0,0,0
2021-08-04 14:30,82,37,45,0,0,0
2021-08-04 14:45,85,41,44,0,0,0
2021-08-04 15:00,83,36,47,0,0,0
2021-08-04 15:15,99,64,35,0,0,0
2021-08-04 15:30,98,45,53,0,0,0
2021-08-04 15:45,100,64,36,0,0,0
2021-08-04 16:00,124,59,65,0,0,0
2021-08-04 16:15,138,77,61,0,0,0
2021-08-04 16:30,117,61,56,0,0,0
2021-08-04 16:45,108,66,42,0,0,0
2021-08-04 17:00,100,43,57,0,0,0
2021-08-04 17:15,107,46,61,0,0,0
2021-08-04 17:30,81,40,41,0,0,0
2021-08-04 17:45,117,46,71,0,0,0
2021-08-04 18:00,133,56,77,0,0,0
2021-08-04 18:15,111,36,75,0,0,0
2021-08-04 18:30,80,21,59,0,0,0
2021-08-04 18:45,49,12,37,0,0,0
2021-08-04 19:00,42,16,26,0,0,0
2021-08-04 19:15,37,15,22,0,0,0
2021-08-04 19:30,49,17,32,0,0,0
2021-08-04 19:45,51,23,28,0,0,0
2021-08-04 20:00,48,17,31,0,0,0
2021-08-04 20:15,49,23,26,0,0,0
2021-08-04 20:30,27,9,18,0,0,0
2021-08-04 20:45,43,25,18,0,0,0
2021-08-04 21:00,31,17,14,0,0,0
2021-08-04 21:15,26,14,12,0,0,0
2021-08-04 21:30,17,10,7,0,0,0
2021-08-04 21:45,24,8,16,0,0,0
2021-08-04 22:00,16,4,12,0,0,0
2021-08-04 22:15,15,6,9,0,0,0
2021-08-04 22:30,20,5,15,0,0,0
2021-08-04 22:45,20,8,12,0,0,0
2021-08-04 23:00,5,2,3,0,0,0
2021-08-04 23:15,19,1,18,0,0,0
2021-08-04 23:30,9,2,7,0,0,0
2021-08-04 23:45,18,2,16,0,0,0
2021-08-05 00:00,5,0,5,0,0,0
2021-08-05 00:15,10,2,8,0,0,0
2021-08-05 00:30,1,0,1,0,0,0
2021-08-05 00:45,4,2,2,0,0,0
2021-08-05 01:00,2,0,2,0,0,0
2021-08-05 01:15,4,0,4,0,0,0
2021-08-05 01:30,0,0,0,0,0,0
2021-08-05 01:45,0,0,0,0,0,0
2021-08-05 02:00,0,0,0,0,0,0
2021-08-05 02:15,11,2,9,0,0,0
2021-08-05 02:30,1,0,1,0,0,0
2021-08-05 02:45,1,0,1,0,0,0
2021-08-05 03:00,4,0,4,0,0,0
2021-08-05 03:15,0,0,0,0,0,0
2021-08-05 03:30,1,0,1,0,0,0
2021-08-05 03:45,0,0,0,0,0,0
2021-08-05 04:00,2,0,2,0,0,0
2021-08-05 04:15,0,0,0,0,0,0
2021-08-05 04:30,2,1,1,0,0,0
2021-08-05 04:45,3,0,3,0,0,0
2021-08-05 05:00,4,1,3,0,0,0
2021-08-05 05:15,3,2,1,0,0,0
2021-08-05 05:30,5,1,4,0,0,0
2021-08-05 05:45,7,1,6,0,0,0
2021-08-05 06:00,5,2,3,0,0,0
2021-08-05 06:15,17,6,11,0,0,0
2021-08-05 06:30,36,11,25,0,0,0
2021-08-05 06:45,40,11,29,0,0,0
2021-08-05 07:00,45,15,30,0,0,0
2021-08-05 07:15,65,21,44,0,0,0
2021-08-05 07:30,81,27,54,0,0,0
2021-08-05 07:45,111,39,72,0,0,0
2021-08-05 08:00,74,29,45,0,0,0
2021-08-05 08:15,86,38,48,0,0,0
2021-08-05 08:30,80,39,41,0,0,0
2021-08-05 08:45,102,49,53,0,0,0
2021-08-05 09:00,63,24,39,0,0,0
2021-08-05 09:15,65,27,38,0,0,0
2021-08-05 09:30,46,24,22,0,0,0
2021-08-05 09:45,65,38,27,0,0,0
2021-08-05 10:00,47,26,21,0,0,0
2021-08-05 10:15,44,27,17,0,0,0
2021-08-05 10:30,49,22,27,0,0,0
2021-08-05 10:45,65,35,30,0,0,0
2021-08-05 11:00,57,27,30,0,0,0
2021-08-05 11:15,67,29,38,0,0,0
2021-08-05 11:30,44,22,22,0,0,0
2021-08-05 11:45,60,29,31,0,0,0
2021-08-05 12:00,80,44,36,0,0,0
2021-08-05 12:15,79,28,51,0,0,0
2021-08-05 12:30,89,43,46,0,0,0
2021-08-05 12:45,87,47,40,0,0,0
2021-08-05 13:00,84,40,44,0,0,0
2021-08-05 13:15,51,23,28,0,0,0
2021-08-05 13:30,89,33,56,0,0,0
2021-08-05 13:45,105,44,61,0,0,0
2021-08-05 14:00,73,38,35,0,0,0
2021-08-05 14:15,84,48,36,0,0,0
2021-08-05 14:30,91,43,48,0,0,0
2021-08-05 14:45,99,42,57,0,0,0
2021-08-05 15:00,115,60,55,0,0,0
2021-08-05 15:15,88,42,46,0,0,0
2021-08-05 15:30,107,65,42,0,0,0
2021-08-05 15:45,118,74,44,0,0,0
2021-08-05 16:00,106,58,48,0,0,0
2021-08-05 16:15,116,59,57,0,0,0
2021-08-05 16:30,118,71,47,0,0,0
2021-08-05 16:45,121,57,64,0,0,0
2021-08-05 17:00,122,66,56,0,0,0
2021-08-05 17:15,101,53,48,0,0,0
2021-08-05 17:30,129,59,70,0,0,0
2021-08-05 17:45,136,73,63,0,0,0
2021-08-05 18:00,99,32,67,0,0,0
2021-08-05 18:15,101,36,65,0,0,0
2021-08-05 18:30,76,33,43,0,0,0
2021-08-05 18:45,75,34,41,0,0,0
2021-08-05 19:00,79,37,42,0,0,0
2021-08-05 19:15,57,25,32,0,0,0
2021-08-05 19:30,77,35,42,0,0,0
2021-08-05 19:45,63,22,41,0,0,0
2021-08-05 20:00,61,25,36,0,0,0
2021-08-05 20:15,46,15,31,0,0,0
2021-08-05 20:30,49,27,22,0,0,0
2021-08-05 20:45,44,11,33,0,0,0
2021-08-05 21:00,43,23,20,0,0,0
2021-08-05 21:15,35,17,18,0,0,0
2021-08-05 21:30,22,8,14,0,0,0
2021-08-05 21:45,28,11,17,0,0,0
2021-08-05 22:00,26,9,17,0,0,0
2021-08-05 22:15,19,7,12,0,0,0
2021-08-05 22:30,35,4,31,0,0,0
2021-08-05 22:45,23,1,22,0,0,0
2021-08-05 23:00,10,4,6,0,0,0
2021-08-05 23:15,25,5,20,0,0,0
2021-08-05 23:30,6,0,6,0,0,0
2021-08-05 23:45,38,4,34,0,0,0
2021-08-06 00:00,34,6,28,0,0,0
2021-08-06 00:15,13,3,10,0,0,0
2021-08-06 00:30,4,0,4,0,0,0
2021-08-06 00:45,6,2,4,0,0,0
2021-08-06 01:00,7,2,5,0,0,0
2021-08-06 01:15,2,2,0,0,0,0
2021-08-06 01:30,3,1,2,0,0,0
2021-08-06 01:45,6,3,3,0,0,0
2021-08-06 02:00,2,0,2,0,0,0
2021-08-06 02:15,0,0,0,0,0,0
2021-08-06 02:30,2,0,2,0,0,0
2021-08-06 02:45,0,0,0,0,0,0
2021-08-06 03:00,0,0,0,0,0,0
2021-08-06 03:15,0,0,0,0,0,0
2021-08-06 03:30,1,0,1,0,0,0
2021-08-06 03:45,1,0,1,0,0,0
2021-08-06 04:00,0,0,0,0,0,0
2021-08-06 04:15,0,0,0,0,0,0
2021-08-06 04:30,2,1,1,0,0,0
2021-08-06 04:45,1,0,1,0,0,0
2021-08-06 05:00,1,1,0,0,0,0
2021-08-06 05:15,4,3,1,0,0,0
2021-08-06 05:30,7,2,5,0,0,0
2021-08-06 05:45,7,0,7,0,0,0
2021-08-06 06:00,9,3,6,0,0,0
2021-08-06 06:15,17,9,8,0,0,0
2021-08-06 06:30,44,16,28,0,0,0
2021-08-06 06:45,41,13,28,0,0,0
2021-08-06 07:00,45,9,36,0,0,0
2021-08-06 07:15,48,20,28,0,0,0
2021-08-06 07:30,54,14,40,0,0,0
2021-08-06 07:45,82,28,54,0,0,0
2021-08-06 08:00,47,18,29,0,0,0
2021-08-06 08:15,67,25,42,0,0,0
2021-08-06 08:30,60,33,27,0,0,0
2021-08-06 08:45,85,43,42,0,0,0
2021-08-06 09:00,72,19,53,0,0,0
2021-08-06 09:15,49,23,26,0,0,0
2021-08-06 09:30,52,29,23,0,0,0
2021-08-06 09:45,56,33,23,0,0,0
2021-08-06 10:00,46,34,12,0,0,0
2021-08-06 10:15,35,23,12,0,0,0
2021-08-06 10:30,35,10,25,0,0,0
2021-08-06 10:45,38,17,21,0,0,0
2021-08-06 11:00,57,36,21,0,0,0
2021-08-06 11:15,39,29,10,0,0,0
2021-08-06 11:30,61,36,25,0,0,0
2021-08-06 11:45,74,49,25,0,0,0
2021-08-06 12:00,50,31,19,0,0,0
2021-08-06 12:15,57,24,33,0,0,0
2021-08-06 12:30,52,26,26,0,0,0
2021-08-06 12:45,69,32,37,0,0,0
2021-08-06 13:00,89,48,41,0,0,0
2021-08-06 13:15,58,26,32,0,0,0
2021-08-06 13:30,69,35,34,0,0,0
2021-08-06 13:45,77,32,45,0,0,0
2021-08-06 14:00,81,46,35,0,0,0
2021-08-06 14:15,80,40,40,0,0,0
2021-08-06 14:30,83,49,34,0,0,0
2021-08-06 14:45,93,40,53,0,0,0
2021-08-06 15:00,87,50,37,0,0,0
2021-08-06 15:15,82,40,42,0,0,0
2021-08-06 15:30,83,56,27,0,0,0
2021-08-06 15:45,83,43,40,0,0,0
2021-08-06 16:00,106,60,46,0,0,0
2021-08-06 16:15,76,36,40,0,0,0
2021-08-06 16:30,78,38,40,0,0,0
2021-08-06 16:45,82,46,36,0,0,0
2021-08-06 17:00,85,45,40,0,0,0
2021-08-06 17:15,72,37,35,0,0,0
2021-08-06 17:30,75,41,34,0,0,0
2021-08-06 17:45,73,33,40,0,0,0
2021-08-06 18:00,79,34,45,0,0,0
2021-08-06 18:15,67,26,41,0,0,0
2021-08-06 18:30,60,25,35,0,0,0
2021-08-06 18:45,48,28,20,0,0,0
2021-08-06 19:00,36,17,19,0,0,0
2021-08-06 19:15,56,24,32,0,0,0
2021-08-06 19:30,35,13,22,0,0,0
2021-08-06 19:45,43,27,16,0,0,0
2021-08-06 20:00,55,30,25,0,0,0
2021-08-06 20:15,36,14,22,0,0,0
2021-08-06 20:30,42,14,28,0,0,0
2021-08-06 20:45,30,18,12,0,0,0
2021-08-06 21:00,34,11,23,0,0,0
2021-08-06 21:15,29,14,15,0,0,0
2021-08-06 21:30,26,11,15,0,0,0
2021-08-06 21:45,34,4,30,0,0,0
2021-08-06 22:00,22,6,16,0,0,0
2021-08-06 22:15,35,13,22,0,0,0
2021-08-06 22:30,31,4,27,0,0,0
2021-08-06 22:45,26,11,15,0,0,0
2021-08-06 23:00,48,5,43,0,0,0
2021-08-06 23:15,21,2,19,0,0,0
2021-08-06 23:30,20,5,15,0,0,0
2021-08-06 23:45,27,6,21,0,0,0
2021-08-07 00:00,19,6,13,0,0,0
2021-08-07 00:15,11,6,5,0,0,0
2021-08-07 00:30,16,6,10,0,0,0
2021-08-07 00:45,18,7,11,0,0,0
2021-08-07 01:00,11,5,6,0,0,0
2021-08-07 01:15,8,3,5,0,0,0
2021-08-07 01:30,7,3,4,0,0,0
2021-08-07 01:45,12,2,10,0,0,0
2021-08-07 02:00,13,6,7,0,0,0
2021-08-07 02:15,9,0,9,0,0,0
2021-08-07 02:30,4,0,4,0,0,0
2021-08-07 02:45,6,2,4,0,0,0
2021-08-07 03:00,8,0,8,0,0,0
2021-08-07 03:15,6,4,2,0,0,0
2021-08-07 03:30,9,1,8,0,0,0
2021-08-07 03:45,4,0,4,0,0,0
2021-08-07 04:00,2,0,2,0,0,0
2021-08-07 04:15,2,0,2,0,0,0
2021-08-07 04:30,6,1,5,0,0,0
2021-08-07 04:45,0,0,0,0,0,0
2021-08-07 05:00,1,0,1,0,0,0
2021-08-07 05:15,1,1,0,0,0,0
2021-08-07 05:30,2,0,2,0,0,0
2021-08-07 05:45,7,3,4,0,0,0
2021-08-07 06:00,4,1,3,0,0,0
2021-08-07 06:15,5,2,3,0,0,0
2021-08-07 06:30,9,7,2,0,0,0
2021-08-07 06:45,13,10,3,0,0,0
2021-08-07 07:00,6,4,2,0,0,0
2021-08-07 07:15,6,5,1,0,0,0
2021-08-07 07:30,15,8,7,0,0,0
2021-08-07 07:45,19,9,10,0,0,0
2021-08-07 08:00,13,10,3,0,0,0
2021-08-07 08:15,25,12,13,0,0,0
2021-08-07 08:30,33,20,13,0,0,0
2021-08-07 08:45,40,29,11,0,0,0
2021-08-07 09:00,41,20,21,0,0,0
2021-08-07 09:15,49,34,15,0,0,0
2021-08-07 09:30,39,29,10,0,0,0
2021-08-07 09:45,50,27,23,0,0,0
2021-08-07 10:00,60,37,23,0,0,0
2021-08-07 10:15,63,32,31,0,0,0
2021-08-07 10:30,68,49,19,0,0,0
2021-08-07 10:45,87,55,32,0,0,0
2021-08-07 11:00,65,31,34,0,0,0
2021-08-07 11:15,74,40,34,0,0,0
2021-08-07 11:30,83,42,41,0,0,0
2021-08-07 11:45,59,38,21,0,0,0
2021-08-07 12:00,66,41,25,0,0,0
2021-08-07 12:15,90,49,41,0,0,0
2021-08-07 12:30,104,58,46,0,0,0
2021-08-07 12:45,49,30,19,0,0,0
2021-08-07 13:00,75,27,48,0,0,0
2021-08-07 13:15,68,38,30,0,0,0
2021-08-07 13:30,92,43,49,0,0,0
2021-08-07 13:45,108,57,51,0,0,0
2021-08-07 14:00,82,33,49,0,0,0
2021-08-07 14:15,80,32,48,0,0,0
2021-08-07 14:30,81,21,60,0,0,0
2021-08-07 14:45,78,32,46,0,0,0
2021-08-07 15:00,72,22,50,0,0,0
2021-08-07 15:15,69,38,31,0,0,0
2021-08-07 15:30,66,27,39,0,0,0
2021-08-07 15:45,90,42,48,0,0,0
2021-08-07 16:00,60,24,36,0,0,0
2021-08-07 16:15,59,33,26,0,0,0
2021-08-07 16:30,68,34,34,0,0,0
2021-08-07 16:45,55,23,32,0,0,0
2021-08-07 17:00,66,34,32,0,0,0
2021-08-07 17:15,55,26,29,0,0,0
2021-08-07 17:30,69,30,39,0,0,0
2021-08-07 17:45,53,26,27,0,0,0
2021-08-07 18:00,63,22,41,0,0,0
2021-08-07 18:15,56,28,28,0,0,0
2021-08-07 18:30,66,33,33,0,0,0
2021-08-07 18:45,67,25,42,0,0,0
2021-08-07 19:00,55,13,42,0,0,0
2021-08-07 19:15,56,31,25,0,0,0
2021-08-07 19:30,51,19,32,0,0,0
2021-08-07 19:45,66,23,43,0,0,0
2021-08-07 20:00,56,20,36,0,0,0
2021-08-07 20:15,30,17,13,0,0,0
2021-08-07 20:30,30,11,19,0,0,0
2021-08-07 20:45,28,10,18,0,0,0
2021-08-07 21:00,18,8,10,0,0,0
2021-08-07 21:15,17,5,12,0,0,0
2021-08-07 21:30,32,7,25,0,0,0
2021-08-07 21:45,24,8,16,0,0,0
2021-08-07 22:00,21,9,12,0,0,0
2021-08-07 22:15,17,6,11,0,0,0
2021-08-07 22:30,9,2,7,0,0,0
2021-08-07 22:45,11,2,9,0,0,0
2021-08-07 23:00,16,3,13,0,0,0
2021-08-07 23:15,14,8,6,0,0,0
2021-08-07 23:30,19,1,18,0,0,0
2021-08-07 23:45,12,5,7,0,0,0
2021-08-08 00:00,10,0,10,0,0,0
2021-08-08 00:15,14,4,10,0,0,0
2021-08-08 00:30,13,5,8,0,0,0
2021-08-08 00:45,14,3,11,0,0,0
2021-08-08 01:00,8,1,7,0,0,0
2021-08-08 01:15,15,7,8,0,0,0
2021-08-08 01:30,10,4,6,0,0,0
2021-08-08 01:45,8,4,4,0,0,0
2021-08-08 02:00,2,0,2,0,0,0
2021-08-08 02:15,4,1,3,0,0,0
2021-08-08 02:30,2,0,2,0,0,0
2021-08-08 02:45,8,0,8,0,0,0
2021-08-08 03:00,3,0,3,0,0,0
2021-08-08 03:15,4,1,3,0,0,0
2021-08-08 03:30,3,0,3,0,0,0
2021-08-08 03:45,3,1,2,0,0,0
2021-08-08 04:00,1,0,1,0,0,0
2021-08-08 04:15,4,0,4,0,0,0
2021-08-08 04:30,1,1,0,0,0,0
2021-08-08 04:45,1,0,1,0,0,0
2021-08-08 05:00,2,0,2,0,0,0
2021-08-08 05:15,1,1,0,0,0,0
2021-08-08 05:30,4,1,3,0,0,0
2021-08-08 05:45,2,0,2,0,0,0
2021-08-08 06:00,0,0,0,0,0,0
2021-08-08 06:15,2,1,1,0,0,0
2021-08-08 06:30,2,2,0,0,0,0
2021-08-08 06:45,9,3,6,0,0,0
2021-08-08 07:00,0,0,0,0,0,0
2021-08-08 07:15,1,0,1,0,0,0
2021-08-08 07:30,6,3,3,0,0,0
2021-08-08 07:45,6,2,4,0,0,0
2021-08-08 08:00,1,1,0,0,0,0
2021-08-08 08:15,5,4,1,0,0,0
2021-08-08 08:30,5,3,2,0,0,0
2021-08-08 08:45,18,14,4,0,0,0
2021-08-08 09:00,15,7,8,0,0,0
2021-08-08 09:15,13,3,10,0,0,0
2021-08-08 09:30,13,6,7,0,0,0
2021-08-08 09:45,24,16,8,0,0,0
2021-08-08 10:00,26,16,10,0,0,0
2021-08-08 10:15,14,6,8,0,0,0
2021-08-08 10:30,24,16,8,0,0,0
2021-08-08 10:45,30,17,13,0,0,0
2021-08-08 11:00,35,15,20,0,0,0
2021-08-08 11:15,38,13,25,0,0,0
2021-08-08 11:30,25,13,12,0,0,0
2021-08-08 11:45,40,27,13,0,0,0
2021-08-08 12:00,37,10,27,0,0,0
2021-08-08 12:15,37,16,21,0,0,0
2021-08-08 12:30,33,14,19,0,0,0
2021-08-08 12:45,39,13,26,0,0,0
2021-08-08 13:00,26,13,13,0,0,0
2021-08-08 13:15,28,11,17,0,0,0
2021-08-08 13:30,40,18,22,0,0,0
2021-08-08 13:45,49,28,21,0,0,0
2021-08-08 14:00,40,20,20,0,0,0
2021-08-08 14:15,61,30,31,0,0,0
2021-08-08 14:30,59,30,29,0,0,0
2021-08-08 14:45,56,34,22,0,0,0
2021-08-08 15:00,50,23,27,0,0,0
2021-08-08 15:15,54,31,23,0,0,0
2021-08-08 15:30,49,20,29,0,0,0
2021-08-08 15:45,51,28,23,0,0,0
2021-08-08 16:00,48,18,30,0,0,0
2021-08-08 16:15,47,17,30,0,0,0
2021-08-08 16:30,35,17,18,0,0,0
2021-08-08 16:45,36,16,20,0,0,0
2021-08-08 17:00,60,21,39,0,0,0
2021-08-08 17:15,39,15,24,0,0,0
2021-08-08 17:30,61,30,31,0,0,0
2021-08-08 17:45,59,27,32,0,0,0
2021-08-08 18:00,44,14,30,0,0,0
2021-08-08 18:15,57,22,35,0,0,0
2021-08-08 18:30,42,16,26,0,0,0
2021-08-08 18:45,39,15,24,0,0,0
2021-08-08 19:00,19,7,12,0,0,0
2021-08-08 19:15,30,9,21,0,0,0
2021-08-08 19:30,45,24,21,0,0,0
2021-08-08 19:45,27,11,16,0,0,0
2021-08-08 20:00,22,8,14,0,0,0
2021-08-08 20:15,23,6,17,0,0,0
2021-08-08 20:30,32,9,23,0,0,0
2021-08-08 20:45,25,7,18,0,0,0
2021-08-08 21:00,37,16,21,0,0,0
2021-08-08 21:15,27,4,23,0,0,0
2021-08-08 21:30,15,5,10,0,0,0
2021-08-08 21:45,13,7,6,0,0,0
2021-08-08 22:00,12,3,9,0,0,0
2021-08-08 22:15,10,1,9,0,0,0
2021-08-08 22:30,10,1,9,0,0,0
2021-08-08 22:45,8,2,6,0,0,0
2021-08-08 23:00,12,2,10,0,0,0
2021-08-08 23:15,7,0,7,0,0,0
2021-08-08 23:30,8,2,6,0,0,0
2021-08-08 23:45,4,1,3,0,0,0
2021-08-09 00:00,8,2,6,0,0,0
2021-08-09 00:15,8,2,6,0,0,0
2021-08-09 00:30,1,0,1,0,0,0
2021-08-09 00:45,3,1,2,0,0,0
2021-08-09 01:00,3,2,1,0,0,0
2021-08-09 01:15,5,2,3,0,0,0
2021-08-09 01:30,0,0,0,0,0,0
2021-08-09 01:45,1,1,0,0,0,0
2021-08-09 02:00,0,0,0,0,0,0
2021-08-09 02:15,0,0,0,0,0,0
2021-08-09 02:30,0,0,0,0,0,0
2021-08-09 02:45,0,0,0,0,0,0
2021-08-09 03:00,0,0,0,0,0,0
2021-08-09 03:15,0,0,0,0,0,0
2021-08-09 03:30,0,0,0,0,0,0
2021-08-09 03:45,0,0,0,0,0,0
2021-08-09 04:00,0,0,0,0,0,0
2021-08-09 04:15,4,2,2,0,0,0
2021-08-09 04:30,1,1,0,0,0,0
2021-08-09 04:45,1,0,1,0,0,0
2021-08-09 05:00,4,3,1,0,0,0
2021-08-09 05:15,7,6,1,0,0,0
2021-08-09 05:30,9,5,4,0,0,0
2021-08-09 05:45,6,1,5,0,0,0
2021-08-09 06:00,3,1,2,0,0,0
2021-08-09 06:15,15,5,10,0,0,0
2021-08-09 06:30,44,16,28,0,0,0
2021-08-09 06:45,47,10,37,0,0,0
2021-08-09 07:00,48,20,28,0,0,0
2021-08-09 07:15,74,29,45,0,0,0
2021-08-09 07:30,78,35,43,0,0,0
2021-08-09 07:45,124,44,80,0,0,0
2021-08-09 08:00,68,31,37,0,0,0
2021-08-09 08:15,88,44,44,0,0,0
2021-08-09 08:30,97,45,52,0,0,0
2021-08-09 08:45,85,46,39,0,0,0
2021-08-09 09:00,53,26,27,0,0,0
2021-08-09 09:15,55,23,32,0,0,0
2021-08-09 09:30,37,19,18,0,0,0
2021-08-09 09:45,49,28,21,0,0,0
2021-08-09 10:00,50,18,32,0,0,0
2021-08-09 10:15,30,13,17,0,0,0
2021-08-09 10:30,51,26,25,0,0,0
2021-08-09 10:45,42,20,22,0,0,0
2021-08-09 11:00,62,38,24,0,0,0
2021-08-09 11:15,39,21,18,0,0,0
2021-08-09 11:30,58,37,21,0,0,0
2021-08-09 11:45,54,27,27,0,0,0
2021-08-09 12:00,55,29,26,0,0,0
2021-08-09 12:15,67,27,40,0,0,0
2021-08-09 12:30,61,20,41,0,0,0
2021-08-09 12:45,48,20,28,0,0,0
2021-08-09 13:00,88,39,49,0,0,0
2021-08-09 13:15,79,30,49,0,0,0
2021-08-09 13:30,68,37,31,0,0,0
2021-08-09 13:45,65,42,23,0,0,0
2021-08-09 14:00,71,38,33,0,0,0
2021-08-09 14:15,70,34,36,0,0,0
2021-08-09 14:30,85,45,40,0,0,0
2021-08-09 14:45,90,52,38,0,0,0
2021-08-09 15:00,88,52,36,0,0,0
2021-08-09 15:15,92,54,38,0,0,0
2021-08-09 15:30,81,37,44,0,0,0
2021-08-09 15:45,107,59,48,0,0,0
2021-08-09 16:00,109,67,42,0,0,0
2021-08-09 16:15,111,53,58,0,0,0
2021-08-09 16:30,98,53,45,0,0,0
2021-08-09 16:45,83,46,37,0,0,0
2021-08-09 17:00,143,78,65,0,0,0
2021-08-09 17:15,96,52,44,0,0,0
2021-08-09 17:30,86,40,46,0,0,0
2021-08-09 17:45,115,45,70,0,0,0
2021-08-09 18:00,82,29,53,0,0,0
2021-08-09 18:15,74,24,50,0,0,0
2021-08-09 18:30,76,24,52,0,0,0
2021-08-09 18:45,74,33,41,0,0,0
2021-08-09 19:00,53,13,40,0,0,0
2021-08-09 19:15,44,20,24,0,0,0
2021-08-09 19:30,48,19,29,0,0,0
2021-08-09 19:45,49,27,22,0,0,0
2021-08-09 20:00,49,17,32,0,0,0
2021-08-09 20:15,38,17,21,0,0,0
2021-08-09 20:30,35,13,22,0,0,0
2021-08-09 20:45,24,12,12,0,0,0
2021-08-09 21:00,34,21,13,0,0,0
2021-08-09 21:15,28,9,19,0,0,0
2021-08-09 21:30,21,11,10,0,0,0
2021-08-09 21:45,24,14,10,0,0,0
2021-08-09 22:00,24,7,17,0,0,0
2021-08-09 22:15,22,2,20,0,0,0
2021-08-09 22:30,14,3,11,0,0,0
2021-08-09 22:45,15,5,10,0,0,0
2021-08-09 23:00,13,4,9,0,0,0
2021-08-09 23:15,8,2,6,0,0,0
2021-08-09 23:30,10,2,8,0,0,0
2021-08-09 23:45,6,3,3,0,0,0
2021-08-10 00:00,8,4,4,0,0,0
2021-08-10 00:15,9,0,9,0,0,0
2021-08-10 00:30,4,1,3,0,0,0
2021-08-10 00:45,5,4,1,0,0,0
2021-08-10 01:00,4,0,4,0,0,0
2021-08-10 01:15,8,0,8,0,0,0
2021-08-10 01:30,3,0,3,0,0,0
2021-08-10 01:45,5,0,5,0,0,0
2021-08-10 02:00,0,0,0,0,0,0
2021-08-10 02:15,2,1,1,0,0,0
2021-08-10 02:30,1,0,1,0,0,0
2021-08-10 02:45,5,0,5,0,0,0
2021-08-10 03:00,0,0,0,0,0,0
2021-08-10 03:15,1,0,1,0,0,0
2021-08-10 03:30,0,0,0,0,0,0
2021-08-10 03:45,0,0,0,0,0,0
2021-08-10 04:00,3,0,3,0,0,0
2021-08-10 04:15,2,0,2,0,0,0
2021-08-10 04:30,1,1,0,0,0,0
2021-08-10 04:45,1,0,1,0,0,0
2021-08-10 05:00,0,0,0,0,0,0
2021-08-10 05:15,3,3,0,0,0,0
2021-08-10 05:30,12,2,10,0,0,0
2021-08-10 05:45,9,1,8,0,0,0
2021-08-10 06:00,8,2,6,0,0,0
2021-08-10 06:15,20,5,15,0,0,0
2021-08-10 06:30,27,5,22,0,0,0
2021-08-10 06:45,40,15,25,0,0,0
2021-08-10 07:00,64,26,38,0,0,0
2021-08-10 07:15,62,21,41,0,0,0
2021-08-10 07:30,87,34,53,0,0,0
2021-08-10 07:45,110,33,77,0,0,0
2021-08-10 08:00,73,32,41,0,0,0
2021-08-10 08:15,84,47,37,0,0,0
2021-08-10 08:30,99,65,34,0,0,0
2021-08-10 08:45,89,48,41,0,0,0
2021-08-10 09:00,72,35,37,0,0,0
2021-08-10 09:15,63,43,20,0,0,0
2021-08-10 09:30,81,43,38,0,0,0
2021-08-10 09:45,87,53,34,0,0,0
2021-08-10 10:00,52,38,14,0,0,0
2021-08-10 10:15,43,21,22,0,0,0
2021-08-10 10:30,50,20,30,0,0,0
2021-08-10 10:45,54,25,29,0,0,0
2021-08-10 11:00,65,34,31,0,0,0
2021-08-10 11:15,76,42,34,0,0,0
2021-08-10 11:30,64,39,25,0,0,0
2021-08-10 11:45,77,42,35,0,0,0
2021-08-10 12:00,72,26,46,0,0,0
2021-08-10 12:15,77,41,36,0,0,0
2021-08-10 12:30,77,34,43,0,0,0
2021-08-10 12:45,80,42,38,0,0,0
2021-08-10 13:00,88,41,47,0,0,0
2021-08-10 13:15,61,29,32,0,0,0
2021-08-10 13:30,78,33,45,0,0,0
2021-08-10 13:45,86,44,42,0,0,0
2021-08-10 14:00,75,34,41,0,0,0
2021-08-10 14:15,89,55,34,0,0,0
2021-08-10 14:30,69,37,32,0,0,0
2021-08-10 14:45,85,49,36,0,0,0
2021-08-10 15:00,78,40,38,0,0,0
2021-08-10 15:15,79,46,33,0,0,0
2021-08-10 15:30,84,45,39,0,0,0
2021-08-10 15:45,82,34,48,0,0,0
2021-08-10 16:00,129,75,54,0,0,0
2021-08-10 16:15,111,53,58,0,0,0
2021-08-10 16:30,125,57,68,0,0,0
2021-08-10 16:45,110,51,59,0,0,0
2021-08-10 17:00,106,54,52,0,0,0
2021-08-10 17:15,130,55,75,0,0,0
2021-08-10 17:30,74,28,46,0,0,0
2021-08-10 17:45,67,25,42,0,0,0
2021-08-10 18:00,88,45,43,0,0,0
2021-08-10 18:15,90,30,60,0,0,0
2021-08-10 18:30,70,18,52,0,0,0
2021-08-10 18:45,43,21,22,0,0,0
2021-08-10 19:00,82,42,40,0,0,0
2021-08-10 19:15,45,22,23,0,0,0
2021-08-10 19:30,48,20,28,0,0,0
2021-08-10 19:45,59,34,25,0,0,0
2021-08-10 20:00,47,27,20,0,0,0
2021-08-10 20:15,48,18,30,0,0,0
2021-08-10 20:30,22,9,13,0,0,0
2021-08-10 20:45,21,9,12,0,0,0
2021-08-10 21:00,35,18,17,0,0,0
2021-08-10 21:15,30,9,21,0,0,0
2021-08-10 21:30,26,7,19,0,0,0
2021-08-10 21:45,32,7,25,0,0,0
2021-08-10 22:00,18,6,12,0,0,0
2021-08-10 22:15,15,8,7,0,0,0
2021-08-10 22:30,10,3,7,0,0,0
2021-08-10 22:45,17,4,13,0,0,0
2021-08-10 23:00,22,4,18,0,0,0
2021-08-10 23:15,15,4,11,0,0,0
2021-08-10 23:30,16,1,15,0,0,0
2021-08-10 23:45,5,0,5,0,0,0
2021-08-11 00:00,3,0,3,0,0,0
2021-08-11 00:15,8,2,6,0,0,0
2021-08-11 00:30,6,1,5,0,0,0
2021-08-11 00:45,5,0,5,0,0,0
2021-08-11 01:00,5,1,4,0,0,0
2021-08-11 01:15,8,1,7,0,0,0
2021-08-11 01:30,1,0,1,0,0,0
2021-08-11 01:45,1,0,1,0,0,0
2021-08-11 02:00,0,0,0,0,0,0
2021-08-11 02:15,2,0,2,0,0,0
2021-08-11 02:30,0,0,0,0,0,0
2021-08-11 02:45,0,0,0,0,0,0
2021-08-11 03:00,0,0,0,0,0,0
2021-08-11 03:15,0,0,0,0,0,0
2021-08-11 03:30,1,0,1,0,0,0
2021-08-11 03:45,0,0,0,0,0,0
2021-08-11 04:00,0,0,0,0,0,0
2021-08-11 04:15,0,0,0,0,0,0
2021-08-11 04:30,2,1,1,0,0,0
2021-08-11 04:45,2,1,1,0,0,0
2021-08-11 05:00,3,0,3,0,0,0
2021-08-11 05:15,1,1,0,0,0,0
2021-08-11 05:30,14,5,9,0,0,0
2021-08-11 05:45,15,4,11,0,0,0
2021-08-11 06:00,5,2,3,0,0,0
2021-08-11 06:15,16,6,10,0,0,0
2021-08-11 06:30,40,11,29,0,0,0
2021-08-11 06:45,44,13,31,0,0,0
2021-08-11 07:00,57,24,33,0,0,0
2021-08-11 07:15,70,37,33,0,0,0
2021-08-11 07:30,70,27,43,0,0,0
2021-08-11 07:45,119,47,72,0,0,0
2021-08-11 08:00,74,32,42,0,0,0
2021-08-11 08:15,94,48,46,0,0,0
2021-08-11 08:30,107,54,53,0,0,0
2021-08-11 08:45,109,67,42,0,0,0
2021-08-11 09:00,83,41,42,0,0,0
2021-08-11 09:15,75,36,39,0,0,0
2021-08-11 09:30,85,45,40,0,0,0
2021-08-11 09:45,100,67,33,0,0,0
2021-08-11 10:00,63,33,30,0,0,0
2021-08-11 10:15,80,43,37,0,0,0
2021-08-11 10:30,70,44,26,0,0,0
2021-08-11 10:45,118,64,54,0,0,0
2021-08-11 11:00,85,46,39,0,0,0
2021-08-11 11:15,76,37,39,0,0,0
2021-08-11 11:30,99,51,48,0,0,0
2021-08-11 11:45,80,34,46,0,0,0
2021-08-11 12:00,109,44,65,0,0,0
2021-08-11 12:15,119,48,71,0,0,0
2021-08-11 12:30,97,36,61,0,0,0
2021-08-11 12:45,127,62,65,0,0,0
2021-08-11 13:00,112,57,55,0,0,0
2021-08-11 13:15,105,49,56,0,0,0
2021-08-11 13:30,114,59,55,0,0,0
2021-08-11 13:45,106,57,49,0,0,0
2021-08-11 14:00,114,46,68,0,0,0
2021-08-11 14:15,87,43,44,0,0,0
2021-08-11 14:30,114,56,58,0,0,0
2021-08-11 14:45,101,40,61,0,0,0
2021-08-11 15:00,113,60,53,0,0,0
2021-08-11 15:15,114,54,60,0,0,0
2021-08-11 15:30,99,50,49,0,0,0
2021-08-11 15:45,109,51,58,0,0,0
2021-08-11 16:00,118,59,59,0,0,0
2021-08-11 16:15,121,59,62,0,0,0
2021-08-11 16:30,129,67,62,0,0,0
2021-08-11 16:45,135,74,61,0,0,0
2021-08-11 17:00,134,55,79,0,0,0
2021-08-11 17:15,126,51,75,0,0,0
2021-08-11 17:30,147,62,85,0,0,0
2021-08-11 17:45,121,63,58,0,0,0
2021-08-11 18:00,102,48,54,0,0,0
2021-08-11 18:15,122,49,73,0,0,0
2021-08-11 18:30,144,67,77,0,0,0
2021-08-11 18:45,114,43,71,0,0,0
2021-08-11 19:00,77,30,47,0,0,0
2021-08-11 19:15,61,27,34,0,0,0
2021-08-11 19:30,82,23,59,0,0,0
2021-08-11 19:45,77,41,36,0,0,0
2021-08-11 20:00,62,15,47,0,0,0
2021-08-11 20:15,59,19,40,0,0,0
2021-08-11 20:30,33,19,14,0,0,0
2021-08-11 20:45,39,22,17,0,0,0
2021-08-11 21:00,29,17,12,0,0,0
2021-08-11 21:15,43,11,32,0,0,0
2021-08-11 21:30,31,11,20,0,0,0
2021-08-11 21:45,35,11,24,0,0,0
2021-08-11 22:00,50,15,35,0,0,0
2021-08-11 22:15,37,9,28,0,0,0
2021-08-11 22:30,29,12,17,0,0,0
2021-08-11 22:45,24,5,19,0,0,0
2021-08-11 23:00,23,6,17,0,0,0
2021-08-11 23:15,21,12,9,0,0,0
2021-08-11 23:30,14,4,10,0,0,0
2021-08-11 23:45,7,4,3,0,0,0
2021-08-12 00:00,14,7,7,0,0,0
2021-08-12 00:15,11,4,7,0,0,0
2021-08-12 00:30,5,0,5,0,0,0
2021-08-12 00:45,6,2,4,0,0,0
2021-08-12 01:00,11,0,11,0,0,0
2021-08-12 01:15,4,1,3,0,0,0
2021-08-12 01:30,5,0,5,0,0,0
2021-08-12 01:45,7,0,7,0,0,0
2021-08-12 02:00,3,1,2,0,0,0
2021-08-12 02:15,3,0,3,0,0,0
2021-08-12 02:30,2,0,2,0,0,0
2021-08-12 02:45,3,0,3,0,0,0
2021-08-12 03:00,2,0,2,0,0,0
2021-08-12 03:15,3,0,3,0,0,0
2021-08-12 03:30,7,0,7,0,0,0
2021-08-12 03:45,13,0,13,0,0,0
2021-08-12 04:00,1,0,1,0,0,0
2021-08-12 04:15,1,1,0,0,0,0
2021-08-12 04:30,6,3,3,0,0,0
2021-08-12 04:45,3,0,3,0,0,0
2021-08-12 05:00,2,1,1,0,0,0
2021-08-12 05:15,4,3,1,0,0,0
2021-08-12 05:30,8,3,5,0,0,0
2021-08-12 05:45,12,2,10,0,0,0
2021-08-12 06:00,5,2,3,0,0,0
2021-08-12 06:15,19,6,13,0,0,0
2021-08-12 06:30,38,11,27,0,0,0
2021-08-12 06:45,39,16,23,0,0,0
2021-08-12 07:00,57,19,38,0,0,0
2021-08-12 07:15,73,33,40,0,0,0
2021-08-12 07:30,79,27,52,0,0,0
2021-08-12 07:45,114,34,80,0,0,0
2021-08-12 08:00,92,44,48,0,0,0
2021-08-12 08:15,95,47,48,0,0,0
2021-08-12 08:30,107,49,58,0,0,0
2021-08-12 08:45,94,54,40,0,0,0
2021-08-12 09:00,78,39,39,0,0,0
2021-08-12 09:15,75,37,38,0,0,0
2021-08-12 09:30,61,34,27,0,0,0
2021-08-12 09:45,89,47,42,0,0,0
2021-08-12 10:00,61,43,18,0,0,0
2021-08-12 10:15,62,37,25,0,0,0
2021-08-12 10:30,59,34,25,0,0,0
2021-08-12 10:45,71,32,39,0,0,0
2021-08-12 11:00,65,41,24,0,0,0
2021-08-12 11:15,76,35,41,0,0,0
2021-08-12 11:30,100,42,58,0,0,0
2021-08-12 11:45,61,27,34,0,0,0
2021-08-12 12:00,75,26,49,0,0,0
2021-08-12 12:15,90,33,57,0,0,0
2021-08-12 12:30,88,43,45,0,0,0
2021-08-12 12:45,88,42,46,0,0,0
2021-08-12 13:00,89,42,47,0,0,0
2021-08-12 13:15,87,46,41,0,0,0
2021-08-12 13:30,66,34,32,0,0,0
2021-08-12 13:45,88,38,50,0,0,0
2021-08-12 14:00,82,43,39,0,0,0
2021-08-12 14:15,94,47,47,0,0,0
2021-08-12 14:30,110,64,46,0,0,0
2021-08-12 14:45,109,52,57,0,0,0
2021-08-12 15:00,82,35,47,0,0,0
2021-08-12 15:15,103,61,42,0,0,0
2021-08-12 15:30,101,52,49,0,0,0
2021-08-12 15:45,107,71,36,0,0,0
2021-08-12 16:00,114,65,49,0,0,0
2021-08-12 16:15,113,57,56,0,0,0
2021-08-12 16:30,107,54,53,0,0,0
2021-08-12 16:45,153,74,79,0,0,0
2021-08-12 17:00,132,63,69,0,0,0
2021-08-12 17:15,132,61,71,0,0,0
2021-08-12 17:30,100,42,58,0,0,0
2021-08-12 17:45,87,36,51,0,0,0
2021-08-12 18:00,109,38,71,0,0,0
2021-08-12 18:15,90,39,51,0,0,0
2021-08-12 18:30,93,39,54,0,0,0
2021-08-12 18:45,101,52,49,0,0,0
2021-08-12 19:00,87,39,48,0,0,0
2021-08-12 19:15,94,44,50,0,0,0
2021-08-12 19:30,69,37,32,0,0,0
2021-08-12 19:45,62,16,46,0,0,0
2021-08-12 20:00,42,20,22,0,0,0
2021-08-12 20:15,50,19,31,0,0,0
2021-08-12 20:30,43,16,27,0,0,0
2021-08-12 20:45,27,11,16,0,0,0
2021-08-12 21:00,45,22,23,0,0,0
2021-08-12 21:15,30,17,13,0,0,0
2021-08-12 21:30,39,8,31,0,0,0
2021-08-12 21:45,38,12,26,0,0,0
2021-08-12 22:00,37,14,23,0,0,0
2021-08-12 22:15,39,14,25,0,0,0
2021-08-12 22:30,21,4,17,0,0,0
2021-08-12 22:45,30,2,28,0,0,0
2021-08-12 23:00,27,6,21,0,0,0
2021-08-12 23:15,18,9,9,0,0,0
2021-08-12 23:30,25,6,19,0,0,0
2021-08-12 23:45,7,2,5,0,0,0
2021-08-13 00:00,16,6,10,0,0,0
2021-08-13 00:15,6,0,6,0,0,0
2021-08-13 00:30,8,0,8,0,0,0
2021-08-13 00:45,7,0,7,0,0,0
2021-08-13 01:00,15,1,14,0,0,0
2021-08-13 01:15,7,0,7,0,0,0
2021-08-13 01:30,6,0,6,0,0,0
2021-08-13 01:45,2,0,2,0,0,0
2021-08-13 02:00,1,0,1,0,0,0
2021-08-13 02:15,2,0,2,0,0,0
2021-08-13 02:30,0,0,0,0,0,0
2021-08-13 02:45,3,1,2,0,0,0
2021-08-13 03:00,1,0,1,0,0,0
2021-08-13 03:15,1,0,1,0,0,0
2021-08-13 03:30,0,0,0,0,0,0
2021-08-13 03:45,2,0,2,0,0,0
2021-08-13 04:00,2,2,0,0,0,0
2021-08-13 04:15,3,0,3,0,0,0
2021-08-13 04:30,4,4,0,0,0,0
2021-08-13 04:45,2,0,2,0,0,0
2021-08-13 05:00,2,1,1,0,0,0
2021-08-13 05:15,3,3,0,0,0,0
2021-08-13 05:30,3,1,2,0,0,0
2021-08-13 05:45,9,0,9,0,0,0
2021-08-13 06:00,5,2,3,0,0,0
2021-08-13 06:15,21,8,13,0,0,0
2021-08-13 06:30,30,10,20,0,0,0
2021-08-13 06:45,45,15,30,0,0,0
2021-08-13 07:00,50,22,28,0,0,0
2021-08-13 07:15,57,17,40,0,0,0
2021-08-13 07:30,63,21,42,0,0,0
2021-08-13 07:45,100,33,67,0,0,0
2021-08-13 08:00,69,34,35,0,0,0
2021-08-13 08:15,80,33,47,0,0,0
2021-08-13 08:30,96,50,46,0,0,0
2021-08-13 08:45,108,55,53,0,0,0
2021-08-13 09:00,57,28,29,0,0,0
2021-08-13 09:15,50,30,20,0,0,0
2021-08-13 09:30,44,26,18,0,0,0
2021-08-13 09:45,69,46,23,0,0,0
2021-08-13 10:00,51,33,18,0,0,0
2021-08-13 10:15,49,28,21,0,0,0
2021-08-13 10:30,69,42,27,0,0,0
2021-08-13 10:45,67,41,26,0,0,0
2021-08-13 11:00,58,31,27,0,0,0
2021-08-13 11:15,65,30,35,0,0,0
2021-08-13 11:30,77,39,38,0,0,0
2021-08-13 11:45,62,29,33,0,0,0
2021-08-13 12:00,92,48,44,0,0,0
2021-08-13 12:15,95,47,48,0,0,0
2021-08-13 12:30,87,44,43,0,0,0
2021-08-13 12:45,94,36,58,0,0,0
2021-08-13 13:00,95,46,49,0,0,0
2021-08-13 13:15,110,44,66,0,0,0
2021-08-13 13:30,86,36,50,0,0,0
2021-08-13 13:45,119,50,69,0,0,0
2021-08-13 14:00,83,48,35,0,0,0
2021-08-13 14:15,103,65,38,0,0,0
2021-08-13 14:30,101,54,47,0,0,0
2021-08-13 14:45,110,52,58,0,0,0
2021-08-13 15:00,95,57,38,0,0,0
2021-08-13 15:15,130,74,56,0,0,0
2021-08-13 15:30,88,43,45,0,0,0
2021-08-13 15:45,104,50,54,0,0,0
2021-08-13 16:00,112,68,44,0,0,0
2021-08-13 16:15,96,47,49,0,0,0
2021-08-13 16:30,112,63,49,0,0,0
2021-08-13 16:45,117,47,70,0,0,0
2021-08-13 17:00,122,58,64,0,0,0
2021-08-13 17:15,87,40,47,0,0,0
2021-08-13 17:30,88,32,56,0,0,0
2021-08-13 17:45,85,30,55,0,0,0
2021-08-13 18:00,83,36,47,0,0,0
2021-08-13 18:15,82,33,49,0,0,0
2021-08-13 18:30,52,23,29,0,0,0
2021-08-13 18:45,105,63,42,0,0,0
2021-08-13 19:00,75,28,47,0,0,0
2021-08-13 19:15,69,30,39,0,0,0
2021-08-13 19:30,66,29,37,0,0,0
2021-08-13 19:45,68,38,30,0,0,0
2021-08-13 20:00,81,39,42,0,0,0
2021-08-13 20:15,38,19,19,0,0,0
2021-08-13 20:30,53,32,21,0,0,0
2021-08-13 20:45,26,12,14,0,0,0
2021-08-13 21:00,55,22,33,0,0,0
2021-08-13 21:15,38,15,23,0,0,0
2021-08-13 21:30,34,12,22,0,0,0
2021-08-13 21:45,33,12,21,0,0,0
2021-08-13 22:00,20,7,13,0,0,0
2021-08-13 22:15,35,14,21,0,0,0
2021-08-13 22:30,20,4,16,0,0,0
2021-08-13 22:45,40,14,26,0,0,0
2021-08-13 23:00,21,6,15,0,0,0
2021-08-13 23:15,15,2,13,0,0,0
2021-08-13 23:30,23,4,19,0,0,0
2021-08-13 23:45,23,6,17,0,0,0
2021-08-14 00:00,13,5,8,0,0,0
2021-08-14 00:15,11,1,10,0,0,0
2021-08-14 00:30,15,6,9,0,0,0
2021-08-14 00:45,12,2,10,0,0,0
2021-08-14 01:00,16,5,11,0,0,0
2021-08-14 01:15,16,7,9,0,0,0
2021-08-14 01:30,4,0,4,0,0,0
2021-08-14 01:45,7,0,7,0,0,0
2021-08-14 02:00,8,2,6,0,0,0
2021-08-14 02:15,24,7,17,0,0,0
2021-08-14 02:30,13,0,13,0,0,0
2021-08-14 02:45,11,1,10,0,0,0
2021-08-14 03:00,8,2,6,0,0,0
2021-08-14 03:15,8,2,6,0,0,0
2021-08-14 03:30,3,0,3,0,0,0
2021-08-14 03:45,6,0,6,0,0,0
2021-08-14 04:00,1,0,1,0,0,0
2021-08-14 04:15,3,0,3,0,0,0
2021-08-14 04:30,5,1,4,0,0,0
2021-08-14 04:45,2,0,2,0,0,0
2021-08-14 05:00,1,1,0,0,0,0
2021-08-14 05:15,4,0,4,0,0,0
2021-08-14 05:30,8,0,8,0,0,0
2021-08-14 05:45,9,0,9,0,0,0
2021-08-14 06:00,1,0,1,0,0,0
2021-08-14 06:15,8,4,4,0,0,0
2021-08-14 06:30,3,3,0,0,0,0
2021-08-14 06:45,9,5,4,0,0,0
2021-08-14 07:00,12,5,7,0,0,0
2021-08-14 07:15,3,2,1,0,0,0
2021-08-14 07:30,20,11,9,0,0,0
2021-08-14 07:45,25,13,12,0,0,0
2021-08-14 08:00,16,12,4,0,0,0
2021-08-14 08:15,19,15,4,0,0,0
2021-08-14 08:30,30,24,6,0,0,0
2021-08-14 08:45,41,23,18,0,0,0
2021-08-14 09:00,44,25,19,0,0,0
2021-08-14 09:15,73,46,27,0,0,0
2021-08-14 09:30,47,31,16,0,0,0
2021-08-14 09:45,61,49,12,0,0,0
2021-08-14 10:00,69,44,25,0,0,0
2021-08-14 10:15,66,46,20,0,0,0
2021-08-14 10:30,75,44,31,0,0,0
2021-08-14 10:45,62,36,26,0,0,0
2021-08-14 11:00,118,58,60,0,0,0
2021-08-14 11:15,95,58,37,0,0,0
2021-08-14 11:30,76,39,37,0,0,0
2021-08-14 11:45,95,56,39,0,0,0
2021-08-14 12:00,109,61,48,0,0,0
2021-08-14 12:15,128,55,73,0,0,0
2021-08-14 12:30,128,56,72,0,0,0
2021-08-14 12:45,113,62,51,0,0,0
2021-08-14 13:00,104,45,59,0,0,0
2021-08-14 13:15,102,61,41,0,0,0
2021-08-14 13:30,86,40,46,0,0,0
2021-08-14 13:45,88,42,46,0,0,0
2021-08-14 14:00,98,43,55,0,0,0
2021-08-14 14:15,88,32,56,0,0,0
2021-08-14 14:30,106,31,75,0,0,0
2021-08-14 14:45,75,22,53,0,0,0
2021-08-14 15:00,109,47,62,0,0,0
2021-08-14 15:15,88,39,49,0,0,0
2021-08-14 15:30,77,27,50,0,0,0
2021-08-14 15:45,64,30,34,0,0,0
2021-08-14 16:00,82,25,57,0,0,0
2021-08-14 16:15,83,40,43,0,0,0
2021-08-14 16:30,64,35,29,0,0,0
2021-08-14 16:45,82,48,34,0,0,0
2021-08-14 17:00,61,23,38,0,0,0
2021-08-14 17:15,75,29,46,0,0,0
2021-08-14 17:30,62,29,33,0,0,0
2021-08-14 17:45,85,25,60,0,0,0
2021-08-14 18:00,86,30,56,0,0,0
2021-08-14 18:15,68,28,40,0,0,0
2021-08-14 18:30,66,31,35,0,0,0
2021-08-14 18:45,80,33,47,0,0,0
2021-08-14 19:00,55,30,25,0,0,0
2021-08-14 19:15,52,18,34,0,0,0
2021-08-14 19:30,64,23,41,0,0,0
2021-08-14 19:45,65,25,40,0,0,0
2021-08-14 20:00,49,26,23,0,0,0
2021-08-14 20:15,61,21,40,0,0,0
2021-08-14 20:30,56,21,35,0,0,0
2021-08-14 20:45,29,13,16,0,0,0
2021-08-14 21:00,35,13,22,0,0,0
2021-08-14 21:15,32,14,18,0,0,0
2021-08-14 21:30,45,30,15,0,0,0
2021-08-14 21:45,26,14,12,0,0,0
2021-08-14 22:00,25,7,18,0,0,0
2021-08-14 22:15,32,18,14,0,0,0
2021-08-14 22:30,24,8,16,0,0,0
2021-08-14 22:45,34,9,25,0,0,0
2021-08-14 23:00,20,5,15,0,0,0
2021-08-14 23:15,21,7,14,0,0,0
2021-08-14 23:30,17,9,8,0,0,0
2021-08-14 23:45,13,2,11,0,0,0
2021-08-15 00:00,19,5,14,0,0,0
2021-08-15 00:15,13,5,8,0,0,0
2021-08-15 00:30,17,0,17,0,0,0
2021-08-15 00:45,18,9,9,0,0,0
2021-08-15 01:00,17,5,12,0,0,0
2021-08-15 01:15,13,3,10,0,0,0
2021-08-15 01:30,16,3,13,0,0,0
2021-08-15 01:45,7,1,6,0,0,0
2021-08-15 02:00,9,4,5,0,0,0
2021-08-15 02:15,9,1,8,0,0,0
2021-08-15 02:30,11,4,7,0,0,0
2021-08-15 02:45,5,0,5,0,0,0
2021-08-15 03:00,11,3,8,0,0,0
2021-08-15 03:15,6,0,6,0,0,0
2021-08-15 03:30,13,5,8,0,0,0
2021-08-15 03:45,5,1,4,0,0,0
2021-08-15 04:00,4,0,4,0,0,0
2021-08-15 04:15,4,0,4,0,0,0
2021-08-15 04:30,2,0,2,0,0,0
2021-08-15 04:45,0,0,0,0,0,0
2021-08-15 05:00,2,1,1,0,0,0
2021-08-15 05:15,2,0,2,0,0,0
2021-08-15 05:30,4,1,3,0,0,0
2021-08-15 05:45,7,1,6,0,0,0
2021-08-15 06:00,1,0,1,0,0,0
2021-08-15 06:15,4,3,1,0,0,0
2021-08-15 06:30,2,2,0,0,0,0
2021-08-15 06:45,4,1,3,0,0,0
2021-08-15 07:00,1,1,0,0,0,0
2021-08-15 07:15,4,3,1,0,0,0
2021-08-15 07:30,7,2,5,0,0,0
2021-08-15 07:45,5,2,3,0,0,0
2021-08-15 08:00,5,2,3,0,0,0
2021-08-15 08:15,10,6,4,0,0,0
2021-08-15 08:30,9,5,4,0,0,0
2021-08-15 08:45,13,9,4,0,0,0
2021-08-15 09:00,16,11,5,0,0,0
2021-08-15 09:15,17,9,8,0,0,0
2021-08-15 09:30,21,9,12,0,0,0
2021-08-15 09:45,39,21,18,0,0,0
2021-08-15 10:00,31,22,9,0,0,0
2021-08-15 10:15,41,18,23,0,0,0
2021-08-15 10:30,35,9,26,0,0,0
2021-08-15 10:45,52,36,16,0,0,0
2021-08-15 11:00,37,16,21,0,0,0
2021-08-15 11:15,30,10,20,0,0,0
2021-08-15 11:30,32,23,9,0,0,0
2021-08-15 11:45,43,16,27,0,0,0
2021-08-15 12:00,26,8,18,0,0,0
2021-08-15 12:15,51,22,29,0,0,0
2021-08-15 12:30,42,17,25,0,0,0
2021-08-15 12:45,79,39,40,0,0,0
2021-08-15 13:00,56,34,22,0,0,0
2021-08-15 13:15,53,33,20,0,0,0
2021-08-15 13:30,81,41,40,0,0,0
2021-08-15 13:45,44,24,20,0,0,0
2021-08-15 14:00,64,30,34,0,0,0
2021-08-15 14:15,59,30,29,0,0,0
2021-08-15 14:30,73,35,38,0,0,0
2021-08-15 14:45,85,51,34,0,0,0
2021-08-15 15:00,72,35,37,0,0,0
2021-08-15 15:15,73,42,31,0,0,0
2021-08-15 15:30,61,32,29,0,0,0
2021-08-15 15:45,85,46,39,0,0,0
2021-08-15 16:00,99,50,49,0,0,0
2021-08-15 16:15,48,21,27,0,0,0
2021-08-15 16:30,62,20,42,0,0,0
2021-08-15 16:45,74,26,48,0,0,0
2021-08-15 17:00,54,22,32,0,0,0
2021-08-15 17:15,55,21,34,0,0,0
2021-08-15 17:30,62,24,38,0,0,0
2021-08-15 17:45,93,47,46,0,0,0
2021-08-15 18:00,42,14,28,0,0,0
2021-08-15 18:15,62,23,39,0,0,0
2021-08-15 18:30,35,8,27,0,0,0
2021-08-15 18:45,46,19,27,0,0,0
2021-08-15 19:00,54,25,29,0,0,0
2021-08-15 19:15,57,30,27,0,0,0
2021-08-15 19:30,41,18,23,0,0,0
2021-08-15 19:45,37,21,16,0,0,0
2021-08-15 20:00,44,12,32,0,0,0
2021-08-15 20:15,46,20,26,0,0,0
2021-08-15 20:30,33,7,26,0,0,0
2021-08-15 20:45,29,9,20,0,0,0
2021-08-15 21:00,29,10,19,0,0,0
2021-08-15 21:15,32,8,24,0,0,0
2021-08-15 21:30,29,11,18,0,0,0
2021-08-15 21:45,26,8,18,0,0,0
2021-08-15 22:00,27,7,20,0,0,0
2021-08-15 22:15,30,3,27,0,0,0
2021-08-15 22:30,18,6,12,0,0,0
2021-08-15 22:45,14,1,13,0,0,0
2021-08-15 23:00,12,1,11,0,0,0
2021-08-15 23:15,7,0,7,0,0,0
2021-08-15 23:30,9,5,4,0,0,0
2021-08-15 23:45,4,0,4,0,0,0
2021-08-16 00:00,8,0,8,0,0,0
2021-08-16 00:15,9,1,8,0,0,0
2021-08-16 00:30,8,1,7,0,0,0
2021-08-16 00:45,1,0,1,0,0,0
2021-08-16 01:00,3,0,3,0,0,0
2021-08-16 01:15,3,0,3,0,0,0
2021-08-16 01:30,3,0,3,0,0,0
2021-08-16 01:45,1,0,1,0,0,0
2021-08-16 02:00,1,0,1,0,0,0
2021-08-16 02:15,0,0,0,0,0,0
2021-08-16 02:30,1,0,1,0,0,0
2021-08-16 02:45,2,0,2,0,0,0
2021-08-16 03:00,0,0,0,0,0,0
2021-08-16 03:15,2,0,2,0,0,0
2021-08-16 03:30,0,0,0,0,0,0
2021-08-16 03:45,0,0,0,0,0,0
2021-08-16 04:00,0,0,0,0,0,0
2021-08-16 04:15,2,1,1,0,0,0
2021-08-16 04:30,1,0,1,0,0,0
2021-08-16 04:45,0,0,0,0,0,0
2021-08-16 05:00,2,2,0,0,0,0
2021-08-16 05:15,2,1,1,0,0,0
2021-08-16 05:30,9,2,7,0,0,0
2021-08-16 05:45,10,0,10,0,0,0
2021-08-16 06:00,5,3,2,0,0,0
2021-08-16 06:15,18,7,11,0,0,0
2021-08-16 06:30,37,16,21,0,0,0
2021-08-16 06:45,45,16,29,0,0,0
2021-08-16 07:00,53,14,39,0,0,0
2021-08-16 07:15,71,29,42,0,0,0
2021-08-16 07:30,81,33,48,0,0,0
2021-08-16 07:45,122,31,91,0,0,0
2021-08-16 08:00,85,32,53,0,0,0
2021-08-16 08:15,80,49,31,0,0,0
2021-08-16 08:30,66,36,30,0,0,0
2021-08-16 08:45,97,44,53,0,0,0
2021-08-16 09:00,72,30,42,0,0,0
2021-08-16 09:15,54,23,31,0,0,0
2021-08-16 09:30,47,24,23,0,0,0
2021-08-16 09:45,47,24,23,0,0,0
2021-08-16 10:00,44,20,24,0,0,0
2021-08-16 10:15,38,22,16,0,0,0
2021-08-16 10:30,55,37,18,0,0,0
2021-08-16 10:45,60,30,30,0,0,0
2021-08-16 11:00,51,31,20,0,0,0
2021-08-16 11:15,39,27,12,0,0,0
2021-08-16 11:30,38,17,21,0,0,0
2021-08-16 11:45,40,22,18,0,0,0
2021-08-16 12:00,42,13,29,0,0,0
2021-08-16 12:15,63,26,37,0,0,0
2021-08-16 12:30,58,23,35,0,0,0
2021-08-16 12:45,48,20,28,0,0,0
2021-08-16 13:00,64,28,36,0,0,0
2021-08-16 13:15,67,32,35,0,0,0
2021-08-16 13:30,57,30,27,0,0,0
2021-08-16 13:45,54,33,21,0,0,0
2021-08-16 14:00,54,27,27,0,0,0
2021-08-16 14:15,87,50,37,0,0,0
2021-08-16 14:30,67,28,39,0,0,0
2021-08-16 14:45,53,21,32,0,0,0
2021-08-16 15:00,66,39,27,0,0,0
2021-08-16 15:15,67,29,38,0,0,0
2021-08-16 15:30,61,39,22,0,0,0
2021-08-16 15:45,71,45,26,0,0,0
2021-08-16 16:00,87,42,45,0,0,0
2021-08-16 16:15,99,53,46,0,0,0
2021-08-16 16:30,95,47,48,0,0,0
2021-08-16 16:45,91,50,41,0,0,0
2021-08-16 17:00,96,61,35,0,0,0
2021-08-16 17:15,75,42,33,0,0,0
2021-08-16 17:30,90,44,46,0,0,0
2021-08-16 17:45,78,43,35,0,0,0
2021-08-16 18:00,73,31,42,0,0,0
2021-08-16 18:15,57,24,33,0,0,0
2021-08-16 18:30,60,28,32,0,0,0
2021-08-16 18:45,60,18,42,0,0,0
2021-08-16 19:00,52,23,29,0,0,0
2021-08-16 19:15,48,25,23,0,0,0
2021-08-16 19:30,55,31,24,0,0,0
2021-08-16 19:45,41,14,27,0,0,0
2021-08-16 20:00,42,13,29,0,0,0
2021-08-16 20:15,33,15,18,0,0,0
2021-08-16 20:30,15,8,7,0,0,0
2021-08-16 20:45,31,8,23,0,0,0
2021-08-16 21:00,33,17,16,0,0,0
2021-08-16 21:15,27,7,20,0,0,0
2021-08-16 21:30,22,13,9,0,0,0
2021-08-16 21:45,36,11,25,0,0,0
2021-08-16 22:00,21,6,15,0,0,0
2021-08-16 22:15,21,7,14,0,0,0
2021-08-16 22:30,20,6,14,0,0,0
2021-08-16 22:45,13,3,10,0,0,0
2021-08-16 23:00,14,7,7,0,0,0
2021-08-16 23:15,14,1,13,0,0,0
2021-08-16 23:30,14,3,11,0,0,0
2021-08-16 23:45,3,1,2,0,0,0
2021-08-17 00:00,7,6,1,0,0,0
2021-08-17 00:15,8,1,7,0,0,0
2021-08-17 00:30,5,0,5,0,0,0
2021-08-17 00:45,5,0,5,0,0,0
2021-08-17 01:00,2,0,2,0,0,0
2021-08-17 01:15,6,2,4,0,0,0
2021-08-17 01:30,3,0,3,0,0,0
2021-08-17 01:45,1,0,1,0,0,0
2021-08-17 02:00,5,0,5,0,0,0
2021-08-17 02:15,0,0,0,0,0,0
2021-08-17 02:30,3,0,3,0,0,0
2021-08-17 02:45,0,0,0,0,0,0
2021-08-17 03:00,2,0,2,0,0,0
2021-08-17 03:15,0,0,0,0,0,0
2021-08-17 03:30,0,0,0,0,0,0
2021-08-17 03:45,1,1,0,0,0,0
2021-08-17 04:00,0,0,0,0,0,0
2021-08-17 04:15,1,0,1,0,0,0
2021-08-17 04:30,2,0,2,0,0,0
2021-08-17 04:45,0,0,0,0,0,0
2021-08-17 05:00,0,0,0,0,0,0
2021-08-17 05:15,5,3,2,0,0,0
2021-08-17 05:30,9,2,7,0,0,0
2021-08-17 05:45,15,2,13,0,0,0
2021-08-17 06:00,8,6,2,0,0,0
2021-08-17 06:15,24,7,17,0,0,0
2021-08-17 06:30,30,11,19,0,0,0
2021-08-17 06:45,40,13,27,0,0,0
2021-08-17 07:00,51,17,34,0,0,0
2021-08-17 07:15,62,19,43,0,0,0
2021-08-17 07:30,97,24,73,0,0,0
2021-08-17 07:45,132,41,91,0,0,0
2021-08-17 08:00,79,28,51,0,0,0
2021-08-17 08:15,95,45,50,0,0,0
2021-08-17 08:30,105,51,54,0,0,0
2021-08-17 08:45,115,53,62,0,0,0
2021-08-17 09:00,60,31,29,0,0,0
2021-08-17 09:15,70,41,29,0,0,0
2021-08-17 09:30,71,38,33,0,0,0
2021-08-17 09:45,61,32,29,0,0,0
2021-08-17 10:00,63,35,28,0,0,0
2021-08-17 10:15,53,36,17,0,0,0
2021-08-17 10:30,78,40,38,0,0,0
2021-08-17 10:45,47,28,19,0,0,0
2021-08-17 11:00,45,20,25,0,0,0
2021-08-17 11:15,65,36,29,0,0,0
2021-08-17 11:30,67,32,35,0,0,0
2021-08-17 11:45,84,37,47,0,0,0
2021-08-17 12:00,65,32,33,0,0,0
2021-08-17 12:15,67,32,35,0,0,0
2021-08-17 12:30,80,27,53,0,0,0
2021-08-17 12:45,68,27,41,0,0,0
2021-08-17 13:00,85,44,41,0,0,0
2021-08-17 13:15,75,35,40,0,0,0
2021-08-17 13:30,94,50,44,0,0,0
2021-08-17 13:45,79,41,38,0,0,0
2021-08-17 14:00,77,44,33,0,0,0
2021-08-17 14:15,79,37,42,0,0,0
2021-08-17 14:30,91,44,47,0,0,0
2021-08-17 14:45,80,41,39,0,0,0
2021-08-17 15:00,83,50,33,0,0,0
2021-08-17 15:15,94,53,41,0,0,0
2021-08-17 15:30,58,26,32,0,0,0
2021-08-17 15:45,92,43,49,0,0,0
2021-08-17 16:00,116,61,55,0,0,0
2021-08-17 16:15,92,54,38,0,0,0
2021-08-17 16:30,113,50,63,0,0,0
2021-08-17 16:45,96,47,49,0,0,0
2021-08-17 17:00,99,44,55,0,0,0
2021-08-17 17:15,91,44,47,0,0,0
2021-08-17 17:30,86,34,52,0,0,0
2021-08-17 17:45,83,43,40,0,0,0
2021-08-17 18:00,81,32,49,0,0,0
2021-08-17 18:15,64,16,48,0,0,0
2021-08-17 18:30,76,33,43,0,0,0
2021-08-17 18:45,61,35,26,0,0,0
2021-08-17 19:00,55,20,35,0,0,0
2021-08-17 19:15,54,28,26,0,0,0
2021-08-17 19:30,46,22,24,0,0,0
2021-08-17 19:45,53,25,28,0,0,0
2021-08-17 20:00,34,14,20,0,0,0
2021-08-17 20:15,32,10,22,0,0,0
2021-08-17 20:30,28,9,19,0,0,0
2021-08-17 20:45,22,6,16,0,0,0
2021-08-17 21:00,38,25,13,0,0,0
2021-08-17 21:15,13,6,7,0,0,0
2021-08-17 21:30,22,12,10,0,0,0
2021-08-17 21:45,57,6,51,0,0,0
2021-08-17 22:00,20,4,16,0,0,0
2021-08-17 22:15,16,7,9,0,0,0
2021-08-17 22:30,24,8,16,0,0,0
2021-08-17 22:45,14,8,6,0,0,0
2021-08-17 23:00,10,1,9,0,0,0
2021-08-17 23:15,9,4,5,0,0,0
2021-08-17 23:30,9,2,7,0,0,0
2021-08-17 23:45,5,2,3,0,0,0
2021-08-18 00:00,3,2,1,0,0,0
2021-08-18 00:15,4,1,3,0,0,0
2021-08-18 00:30,0,0,0,0,0,0
2021-08-18 00:45,1,1,0,0,0,0
2021-08-18 01:00,4,1,3,0,0,0
2021-08-18 01:15,3,3,0,0,0,0
2021-08-18 01:30,0,0,0,0,0,0
2021-08-18 01:45,1,1,0,0,0,0
2021-08-18 02:00,2,1,1,0,0,0
2021-08-18 02:15,2,0,2,0,0,0
2021-08-18 02:30,0,0,0,0,0,0
2021-08-18 02:45,1,0,1,0,0,0
2021-08-18 03:00,0,0,0,0,0,0
2021-08-18 03:15,1,0,1,0,0,0
2021-08-18 03:30,1,0,1,0,0,0
2021-08-18 03:45,3,2,1,0,0,0
2021-08-18 04:00,0,0,0,0,0,0
2021-08-18 04:15,0,0,0,0,0,0
2021-08-18 04:30,2,1,1,0,0,0
2021-08-18 04:45,1,0,1,0,0,0
2021-08-18 05:00,0,0,0,0,0,0
2021-08-18 05:15,1,1,0,0,0,0
2021-08-18 05:30,13,1,12,0,0,0
2021-08-18 05:45,13,3,10,0,0,0
2021-08-18 06:00,6,1,5,0,0,0
2021-08-18 06:15,25,15,10,0,0,0
2021-08-18 06:30,30,5,25,0,0,0
2021-08-18 06:45,58,24,34,0,0,0
2021-08-18 07:00,62,26,36,0,0,0
2021-08-18 07:15,78,30,48,0,0,0
2021-08-18 07:30,133,70,63,0,0,0
2021-08-18 07:45,213,125,88,0,0,0
2021-08-18 08:00,160,86,74,0,0,0
2021-08-18 08:15,133,55,78,0,0,0
2021-08-18 08:30,126,77,49,0,0,0
2021-08-18 08:45,104,47,57,0,0,0
2021-08-18 09:00,82,55,27,0,0,0
2021-08-18 09:15,82,50,32,0,0,0
2021-08-18 09:30,87,52,35,0,0,0
2021-08-18 09:45,137,80,57,0,0,0
2021-08-18 10:00,78,46,32,0,0,0
2021-08-18 10:15,75,52,23,0,0,0
2021-08-18 10:30,60,31,29,0,0,0
2021-08-18 10:45,84,42,42,0,0,0
2021-08-18 11:00,96,54,42,0,0,0
2021-08-18 11:15,116,61,55,0,0,0
2021-08-18 11:30,84,44,40,0,0,0
2021-08-18 11:45,137,90,47,0,0,0
2021-08-18 12:00,92,38,54,0,0,0
2021-08-18 12:15,87,42,45,0,0,0
2021-08-18 12:30,139,54,85,0,0,0
2021-08-18 12:45,122,41,81,0,0,0
2021-08-18 13:00,105,43,62,0,0,0
2021-08-18 13:15,115,51,64,0,0,0
2021-08-18 13:30,168,51,117,0,0,0
2021-08-18 13:45,120,41,79,0,0,0
2021-08-18 14:00,101,42,59,0,0,0
2021-08-18 14:15,104,52,52,0,0,0
2021-08-18 14:30,101,48,53,0,0,0
2021-08-18 14:45,120,51,69,0,0,0
2021-08-18 15:00,94,44,50,0,0,0
2021-08-18 15:15,120,65,55,0,0,0
2021-08-18 15:30,126,61,65,0,0,0
2021-08-18 15:45,96,45,51,0,0,0
2021-08-18 16:00,116,63,53,0,0,0
2021-08-18 16:15,114,62,52,0,0,0
2021-08-18 16:30,114,67,47,0,0,0
2021-08-18 16:45,132,59,73,0,0,0
2021-08-18 17:00,98,52,46,0,0,0
2021-08-18 17:15,108,49,59,0,0,0
2021-08-18 17:30,103,36,67,0,0,0
2021-08-18 17:45,105,54,51,0,0,0
2021-08-18 18:00,102,50,52,0,0,0
2021-08-18 18:15,85,43,42,0,0,0
2021-08-18 18:30,76,28,48,0,0,0
2021-08-18 18:45,74,22,52,0,0,0
2021-08-18 19:00,69,20,49,0,0,0
2021-08-18 19:15,91,47,44,0,0,0
2021-08-18 19:30,63,28,35,0,0,0
2021-08-18 19:45,71,39,32,0,0,0
2021-08-18 20:00,54,34,20,0,0,0
2021-08-18 20:15,48,17,31,0,0,0
2021-08-18 20:30,52,29,23,0,0,0
2021-08-18 20:45,22,10,12,0,0,0
2021-08-18 21:00,29,12,17,0,0,0
2021-08-18 21:15,24,14,10,0,0,0
2021-08-18 21:30,42,15,27,0,0,0
2021-08-18 21:45,36,4,32,0,0,0
2021-08-18 22:00,41,8,33,0,0,0
2021-08-18 22:15,32,13,19,0,0,0
2021-08-18 22:30,25,10,15,0,0,0
2021-08-18 22:45,24,9,15,0,0,0
2021-08-18 23:00,19,2,17,0,0,0
2021-08-18 23:15,9,5,4,0,0,0
2021-08-18 23:30,6,1,5,0,0,0
2021-08-18 23:45,8,1,7,0,0,0
2021-08-19 00:00,9,2,7,0,0,0
2021-08-19 00:15,6,0,6,0,0,0
2021-08-19 00:30,10,4,6,0,0,0
2021-08-19 00:45,8,2,6,0,0,0
2021-08-19 01:00,10,1,9,0,0,0
2021-08-19 01:15,1,0,1,0,0,0
2021-08-19 01:30,11,2,9,0,0,0
2021-08-19 01:45,4,3,1,0,0,0
2021-08-19 02:00,7,0,7,0,0,0
2021-08-19 02:15,3,2,1,0,0,0
2021-08-19 02:30,4,0,4,0,0,0
2021-08-19 02:45,3,0,3,0,0,0
2021-08-19 03:00,1,0,1,0,0,0
2021-08-19 03:15,0,0,0,0,0,0
2021-08-19 03:30,1,0,1,0,0,0
2021-08-19 03:45,1,0,1,0,0,0
2021-08-19 04:00,0,0,0,0,0,0
2021-08-19 04:15,0,0,0,0,0,0
2021-08-19 04:30,6,1,5,0,0,0
2021-08-19 04:45,1,0,1,0,0,0
2021-08-19 05:00,1,1,0,0,0,0
2021-08-19 05:15,5,4,1,0,0,0
2021-08-19 05:30,8,2,6,0,0,0
2021-08-19 05:45,9,4,5,0,0,0
2021-08-19 06:00,4,3,1,0,0,0
2021-08-19 06:15,21,12,9,0,0,0
2021-08-19 06:30,34,14,20,0,0,0
2021-08-19 06:45,38,11,27,0,0,0
2021-08-19 07:00,64,22,42,0,0,0
2021-08-19 07:15,70,35,35,0,0,0
2021-08-19 07:30,126,58,68,0,0,0
2021-08-19 07:45,247,167,80,0,0,0
2021-08-19 08:00,183,126,57,0,0,0
2021-08-19 08:15,101,50,51,0,0,0
2021-08-19 08:30,82,44,38,0,0,0
2021-08-19 08:45,111,61,50,0,0,0
2021-08-19 09:00,65,34,31,0,0,0
2021-08-19 09:15,53,20,33,0,0,0
2021-08-19 09:30,45,28,17,0,0,0
2021-08-19 09:45,65,45,20,0,0,0
2021-08-19 10:00,39,19,20,0,0,0
2021-08-19 10:15,47,23,24,0,0,0
2021-08-19 10:30,55,26,29,0,0,0
2021-08-19 10:45,54,32,22,0,0,0
2021-08-19 11:00,48,21,27,0,0,0
2021-08-19 11:15,42,15,27,0,0,0
2021-08-19 11:30,45,20,25,0,0,0
2021-08-19 11:45,71,32,39,0,0,0
2021-08-19 12:00,55,29,26,0,0,0
2021-08-19 12:15,62,27,35,0,0,0
2021-08-19 12:30,69,35,34,0,0,0
2021-08-19 12:45,87,34,53,0,0,0
2021-08-19 13:00,76,22,54,0,0,0
2021-08-19 13:15,72,25,47,0,0,0
2021-08-19 13:30,127,26,101,0,0,0
2021-08-19 13:45,77,32,45,0,0,0
2021-08-19 14:00,71,46,25,0,0,0
2021-08-19 14:15,111,40,71,0,0,0
2021-08-19 14:30,101,37,64,0,0,0
2021-08-19 14:45,87,42,45,0,0,0
2021-08-19 15:00,78,37,41,0,0,0
2021-08-19 15:15,70,40,30,0,0,0
2021-08-19 15:30,63,36,27,0,0,0
2021-08-19 15:45,108,64,44,0,0,0
2021-08-19 16:00,118,64,54,0,0,0
2021-08-19 16:15,111,56,55,0,0,0
2021-08-19 16:30,108,48,60,0,0,0
2021-08-19 16:45,78,43,35,0,0,0
2021-08-19 17:00,96,51,45,0,0,0
2021-08-19 17:15,93,42,51,0,0,0
2021-08-19 17:30,106,57,49,0,0,0
2021-08-19 17:45,85,48,37,0,0,0
2021-08-19 18:00,82,32,50,0,0,0
2021-08-19 18:15,86,30,56,0,0,0
2021-08-19 18:30,70,23,47,0,0,0
2021-08-19 18:45,69,39,30,0,0,0
2021-08-19 19:00,58,22,36,0,0,0
2021-08-19 19:15,58,33,25,0,0,0
2021-08-19 19:30,53,30,23,0,0,0
2021-08-19 19:45,40,18,22,0,0,0
2021-08-19 20:00,34,11,23,0,0,0
2021-08-19 20:15,34,11,23,0,0,0
2021-08-19 20:30,39,24,15,0,0,0
2021-08-19 20:45,29,18,11,0,0,0
2021-08-19 21:00,30,11,19,0,0,0
2021-08-19 21:15,25,9,16,0,0,0
2021-08-19 21:30,31,12,19,0,0,0
2021-08-19 21:45,34,3,31,0,0,0
2021-08-19 22:00,22,3,19,0,0,0
2021-08-19 22:15,39,10,29,0,0,0
2021-08-19 22:30,29,5,24,0,0,0
2021-08-19 22:45,21,4,17,0,0,0
2021-08-19 23:00,17,3,14,0,0,0
2021-08-19 23:15,11,2,9,0,0,0
2021-08-19 23:30,10,2,8,0,0,0
2021-08-19 23:45,7,1,6,0,0,0
2021-08-20 00:00,6,3,3,0,0,0
2021-08-20 00:15,3,1,2,0,0,0
2021-08-20 00:30,8,1,7,0,0,0
2021-08-20 00:45,3,0,3,0,0,0
2021-08-20 01:00,3,0,3,0,0,0
2021-08-20 01:15,5,2,3,0,0,0
2021-08-20 01:30,0,0,0,0,0,0
2021-08-20 01:45,6,0,6,0,0,0
2021-08-20 02:00,2,0,2,0,0,0
2021-08-20 02:15,4,0,4,0,0,0
2021-08-20 02:30,0,0,0,0,0,0
2021-08-20 02:45,0,0,0,0,0,0
2021-08-20 03:00,1,0,1,0,0,0
2021-08-20 03:15,0,0,0,0,0,0
2021-08-20 03:30,1,0,1,0,0,0
2021-08-20 03:45,0,0,0,0,0,0
2021-08-20 04:00,2,0,2,0,0,0
2021-08-20 04:15,2,0,2,0,0,0
2021-08-20 04:30,0,0,0,0,0,0
2021-08-20 04:45,1,0,1,0,0,0
2021-08-20 05:00,0,0,0,0,0,0
2021-08-20 05:15,2,2,0,0,0,0
2021-08-20 05:30,4,1,3,0,0,0
2021-08-20 05:45,9,2,7,0,0,0
2021-08-20 06:00,13,5,8,0,0,0
2021-08-20 06:15,22,7,15,0,0,0
2021-08-20 06:30,34,14,20,0,0,0
2021-08-20 06:45,41,15,26,0,0,0
2021-08-20 07:00,53,19,34,0,0,0
2021-08-20 07:15,58,32,26,0,0,0
2021-08-20 07:30,121,63,58,0,0,0
2021-08-20 07:45,221,144,77,0,0,0
2021-08-20 08:00,205,153,52,0,0,0
2021-08-20 08:15,87,42,45,0,0,0
2021-08-20 08:30,90,43,47,0,0,0
2021-08-20 08:45,110,61,49,0,0,0
2021-08-20 09:00,64,28,36,0,0,0
2021-08-20 09:15,57,39,18,0,0,0
2021-08-20 09:30,66,39,27,0,0,0
2021-08-20 09:45,95,48,47,0,0,0
2021-08-20 10:00,56,37,19,0,0,0
2021-08-20 10:15,58,30,28,0,0,0
2021-08-20 10:30,47,22,25,0,0,0
2021-08-20 10:45,61,40,21,0,0,0
2021-08-20 11:00,58,20,38,0,0,0
2021-08-20 11:15,95,60,35,0,0,0
2021-08-20 11:30,56,31,25,0,0,0
2021-08-20 11:45,79,38,41,0,0,0
2021-08-20 12:00,65,32,33,0,0,0
2021-08-20 12:15,70,26,44,0,0,0
2021-08-20 12:30,77,30,47,0,0,0
2021-08-20 12:45,106,40,66,0,0,0
2021-08-20 13:00,93,34,59,0,0,0
2021-08-20 13:15,104,43,61,0,0,0
2021-08-20 13:30,156,40,116,0,0,0
2021-08-20 13:45,104,40,64,0,0,0
2021-08-20 14:00,117,62,55,0,0,0
2021-08-20 14:15,153,75,78,0,0,0
2021-08-20 14:30,150,54,96,0,0,0
2021-08-20 14:45,130,75,55,0,0,0
2021-08-20 15:00,115,48,67,0,0,0
2021-08-20 15:15,119,69,50,0,0,0
2021-08-20 15:30,98,47,51,0,0,0
2021-08-20 15:45,116,61,55,0,0,0
2021-08-20 16:00,116,58,58,0,0,0
2021-08-20 16:15,76,35,41,0,0,0
2021-08-20 16:30,116,46,70,0,0,0
2021-08-20 16:45,96,58,38,0,0,0
2021-08-20 17:00,100,63,37,0,0,0
2021-08-20 17:15,118,50,68,0,0,0
2021-08-20 17:30,91,41,50,0,0,0
2021-08-20 17:45,85,40,45,0,0,0
2021-08-20 18:00,80,38,42,0,0,0
2021-08-20 18:15,70,31,39,0,0,0
2021-08-20 18:30,100,48,52,0,0,0
2021-08-20 18:45,47,16,31,0,0,0
2021-08-20 19:00,63,34,29,0,0,0
2021-08-20 19:15,82,39,43,0,0,0
2021-08-20 19:30,77,34,43,0,0,0
2021-08-20 19:45,61,34,27,0,0,0
2021-08-20 20:00,63,24,39,0,0,0
2021-08-20 20:15,38,13,25,0,0,0
2021-08-20 20:30,36,10,26,0,0,0
2021-08-20 20:45,28,12,16,0,0,0
2021-08-20 21:00,52,26,26,0,0,0
2021-08-20 21:15,30,15,15,0,0,0
2021-08-20 21:30,41,27,14,0,0,0
2021-08-20 21:45,14,5,9,0,0,0
2021-08-20 22:00,22,8,14,0,0,0
2021-08-20 22:15,31,10,21,0,0,0
2021-08-20 22:30,33,9,24,0,0,0
2021-08-20 22:45,36,12,24,0,0,0
2021-08-20 23:00,16,7,9,0,0,0
2021-08-20 23:15,14,8,6,0,0,0
2021-08-20 23:30,14,3,11,0,0,0
2021-08-20 23:45,20,3,17,0,0,0
2021-08-21 00:00,14,1,13,0,0,0
2021-08-21 00:15,23,6,17,0,0,0
2021-08-21 00:30,18,2,16,0,0,0
2021-08-21 00:45,15,0,15,0,0,0
2021-08-21 01:00,14,1,13,0,0,0
2021-08-21 01:15,11,1,10,0,0,0
2021-08-21 01:30,9,5,4,0,0,0
2021-08-21 01:45,8,3,5,0,0,0
2021-08-21 02:00,14,2,12,0,0,0
2021-08-21 02:15,5,0,5,0,0,0
2021-08-21 02:30,14,6,8,0,0,0
2021-08-21 02:45,7,0,7,0,0,0
2021-08-21 03:00,9,3,6,0,0,0
2021-08-21 03:15,3,0,3,0,0,0
2021-08-21 03:30,10,1,9,0,0,0
2021-08-21 03:45,7,2,5,0,0,0
2021-08-21 04:00,3,0,3,0,0,0
2021-08-21 04:15,4,1,3,0,0,0
2021-08-21 04:30,0,0,0,0,0,0
2021-08-21 04:45,0,0,0,0,0,0
2021-08-21 05:00,0,0,0,0,0,0
2021-08-21 05:15,3,0,3,0,0,0
2021-08-21 05:30,8,1,7,0,0,0
2021-08-21 05:45,6,1,5,0,0,0
2021-08-21 06:00,4,3,1,0,0,0
2021-08-21 06:15,8,6,2,0,0,0
2021-08-21 06:30,4,2,2,0,0,0
2021-08-21 06:45,14,8,6,0,0,0
2021-08-21 07:00,7,4,3,0,0,0
2021-08-21 07:15,11,11,0,0,0,0
2021-08-21 07:30,15,9,6,0,0,0
2021-08-21 07:45,15,7,8,0,0,0
2021-08-21 08:00,15,13,2,0,0,0
2021-08-21 08:15,17,9,8,0,0,0
2021-08-21 08:30,31,19,12,0,0,0
2021-08-21 08:45,38,28,10,0,0,0
2021-08-21 09:00,60,45,15,0,0,0
2021-08-21 09:15,50,39,11,0,0,0
2021-08-21 09:30,68,37,31,0,0,0
2021-08-21 09:45,69,50,19,0,0,0
2021-08-21 10:00,56,32,24,0,0,0
2021-08-21 10:15,65,42,23,0,0,0
2021-08-21 10:30,64,43,21,0,0,0
2021-08-21 10:45,109,71,38,0,0,0
2021-08-21 11:00,92,48,44,0,0,0
2021-08-21 11:15,82,48,34,0,0,0
2021-08-21 11:30,81,41,40,0,0,0
2021-08-21 11:45,110,70,40,0,0,0
2021-08-21 12:00,128,74,54,0,0,0
2021-08-21 12:15,74,32,42,0,0,0
2021-08-21 12:30,99,56,43,0,0,0
2021-08-21 12:45,85,37,48,0,0,0
2021-08-21 13:00,120,70,50,0,0,0
2021-08-21 13:15,115,52,63,0,0,0
2021-08-21 13:30,93,45,48,0,0,0
2021-08-21 13:45,132,40,92,0,0,0
2021-08-21 14:00,81,45,36,0,0,0
2021-08-21 14:15,112,47,65,0,0,0
2021-08-21 14:30,93,34,59,0,0,0
2021-08-21 14:45,105,49,56,0,0,0
2021-08-21 15:00,64,28,36,0,0,0
2021-08-21 15:15,80,23,57,0,0,0
2021-08-21 15:30,52,18,34,0,0,0
2021-08-21 15:45,71,32,39,0,0,0
2021-08-21 16:00,82,35,47,0,0,0
2021-08-21 16:15,76,28,48,0,0,0
2021-08-21 16:30,64,27,37,0,0,0
2021-08-21 16:45,59,30,29,0,0,0
2021-08-21 17:00,98,50,48,0,0,0
2021-08-21 17:15,92,40,52,0,0,0
2021-08-21 17:30,60,26,34,0,0,0
2021-08-21 17:45,72,31,41,0,0,0
2021-08-21 18:00,80,29,51,0,0,0
2021-08-21 18:15,92,34,58,0,0,0
2021-08-21 18:30,66,23,43,0,0,0
2021-08-21 18:45,85,31,54,0,0,0
2021-08-21 19:00,79,25,54,0,0,0
2021-08-21 19:15,51,21,30,0,0,0
2021-08-21 19:30,54,20,34,0,0,0
2021-08-21 19:45,52,27,25,0,0,0
2021-08-21 20:00,61,20,41,0,0,0
2021-08-21 20:15,33,11,22,0,0,0
2021-08-21 20:30,29,11,18,0,0,0
2021-08-21 20:45,45,21,24,0,0,0
2021-08-21 21:00,34,19,15,0,0,0
2021-08-21 21:15,26,10,16,0,0,0
2021-08-21 21:30,45,13,32,0,0,0
2021-08-21 21:45,24,17,7,0,0,0
2021-08-21 22:00,27,5,22,0,0,0
2021-08-21 22:15,30,16,14,0,0,0
2021-08-21 22:30,37,17,20,0,0,0
2021-08-21 22:45,35,8,27,0,0,0
2021-08-21 23:00,20,5,15,0,0,0
2021-08-21 23:15,18,4,14,0,0,0
2021-08-21 23:30,20,15,5,0,0,0
2021-08-21 23:45,20,6,14,0,0,0
2021-08-22 00:00,18,5,13,0,0,0
2021-08-22 00:15,24,5,19,0,0,0
2021-08-22 00:30,10,3,7,0,0,0
2021-08-22 00:45,24,17,7,0,0,0
2021-08-22 01:00,23,8,15,0,0,0
2021-08-22 01:15,20,5,15,0,0,0
2021-08-22 01:30,11,1,10,0,0,0
2021-08-22 01:45,11,0,11,0,0,0
2021-08-22 02:00,13,1,12,0,0,0
2021-08-22 02:15,8,3,5,0,0,0
2021-08-22 02:30,9,0,9,0,0,0
2021-08-22 02:45,10,0,10,0,0,0
2021-08-22 03:00,11,3,8,0,0,0
2021-08-22 03:15,6,0,6,0,0,0
2021-08-22 03:30,0,0,0,0,0,0
2021-08-22 03:45,8,0,8,0,0,0
2021-08-22 04:00,4,0,4,0,0,0
2021-08-22 04:15,0,0,0,0,0,0
2021-08-22 04:30,1,0,1,0,0,0
2021-08-22 04:45,4,0,4,0,0,0
2021-08-22 05:00,0,0,0,0,0,0
2021-08-22 05:15,3,0,3,0,0,0
2021-08-22 05:30,3,0,3,0,0,0
2021-08-22 05:45,3,0,3,0,0,0
2021-08-22 06:00,1,1,0,0,0,0
2021-08-22 06:15,2,1,1,0,0,0
2021-08-22 06:30,5,3,2,0,0,0
2021-08-22 06:45,2,0,2,0,0,0
2021-08-22 07:00,2,2,0,0,0,0
2021-08-22 07:15,1,1,0,0,0,0
2021-08-22 07:30,4,2,2,0,0,0
2021-08-22 07:45,4,2,2,0,0,0
2021-08-22 08:00,5,2,3,0,0,0
2021-08-22 08:15,3,1,2,0,0,0
2021-08-22 08:30,9,8,1,0,0,0
2021-08-22 08:45,13,8,5,0,0,0
2021-08-22 09:00,8,5,3,0,0,0
2021-08-22 09:15,12,8,4,0,0,0
2021-08-22 09:30,25,21,4,0,0,0
2021-08-22 09:45,19,9,10,0,0,0
2021-08-22 10:00,29,15,14,0,0,0
2021-08-22 10:15,35,21,14,0,0,0
2021-08-22 10:30,25,12,13,0,0,0
2021-08-22 10:45,18,8,10,0,0,0
2021-08-22 11:00,20,13,7,0,0,0
2021-08-22 11:15,27,14,13,0,0,0
2021-08-22 11:30,18,10,8,0,0,0
2021-08-22 11:45,26,8,18,0,0,0
2021-08-22 12:00,15,7,8,0,0,0
2021-08-22 12:15,36,19,17,0,0,0
2021-08-22 12:30,42,15,27,0,0,0
2021-08-22 12:45,25,10,15,0,0,0
2021-08-22 13:00,45,16,29,0,0,0
2021-08-22 13:15,41,20,21,0,0,0
2021-08-22 13:30,48,29,19,0,0,0
2021-08-22 13:45,33,16,17,0,0,0
2021-08-22 14:00,50,26,24,0,0,0
2021-08-22 14:15,34,15,19,0,0,0
2021-08-22 14:30,35,19,16,0,0,0
2021-08-22 14:45,40,21,19,0,0,0
2021-08-22 15:00,39,22,17,0,0,0
2021-08-22 15:15,34,11,23,0,0,0
2021-08-22 15:30,44,22,22,0,0,0
2021-08-22 15:45,53,17,36,0,0,0
2021-08-22 16:00,38,21,17,0,0,0
2021-08-22 16:15,46,18,28,0,0,0
2021-08-22 16:30,42,18,24,0,0,0
2021-08-22 16:45,51,22,29,0,0,0
2021-08-22 17:00,40,17,23,0,0,0
2021-08-22 17:15,36,17,19,0,0,0
2021-08-22 17:30,44,12,32,0,0,0
2021-08-22 17:45,37,10,27,0,0,0
2021-08-22 18:00,50,22,28,0,0,0
2021-08-22 18:15,59,23,36,0,0,0
2021-08-22 18:30,47,26,21,0,0,0
2021-08-22 18:45,48,19,29,0,0,0
2021-08-22 19:00,47,21,26,0,0,0
2021-08-22 19:15,35,18,17,0,0,0
2021-08-22 19:30,27,10,17,0,0,0
2021-08-22 19:45,42,19,23,0,0,0
2021-08-22 20:00,45,9,36,0,0,0
2021-08-22 20:15,28,6,22,0,0,0
2021-08-22 20:30,21,6,15,0,0,0
2021-08-22 20:45,23,7,16,0,0,0
2021-08-22 21:00,33,17,16,0,0,0
2021-08-22 21:15,10,4,6,0,0,0
2021-08-22 21:30,16,5,11,0,0,0
2021-08-22 21:45,41,32,9,0,0,0
2021-08-22 22:00,16,4,12,0,0,0
2021-08-22 22:15,9,4,5,0,0,0
2021-08-22 22:30,11,2,9,0,0,0
2021-08-22 22:45,13,5,8,0,0,0
2021-08-22 23:00,11,2,9,0,0,0
2021-08-22 23:15,10,1,9,0,0,0
2021-08-22 23:30,1,1,0,0,0,0
2021-08-22 23:45,2,0,2,0,0,0
2021-08-23 00:00,0,0,0,0,0,0
2021-08-23 00:15,4,1,3,0,0,0
2021-08-23 00:30,3,0,3,0,0,0
2021-08-23 00:45,2,0,2,0,0,0
2021-08-23 01:00,2,0,2,0,0,0
2021-08-23 01:15,2,1,1,0,0,0
2021-08-23 01:30,7,0,7,0,0,0
2021-08-23 01:45,0,0,0,0,0,0
2021-08-23 02:00,0,0,0,0,0,0
2021-08-23 02:15,0,0,0,0,0,0
2021-08-23 02:30,1,1,0,0,0,0
2021-08-23 02:45,0,0,0,0,0,0
2021-08-23 03:00,0,0,0,0,0,0
2021-08-23 03:15,0,0,0,0,0,0
2021-08-23 03:30,0,0,0,0,0,0
2021-08-23 03:45,2,1,1,0,0,0
2021-08-23 04:00,0,0,0,0,0,0
2021-08-23 04:15,1,1,0,0,0,0
2021-08-23 04:30,1,0,1,0,0,0
2021-08-23 04:45,2,2,0,0,0,0
2021-08-23 05:00,0,0,0,0,0,0
2021-08-23 05:15,5,4,1,0,0,0
2021-08-23 05:30,5,1,4,0,0,0
2021-08-23 05:45,8,3,5,0,0,0
2021-08-23 06:00,3,2,1,0,0,0
2021-08-23 06:15,27,12,15,0,0,0
2021-08-23 06:30,28,7,21,0,0,0
2021-08-23 06:45,49,12,37,0,0,0
2021-08-23 07:00,51,17,34,0,0,0
2021-08-23 07:15,88,37,51,0,0,0
2021-08-23 07:30,128,69,59,0,0,0
2021-08-23 07:45,206,120,86,0,0,0
2021-08-23 08:00,226,165,61,0,0,0
2021-08-23 08:15,103,60,43,0,0,0
2021-08-23 08:30,92,49,43,0,0,0
2021-08-23 08:45,118,63,55,0,0,0
2021-08-23 09:00,68,31,37,0,0,0
2021-08-23 09:15,65,36,29,0,0,0
2021-08-23 09:30,59,32,27,0,0,0
2021-08-23 09:45,76,47,29,0,0,0
2021-08-23 10:00,52,28,24,0,0,0
2021-08-23 10:15,40,18,22,0,0,0
2021-08-23 10:30,57,30,27,0,0,0
2021-08-23 10:45,62,32,30,0,0,0
2021-08-23 11:00,64,30,34,0,0,0
2021-08-23 11:15,67,30,37,0,0,0
2021-08-23 11:30,67,34,33,0,0,0
2021-08-23 11:45,74,45,29,0,0,0
2021-08-23 12:00,54,26,28,0,0,0
2021-08-23 12:15,77,27,50,0,0,0
2021-08-23 12:30,72,22,50,0,0,0
2021-08-23 12:45,126,38,88,0,0,0
2021-08-23 13:00,95,31,64,0,0,0
2021-08-23 13:15,92,38,54,0,0,0
2021-08-23 13:30,151,40,111,0,0,0
2021-08-23 13:45,93,47,46,0,0,0
2021-08-23 14:00,100,45,55,0,0,0
2021-08-23 14:15,109,61,48,0,0,0
2021-08-23 14:30,133,42,91,0,0,0
2021-08-23 14:45,100,48,52,0,0,0
2021-08-23 15:00,105,46,59,0,0,0
2021-08-23 15:15,124,60,64,0,0,0
2021-08-23 15:30,116,51,65,0,0,0
2021-08-23 15:45,112,55,57,0,0,0
2021-08-23 16:00,145,59,86,0,0,0
2021-08-23 16:15,136,64,72,0,0,0
2021-08-23 16:30,128,55,73,0,0,0
2021-08-23 16:45,138,80,58,0,0,0
2021-08-23 17:00,129,79,50,0,0,0
2021-08-23 17:15,106,38,68,0,0,0
2021-08-23 17:30,107,54,53,0,0,0
2021-08-23 17:45,116,53,63,0,0,0
2021-08-23 18:00,126,49,77,0,0,0
2021-08-23 18:15,93,47,46,0,0,0
2021-08-23 18:30,99,38,61,0,0,0
2021-08-23 18:45,79,36,43,0,0,0
2021-08-23 19:00,74,26,48,0,0,0
2021-08-23 19:15,64,26,38,0,0,0
2021-08-23 19:30,46,13,33,0,0,0
2021-08-23 19:45,58,23,35,0,0,0
2021-08-23 20:00,53,21,32,0,0,0
2021-08-23 20:15,41,12,29,0,0,0
2021-08-23 20:30,27,5,22,0,0,0
2021-08-23 20:45,32,11,21,0,0,0
2021-08-23 21:00,47,13,34,0,0,0
2021-08-23 21:15,31,6,25,0,0,0
2021-08-23 21:30,38,8,30,0,0,0
2021-08-23 21:45,12,1,11,0,0,0
2021-08-23 22:00,22,7,15,0,0,0
2021-08-23 22:15,22,7,15,0,0,0
2021-08-23 22:30,12,3,9,0,0,0
2021-08-23 22:45,14,5,9,0,0,0
2021-08-23 23:00,14,4,10,0,0,0
2021-08-23 23:15,12,1,11,0,0,0
2021-08-23 23:30,5,0,5,0,0,0
2021-08-23 23:45,1,0,1,0,0,0
2021-08-24 00:00,1,0,1,0,0,0
2021-08-24 00:15,6,1,5,0,0,0
2021-08-24 00:30,0,0,0,0,0,0
2021-08-24 00:45,3,0,3,0,0,0
2021-08-24 01:00,1,0,1,0,0,0
2021-08-24 01:15,4,0,4,0,0,0
2021-08-24 01:30,1,0,1,0,0,0
2021-08-24 01:45,1,0,1,0,0,0
2021-08-24 02:00,2,0,2,0,0,0
2021-08-24 02:15,5,0,5,0,0,0
2021-08-24 02:30,0,0,0,0,0,0
2021-08-24 02:45,0,0,0,0,0,0
2021-08-24 03:00,0,0,0,0,0,0
2021-08-24 03:15,0,0,0,0,0,0
2021-08-24 03:30,1,0,1,0,0,0
2021-08-24 03:45,2,2,0,0,0,0
2021-08-24 04:00,0,0,0,0,0,0
2021-08-24 04:15,1,0,1,0,0,0
2021-08-24 04:30,2,0,2,0,0,0
2021-08-24 04:45,1,1,0,0,0,0
2021-08-24 05:00,2,0,2,0,0,0
2021-08-24 05:15,4,3,1,0,0,0
2021-08-24 05:30,6,2,4,0,0,0
2021-08-24 05:45,6,1,5,0,0,0
2021-08-24 06:00,11,3,8,0,0,0
2021-08-24 06:15,25,10,15,0,0,0
2021-08-24 06:30,35,11,24,0,0,0
2021-08-24 06:45,58,21,37,0,0,0
2021-08-24 07:00,66,23,43,0,0,0
2021-08-24 07:15,71,25,46,0,0,0
2021-08-24 07:30,144,74,70,0,0,0
2021-08-24 07:45,243,131,112,0,0,0
2021-08-24 08:00,209,145,64,0,0,0
2021-08-24 08:15,101,60,41,0,0,0
2021-08-24 08:30,109,57,52,0,0,0
2021-08-24 08:45,132,71,61,0,0,0
2021-08-24 09:00,75,35,40,0,0,0
2021-08-24 09:15,81,37,44,0,0,0
2021-08-24 09:30,68,37,31,0,0,0
2021-08-24 09:45,85,60,25,0,0,0
2021-08-24 10:00,65,39,26,0,0,0
2021-08-24 10:15,79,45,34,0,0,0
2021-08-24 10:30,60,31,29,0,0,0
2021-08-24 10:45,74,42,32,0,0,0
2021-08-24 11:00,57,29,28,0,0,0
2021-08-24 11:15,67,41,26,0,0,0
2021-08-24 11:30,64,43,21,0,0,0
2021-08-24 11:45,80,48,32,0,0,0
2021-08-24 12:00,78,33,45,0,0,0
2021-08-24 12:15,81,26,55,0,0,0
2021-08-24 12:30,92,31,61,0,0,0
2021-08-24 12:45,87,37,50,0,0,0
2021-08-24 13:00,89,41,48,0,0,0
2021-08-24 13:15,119,53,66,0,0,0
2021-08-24 13:30,174,44,130,0,0,0
2021-08-24 13:45,128,52,76,0,0,0
2021-08-24 14:00,96,47,49,0,0,0
2021-08-24 14:15,116,54,62,0,0,0
2021-08-24 14:30,119,52,67,0,0,0
2021-08-24 14:45,117,56,61,0,0,0
2021-08-24 15:00,100,54,46,0,0,0
2021-08-24 15:15,137,58,79,0,0,0
2021-08-24 15:30,115,54,61,0,0,0
2021-08-24 15:45,170,83,87,0,0,0
2021-08-24 16:00,180,92,88,0,0,0
2021-08-24 16:15,119,64,55,0,0,0
2021-08-24 16:30,178,83,95,0,0,0
2021-08-24 16:45,162,79,83,0,0,0
2021-08-24 17:00,151,81,70,0,0,0
2021-08-24 17:15,143,63,80,0,0,0
2021-08-24 17:30,112,55,57,0,0,0
2021-08-24 17:45,134,56,78,0,0,0
2021-08-24 18:00,98,35,63,0,0,0
2021-08-24 18:15,103,40,63,0,0,0
2021-08-24 18:30,101,34,67,0,0,0
2021-08-24 18:45,89,34,55,0,0,0
2021-08-24 19:00,75,30,45,0,0,0
2021-08-24 19:15,78,40,38,0,0,0
2021-08-24 19:30,61,22,39,0,0,0
2021-08-24 19:45,60,21,39,0,0,0
2021-08-24 20:00,64,18,46,0,0,0
2021-08-24 20:15,50,18,32,0,0,0
2021-08-24 20:30,22,8,14,0,0,0
2021-08-24 20:45,48,18,30,0,0,0
2021-08-24 21:00,36,16,20,0,0,0
2021-08-24 21:15,51,18,33,0,0,0
2021-08-24 21:30,32,6,26,0,0,0
2021-08-24 21:45,35,7,28,0,0,0
2021-08-24 22:00,26,15,11,0,0,0
2021-08-24 22:15,21,7,14,0,0,0
2021-08-24 22:30,27,6,21,0,0,0
2021-08-24 22:45,21,5,16,0,0,0
2021-08-24 23:00,16,5,11,0,0,0
2021-08-24 23:15,14,1,13,0,0,0
2021-08-24 23:30,10,3,7,0,0,0
2021-08-24 23:45,12,0,12,0,0,0
2021-08-25 00:00,4,0,4,0,0,0
2021-08-25 00:15,3,1,2,0,0,0
2021-08-25 00:30,9,0,9,0,0,0
2021-08-25 00:45,0,0,0,0,0,0
2021-08-25 01:00,5,0,5,0,0,0
2021-08-25 01:15,8,2,6,0,0,0
2021-08-25 01:30,5,1,4,0,0,0
2021-08-25 01:45,2,1,1,0,0,0
2021-08-25 02:00,7,2,5,0,0,0
2021-08-25 02:15,0,0,0,0,0,0
2021-08-25 02:30,4,4,0,0,0,0
2021-08-25 02:45,0,0,0,0,0,0
2021-08-25 03:00,2,2,0,0,0,0
2021-08-25 03:15,0,0,0,0,0,0
2021-08-25 03:30,0,0,0,0,0,0
2021-08-25 03:45,1,1,0,0,0,0
2021-08-25 04:00,0,0,0,0,0,0
2021-08-25 04:15,3,1,2,0,0,0
2021-08-25 04:30,1,0,1,0,0,0
2021-08-25 04:45,1,0,1,0,0,0
2021-08-25 05:00,1,0,1,0,0,0
2021-08-25 05:15,3,2,1,0,0,0
2021-08-25 05:30,10,3,7,0,0,0
2021-08-25 05:45,15,4,11,0,0,0
2021-08-25 06:00,10,8,2,0,0,0
2021-08-25 06:15,22,8,14,0,0,0
2021-08-25 06:30,32,17,15,0,0,0
2021-08-25 06:45,47,15,32,0,0,0
2021-08-25 07:00,66,22,44,0,0,0
2021-08-25 07:15,69,31,38,0,0,0
2021-08-25 07:30,153,88,65,0,0,0
2021-08-25 07:45,230,131,99,0,0,0
2021-08-25 08:00,238,156,82,0,0,0
2021-08-25 08:15,112,53,59,0,0,0
2021-08-25 08:30,99,52,47,0,0,0
2021-08-25 08:45,120,62,58,0,0,0
2021-08-25 09:00,110,66,44,0,0,0
2021-08-25 09:15,81,42,39,0,0,0
2021-08-25 09:30,72,53,19,0,0,0
2021-08-25 09:45,107,62,45,0,0,0
2021-08-25 10:00,84,39,45,0,0,0
2021-08-25 10:15,82,54,28,0,0,0
2021-08-25 10:30,76,47,29,0,0,0
2021-08-25 10:45,90,50,40,0,0,0
2021-08-25 11:00,69,30,39,0,0,0
2021-08-25 11:15,84,43,41,0,0,0
2021-08-25 11:30,128,69,59,0,0,0
2021-08-25 11:45,114,66,48,0,0,0
2021-08-25 12:00,87,41,46,0,0,0
2021-08-25 12:15,94,45,49,0,0,0
2021-08-25 12:30,114,35,79,0,0,0
2021-08-25 12:45,97,39,58,0,0,0
2021-08-25 13:00,125,51,74,0,0,0
2021-08-25 13:15,114,53,61,0,0,0
2021-08-25 13:30,206,61,145,0,0,0
2021-08-25 13:45,113,46,67,0,0,0
2021-08-25 14:00,143,60,83,0,0,0
2021-08-25 14:15,112,51,61,0,0,0
2021-08-25 14:30,141,40,101,0,0,0
2021-08-25 14:45,122,53,69,0,0,0
2021-08-25 15:00,114,53,61,0,0,0
2021-08-25 15:15,128,56,72,0,0,0
2021-08-25 15:30,150,53,97,0,0,0
2021-08-25 15:45,159,64,95,0,0,0
2021-08-25 16:00,145,66,79,0,0,0
2021-08-25 16:15,136,57,79,0,0,0
2021-08-25 16:30,136,69,67,0,0,0
2021-08-25 16:45,136,56,80,0,0,0
2021-08-25 17:00,130,58,72,0,0,0
2021-08-25 17:15,117,61,56,0,0,0
2021-08-25 17:30,120,74,46,0,0,0
2021-08-25 17:45,130,76,54,0,0,0
2021-08-25 18:00,122,67,55,0,0,0
2021-08-25 18:15,116,53,63,0,0,0
2021-08-25 18:30,96,32,64,0,0,0
2021-08-25 18:45,62,27,35,0,0,0
2021-08-25 19:00,74,26,48,0,0,0
2021-08-25 19:15,85,35,50,0,0,0
2021-08-25 19:30,80,30,50,0,0,0
2021-08-25 19:45,83,35,48,0,0,0
2021-08-25 20:00,61,17,44,0,0,0
2021-08-25 20:15,62,31,31,0,0,0
2021-08-25 20:30,44,18,26,0,0,0
2021-08-25 20:45,49,17,32,0,0,0
2021-08-25 21:00,46,15,31,0,0,0
2021-08-25 21:15,32,13,19,0,0,0
2021-08-25 21:30,19,7,12,0,0,0
2021-08-25 21:45,24,7,17,0,0,0
2021-08-25 22:00,47,17,30,0,0,0
2021-08-25 22:15,39,16,23,0,0,0
2021-08-25 22:30,25,10,15,0,0,0
2021-08-25 22:45,31,11,20,0,0,0
2021-08-25 23:00,23,5,18,0,0,0
2021-08-25 23:15,24,8,16,0,0,0
2021-08-25 23:30,15,7,8,0,0,0
2021-08-25 23:45,12,2,10,0,0,0
2021-08-26 00:00,12,1,11,0,0,0
2021-08-26 00:15,6,1,5,0,0,0
2021-08-26 00:30,5,0,5,0,0,0
2021-08-26 00:45,5,2,3,0,0,0
2021-08-26 01:00,7,1,6,0,0,0
2021-08-26 01:15,5,2,3,0,0,0
2021-08-26 01:30,2,0,2,0,0,0
2021-08-26 01:45,5,0,5,0,0,0
2021-08-26 02:00,7,3,4,0,0,0
2021-08-26 02:15,2,0,2,0,0,0
2021-08-26 02:30,2,0,2,0,0,0
2021-08-26 02:45,1,0,1,0,0,0
2021-08-26 03:00,4,1,3,0,0,0
2021-08-26 03:15,2,0,2,0,0,0
2021-08-26 03:30,2,1,1,0,0,0
2021-08-26 03:45,2,0,2,0,0,0
2021-08-26 04:00,4,0,4,0,0,0
2021-08-26 04:15,5,1,4,0,0,0
2021-08-26 04:30,1,1,0,0,0,0
2021-08-26 04:45,0,0,0,0,0,0
2021-08-26 05:00,1,0,1,0,0,0
2021-08-26 05:15,4,2,2,0,0,0
2021-08-26 05:30,9,2,7,0,0,0
2021-08-26 05:45,12,3,9,0,0,0
2021-08-26 06:00,4,1,3,0,0,0
2021-08-26 06:15,26,9,17,0,0,0
2021-08-26 06:30,32,14,18,0,0,0
2021-08-26 06:45,45,14,31,0,0,0
2021-08-26 07:00,54,21,33,0,0,0
2021-08-26 07:15,73,25,48,0,0,0
2021-08-26 07:30,120,77,43,0,0,0
2021-08-26 07:45,215,117,98,0,0,0
2021-08-26 08:00,201,141,60,0,0,0
2021-08-26 08:15,90,52,38,0,0,0
2021-08-26 08:30,82,39,43,0,0,0
2021-08-26 08:45,109,59,50,0,0,0
2021-08-26 09:00,68,40,28,0,0,0
2021-08-26 09:15,69,33,36,0,0,0
2021-08-26 09:30,44,31,13,0,0,0
2021-08-26 09:45,78,43,35,0,0,0
2021-08-26 10:00,58,31,27,0,0,0
2021-08-26 10:15,44,26,18,0,0,0
2021-08-26 10:30,43,22,21,0,0,0
2021-08-26 10:45,55,31,24,0,0,0
2021-08-26 11:00,60,32,28,0,0,0
2021-08-26 11:15,62,27,35,0,0,0
2021-08-26 11:30,77,43,34,0,0,0
2021-08-26 11:45,75,43,32,0,0,0
2021-08-26 12:00,81,52,29,0,0,0
2021-08-26 12:15,55,25,30,0,0,0
2021-08-26 12:30,84,39,45,0,0,0
2021-08-26 12:45,105,22,83,0,0,0
2021-08-26 13:00,57,21,36,0,0,0
2021-08-26 13:15,70,27,43,0,0,0
2021-08-26 13:30,116,22,94,0,0,0
2021-08-26 13:45,68,34,34,0,0,0
2021-08-26 14:00,72,38,34,0,0,0
2021-08-26 14:15,78,45,33,0,0,0
2021-08-26 14:30,140,49,91,0,0,0
2021-08-26 14:45,82,40,42,0,0,0
2021-08-26 15:00,93,46,47,0,0,0
2021-08-26 15:15,101,53,48,0,0,0
2021-08-26 15:30,120,31,89,0,0,0
2021-08-26 15:45,128,79,49,0,0,0
2021-08-26 16:00,121,68,53,0,0,0
2021-08-26 16:15,124,57,67,0,0,0
2021-08-26 16:30,114,58,56,0,0,0
2021-08-26 16:45,104,69,35,0,0,0
2021-08-26 17:00,131,79,52,0,0,0
2021-08-26 17:15,73,23,50,0,0,0
2021-08-26 17:30,97,43,54,0,0,0
2021-08-26 17:45,118,47,71,0,0,0
2021-08-26 18:00,110,50,60,0,0,0
2021-08-26 18:15,88,37,51,0,0,0
2021-08-26 18:30,81,26,55,0,0,0
2021-08-26 18:45,73,32,41,0,0,0
2021-08-26 19:00,66,36,30,0,0,0
2021-08-26 19:15,40,20,20,0,0,0
2021-08-26 19:30,53,33,20,0,0,0
2021-08-26 19:45,46,20,26,0,0,0
2021-08-26 20:00,61,33,28,0,0,0
2021-08-26 20:15,48,13,35,0,0,0
2021-08-26 20:30,30,11,19,0,0,0
2021-08-26 20:45,52,14,38,0,0,0
2021-08-26 21:00,31,15,16,0,0,0
2021-08-26 21:15,27,11,16,0,0,0
2021-08-26 21:30,24,11,13,0,0,0
2021-08-26 21:45,31,6,25,0,0,0
2021-08-26 22:00,29,6,23,0,0,0
2021-08-26 22:15,34,11,23,0,0,0
2021-08-26 22:30,27,7,20,0,0,0
2021-08-26 22:45,18,7,11,0,0,0
2021-08-26 23:00,23,3,20,0,0,0
2021-08-26 23:15,9,2,7,0,0,0
2021-08-26 23:30,4,0,4,0,0,0
2021-08-26 23:45,10,3,7,0,0,0
2021-08-27 00:00,7,1,6,0,0,0
2021-08-27 00:15,5,1,4,0,0,0
2021-08-27 00:30,5,0,5,0,0,0
2021-08-27 00:45,0,0,0,0,0,0
2021-08-27 01:00,6,0,6,0,0,0
2021-08-27 01:15,9,2,7,0,0,0
2021-08-27 01:30,5,0,5,0,0,0
2021-08-27 01:45,7,1,6,0,0,0
2021-08-27 02:00,0,0,0,0,0,0
2021-08-27 02:15,1,0,1,0,0,0
2021-08-27 02:30,0,0,0,0,0,0
2021-08-27 02:45,1,0,1,0,0,0
2021-08-27 03:00,0,0,0,0,0,0
2021-08-27 03:15,2,0,2,0,0,0
2021-08-27 03:30,1,1,0,0,0,0
2021-08-27 03:45,2,1,1,0,0,0
2021-08-27 04:00,1,0,1,0,0,0
2021-08-27 04:15,2,0,2,0,0,0
2021-08-27 04:30,1,1,0,0,0,0
2021-08-27 04:45,0,0,0,0,0,0
2021-08-27 05:00,1,0,1,0,0,0
2021-08-27 05:15,1,1,0,0,0,0
2021-08-27 05:30,5,1,4,0,0,0
2021-08-27 05:45,6,2,4,0,0,0
2021-08-27 06:00,6,3,3,0,0,0
2021-08-27 06:15,27,9,18,0,0,0
2021-08-27 06:30,38,14,24,0,0,0
2021-08-27 06:45,35,7,28,0,0,0
2021-08-27 07:00,41,13,28,0,0,0
2021-08-27 07:15,64,31,33,0,0,0
2021-08-27 07:30,109,59,50,0,0,0
2021-08-27 07:45,226,141,85,0,0,0
2021-08-27 08:00,184,141,43,0,0,0
2021-08-27 08:15,79,43,36,0,0,0
2021-08-27 08:30,103,57,46,0,0,0
2021-08-27 08:45,113,60,53,0,0,0
2021-08-27 09:00,67,30,37,0,0,0
2021-08-27 09:15,64,39,25,0,0,0
2021-08-27 09:30,67,34,33,0,0,0
2021-08-27 09:45,80,47,33,0,0,0
2021-08-27 10:00,53,32,21,0,0,0
2021-08-27 10:15,55,37,18,0,0,0
2021-08-27 10:30,44,25,19,0,0,0
2021-08-27 10:45,49,27,22,0,0,0
2021-08-27 11:00,86,30,56,0,0,0
2021-08-27 11:15,67,35,32,0,0,0
2021-08-27 11:30,65,34,31,0,0,0
2021-08-27 11:45,78,44,34,0,0,0
2021-08-27 12:00,71,41,30,0,0,0
2021-08-27 12:15,57,24,33,0,0,0
2021-08-27 12:30,74,33,41,0,0,0
2021-08-27 12:45,86,35,51,0,0,0
2021-08-27 13:00,126,68,58,0,0,0
2021-08-27 13:15,87,47,40,0,0,0
2021-08-27 13:30,186,36,150,0,0,0
2021-08-27 13:45,72,28,44,0,0,0
2021-08-27 14:00,93,37,56,0,0,0
2021-08-27 14:15,90,43,47,0,0,0
2021-08-27 14:30,109,36,73,0,0,0
2021-08-27 14:45,102,50,52,0,0,0
2021-08-27 15:00,99,57,42,0,0,0
2021-08-27 15:15,110,56,54,0,0,0
2021-08-27 15:30,110,52,58,0,0,0
2021-08-27 15:45,88,42,46,0,0,0
2021-08-27 16:00,97,53,44,0,0,0
2021-08-27 16:15,72,39,33,0,0,0
2021-08-27 16:30,96,40,56,0,0,0
2021-08-27 16:45,73,35,38,0,0,0
2021-08-27 17:00,48,26,22,0,0,0
2021-08-27 17:15,81,36,45,0,0,0
2021-08-27 17:30,62,30,32,0,0,0
2021-08-27 17:45,73,33,40,0,0,0
2021-08-27 18:00,51,13,38,0,0,0
2021-08-27 18:15,51,23,28,0,0,0
2021-08-27 18:30,64,33,31,0,0,0
2021-08-27 18:45,53,27,26,0,0,0
2021-08-27 19:00,57,28,29,0,0,0
2021-08-27 19:15,55,28,27,0,0,0
2021-08-27 19:30,38,21,17,0,0,0
2021-08-27 19:45,59,30,29,0,0,0
2021-08-27 20:00,44,19,25,0,0,0
2021-08-27 20:15,29,18,11,0,0,0
2021-08-27 20:30,28,15,13,0,0,0
2021-08-27 20:45,36,14,22,0,0,0
2021-08-27 21:00,33,16,17,0,0,0
2021-08-27 21:15,23,7,16,0,0,0
2021-08-27 21:30,20,12,8,0,0,0
2021-08-27 21:45,19,11,8,0,0,0
2021-08-27 22:00,24,9,15,0,0,0
2021-08-27 22:15,11,5,6,0,0,0
2021-08-27 22:30,32,10,22,0,0,0
2021-08-27 22:45,17,4,13,0,0,0
2021-08-27 23:00,24,13,11,0,0,0
2021-08-27 23:15,19,10,9,0,0,0
2021-08-27 23:30,15,5,10,0,0,0
2021-08-27 23:45,21,5,16,0,0,0
2021-08-28 00:00,13,4,9,0,0,0
2021-08-28 00:15,14,4,10,0,0,0
2021-08-28 00:30,12,5,7,0,0,0
2021-08-28 00:45,24,8,16,0,0,0
2021-08-28 01:00,18,4,14,0,0,0
2021-08-28 01:15,16,3,13,0,0,0
2021-08-28 01:30,6,3,3,0,0,0
2021-08-28 01:45,10,3,7,0,0,0
2021-08-28 02:00,9,2,7,0,0,0
2021-08-28 02:15,15,1,14,0,0,0
2021-08-28 02:30,7,0,7,0,0,0
2021-08-28 02:45,12,0,12,0,0,0
2021-08-28 03:00,10,3,7,0,0,0
2021-08-28 03:15,3,0,3,0,0,0
2021-08-28 03:30,1,0,1,0,0,0
2021-08-28 03:45,7,4,3,0,0,0
2021-08-28 04:00,7,2,5,0,0,0
2021-08-28 04:15,2,0,2,0,0,0
2021-08-28 04:30,5,2,3,0,0,0
2021-08-28 04:45,2,2,0,0,0,0
2021-08-28 05:00,1,1,0,0,0,0
2021-08-28 05:15,3,2,1,0,0,0
2021-08-28 05:30,5,2,3,0,0,0
2021-08-28 05:45,3,0,3,0,0,0
2021-08-28 06:00,2,2,0,0,0,0
2021-08-28 06:15,4,3,1,0,0,0
2021-08-28 06:30,6,6,0,0,0,0
2021-08-28 06:45,5,4,1,0,0,0
2021-08-28 07:00,3,1,2,0,0,0
2021-08-28 07:15,10,8,2,0,0,0
2021-08-28 07:30,12,8,4,0,0,0
2021-08-28 07:45,17,8,9,0,0,0
2021-08-28 08:00,15,7,8,0,0,0
2021-08-28 08:15,16,12,4,0,0,0
2021-08-28 08:30,20,9,11,0,0,0
2021-08-28 08:45,25,18,7,0,0,0
2021-08-28 09:00,23,15,8,0,0,0
2021-08-28 09:15,41,28,13,0,0,0
2021-08-28 09:30,57,50,7,0,0,0
2021-08-28 09:45,47,35,12,0,0,0
2021-08-28 10:00,62,42,20,0,0,0
2021-08-28 10:15,65,42,23,0,0,0
2021-08-28 10:30,56,39,17,0,0,0
2021-08-28 10:45,68,50,18,0,0,0
2021-08-28 11:00,67,32,35,0,0,0
2021-08-28 11:15,48,22,26,0,0,0
2021-08-28 11:30,66,38,28,0,0,0
2021-08-28 11:45,79,46,33,0,0,0
2021-08-28 12:00,75,44,31,0,0,0
2021-08-28 12:15,88,40,48,0,0,0
2021-08-28 12:30,62,28,34,0,0,0
2021-08-28 12:45,74,33,41,0,0,0
2021-08-28 13:00,74,31,43,0,0,0
2021-08-28 13:15,57,20,37,0,0,0
2021-08-28 13:30,84,40,44,0,0,0
2021-08-28 13:45,63,33,30,0,0,0
2021-08-28 14:00,46,21,25,0,0,0
2021-08-28 14:15,79,34,45,0,0,0
2021-08-28 14:30,53,24,29,0,0,0
2021-08-28 14:45,63,40,23,0,0,0
2021-08-28 15:00,40,10,30,0,0,0
2021-08-28 15:15,27,9,18,0,0,0
2021-08-28 15:30,31,10,21,0,0,0
2021-08-28 15:45,65,31,34,0,0,0
2021-08-28 16:00,62,26,36,0,0,0
2021-08-28 16:15,39,19,20,0,0,0
2021-08-28 16:30,37,15,22,0,0,0
2021-08-28 16:45,72,34,38,0,0,0
2021-08-28 17:00,61,43,18,0,0,0
2021-08-28 17:15,38,21,17,0,0,0
2021-08-28 17:30,37,16,21,0,0,0
2021-08-28 17:45,60,29,31,0,0,0
2021-08-28 18:00,44,18,26,0,0,0
2021-08-28 18:15,64,15,49,0,0,0
2021-08-28 18:30,47,26,21,0,0,0
2021-08-28 18:45,60,15,45,0,0,0
2021-08-28 19:00,57,15,42,0,0,0
2021-08-28 19:15,35,8,27,0,0,0
2021-08-28 19:30,38,12,26,0,0,0
2021-08-28 19:45,36,16,20,0,0,0
2021-08-28 20:00,36,10,26,0,0,0
2021-08-28 20:15,40,18,22,0,0,0
2021-08-28 20:30,21,8,13,0,0,0
2021-08-28 20:45,17,9,8,0,0,0
2021-08-28 21:00,18,10,8,0,0,0
2021-08-28 21:15,24,9,15,0,0,0
2021-08-28 21:30,18,4,14,0,0,0
2021-08-28 21:45,17,3,14,0,0,0
2021-08-28 22:00,20,7,13,0,0,0
2021-08-28 22:15,42,36,6,0,0,0
2021-08-28 22:30,20,15,5,0,0,0
2021-08-28 22:45,24,9,15,0,0,0
2021-08-28 23:00,16,6,10,0,0,0
2021-08-28 23:15,19,5,14,0,0,0
2021-08-28 23:30,11,4,7,0,0,0
2021-08-28 23:45,5,3,2,0,0,0
2021-08-29 00:00,11,5,6,0,0,0
2021-08-29 00:15,15,2,13,0,0,0
2021-08-29 00:30,9,1,8,0,0,0
2021-08-29 00:45,12,5,7,0,0,0
2021-08-29 01:00,12,2,10,0,0,0
2021-08-29 01:15,7,1,6,0,0,0
2021-08-29 01:30,9,3,6,0,0,0
2021-08-29 01:45,9,0,9,0,0,0
2021-08-29 02:00,5,0,5,0,0,0
2021-08-29 02:15,1,1,0,0,0,0
2021-08-29 02:30,2,1,1,0,0,0
2021-08-29 02:45,3,1,2,0,0,0
2021-08-29 03:00,9,6,3,0,0,0
2021-08-29 03:15,2,1,1,0,0,0
2021-08-29 03:30,8,0,8,0,0,0
2021-08-29 03:45,6,4,2,0,0,0
2021-08-29 04:00,11,0,11,0,0,0
2021-08-29 04:15,3,0,3,0,0,0
2021-08-29 04:30,2,0,2,0,0,0
2021-08-29 04:45,4,3,1,0,0,0
2021-08-29 05:00,1,0,1,0,0,0
2021-08-29 05:15,2,0,2,0,0,0
2021-08-29 05:30,2,0,2,0,0,0
2021-08-29 05:45,8,1,7,0,0,0
2021-08-29 06:00,1,0,1,0,0,0
2021-08-29 06:15,2,2,0,0,0,0
2021-08-29 06:30,5,3,2,0,0,0
2021-08-29 06:45,4,2,2,0,0,0
2021-08-29 07:00,1,0,1,0,0,0
2021-08-29 07:15,3,3,0,0,0,0
2021-08-29 07:30,6,1,5,0,0,0
2021-08-29 07:45,5,0,5,0,0,0
2021-08-29 08:00,3,3,0,0,0,0
2021-08-29 08:15,6,3,3,0,0,0
2021-08-29 08:30,9,6,3,0,0,0
2021-08-29 08:45,7,4,3,0,0,0
2021-08-29 09:00,7,6,1,0,0,0
2021-08-29 09:15,4,2,2,0,0,0
2021-08-29 09:30,29,7,22,0,0,0
2021-08-29 09:45,22,20,2,0,0,0
2021-08-29 10:00,9,7,2,0,0,0
2021-08-29 10:15,16,8,8,0,0,0
2021-08-29 10:30,16,7,9,0,0,0
2021-08-29 10:45,11,5,6,0,0,0
2021-08-29 11:00,10,3,7,0,0,0
2021-08-29 11:15,12,5,7,0,0,0
2021-08-29 11:30,10,6,4,0,0,0
2021-08-29 11:45,21,9,12,0,0,0
2021-08-29 12:00,21,12,9,0,0,0
2021-08-29 12:15,29,17,12,0,0,0
2021-08-29 12:30,13,5,8,0,0,0
2021-08-29 12:45,17,10,7,0,0,0
2021-08-29 13:00,24,7,17,0,0,0
2021-08-29 13:15,44,19,25,0,0,0
2021-08-29 13:30,23,17,6,0,0,0
2021-08-29 13:45,35,16,19,0,0,0
2021-08-29 14:00,26,10,16,0,0,0
2021-08-29 14:15,31,15,16,0,0,0
2021-08-29 14:30,45,31,14,0,0,0
2021-08-29 14:45,39,20,19,0,0,0
2021-08-29 15:00,26,11,15,0,0,0
2021-08-29 15:15,29,14,15,0,0,0
2021-08-29 15:30,26,15,11,0,0,0
2021-08-29 15:45,26,7,19,0,0,0
2021-08-29 16:00,32,11,21,0,0,0
2021-08-29 16:15,28,4,24,0,0,0
2021-08-29 16:30,43,21,22,0,0,0
2021-08-29 16:45,17,5,12,0,0,0
2021-08-29 17:00,42,20,22,0,0,0
2021-08-29 17:15,31,17,14,0,0,0
2021-08-29 17:30,32,11,21,0,0,0
2021-08-29 17:45,24,15,9,0,0,0
2021-08-29 18:00,27,11,16,0,0,0
2021-08-29 18:15,19,6,13,0,0,0
2021-08-29 18:30,23,13,10,0,0,0
2021-08-29 18:45,27,10,17,0,0,0
2021-08-29 19:00,16,4,12,0,0,0
2021-08-29 19:15,19,4,15,0,0,0
2021-08-29 19:30,25,5,20,0,0,0
2021-08-29 19:45,22,5,17,0,0,0
2021-08-29 20:00,18,3,15,0,0,0
2021-08-29 20:15,9,5,4,0,0,0
2021-08-29 20:30,12,2,10,0,0,0
2021-08-29 20:45,10,4,6,0,0,0
2021-08-29 21:00,7,4,3,0,0,0
2021-08-29 21:15,8,5,3,0,0,0
2021-08-29 21:30,10,7,3,0,0,0
2021-08-29 21:45,6,3,3,0,0,0
2021-08-29 22:00,11,3,8,0,0,0
2021-08-29 22:15,22,14,8,0,0,0
2021-08-29 22:30,9,1,8,0,0,0
2021-08-29 22:45,7,2,5,0,0,0
2021-08-29 23:00,6,1,5,0,0,0
2021-08-29 23:15,3,1,2,0,0,0
2021-08-29 23:30,0,0,0,0,0,0
2021-08-29 23:45,6,2,4,0,0,0
2021-08-30 00:00,2,2,0,0,0,0
2021-08-30 00:15,1,0,1,0,0,0
2021-08-30 00:30,1,0,1,0,0,0
2021-08-30 00:45,2,0,2,0,0,0
2021-08-30 01:00,2,2,0,0,0,0
2021-08-30 01:15,3,0,3,0,0,0
2021-08-30 01:30,2,1,1,0,0,0
2021-08-30 01:45,0,0,0,0,0,0
2021-08-30 02:00,3,1,2,0,0,0
2021-08-30 02:15,0,0,0,0,0,0
2021-08-30 02:30,0,0,0,0,0,0
2021-08-30 02:45,0,0,0,0,0,0
2021-08-30 03:00,0,0,0,0,0,0
2021-08-30 03:15,0,0,0,0,0,0
2021-08-30 03:30,0,0,0,0,0,0
2021-08-30 03:45,0,0,0,0,0,0
2021-08-30 04:00,0,0,0,0,0,0
2021-08-30 04:15,0,0,0,0,0,0
2021-08-30 04:30,3,0,3,0,0,0
2021-08-30 04:45,0,0,0,0,0,0
2021-08-30 05:00,6,5,1,0,0,0
2021-08-30 05:15,3,2,1,0,0,0
2021-08-30 05:30,9,3,6,0,0,0
2021-08-30 05:45,14,4,10,0,0,0
2021-08-30 06:00,8,6,2,0,0,0
2021-08-30 06:15,19,5,14,0,0,0
2021-08-30 06:30,28,10,18,0,0,0
2021-08-30 06:45,42,12,30,0,0,0
2021-08-30 07:00,50,18,32,0,0,0
2021-08-30 07:15,58,27,31,0,0,0
2021-08-30 07:30,127,75,52,0,0,0
2021-08-30 07:45,213,127,86,0,0,0
2021-08-30 08:00,190,143,47,0,0,0
2021-08-30 08:15,89,37,52,0,0,0
2021-08-30 08:30,98,31,67,0,0,0
2021-08-30 08:45,122,69,53,0,0,0
2021-08-30 09:00,64,30,34,0,0,0
2021-08-30 09:15,50,23,27,0,0,0
2021-08-30 09:30,71,41,30,0,0,0
2021-08-30 09:45,69,37,32,0,0,0
2021-08-30 10:00,61,35,26,0,0,0
2021-08-30 10:15,50,25,25,0,0,0
2021-08-30 10:30,58,35,23,0,0,0
2021-08-30 10:45,61,28,33,0,0,0
2021-08-30 11:00,46,25,21,0,0,0
2021-08-30 11:15,50,22,28,0,0,0
2021-08-30 11:30,68,21,47,0,0,0
2021-08-30 11:45,56,32,24,0,0,0
2021-08-30 12:00,69,33,36,0,0,0
2021-08-30 12:15,59,23,36,0,0,0
2021-08-30 12:30,76,27,49,0,0,0
2021-08-30 12:45,101,24,77,0,0,0
2021-08-30 13:00,94,56,38,0,0,0
2021-08-30 13:15,106,63,43,0,0,0
2021-08-30 13:30,175,50,125,0,0,0
2021-08-30 13:45,93,35,58,0,0,0
2021-08-30 14:00,86,43,43,0,0,0
2021-08-30 14:15,83,36,47,0,0,0
2021-08-30 14:30,87,28,59,0,0,0
2021-08-30 14:45,88,32,56,0,0,0
2021-08-30 15:00,106,48,58,0,0,0
2021-08-30 15:15,113,62,51,0,0,0
2021-08-30 15:30,123,48,75,0,0,0
2021-08-30 15:45,123,59,64,0,0,0
2021-08-30 16:00,119,49,70,0,0,0
2021-08-30 16:15,116,67,49,0,0,0
2021-08-30 16:30,102,45,57,0,0,0
2021-08-30 16:45,106,62,44,0,0,0
2021-08-30 17:00,116,55,61,0,0,0
2021-08-30 17:15,118,52,66,0,0,0
2021-08-30 17:30,112,62,50,0,0,0
2021-08-30 17:45,105,53,52,0,0,0
2021-08-30 18:00,84,30,54,0,0,0
2021-08-30 18:15,106,42,64,0,0,0
2021-08-30 18:30,77,28,49,0,0,0
2021-08-30 18:45,70,30,40,0,0,0
2021-08-30 19:00,68,31,37,0,0,0
2021-08-30 19:15,70,31,39,0,0,0
2021-08-30 19:30,58,19,39,0,0,0
2021-08-30 19:45,47,21,26,0,0,0
2021-08-30 20:00,61,21,40,0,0,0
2021-08-30 20:15,41,16,25,0,0,0
2021-08-30 20:30,30,11,19,0,0,0
2021-08-30 20:45,29,8,21,0,0,0
2021-08-30 21:00,40,12,28,0,0,0
2021-08-30 21:15,36,13,23,0,0,0
2021-08-30 21:30,21,5,16,0,0,0
2021-08-30 21:45,19,7,12,0,0,0
2021-08-30 22:00,30,12,18,0,0,0
2021-08-30 22:15,15,1,14,0,0,0
2021-08-30 22:30,15,5,10,0,0,0
2021-08-30 22:45,29,5,24,0,0,0
2021-08-30 23:00,6,2,4,0,0,0
2021-08-30 23:15,10,2,8,0,0,0
2021-08-30 23:30,8,1,7,0,0,0
2021-08-30 23:45,5,3,2,0,0,0
