Datetime,100035541 (Neutor),101035541 (Neutor stadteinwÃ¤rts),102035541 (Neutor stadtauswÃ¤rts),100035541-status,101035541-status,102035541-status
2019-08-01 00:00,57,32,25,0,0,0
2019-08-01 00:15,36,15,21,0,0,0
2019-08-01 00:30,34,6,28,0,0,0
2019-08-01 00:45,28,12,16,0,0,0
2019-08-01 01:00,20,6,14,0,0,0
2019-08-01 01:15,24,7,17,0,0,0
2019-08-01 01:30,24,3,21,0,0,0
2019-08-01 01:45,33,5,28,0,0,0
2019-08-01 02:00,25,10,15,0,0,0
2019-08-01 02:15,19,3,16,0,0,0
2019-08-01 02:30,30,2,28,0,0,0
2019-08-01 02:45,26,8,18,0,0,0
2019-08-01 03:00,16,4,12,0,0,0
2019-08-01 03:15,22,3,19,0,0,0
2019-08-01 03:30,21,3,18,0,0,0
2019-08-01 03:45,7,2,5,0,0,0
2019-08-01 04:00,4,1,3,0,0,0
2019-08-01 04:15,9,4,5,0,0,0
2019-08-01 04:30,13,2,11,0,0,0
2019-08-01 04:45,24,7,17,0,0,0
2019-08-01 05:00,14,6,8,0,0,0
2019-08-01 05:15,16,7,9,0,0,0
2019-08-01 05:30,21,13,8,0,0,0
2019-08-01 05:45,37,22,15,0,0,0
2019-08-01 06:00,32,21,11,0,0,0
2019-08-01 06:15,33,23,10,0,0,0
2019-08-01 06:30,61,41,20,0,0,0
2019-08-01 06:45,109,60,49,0,0,0
2019-08-01 07:00,102,56,46,0,0,0
2019-08-01 07:15,96,51,45,0,0,0
2019-08-01 07:30,159,98,61,0,0,0
2019-08-01 07:45,199,119,80,0,0,0
2019-08-01 08:00,184,116,68,0,0,0
2019-08-01 08:15,179,117,62,0,0,0
2019-08-01 08:30,182,126,56,0,0,0
2019-08-01 08:45,192,125,67,0,0,0
2019-08-01 09:00,159,101,58,0,0,0
2019-08-01 09:15,155,104,51,0,0,0
2019-08-01 09:30,166,103,63,0,0,0
2019-08-01 09:45,191,120,71,0,0,0
2019-08-01 10:00,127,77,50,0,0,0
2019-08-01 10:15,124,84,40,0,0,0
2019-08-01 10:30,136,85,51,0,0,0
2019-08-01 10:45,151,86,65,0,0,0
2019-08-01 11:00,136,77,59,0,0,0
2019-08-01 11:15,135,83,52,0,0,0
2019-08-01 11:30,124,73,51,0,0,0
2019-08-01 11:45,161,94,67,0,0,0
2019-08-01 12:00,139,79,60,0,0,0
2019-08-01 12:15,152,87,65,0,0,0
2019-08-01 12:30,153,79,74,0,0,0
2019-08-01 12:45,214,125,89,0,0,0
2019-08-01 13:00,170,91,79,0,0,0
2019-08-01 13:15,168,97,71,0,0,0
2019-08-01 13:30,163,101,62,0,0,0
2019-08-01 13:45,194,113,81,0,0,0
2019-08-01 14:00,185,78,107,0,0,0
2019-08-01 14:15,142,84,58,0,0,0
2019-08-01 14:30,163,80,83,0,0,0
2019-08-01 14:45,201,104,97,0,0,0
2019-08-01 15:00,190,107,83,0,0,0
2019-08-01 15:15,201,97,104,0,0,0
2019-08-01 15:30,188,91,97,0,0,0
2019-08-01 15:45,209,115,94,0,0,0
2019-08-01 16:00,210,106,104,0,0,0
2019-08-01 16:15,223,100,123,0,0,0
2019-08-01 16:30,222,103,119,0,0,0
2019-08-01 16:45,260,143,117,0,0,0
2019-08-01 17:00,236,109,127,0,0,0
2019-08-01 17:15,300,135,165,0,0,0
2019-08-01 17:30,260,126,134,0,0,0
2019-08-01 17:45,279,152,127,0,0,0
2019-08-01 18:00,242,121,121,0,0,0
2019-08-01 18:15,236,101,135,0,0,0
2019-08-01 18:30,203,104,99,0,0,0
2019-08-01 18:45,223,104,119,0,0,0
2019-08-01 19:00,177,99,78,0,0,0
2019-08-01 19:15,197,93,104,0,0,0
2019-08-01 19:30,158,76,82,0,0,0
2019-08-01 19:45,183,93,90,0,0,0
2019-08-01 20:00,151,68,83,0,0,0
2019-08-01 20:15,125,48,77,0,0,0
2019-08-01 20:30,96,39,57,0,0,0
2019-08-01 20:45,94,47,47,0,0,0
2019-08-01 21:00,105,44,61,0,0,0
2019-08-01 21:15,74,29,45,0,0,0
2019-08-01 21:30,107,35,72,0,0,0
2019-08-01 21:45,138,47,91,0,0,0
2019-08-01 22:00,77,37,40,0,0,0
2019-08-01 22:15,88,25,63,0,0,0
2019-08-01 22:30,86,41,45,0,0,0
2019-08-01 22:45,73,19,54,0,0,0
2019-08-01 23:00,71,20,51,0,0,0
2019-08-01 23:15,53,9,44,0,0,0
2019-08-01 23:30,45,15,30,0,0,0
2019-08-01 23:45,41,11,30,0,0,0
2019-08-02 00:00,36,8,28,0,0,0
2019-08-02 00:15,28,11,17,0,0,0
2019-08-02 00:30,37,6,31,0,0,0
2019-08-02 00:45,26,7,19,0,0,0
2019-08-02 01:00,29,10,19,0,0,0
2019-08-02 01:15,17,3,14,0,0,0
2019-08-02 01:30,13,3,10,0,0,0
2019-08-02 01:45,12,1,11,0,0,0
2019-08-02 02:00,18,4,14,0,0,0
2019-08-02 02:15,15,1,14,0,0,0
2019-08-02 02:30,16,3,13,0,0,0
2019-08-02 02:45,10,3,7,0,0,0
2019-08-02 03:00,6,1,5,0,0,0
2019-08-02 03:15,8,3,5,0,0,0
2019-08-02 03:30,5,3,2,0,0,0
2019-08-02 03:45,4,2,2,0,0,0
2019-08-02 04:00,6,0,6,0,0,0
2019-08-02 04:15,4,2,2,0,0,0
2019-08-02 04:30,5,2,3,0,0,0
2019-08-02 04:45,10,5,5,0,0,0
2019-08-02 05:00,11,5,6,0,0,0
2019-08-02 05:15,11,5,6,0,0,0
2019-08-02 05:30,22,12,10,0,0,0
2019-08-02 05:45,28,20,8,0,0,0
2019-08-02 06:00,31,19,12,0,0,0
2019-08-02 06:15,36,20,16,0,0,0
2019-08-02 06:30,52,29,23,0,0,0
2019-08-02 06:45,95,61,34,0,0,0
2019-08-02 07:00,85,54,31,0,0,0
2019-08-02 07:15,86,54,32,0,0,0
2019-08-02 07:30,134,82,52,0,0,0
2019-08-02 07:45,171,103,68,0,0,0
2019-08-02 08:00,166,99,67,0,0,0
2019-08-02 08:15,167,100,67,0,0,0
2019-08-02 08:30,164,112,52,0,0,0
2019-08-02 08:45,182,120,62,0,0,0
2019-08-02 09:00,136,72,64,0,0,0
2019-08-02 09:15,125,84,41,0,0,0
2019-08-02 09:30,124,84,40,0,0,0
2019-08-02 09:45,140,99,41,0,0,0
2019-08-02 10:00,120,75,45,0,0,0
2019-08-02 10:15,130,88,42,0,0,0
2019-08-02 10:30,139,88,51,0,0,0
2019-08-02 10:45,146,86,60,0,0,0
2019-08-02 11:00,205,143,62,0,0,0
2019-08-02 11:15,121,75,46,0,0,0
2019-08-02 11:30,153,82,71,0,0,0
2019-08-02 11:45,150,84,66,0,0,0
2019-08-02 12:00,139,64,75,0,0,0
2019-08-02 12:15,161,80,81,0,0,0
2019-08-02 12:30,164,96,68,0,0,0
2019-08-02 12:45,175,98,77,0,0,0
2019-08-02 13:00,161,76,85,0,0,0
2019-08-02 13:15,175,95,80,0,0,0
2019-08-02 13:30,168,73,95,0,0,0
2019-08-02 13:45,204,97,107,0,0,0
2019-08-02 14:00,174,93,81,0,0,0
2019-08-02 14:15,188,98,90,0,0,0
2019-08-02 14:30,160,82,78,0,0,0
2019-08-02 14:45,150,78,72,0,0,0
2019-08-02 15:00,190,89,101,0,0,0
2019-08-02 15:15,173,90,83,0,0,0
2019-08-02 15:30,195,104,91,0,0,0
2019-08-02 15:45,197,91,106,0,0,0
2019-08-02 16:00,192,100,92,0,0,0
2019-08-02 16:15,198,88,110,0,0,0
2019-08-02 16:30,194,88,106,0,0,0
2019-08-02 16:45,186,88,98,0,0,0
2019-08-02 17:00,151,69,82,0,0,0
2019-08-02 17:15,177,78,99,0,0,0
2019-08-02 17:30,181,81,100,0,0,0
2019-08-02 17:45,173,89,84,0,0,0
2019-08-02 18:00,173,73,100,0,0,0
2019-08-02 18:15,136,51,85,0,0,0
2019-08-02 18:30,122,54,68,0,0,0
2019-08-02 18:45,150,83,67,0,0,0
2019-08-02 19:00,126,66,60,0,0,0
2019-08-02 19:15,117,72,45,0,0,0
2019-08-02 19:30,112,61,51,0,0,0
2019-08-02 19:45,142,80,62,0,0,0
2019-08-02 20:00,129,63,66,0,0,0
2019-08-02 20:15,122,62,60,0,0,0
2019-08-02 20:30,98,42,56,0,0,0
2019-08-02 20:45,85,44,41,0,0,0
2019-08-02 21:00,84,41,43,0,0,0
2019-08-02 21:15,85,35,50,0,0,0
2019-08-02 21:30,55,22,33,0,0,0
2019-08-02 21:45,67,32,35,0,0,0
2019-08-02 22:00,46,30,16,0,0,0
2019-08-02 22:15,55,25,30,0,0,0
2019-08-02 22:30,56,19,37,0,0,0
2019-08-02 22:45,71,35,36,0,0,0
2019-08-02 23:00,58,23,35,0,0,0
2019-08-02 23:15,47,15,32,0,0,0
2019-08-02 23:30,56,21,35,0,0,0
2019-08-02 23:45,74,26,48,0,0,0
2019-08-03 00:00,51,18,33,0,0,0
2019-08-03 00:15,45,19,26,0,0,0
2019-08-03 00:30,59,26,33,0,0,0
2019-08-03 00:45,60,30,30,0,0,0
2019-08-03 01:00,85,35,50,0,0,0
2019-08-03 01:15,45,10,35,0,0,0
2019-08-03 01:30,44,10,34,0,0,0
2019-08-03 01:45,14,5,9,0,0,0
2019-08-03 02:00,45,9,36,0,0,0
2019-08-03 02:15,27,3,24,0,0,0
2019-08-03 02:30,17,7,10,0,0,0
2019-08-03 02:45,34,5,29,0,0,0
2019-08-03 03:00,34,3,31,0,0,0
2019-08-03 03:15,32,4,28,0,0,0
2019-08-03 03:30,16,4,12,0,0,0
2019-08-03 03:45,25,6,19,0,0,0
2019-08-03 04:00,19,1,18,0,0,0
2019-08-03 04:15,30,5,25,0,0,0
2019-08-03 04:30,17,2,15,0,0,0
2019-08-03 04:45,21,4,17,0,0,0
2019-08-03 05:00,9,1,8,0,0,0
2019-08-03 05:15,17,7,10,0,0,0
2019-08-03 05:30,21,2,19,0,0,0
2019-08-03 05:45,24,13,11,0,0,0
2019-08-03 06:00,19,5,14,0,0,0
2019-08-03 06:15,16,8,8,0,0,0
2019-08-03 06:30,14,7,7,0,0,0
2019-08-03 06:45,20,10,10,0,0,0
2019-08-03 07:00,13,8,5,0,0,0
2019-08-03 07:15,22,15,7,0,0,0
2019-08-03 07:30,33,20,13,0,0,0
2019-08-03 07:45,39,28,11,0,0,0
2019-08-03 08:00,33,23,10,0,0,0
2019-08-03 08:15,34,22,12,0,0,0
2019-08-03 08:30,58,40,18,0,0,0
2019-08-03 08:45,72,44,28,0,0,0
2019-08-03 09:00,52,34,18,0,0,0
2019-08-03 09:15,67,55,12,0,0,0
2019-08-03 09:30,79,57,22,0,0,0
2019-08-03 09:45,114,82,32,0,0,0
2019-08-03 10:00,115,82,33,0,0,0
2019-08-03 10:15,127,94,33,0,0,0
2019-08-03 10:30,116,89,27,0,0,0
2019-08-03 10:45,111,72,39,0,0,0
2019-08-03 11:00,124,72,52,0,0,0
2019-08-03 11:15,101,64,37,0,0,0
2019-08-03 11:30,128,68,60,0,0,0
2019-08-03 11:45,129,82,47,0,0,0
2019-08-03 12:00,130,79,51,0,0,0
2019-08-03 12:15,145,77,68,0,0,0
2019-08-03 12:30,150,104,46,0,0,0
2019-08-03 12:45,161,93,68,0,0,0
2019-08-03 13:00,156,102,54,0,0,0
2019-08-03 13:15,143,106,37,0,0,0
2019-08-03 13:30,148,84,64,0,0,0
2019-08-03 13:45,160,87,73,0,0,0
2019-08-03 14:00,159,81,78,0,0,0
2019-08-03 14:15,149,89,60,0,0,0
2019-08-03 14:30,133,73,60,0,0,0
2019-08-03 14:45,156,68,88,0,0,0
2019-08-03 15:00,129,72,57,0,0,0
2019-08-03 15:15,114,52,62,0,0,0
2019-08-03 15:30,143,59,84,0,0,0
2019-08-03 15:45,133,69,64,0,0,0
2019-08-03 16:00,124,72,52,0,0,0
2019-08-03 16:15,154,67,87,0,0,0
2019-08-03 16:30,142,70,72,0,0,0
2019-08-03 16:45,112,52,60,0,0,0
2019-08-03 17:00,125,72,53,0,0,0
2019-08-03 17:15,146,76,70,0,0,0
2019-08-03 17:30,129,72,57,0,0,0
2019-08-03 17:45,187,105,82,0,0,0
2019-08-03 18:00,166,93,73,0,0,0
2019-08-03 18:15,154,76,78,0,0,0
2019-08-03 18:30,162,77,85,0,0,0
2019-08-03 18:45,164,98,66,0,0,0
2019-08-03 19:00,130,61,69,0,0,0
2019-08-03 19:15,144,58,86,0,0,0
2019-08-03 19:30,131,62,69,0,0,0
2019-08-03 19:45,135,57,78,0,0,0
2019-08-03 20:00,156,79,77,0,0,0
2019-08-03 20:15,107,58,49,0,0,0
2019-08-03 20:30,100,53,47,0,0,0
2019-08-03 20:45,104,64,40,0,0,0
2019-08-03 21:00,78,37,41,0,0,0
2019-08-03 21:15,102,51,51,0,0,0
2019-08-03 21:30,64,39,25,0,0,0
2019-08-03 21:45,52,29,23,0,0,0
2019-08-03 22:00,60,28,32,0,0,0
2019-08-03 22:15,76,36,40,0,0,0
2019-08-03 22:30,63,33,30,0,0,0
2019-08-03 22:45,60,18,42,0,0,0
2019-08-03 23:00,77,33,44,0,0,0
2019-08-03 23:15,112,40,72,0,0,0
2019-08-03 23:30,121,29,92,0,0,0
2019-08-03 23:45,71,26,45,0,0,0
2019-08-04 00:00,43,11,32,0,0,0
2019-08-04 00:15,74,22,52,0,0,0
2019-08-04 00:30,59,21,38,0,0,0
2019-08-04 00:45,43,11,32,0,0,0
2019-08-04 01:00,76,24,52,0,0,0
2019-08-04 01:15,38,8,30,0,0,0
2019-08-04 01:30,31,6,25,0,0,0
2019-08-04 01:45,38,9,29,0,0,0
2019-08-04 02:00,45,9,36,0,0,0
2019-08-04 02:15,41,16,25,0,0,0
2019-08-04 02:30,37,9,28,0,0,0
2019-08-04 02:45,32,6,26,0,0,0
2019-08-04 03:00,33,5,28,0,0,0
2019-08-04 03:15,37,5,32,0,0,0
2019-08-04 03:30,16,5,11,0,0,0
2019-08-04 03:45,35,13,22,0,0,0
2019-08-04 04:00,16,7,9,0,0,0
2019-08-04 04:15,12,7,5,0,0,0
2019-08-04 04:30,14,1,13,0,0,0
2019-08-04 04:45,15,9,6,0,0,0
2019-08-04 05:00,19,5,14,0,0,0
2019-08-04 05:15,22,7,15,0,0,0
2019-08-04 05:30,15,5,10,0,0,0
2019-08-04 05:45,18,9,9,0,0,0
2019-08-04 06:00,15,1,14,0,0,0
2019-08-04 06:15,14,9,5,0,0,0
2019-08-04 06:30,9,3,6,0,0,0
2019-08-04 06:45,11,5,6,0,0,0
2019-08-04 07:00,17,11,6,0,0,0
2019-08-04 07:15,17,13,4,0,0,0
2019-08-04 07:30,12,6,6,0,0,0
2019-08-04 07:45,23,17,6,0,0,0
2019-08-04 08:00,15,10,5,0,0,0
2019-08-04 08:15,15,11,4,0,0,0
2019-08-04 08:30,20,12,8,0,0,0
2019-08-04 08:45,32,16,16,0,0,0
2019-08-04 09:00,43,29,14,0,0,0
2019-08-04 09:15,70,57,13,0,0,0
2019-08-04 09:30,63,44,19,0,0,0
2019-08-04 09:45,93,81,12,0,0,0
2019-08-04 10:00,70,53,17,0,0,0
2019-08-04 10:15,59,40,19,0,0,0
2019-08-04 10:30,65,49,16,0,0,0
2019-08-04 10:45,121,74,47,0,0,0
2019-08-04 11:00,94,57,37,0,0,0
2019-08-04 11:15,90,62,28,0,0,0
2019-08-04 11:30,90,52,38,0,0,0
2019-08-04 11:45,140,79,61,0,0,0
2019-08-04 12:00,85,57,28,0,0,0
2019-08-04 12:15,88,52,36,0,0,0
2019-08-04 12:30,117,81,36,0,0,0
2019-08-04 12:45,132,90,42,0,0,0
2019-08-04 13:00,127,62,65,0,0,0
2019-08-04 13:15,115,65,50,0,0,0
2019-08-04 13:30,119,80,39,0,0,0
2019-08-04 13:45,147,85,62,0,0,0
2019-08-04 14:00,118,76,42,0,0,0
2019-08-04 14:15,126,80,46,0,0,0
2019-08-04 14:30,105,66,39,0,0,0
2019-08-04 14:45,152,104,48,0,0,0
2019-08-04 15:00,150,95,55,0,0,0
2019-08-04 15:15,148,82,66,0,0,0
2019-08-04 15:30,139,76,63,0,0,0
2019-08-04 15:45,130,78,52,0,0,0
2019-08-04 16:00,132,77,55,0,0,0
2019-08-04 16:15,114,62,52,0,0,0
2019-08-04 16:30,132,63,69,0,0,0
2019-08-04 16:45,127,72,55,0,0,0
2019-08-04 17:00,129,59,70,0,0,0
2019-08-04 17:15,168,84,84,0,0,0
2019-08-04 17:30,163,71,92,0,0,0
2019-08-04 17:45,186,87,99,0,0,0
2019-08-04 18:00,162,54,108,0,0,0
2019-08-04 18:15,145,63,82,0,0,0
2019-08-04 18:30,144,60,84,0,0,0
2019-08-04 18:45,117,62,55,0,0,0
2019-08-04 19:00,117,48,69,0,0,0
2019-08-04 19:15,122,53,69,0,0,0
2019-08-04 19:30,115,51,64,0,0,0
2019-08-04 19:45,118,47,71,0,0,0
2019-08-04 20:00,77,42,35,0,0,0
2019-08-04 20:15,99,43,56,0,0,0
2019-08-04 20:30,92,39,53,0,0,0
2019-08-04 20:45,66,28,38,0,0,0
2019-08-04 21:00,93,43,50,0,0,0
2019-08-04 21:15,56,17,39,0,0,0
2019-08-04 21:30,58,12,46,0,0,0
2019-08-04 21:45,63,20,43,0,0,0
2019-08-04 22:00,60,17,43,0,0,0
2019-08-04 22:15,51,16,35,0,0,0
2019-08-04 22:30,36,11,25,0,0,0
2019-08-04 22:45,40,13,27,0,0,0
2019-08-04 23:00,26,8,18,0,0,0
2019-08-04 23:15,48,11,37,0,0,0
2019-08-04 23:30,27,9,18,0,0,0
2019-08-04 23:45,19,5,14,0,0,0
2019-08-05 00:00,20,6,14,0,0,0
2019-08-05 00:15,17,9,8,0,0,0
2019-08-05 00:30,18,7,11,0,0,0
2019-08-05 00:45,16,2,14,0,0,0
2019-08-05 01:00,18,9,9,0,0,0
2019-08-05 01:15,13,4,9,0,0,0
2019-08-05 01:30,9,1,8,0,0,0
2019-08-05 01:45,3,2,1,0,0,0
2019-08-05 02:00,3,1,2,0,0,0
2019-08-05 02:15,9,4,5,0,0,0
2019-08-05 02:30,4,3,1,0,0,0
2019-08-05 02:45,5,2,3,0,0,0
2019-08-05 03:00,2,1,1,0,0,0
2019-08-05 03:15,0,0,0,0,0,0
2019-08-05 03:30,2,1,1,0,0,0
2019-08-05 03:45,1,1,0,0,0,0
2019-08-05 04:00,0,0,0,0,0,0
2019-08-05 04:15,4,2,2,0,0,0
2019-08-05 04:30,4,1,3,0,0,0
2019-08-05 04:45,15,8,7,0,0,0
2019-08-05 05:00,12,9,3,0,0,0
2019-08-05 05:15,19,8,11,0,0,0
2019-08-05 05:30,26,15,11,0,0,0
2019-08-05 05:45,28,23,5,0,0,0
2019-08-05 06:00,26,16,10,0,0,0
2019-08-05 06:15,39,27,12,0,0,0
2019-08-05 06:30,54,35,19,0,0,0
2019-08-05 06:45,108,72,36,0,0,0
2019-08-05 07:00,82,52,30,0,0,0
2019-08-05 07:15,87,57,30,0,0,0
2019-08-05 07:30,146,95,51,0,0,0
2019-08-05 07:45,211,130,81,0,0,0
2019-08-05 08:00,171,105,66,0,0,0
2019-08-05 08:15,162,96,66,0,0,0
2019-08-05 08:30,160,108,52,0,0,0
2019-08-05 08:45,222,143,79,0,0,0
2019-08-05 09:00,136,81,55,0,0,0
2019-08-05 09:15,124,82,42,0,0,0
2019-08-05 09:30,149,75,74,0,0,0
2019-08-05 09:45,154,104,50,0,0,0
2019-08-05 10:00,105,64,41,0,0,0
2019-08-05 10:15,103,65,38,0,0,0
2019-08-05 10:30,121,81,40,0,0,0
2019-08-05 10:45,122,68,54,0,0,0
2019-08-05 11:00,121,67,54,0,0,0
2019-08-05 11:15,123,73,50,0,0,0
2019-08-05 11:30,121,69,52,0,0,0
2019-08-05 11:45,138,82,56,0,0,0
2019-08-05 12:00,137,68,69,0,0,0
2019-08-05 12:15,134,75,59,0,0,0
2019-08-05 12:30,135,79,56,0,0,0
2019-08-05 12:45,139,73,66,0,0,0
2019-08-05 13:00,146,74,72,0,0,0
2019-08-05 13:15,126,69,57,0,0,0
2019-08-05 13:30,133,69,64,0,0,0
2019-08-05 13:45,160,91,69,0,0,0
2019-08-05 14:00,151,82,69,0,0,0
2019-08-05 14:15,164,98,66,0,0,0
2019-08-05 14:30,149,85,64,0,0,0
2019-08-05 14:45,148,76,72,0,0,0
2019-08-05 15:00,154,73,81,0,0,0
2019-08-05 15:15,185,102,83,0,0,0
2019-08-05 15:30,192,102,90,0,0,0
2019-08-05 15:45,183,97,86,0,0,0
2019-08-05 16:00,181,79,102,0,0,0
2019-08-05 16:15,218,92,126,0,0,0
2019-08-05 16:30,217,100,117,0,0,0
2019-08-05 16:45,236,108,128,0,0,0
2019-08-05 17:00,217,106,111,0,0,0
2019-08-05 17:15,248,106,142,0,0,0
2019-08-05 17:30,221,112,109,0,0,0
2019-08-05 17:45,248,132,116,0,0,0
2019-08-05 18:00,243,112,131,0,0,0
2019-08-05 18:15,240,109,131,0,0,0
2019-08-05 18:30,233,95,138,0,0,0
2019-08-05 18:45,198,87,111,0,0,0
2019-08-05 19:00,184,95,89,0,0,0
2019-08-05 19:15,164,83,81,0,0,0
2019-08-05 19:30,164,75,89,0,0,0
2019-08-05 19:45,152,86,66,0,0,0
2019-08-05 20:00,129,53,76,0,0,0
2019-08-05 20:15,111,44,67,0,0,0
2019-08-05 20:30,94,48,46,0,0,0
2019-08-05 20:45,124,53,71,0,0,0
2019-08-05 21:00,114,47,67,0,0,0
2019-08-05 21:15,85,39,46,0,0,0
2019-08-05 21:30,89,30,59,0,0,0
2019-08-05 21:45,58,20,38,0,0,0
2019-08-05 22:00,72,28,44,0,0,0
2019-08-05 22:15,53,13,40,0,0,0
2019-08-05 22:30,47,9,38,0,0,0
2019-08-05 22:45,59,8,51,0,0,0
2019-08-05 23:00,45,9,36,0,0,0
2019-08-05 23:15,44,15,29,0,0,0
2019-08-05 23:30,35,13,22,0,0,0
2019-08-05 23:45,31,9,22,0,0,0
2019-08-06 00:00,29,9,20,0,0,0
2019-08-06 00:15,15,6,9,0,0,0
2019-08-06 00:30,20,5,15,0,0,0
2019-08-06 00:45,16,5,11,0,0,0
2019-08-06 01:00,21,9,12,0,0,0
2019-08-06 01:15,12,2,10,0,0,0
2019-08-06 01:30,9,0,9,0,0,0
2019-08-06 01:45,16,4,12,0,0,0
2019-08-06 02:00,10,2,8,0,0,0
2019-08-06 02:15,12,4,8,0,0,0
2019-08-06 02:30,1,0,1,0,0,0
2019-08-06 02:45,7,3,4,0,0,0
2019-08-06 03:00,4,0,4,0,0,0
2019-08-06 03:15,3,1,2,0,0,0
2019-08-06 03:30,0,0,0,0,0,0
2019-08-06 03:45,3,1,2,0,0,0
2019-08-06 04:00,3,1,2,0,0,0
2019-08-06 04:15,7,5,2,0,0,0
2019-08-06 04:30,8,7,1,0,0,0
2019-08-06 04:45,6,3,3,0,0,0
2019-08-06 05:00,8,4,4,0,0,0
2019-08-06 05:15,12,5,7,0,0,0
2019-08-06 05:30,15,9,6,0,0,0
2019-08-06 05:45,32,18,14,0,0,0
2019-08-06 06:00,29,20,9,0,0,0
2019-08-06 06:15,39,26,13,0,0,0
2019-08-06 06:30,54,36,18,0,0,0
2019-08-06 06:45,106,74,32,0,0,0
2019-08-06 07:00,77,56,21,0,0,0
2019-08-06 07:15,88,54,34,0,0,0
2019-08-06 07:30,110,64,46,0,0,0
2019-08-06 07:45,157,93,64,0,0,0
2019-08-06 08:00,150,93,57,0,0,0
2019-08-06 08:15,167,111,56,0,0,0
2019-08-06 08:30,154,97,57,0,0,0
2019-08-06 08:45,188,128,60,0,0,0
2019-08-06 09:00,140,87,53,0,0,0
2019-08-06 09:15,141,83,58,0,0,0
2019-08-06 09:30,113,70,43,0,0,0
2019-08-06 09:45,147,90,57,0,0,0
2019-08-06 10:00,118,70,48,0,0,0
2019-08-06 10:15,114,71,43,0,0,0
2019-08-06 10:30,143,84,59,0,0,0
2019-08-06 10:45,144,83,61,0,0,0
2019-08-06 11:00,102,62,40,0,0,0
2019-08-06 11:15,99,49,50,0,0,0
2019-08-06 11:30,130,62,68,0,0,0
2019-08-06 11:45,174,106,68,0,0,0
2019-08-06 12:00,123,80,43,0,0,0
2019-08-06 12:15,146,84,62,0,0,0
2019-08-06 12:30,149,78,71,0,0,0
2019-08-06 12:45,145,82,63,0,0,0
2019-08-06 13:00,135,67,68,0,0,0
2019-08-06 13:15,115,64,51,0,0,0
2019-08-06 13:30,144,87,57,0,0,0
2019-08-06 13:45,175,107,68,0,0,0
2019-08-06 14:00,127,61,66,0,0,0
2019-08-06 14:15,165,96,69,0,0,0
2019-08-06 14:30,179,100,79,0,0,0
2019-08-06 14:45,155,74,81,0,0,0
2019-08-06 15:00,169,84,85,0,0,0
2019-08-06 15:15,169,84,85,0,0,0
2019-08-06 15:30,184,97,87,0,0,0
2019-08-06 15:45,210,104,106,0,0,0
2019-08-06 16:00,226,122,104,0,0,0
2019-08-06 16:15,236,118,118,0,0,0
2019-08-06 16:30,228,110,118,0,0,0
2019-08-06 16:45,200,104,96,0,0,0
2019-08-06 17:00,242,121,121,0,0,0
2019-08-06 17:15,262,107,155,0,0,0
2019-08-06 17:30,229,107,122,0,0,0
2019-08-06 17:45,244,106,138,0,0,0
2019-08-06 18:00,221,102,119,0,0,0
2019-08-06 18:15,230,109,121,0,0,0
2019-08-06 18:30,200,103,97,0,0,0
2019-08-06 18:45,258,123,135,0,0,0
2019-08-06 19:00,194,99,95,0,0,0
2019-08-06 19:15,181,85,96,0,0,0
2019-08-06 19:30,135,58,77,0,0,0
2019-08-06 19:45,176,83,93,0,0,0
2019-08-06 20:00,146,67,79,0,0,0
2019-08-06 20:15,149,65,84,0,0,0
2019-08-06 20:30,93,45,48,0,0,0
2019-08-06 20:45,117,44,73,0,0,0
2019-08-06 21:00,104,51,53,0,0,0
2019-08-06 21:15,90,39,51,0,0,0
2019-08-06 21:30,95,43,52,0,0,0
2019-08-06 21:45,73,26,47,0,0,0
2019-08-06 22:00,91,37,54,0,0,0
2019-08-06 22:15,100,31,69,0,0,0
2019-08-06 22:30,63,16,47,0,0,0
2019-08-06 22:45,68,33,35,0,0,0
2019-08-06 23:00,45,8,37,0,0,0
2019-08-06 23:15,54,18,36,0,0,0
2019-08-06 23:30,31,9,22,0,0,0
2019-08-06 23:45,32,7,25,0,0,0
2019-08-07 00:00,25,8,17,0,0,0
2019-08-07 00:15,23,6,17,0,0,0
2019-08-07 00:30,27,4,23,0,0,0
2019-08-07 00:45,24,5,19,0,0,0
2019-08-07 01:00,22,4,18,0,0,0
2019-08-07 01:15,18,6,12,0,0,0
2019-08-07 01:30,18,5,13,0,0,0
2019-08-07 01:45,6,4,2,0,0,0
2019-08-07 02:00,9,3,6,0,0,0
2019-08-07 02:15,6,3,3,0,0,0
2019-08-07 02:30,10,2,8,0,0,0
2019-08-07 02:45,3,1,2,0,0,0
2019-08-07 03:00,4,0,4,0,0,0
2019-08-07 03:15,3,0,3,0,0,0
2019-08-07 03:30,3,2,1,0,0,0
2019-08-07 03:45,4,3,1,0,0,0
2019-08-07 04:00,5,2,3,0,0,0
2019-08-07 04:15,0,0,0,0,0,0
2019-08-07 04:30,3,3,0,0,0,0
2019-08-07 04:45,2,1,1,0,0,0
2019-08-07 05:00,7,6,1,0,0,0
2019-08-07 05:15,12,6,6,0,0,0
2019-08-07 05:30,10,7,3,0,0,0
2019-08-07 05:45,24,15,9,0,0,0
2019-08-07 06:00,24,13,11,0,0,0
2019-08-07 06:15,33,24,9,0,0,0
2019-08-07 06:30,72,48,24,0,0,0
2019-08-07 06:45,101,73,28,0,0,0
2019-08-07 07:00,102,76,26,0,0,0
2019-08-07 07:15,110,77,33,0,0,0
2019-08-07 07:30,135,81,54,0,0,0
2019-08-07 07:45,190,124,66,0,0,0
2019-08-07 08:00,167,99,68,0,0,0
2019-08-07 08:15,154,103,51,0,0,0
2019-08-07 08:30,160,98,62,0,0,0
2019-08-07 08:45,244,155,89,0,0,0
2019-08-07 09:00,165,106,59,0,0,0
2019-08-07 09:15,133,86,47,0,0,0
2019-08-07 09:30,152,109,43,0,0,0
2019-08-07 09:45,206,139,67,0,0,0
2019-08-07 10:00,140,92,48,0,0,0
2019-08-07 10:15,138,91,47,0,0,0
2019-08-07 10:30,130,84,46,0,0,0
2019-08-07 10:45,151,93,58,0,0,0
2019-08-07 11:00,139,89,50,0,0,0
2019-08-07 11:15,157,94,63,0,0,0
2019-08-07 11:30,146,93,53,0,0,0
2019-08-07 11:45,178,111,67,0,0,0
2019-08-07 12:00,128,65,63,0,0,0
2019-08-07 12:15,137,76,61,0,0,0
2019-08-07 12:30,172,96,76,0,0,0
2019-08-07 12:45,157,88,69,0,0,0
2019-08-07 13:00,174,96,78,0,0,0
2019-08-07 13:15,140,72,68,0,0,0
2019-08-07 13:30,145,73,72,0,0,0
2019-08-07 13:45,187,97,90,0,0,0
2019-08-07 14:00,147,86,61,0,0,0
2019-08-07 14:15,177,91,86,0,0,0
2019-08-07 14:30,164,85,79,0,0,0
2019-08-07 14:45,171,91,80,0,0,0
2019-08-07 15:00,182,83,99,0,0,0
2019-08-07 15:15,176,89,87,0,0,0
2019-08-07 15:30,155,80,75,0,0,0
2019-08-07 15:45,204,102,102,0,0,0
2019-08-07 16:00,199,93,106,0,0,0
2019-08-07 16:15,218,106,112,0,0,0
2019-08-07 16:30,213,96,117,0,0,0
2019-08-07 16:45,215,104,111,0,0,0
2019-08-07 17:00,238,130,108,0,0,0
2019-08-07 17:15,258,116,142,0,0,0
2019-08-07 17:30,230,103,127,0,0,0
2019-08-07 17:45,239,117,122,0,0,0
2019-08-07 18:00,278,127,151,0,0,0
2019-08-07 18:15,230,111,119,0,0,0
2019-08-07 18:30,227,106,121,0,0,0
2019-08-07 18:45,211,117,94,0,0,0
2019-08-07 19:00,147,68,79,0,0,0
2019-08-07 19:15,169,74,95,0,0,0
2019-08-07 19:30,175,87,88,0,0,0
2019-08-07 19:45,186,88,98,0,0,0
2019-08-07 20:00,184,84,100,0,0,0
2019-08-07 20:15,155,61,94,0,0,0
2019-08-07 20:30,112,39,73,0,0,0
2019-08-07 20:45,76,31,45,0,0,0
2019-08-07 21:00,94,39,55,0,0,0
2019-08-07 21:15,85,32,53,0,0,0
2019-08-07 21:30,75,30,45,0,0,0
2019-08-07 21:45,78,24,54,0,0,0
2019-08-07 22:00,94,38,56,0,0,0
2019-08-07 22:15,92,32,60,0,0,0
2019-08-07 22:30,72,18,54,0,0,0
2019-08-07 22:45,90,34,56,0,0,0
2019-08-07 23:00,64,37,27,0,0,0
2019-08-07 23:15,53,22,31,0,0,0
2019-08-07 23:30,62,33,29,0,0,0
2019-08-07 23:45,44,19,25,0,0,0
2019-08-08 00:00,42,19,23,0,0,0
2019-08-08 00:15,43,25,18,0,0,0
2019-08-08 00:30,41,16,25,0,0,0
2019-08-08 00:45,35,7,28,0,0,0
2019-08-08 01:00,28,13,15,0,0,0
2019-08-08 01:15,38,15,23,0,0,0
2019-08-08 01:30,15,5,10,0,0,0
2019-08-08 01:45,12,4,8,0,0,0
2019-08-08 02:00,21,5,16,0,0,0
2019-08-08 02:15,26,9,17,0,0,0
2019-08-08 02:30,27,3,24,0,0,0
2019-08-08 02:45,19,6,13,0,0,0
2019-08-08 03:00,10,3,7,0,0,0
2019-08-08 03:15,24,2,22,0,0,0
2019-08-08 03:30,14,1,13,0,0,0
2019-08-08 03:45,3,2,1,0,0,0
2019-08-08 04:00,7,3,4,0,0,0
2019-08-08 04:15,7,0,7,0,0,0
2019-08-08 04:30,11,7,4,0,0,0
2019-08-08 04:45,9,4,5,0,0,0
2019-08-08 05:00,13,5,8,0,0,0
2019-08-08 05:15,29,9,20,0,0,0
2019-08-08 05:30,22,12,10,0,0,0
2019-08-08 05:45,36,23,13,0,0,0
2019-08-08 06:00,27,18,9,0,0,0
2019-08-08 06:15,49,33,16,0,0,0
2019-08-08 06:30,70,52,18,0,0,0
2019-08-08 06:45,99,66,33,0,0,0
2019-08-08 07:00,100,69,31,0,0,0
2019-08-08 07:15,113,76,37,0,0,0
2019-08-08 07:30,163,103,60,0,0,0
2019-08-08 07:45,207,127,80,0,0,0
2019-08-08 08:00,174,103,71,0,0,0
2019-08-08 08:15,175,108,67,0,0,0
2019-08-08 08:30,180,102,78,0,0,0
2019-08-08 08:45,206,125,81,0,0,0
2019-08-08 09:00,129,89,40,0,0,0
2019-08-08 09:15,136,82,54,0,0,0
2019-08-08 09:30,117,75,42,0,0,0
2019-08-08 09:45,141,98,43,0,0,0
2019-08-08 10:00,124,86,38,0,0,0
2019-08-08 10:15,108,67,41,0,0,0
2019-08-08 10:30,120,76,44,0,0,0
2019-08-08 10:45,120,77,43,0,0,0
2019-08-08 11:00,127,83,44,0,0,0
2019-08-08 11:15,110,60,50,0,0,0
2019-08-08 11:30,124,77,47,0,0,0
2019-08-08 11:45,163,96,67,0,0,0
2019-08-08 12:00,132,70,62,0,0,0
2019-08-08 12:15,146,78,68,0,0,0
2019-08-08 12:30,129,71,58,0,0,0
2019-08-08 12:45,143,82,61,0,0,0
2019-08-08 13:00,120,64,56,0,0,0
2019-08-08 13:15,146,73,73,0,0,0
2019-08-08 13:30,167,93,74,0,0,0
2019-08-08 13:45,173,81,92,0,0,0
2019-08-08 14:00,158,87,71,0,0,0
2019-08-08 14:15,169,99,70,0,0,0
2019-08-08 14:30,172,96,76,0,0,0
2019-08-08 14:45,188,97,91,0,0,0
2019-08-08 15:00,169,81,88,0,0,0
2019-08-08 15:15,170,74,96,0,0,0
2019-08-08 15:30,197,90,107,0,0,0
2019-08-08 15:45,188,99,89,0,0,0
2019-08-08 16:00,254,127,127,0,0,0
2019-08-08 16:15,228,102,126,0,0,0
2019-08-08 16:30,186,95,91,0,0,0
2019-08-08 16:45,239,119,120,0,0,0
2019-08-08 17:00,234,103,131,0,0,0
2019-08-08 17:15,261,119,142,0,0,0
2019-08-08 17:30,246,115,131,0,0,0
2019-08-08 17:45,242,123,119,0,0,0
2019-08-08 18:00,246,112,134,0,0,0
2019-08-08 18:15,228,124,104,0,0,0
2019-08-08 18:30,202,95,107,0,0,0
2019-08-08 18:45,258,109,149,0,0,0
2019-08-08 19:00,166,85,81,0,0,0
2019-08-08 19:15,190,82,108,0,0,0
2019-08-08 19:30,163,72,91,0,0,0
2019-08-08 19:45,175,102,73,0,0,0
2019-08-08 20:00,138,54,84,0,0,0
2019-08-08 20:15,113,49,64,0,0,0
2019-08-08 20:30,128,63,65,0,0,0
2019-08-08 20:45,91,43,48,0,0,0
2019-08-08 21:00,93,34,59,0,0,0
2019-08-08 21:15,97,45,52,0,0,0
2019-08-08 21:30,79,30,49,0,0,0
2019-08-08 21:45,79,25,54,0,0,0
2019-08-08 22:00,73,24,49,0,0,0
2019-08-08 22:15,84,18,66,0,0,0
2019-08-08 22:30,66,14,52,0,0,0
2019-08-08 22:45,74,23,51,0,0,0
2019-08-08 23:00,48,6,42,0,0,0
2019-08-08 23:15,59,25,34,0,0,0
2019-08-08 23:30,41,17,24,0,0,0
2019-08-08 23:45,49,16,33,0,0,0
2019-08-09 00:00,35,14,21,0,0,0
2019-08-09 00:15,23,8,15,0,0,0
2019-08-09 00:30,22,2,20,0,0,0
2019-08-09 00:45,19,6,13,0,0,0
2019-08-09 01:00,14,0,14,0,0,0
2019-08-09 01:15,12,1,11,0,0,0
2019-08-09 01:30,21,2,19,0,0,0
2019-08-09 01:45,12,4,8,0,0,0
2019-08-09 02:00,8,0,8,0,0,0
2019-08-09 02:15,5,0,5,0,0,0
2019-08-09 02:30,10,2,8,0,0,0
2019-08-09 02:45,7,1,6,0,0,0
2019-08-09 03:00,6,0,6,0,0,0
2019-08-09 03:15,2,0,2,0,0,0
2019-08-09 03:30,5,2,3,0,0,0
2019-08-09 03:45,5,2,3,0,0,0
2019-08-09 04:00,2,1,1,0,0,0
2019-08-09 04:15,10,4,6,0,0,0
2019-08-09 04:30,13,8,5,0,0,0
2019-08-09 04:45,3,3,0,0,0,0
2019-08-09 05:00,5,3,2,0,0,0
2019-08-09 05:15,11,5,6,0,0,0
2019-08-09 05:30,16,10,6,0,0,0
2019-08-09 05:45,21,17,4,0,0,0
2019-08-09 06:00,25,18,7,0,0,0
2019-08-09 06:15,36,26,10,0,0,0
2019-08-09 06:30,54,36,18,0,0,0
2019-08-09 06:45,65,50,15,0,0,0
2019-08-09 07:00,84,61,23,0,0,0
2019-08-09 07:15,85,64,21,0,0,0
2019-08-09 07:30,109,77,32,0,0,0
2019-08-09 07:45,158,118,40,0,0,0
2019-08-09 08:00,171,93,78,0,0,0
2019-08-09 08:15,136,88,48,0,0,0
2019-08-09 08:30,156,103,53,0,0,0
2019-08-09 08:45,148,100,48,0,0,0
2019-08-09 09:00,172,89,83,0,0,0
2019-08-09 09:15,136,76,60,0,0,0
2019-08-09 09:30,115,74,41,0,0,0
2019-08-09 09:45,134,85,49,0,0,0
2019-08-09 10:00,99,71,28,0,0,0
2019-08-09 10:15,102,65,37,0,0,0
2019-08-09 10:30,104,67,37,0,0,0
2019-08-09 10:45,112,71,41,0,0,0
2019-08-09 11:00,109,59,50,0,0,0
2019-08-09 11:15,103,59,44,0,0,0
2019-08-09 11:30,114,67,47,0,0,0
2019-08-09 11:45,136,90,46,0,0,0
2019-08-09 12:00,110,71,39,0,0,0
2019-08-09 12:15,119,65,54,0,0,0
2019-08-09 12:30,127,69,58,0,0,0
2019-08-09 12:45,120,73,47,0,0,0
2019-08-09 13:00,139,66,73,0,0,0
2019-08-09 13:15,155,84,71,0,0,0
2019-08-09 13:30,114,57,57,0,0,0
2019-08-09 13:45,144,94,50,0,0,0
2019-08-09 14:00,144,75,69,0,0,0
2019-08-09 14:15,133,60,73,0,0,0
2019-08-09 14:30,143,66,77,0,0,0
2019-08-09 14:45,133,70,63,0,0,0
2019-08-09 15:00,118,50,68,0,0,0
2019-08-09 15:15,157,90,67,0,0,0
2019-08-09 15:30,134,67,67,0,0,0
2019-08-09 15:45,156,88,68,0,0,0
2019-08-09 16:00,179,78,101,0,0,0
2019-08-09 16:15,153,77,76,0,0,0
2019-08-09 16:30,160,89,71,0,0,0
2019-08-09 16:45,147,72,75,0,0,0
2019-08-09 17:00,137,67,70,0,0,0
2019-08-09 17:15,143,84,59,0,0,0
2019-08-09 17:30,134,67,67,0,0,0
2019-08-09 17:45,184,94,90,0,0,0
2019-08-09 18:00,154,75,79,0,0,0
2019-08-09 18:15,141,49,92,0,0,0
2019-08-09 18:30,149,64,85,0,0,0
2019-08-09 18:45,153,78,75,0,0,0
2019-08-09 19:00,137,67,70,0,0,0
2019-08-09 19:15,129,57,72,0,0,0
2019-08-09 19:30,112,56,56,0,0,0
2019-08-09 19:45,131,62,69,0,0,0
2019-08-09 20:00,130,74,56,0,0,0
2019-08-09 20:15,79,36,43,0,0,0
2019-08-09 20:30,106,57,49,0,0,0
2019-08-09 20:45,91,41,50,0,0,0
2019-08-09 21:00,70,31,39,0,0,0
2019-08-09 21:15,77,43,34,0,0,0
2019-08-09 21:30,66,30,36,0,0,0
2019-08-09 21:45,62,31,31,0,0,0
2019-08-09 22:00,35,12,23,0,0,0
2019-08-09 22:15,55,25,30,0,0,0
2019-08-09 22:30,62,21,41,0,0,0
2019-08-09 22:45,53,30,23,0,0,0
2019-08-09 23:00,41,20,21,0,0,0
2019-08-09 23:15,88,25,63,0,0,0
2019-08-09 23:30,55,15,40,0,0,0
2019-08-09 23:45,47,17,30,0,0,0
2019-08-10 00:00,48,21,27,0,0,0
2019-08-10 00:15,49,16,33,0,0,0
2019-08-10 00:30,67,34,33,0,0,0
2019-08-10 00:45,38,19,19,0,0,0
2019-08-10 01:00,51,23,28,0,0,0
2019-08-10 01:15,42,7,35,0,0,0
2019-08-10 01:30,31,8,23,0,0,0
2019-08-10 01:45,46,15,31,0,0,0
2019-08-10 02:00,24,8,16,0,0,0
2019-08-10 02:15,34,9,25,0,0,0
2019-08-10 02:30,33,8,25,0,0,0
2019-08-10 02:45,23,5,18,0,0,0
2019-08-10 03:00,21,5,16,0,0,0
2019-08-10 03:15,18,5,13,0,0,0
2019-08-10 03:30,25,3,22,0,0,0
2019-08-10 03:45,19,3,16,0,0,0
2019-08-10 04:00,20,1,19,0,0,0
2019-08-10 04:15,15,2,13,0,0,0
2019-08-10 04:30,18,1,17,0,0,0
2019-08-10 04:45,4,2,2,0,0,0
2019-08-10 05:00,19,5,14,0,0,0
2019-08-10 05:15,13,4,9,0,0,0
2019-08-10 05:30,13,6,7,0,0,0
2019-08-10 05:45,20,12,8,0,0,0
2019-08-10 06:00,14,8,6,0,0,0
2019-08-10 06:15,6,3,3,0,0,0
2019-08-10 06:30,7,3,4,0,0,0
2019-08-10 06:45,13,8,5,0,0,0
2019-08-10 07:00,8,4,4,0,0,0
2019-08-10 07:15,15,11,4,0,0,0
2019-08-10 07:30,19,11,8,0,0,0
2019-08-10 07:45,37,32,5,0,0,0
2019-08-10 08:00,48,30,18,0,0,0
2019-08-10 08:15,34,30,4,0,0,0
2019-08-10 08:30,30,22,8,0,0,0
2019-08-10 08:45,62,42,20,0,0,0
2019-08-10 09:00,53,40,13,0,0,0
2019-08-10 09:15,69,52,17,0,0,0
2019-08-10 09:30,84,55,29,0,0,0
2019-08-10 09:45,116,106,10,0,0,0
2019-08-10 10:00,98,71,27,0,0,0
2019-08-10 10:15,121,103,18,0,0,0
2019-08-10 10:30,112,71,41,0,0,0
2019-08-10 10:45,98,61,37,0,0,0
2019-08-10 11:00,113,80,33,0,0,0
2019-08-10 11:15,125,62,63,0,0,0
2019-08-10 11:30,99,56,43,0,0,0
2019-08-10 11:45,109,69,40,0,0,0
2019-08-10 12:00,118,66,52,0,0,0
2019-08-10 12:15,106,56,50,0,0,0
2019-08-10 12:30,136,87,49,0,0,0
2019-08-10 12:45,116,67,49,0,0,0
2019-08-10 13:00,123,61,62,0,0,0
2019-08-10 13:15,134,86,48,0,0,0
2019-08-10 13:30,155,96,59,0,0,0
2019-08-10 13:45,130,83,47,0,0,0
2019-08-10 14:00,133,88,45,0,0,0
2019-08-10 14:15,123,60,63,0,0,0
2019-08-10 14:30,132,69,63,0,0,0
2019-08-10 14:45,117,69,48,0,0,0
2019-08-10 15:00,84,36,48,0,0,0
2019-08-10 15:15,115,52,63,0,0,0
2019-08-10 15:30,113,56,57,0,0,0
2019-08-10 15:45,119,54,65,0,0,0
2019-08-10 16:00,95,38,57,0,0,0
2019-08-10 16:15,140,65,75,0,0,0
2019-08-10 16:30,126,65,61,0,0,0
2019-08-10 16:45,131,56,75,0,0,0
2019-08-10 17:00,105,38,67,0,0,0
2019-08-10 17:15,90,43,47,0,0,0
2019-08-10 17:30,110,52,58,0,0,0
2019-08-10 17:45,129,61,68,0,0,0
2019-08-10 18:00,114,49,65,0,0,0
2019-08-10 18:15,112,57,55,0,0,0
2019-08-10 18:30,130,60,70,0,0,0
2019-08-10 18:45,135,71,64,0,0,0
2019-08-10 19:00,98,50,48,0,0,0
2019-08-10 19:15,105,54,51,0,0,0
2019-08-10 19:30,133,83,50,0,0,0
2019-08-10 19:45,135,80,55,0,0,0
2019-08-10 20:00,131,60,71,0,0,0
2019-08-10 20:15,113,57,56,0,0,0
2019-08-10 20:30,91,42,49,0,0,0
2019-08-10 20:45,74,32,42,0,0,0
2019-08-10 21:00,72,43,29,0,0,0
2019-08-10 21:15,68,31,37,0,0,0
2019-08-10 21:30,56,23,33,0,0,0
2019-08-10 21:45,73,24,49,0,0,0
2019-08-10 22:00,63,29,34,0,0,0
2019-08-10 22:15,75,37,38,0,0,0
2019-08-10 22:30,76,26,50,0,0,0
2019-08-10 22:45,66,20,46,0,0,0
2019-08-10 23:00,46,22,24,0,0,0
2019-08-10 23:15,48,20,28,0,0,0
2019-08-10 23:30,59,42,17,0,0,0
2019-08-10 23:45,91,20,71,0,0,0
2019-08-11 00:00,40,18,22,0,0,0
2019-08-11 00:15,59,14,45,0,0,0
2019-08-11 00:30,43,11,32,0,0,0
2019-08-11 00:45,33,4,29,0,0,0
2019-08-11 01:00,35,8,27,0,0,0
2019-08-11 01:15,34,7,27,0,0,0
2019-08-11 01:30,33,11,22,0,0,0
2019-08-11 01:45,32,9,23,0,0,0
2019-08-11 02:00,38,13,25,0,0,0
2019-08-11 02:15,38,8,30,0,0,0
2019-08-11 02:30,23,2,21,0,0,0
2019-08-11 02:45,34,2,32,0,0,0
2019-08-11 03:00,25,7,18,0,0,0
2019-08-11 03:15,41,9,32,0,0,0
2019-08-11 03:30,18,2,16,0,0,0
2019-08-11 03:45,15,3,12,0,0,0
2019-08-11 04:00,22,5,17,0,0,0
2019-08-11 04:15,28,11,17,0,0,0
2019-08-11 04:30,18,7,11,0,0,0
2019-08-11 04:45,12,1,11,0,0,0
2019-08-11 05:00,7,0,7,0,0,0
2019-08-11 05:15,7,0,7,0,0,0
2019-08-11 05:30,9,5,4,0,0,0
2019-08-11 05:45,19,10,9,0,0,0
2019-08-11 06:00,12,8,4,0,0,0
2019-08-11 06:15,8,3,5,0,0,0
2019-08-11 06:30,7,4,3,0,0,0
2019-08-11 06:45,12,8,4,0,0,0
2019-08-11 07:00,12,7,5,0,0,0
2019-08-11 07:15,11,4,7,0,0,0
2019-08-11 07:30,8,6,2,0,0,0
2019-08-11 07:45,11,9,2,0,0,0
2019-08-11 08:00,18,9,9,0,0,0
2019-08-11 08:15,11,5,6,0,0,0
2019-08-11 08:30,23,16,7,0,0,0
2019-08-11 08:45,24,18,6,0,0,0
2019-08-11 09:00,28,20,8,0,0,0
2019-08-11 09:15,37,21,16,0,0,0
2019-08-11 09:30,41,26,15,0,0,0
2019-08-11 09:45,71,51,20,0,0,0
2019-08-11 10:00,55,41,14,0,0,0
2019-08-11 10:15,88,54,34,0,0,0
2019-08-11 10:30,68,42,26,0,0,0
2019-08-11 10:45,100,73,27,0,0,0
2019-08-11 11:00,52,35,17,0,0,0
2019-08-11 11:15,72,48,24,0,0,0
2019-08-11 11:30,88,60,28,0,0,0
2019-08-11 11:45,84,56,28,0,0,0
2019-08-11 12:00,70,35,35,0,0,0
2019-08-11 12:15,77,33,44,0,0,0
2019-08-11 12:30,116,71,45,0,0,0
2019-08-11 12:45,89,58,31,0,0,0
2019-08-11 13:00,101,54,47,0,0,0
2019-08-11 13:15,101,40,61,0,0,0
2019-08-11 13:30,90,54,36,0,0,0
2019-08-11 13:45,107,68,39,0,0,0
2019-08-11 14:00,90,56,34,0,0,0
2019-08-11 14:15,94,52,42,0,0,0
2019-08-11 14:30,97,62,35,0,0,0
2019-08-11 14:45,110,69,41,0,0,0
2019-08-11 15:00,117,60,57,0,0,0
2019-08-11 15:15,116,64,52,0,0,0
2019-08-11 15:30,115,53,62,0,0,0
2019-08-11 15:45,119,69,50,0,0,0
2019-08-11 16:00,98,53,45,0,0,0
2019-08-11 16:15,91,39,52,0,0,0
2019-08-11 16:30,76,37,39,0,0,0
2019-08-11 16:45,98,49,49,0,0,0
2019-08-11 17:00,100,48,52,0,0,0
2019-08-11 17:15,109,61,48,0,0,0
2019-08-11 17:30,111,62,49,0,0,0
2019-08-11 17:45,100,55,45,0,0,0
2019-08-11 18:00,126,69,57,0,0,0
2019-08-11 18:15,119,61,58,0,0,0
2019-08-11 18:30,118,60,58,0,0,0
2019-08-11 18:45,131,70,61,0,0,0
2019-08-11 19:00,105,66,39,0,0,0
2019-08-11 19:15,146,99,47,0,0,0
2019-08-11 19:30,134,82,52,0,0,0
2019-08-11 19:45,117,74,43,0,0,0
2019-08-11 20:00,111,54,57,0,0,0
2019-08-11 20:15,91,42,49,0,0,0
2019-08-11 20:30,89,39,50,0,0,0
2019-08-11 20:45,99,52,47,0,0,0
2019-08-11 21:00,59,22,37,0,0,0
2019-08-11 21:15,62,18,44,0,0,0
2019-08-11 21:30,48,17,31,0,0,0
2019-08-11 21:45,53,15,38,0,0,0
2019-08-11 22:00,51,18,33,0,0,0
2019-08-11 22:15,53,19,34,0,0,0
2019-08-11 22:30,47,25,22,0,0,0
2019-08-11 22:45,38,4,34,0,0,0
2019-08-11 23:00,35,13,22,0,0,0
2019-08-11 23:15,34,9,25,0,0,0
2019-08-11 23:30,25,7,18,0,0,0
2019-08-11 23:45,45,30,15,0,0,0
2019-08-12 00:00,149,16,133,0,0,0
2019-08-12 00:15,83,9,74,0,0,0
2019-08-12 00:30,18,3,15,0,0,0
2019-08-12 00:45,18,3,15,0,0,0
2019-08-12 01:00,9,3,6,0,0,0
2019-08-12 01:15,9,2,7,0,0,0
2019-08-12 01:30,4,0,4,0,0,0
2019-08-12 01:45,6,3,3,0,0,0
2019-08-12 02:00,8,2,6,0,0,0
2019-08-12 02:15,3,0,3,0,0,0
2019-08-12 02:30,8,5,3,0,0,0
2019-08-12 02:45,4,1,3,0,0,0
2019-08-12 03:00,6,0,6,0,0,0
2019-08-12 03:15,3,0,3,0,0,0
2019-08-12 03:30,3,2,1,0,0,0
2019-08-12 03:45,0,0,0,0,0,0
2019-08-12 04:00,1,0,1,0,0,0
2019-08-12 04:15,2,1,1,0,0,0
2019-08-12 04:30,5,4,1,0,0,0
2019-08-12 04:45,11,5,6,0,0,0
2019-08-12 05:00,3,0,3,0,0,0
2019-08-12 05:15,5,5,0,0,0,0
2019-08-12 05:30,19,15,4,0,0,0
2019-08-12 05:45,23,19,4,0,0,0
2019-08-12 06:00,35,20,15,0,0,0
2019-08-12 06:15,35,29,6,0,0,0
2019-08-12 06:30,66,55,11,0,0,0
2019-08-12 06:45,72,60,12,0,0,0
2019-08-12 07:00,85,59,26,0,0,0
2019-08-12 07:15,96,74,22,0,0,0
2019-08-12 07:30,157,111,46,0,0,0
2019-08-12 07:45,187,133,54,0,0,0
2019-08-12 08:00,183,106,77,0,0,0
2019-08-12 08:15,161,101,60,0,0,0
2019-08-12 08:30,147,88,59,0,0,0
2019-08-12 08:45,187,121,66,0,0,0
2019-08-12 09:00,160,89,71,0,0,0
2019-08-12 09:15,142,94,48,0,0,0
2019-08-12 09:30,154,103,51,0,0,0
2019-08-12 09:45,168,120,48,0,0,0
2019-08-12 10:00,134,72,62,0,0,0
2019-08-12 10:15,136,90,46,0,0,0
2019-08-12 10:30,124,84,40,0,0,0
2019-08-12 10:45,120,59,61,0,0,0
2019-08-12 11:00,145,69,76,0,0,0
2019-08-12 11:15,123,72,51,0,0,0
2019-08-12 11:30,116,71,45,0,0,0
2019-08-12 11:45,114,64,50,0,0,0
2019-08-12 12:00,134,69,65,0,0,0
2019-08-12 12:15,149,90,59,0,0,0
2019-08-12 12:30,173,93,80,0,0,0
2019-08-12 12:45,148,78,70,0,0,0
2019-08-12 13:00,146,82,64,0,0,0
2019-08-12 13:15,148,87,61,0,0,0
2019-08-12 13:30,156,85,71,0,0,0
2019-08-12 13:45,143,73,70,0,0,0
2019-08-12 14:00,154,70,84,0,0,0
2019-08-12 14:15,149,75,74,0,0,0
2019-08-12 14:30,153,82,71,0,0,0
2019-08-12 14:45,163,78,85,0,0,0
2019-08-12 15:00,148,76,72,0,0,0
2019-08-12 15:15,155,81,74,0,0,0
2019-08-12 15:30,189,83,106,0,0,0
2019-08-12 15:45,200,91,109,0,0,0
2019-08-12 16:00,164,89,75,0,0,0
2019-08-12 16:15,179,85,94,0,0,0
2019-08-12 16:30,275,133,142,0,0,0
2019-08-12 16:45,240,127,113,0,0,0
2019-08-12 17:00,239,123,116,0,0,0
2019-08-12 17:15,261,114,147,0,0,0
2019-08-12 17:30,212,76,136,0,0,0
2019-08-12 17:45,159,55,104,0,0,0
2019-08-12 18:00,142,70,72,0,0,0
2019-08-12 18:15,129,52,77,0,0,0
2019-08-12 18:30,150,52,98,0,0,0
2019-08-12 18:45,141,69,72,0,0,0
2019-08-12 19:00,125,52,73,0,0,0
2019-08-12 19:15,120,46,74,0,0,0
2019-08-12 19:30,106,59,47,0,0,0
2019-08-12 19:45,121,57,64,0,0,0
2019-08-12 20:00,97,50,47,0,0,0
2019-08-12 20:15,84,26,58,0,0,0
2019-08-12 20:30,67,24,43,0,0,0
2019-08-12 20:45,60,18,42,0,0,0
2019-08-12 21:00,54,18,36,0,0,0
2019-08-12 21:15,47,17,30,0,0,0
2019-08-12 21:30,46,15,31,0,0,0
2019-08-12 21:45,41,11,30,0,0,0
2019-08-12 22:00,51,11,40,0,0,0
2019-08-12 22:15,45,17,28,0,0,0
2019-08-12 22:30,48,14,34,0,0,0
2019-08-12 22:45,51,9,42,0,0,0
2019-08-12 23:00,30,12,18,0,0,0
2019-08-12 23:15,52,17,35,0,0,0
2019-08-12 23:30,62,9,53,0,0,0
2019-08-12 23:45,32,10,22,0,0,0
2019-08-13 00:00,34,8,26,0,0,0
2019-08-13 00:15,15,6,9,0,0,0
2019-08-13 00:30,25,3,22,0,0,0
2019-08-13 00:45,8,1,7,0,0,0
2019-08-13 01:00,5,2,3,0,0,0
2019-08-13 01:15,11,2,9,0,0,0
2019-08-13 01:30,5,1,4,0,0,0
2019-08-13 01:45,12,1,11,0,0,0
2019-08-13 02:00,9,3,6,0,0,0
2019-08-13 02:15,3,1,2,0,0,0
2019-08-13 02:30,6,0,6,0,0,0
2019-08-13 02:45,3,2,1,0,0,0
2019-08-13 03:00,5,2,3,0,0,0
2019-08-13 03:15,5,0,5,0,0,0
2019-08-13 03:30,2,0,2,0,0,0
2019-08-13 03:45,2,1,1,0,0,0
2019-08-13 04:00,2,1,1,0,0,0
2019-08-13 04:15,2,2,0,0,0,0
2019-08-13 04:30,5,5,0,0,0,0
2019-08-13 04:45,4,3,1,0,0,0
2019-08-13 05:00,6,4,2,0,0,0
2019-08-13 05:15,9,7,2,0,0,0
2019-08-13 05:30,17,8,9,0,0,0
2019-08-13 05:45,21,17,4,0,0,0
2019-08-13 06:00,30,22,8,0,0,0
2019-08-13 06:15,26,24,2,0,0,0
2019-08-13 06:30,52,45,7,0,0,0
2019-08-13 06:45,62,41,21,0,0,0
2019-08-13 07:00,88,58,30,0,0,0
2019-08-13 07:15,87,58,29,0,0,0
2019-08-13 07:30,107,86,21,0,0,0
2019-08-13 07:45,171,122,49,0,0,0
2019-08-13 08:00,184,101,83,0,0,0
2019-08-13 08:15,134,88,46,0,0,0
2019-08-13 08:30,194,128,66,0,0,0
2019-08-13 08:45,208,145,63,0,0,0
2019-08-13 09:00,178,111,67,0,0,0
2019-08-13 09:15,151,99,52,0,0,0
2019-08-13 09:30,135,87,48,0,0,0
2019-08-13 09:45,177,125,52,0,0,0
2019-08-13 10:00,116,70,46,0,0,0
2019-08-13 10:15,116,70,46,0,0,0
2019-08-13 10:30,117,63,54,0,0,0
2019-08-13 10:45,133,80,53,0,0,0
2019-08-13 11:00,111,55,56,0,0,0
2019-08-13 11:15,116,69,47,0,0,0
2019-08-13 11:30,130,93,37,0,0,0
2019-08-13 11:45,138,89,49,0,0,0
2019-08-13 12:00,120,70,50,0,0,0
2019-08-13 12:15,147,97,50,0,0,0
2019-08-13 12:30,206,74,132,0,0,0
2019-08-13 12:45,166,92,74,0,0,0
2019-08-13 13:00,161,85,76,0,0,0
2019-08-13 13:15,148,76,72,0,0,0
2019-08-13 13:30,158,74,84,0,0,0
2019-08-13 13:45,147,68,79,0,0,0
2019-08-13 14:00,121,50,71,0,0,0
2019-08-13 14:15,100,26,74,0,0,0
2019-08-13 14:30,105,57,48,0,0,0
2019-08-13 14:45,159,74,85,0,0,0
2019-08-13 15:00,140,67,73,0,0,0
2019-08-13 15:15,153,86,67,0,0,0
2019-08-13 15:30,132,63,69,0,0,0
2019-08-13 15:45,128,64,64,0,0,0
2019-08-13 16:00,139,52,87,0,0,0
2019-08-13 16:15,164,81,83,0,0,0
2019-08-13 16:30,152,77,75,0,0,0
2019-08-13 16:45,186,100,86,0,0,0
2019-08-13 17:00,192,90,102,0,0,0
2019-08-13 17:15,193,83,110,0,0,0
2019-08-13 17:30,191,79,112,0,0,0
2019-08-13 17:45,216,93,123,0,0,0
2019-08-13 18:00,199,84,115,0,0,0
2019-08-13 18:15,171,66,105,0,0,0
2019-08-13 18:30,145,47,98,0,0,0
2019-08-13 18:45,178,73,105,0,0,0
2019-08-13 19:00,163,72,91,0,0,0
2019-08-13 19:15,114,53,61,0,0,0
2019-08-13 19:30,118,61,57,0,0,0
2019-08-13 19:45,105,53,52,0,0,0
2019-08-13 20:00,143,62,81,0,0,0
2019-08-13 20:15,122,56,66,0,0,0
2019-08-13 20:30,86,37,49,0,0,0
2019-08-13 20:45,87,38,49,0,0,0
2019-08-13 21:00,73,19,54,0,0,0
2019-08-13 21:15,61,21,40,0,0,0
2019-08-13 21:30,68,29,39,0,0,0
2019-08-13 21:45,83,23,60,0,0,0
2019-08-13 22:00,53,21,32,0,0,0
2019-08-13 22:15,61,28,33,0,0,0
2019-08-13 22:30,70,25,45,0,0,0
2019-08-13 22:45,66,22,44,0,0,0
2019-08-13 23:00,53,24,29,0,0,0
2019-08-13 23:15,42,13,29,0,0,0
2019-08-13 23:30,33,19,14,0,0,0
2019-08-13 23:45,41,17,24,0,0,0
2019-08-14 00:00,73,8,65,0,0,0
2019-08-14 00:15,22,6,16,0,0,0
2019-08-14 00:30,32,9,23,0,0,0
2019-08-14 00:45,22,4,18,0,0,0
2019-08-14 01:00,27,4,23,0,0,0
2019-08-14 01:15,20,8,12,0,0,0
2019-08-14 01:30,12,1,11,0,0,0
2019-08-14 01:45,11,2,9,0,0,0
2019-08-14 02:00,6,1,5,0,0,0
2019-08-14 02:15,1,1,0,0,0,0
2019-08-14 02:30,6,1,5,0,0,0
2019-08-14 02:45,5,3,2,0,0,0
2019-08-14 03:00,4,1,3,0,0,0
2019-08-14 03:15,7,2,5,0,0,0
2019-08-14 03:30,3,0,3,0,0,0
2019-08-14 03:45,5,1,4,0,0,0
2019-08-14 04:00,2,2,0,0,0,0
2019-08-14 04:15,3,0,3,0,0,0
2019-08-14 04:30,10,4,6,0,0,0
2019-08-14 04:45,6,4,2,0,0,0
2019-08-14 05:00,9,8,1,0,0,0
2019-08-14 05:15,9,6,3,0,0,0
2019-08-14 05:30,21,11,10,0,0,0
2019-08-14 05:45,24,15,9,0,0,0
2019-08-14 06:00,32,27,5,0,0,0
2019-08-14 06:15,42,31,11,0,0,0
2019-08-14 06:30,45,36,9,0,0,0
2019-08-14 06:45,90,70,20,0,0,0
2019-08-14 07:00,89,54,35,0,0,0
2019-08-14 07:15,112,81,31,0,0,0
2019-08-14 07:30,175,140,35,0,0,0
2019-08-14 07:45,210,148,62,0,0,0
2019-08-14 08:00,179,96,83,0,0,0
2019-08-14 08:15,146,96,50,0,0,0
2019-08-14 08:30,185,113,72,0,0,0
2019-08-14 08:45,193,138,55,0,0,0
2019-08-14 09:00,187,79,108,0,0,0
2019-08-14 09:15,142,92,50,0,0,0
2019-08-14 09:30,131,79,52,0,0,0
2019-08-14 09:45,186,131,55,0,0,0
2019-08-14 10:00,129,89,40,0,0,0
2019-08-14 10:15,133,85,48,0,0,0
2019-08-14 10:30,140,99,41,0,0,0
2019-08-14 10:45,148,87,61,0,0,0
2019-08-14 11:00,138,79,59,0,0,0
2019-08-14 11:15,157,103,54,0,0,0
2019-08-14 11:30,141,95,46,0,0,0
2019-08-14 11:45,160,103,57,0,0,0
2019-08-14 12:00,153,90,63,0,0,0
2019-08-14 12:15,168,86,82,0,0,0
2019-08-14 12:30,177,106,71,0,0,0
2019-08-14 12:45,176,109,67,0,0,0
2019-08-14 13:00,270,91,179,0,0,0
2019-08-14 13:15,185,87,98,0,0,0
2019-08-14 13:30,188,89,99,0,0,0
2019-08-14 13:45,178,79,99,0,0,0
2019-08-14 14:00,161,80,81,0,0,0
2019-08-14 14:15,171,75,96,0,0,0
2019-08-14 14:30,212,103,109,0,0,0
2019-08-14 14:45,144,81,63,0,0,0
2019-08-14 15:00,198,93,105,0,0,0
2019-08-14 15:15,184,90,94,0,0,0
2019-08-14 15:30,185,104,81,0,0,0
2019-08-14 15:45,190,91,99,0,0,0
2019-08-14 16:00,180,84,96,0,0,0
2019-08-14 16:15,214,95,119,0,0,0
2019-08-14 16:30,216,99,117,0,0,0
2019-08-14 16:45,228,113,115,0,0,0
2019-08-14 17:00,227,105,122,0,0,0
2019-08-14 17:15,240,109,131,0,0,0
2019-08-14 17:30,249,116,133,0,0,0
2019-08-14 17:45,253,122,131,0,0,0
2019-08-14 18:00,222,115,107,0,0,0
2019-08-14 18:15,237,101,136,0,0,0
2019-08-14 18:30,230,104,126,0,0,0
2019-08-14 18:45,219,104,115,0,0,0
2019-08-14 19:00,216,96,120,0,0,0
2019-08-14 19:15,194,105,89,0,0,0
2019-08-14 19:30,186,83,103,0,0,0
2019-08-14 19:45,203,109,94,0,0,0
2019-08-14 20:00,173,98,75,0,0,0
2019-08-14 20:15,189,79,110,0,0,0
2019-08-14 20:30,132,44,88,0,0,0
2019-08-14 20:45,123,43,80,0,0,0
2019-08-14 21:00,99,43,56,0,0,0
2019-08-14 21:15,110,57,53,0,0,0
2019-08-14 21:30,80,38,42,0,0,0
2019-08-14 21:45,85,31,54,0,0,0
2019-08-14 22:00,107,51,56,0,0,0
2019-08-14 22:15,99,39,60,0,0,0
2019-08-14 22:30,83,34,49,0,0,0
2019-08-14 22:45,68,28,40,0,0,0
2019-08-14 23:00,71,29,42,0,0,0
2019-08-14 23:15,66,14,52,0,0,0
2019-08-14 23:30,40,11,29,0,0,0
2019-08-14 23:45,118,25,93,0,0,0
2019-08-15 00:00,64,15,49,0,0,0
2019-08-15 00:15,35,8,27,0,0,0
2019-08-15 00:30,54,19,35,0,0,0
2019-08-15 00:45,39,9,30,0,0,0
2019-08-15 01:00,26,4,22,0,0,0
2019-08-15 01:15,39,4,35,0,0,0
2019-08-15 01:30,25,3,22,0,0,0
2019-08-15 01:45,18,4,14,0,0,0
2019-08-15 02:00,16,0,16,0,0,0
2019-08-15 02:15,18,1,17,0,0,0
2019-08-15 02:30,23,2,21,0,0,0
2019-08-15 02:45,30,6,24,0,0,0
2019-08-15 03:00,21,2,19,0,0,0
2019-08-15 03:15,22,4,18,0,0,0
2019-08-15 03:30,4,1,3,0,0,0
2019-08-15 03:45,15,1,14,0,0,0
2019-08-15 04:00,17,1,16,0,0,0
2019-08-15 04:15,3,1,2,0,0,0
2019-08-15 04:30,9,5,4,0,0,0
2019-08-15 04:45,7,4,3,0,0,0
2019-08-15 05:00,5,0,5,0,0,0
2019-08-15 05:15,12,8,4,0,0,0
2019-08-15 05:30,24,10,14,0,0,0
2019-08-15 05:45,24,18,6,0,0,0
2019-08-15 06:00,36,28,8,0,0,0
2019-08-15 06:15,35,24,11,0,0,0
2019-08-15 06:30,42,31,11,0,0,0
2019-08-15 06:45,58,39,19,0,0,0
2019-08-15 07:00,60,39,21,0,0,0
2019-08-15 07:15,77,61,16,0,0,0
2019-08-15 07:30,149,123,26,0,0,0
2019-08-15 07:45,184,127,57,0,0,0
2019-08-15 08:00,135,87,48,0,0,0
2019-08-15 08:15,146,85,61,0,0,0
2019-08-15 08:30,147,85,62,0,0,0
2019-08-15 08:45,166,114,52,0,0,0
2019-08-15 09:00,144,78,66,0,0,0
2019-08-15 09:15,105,52,53,0,0,0
2019-08-15 09:30,90,62,28,0,0,0
2019-08-15 09:45,107,73,34,0,0,0
2019-08-15 10:00,89,51,38,0,0,0
2019-08-15 10:15,91,56,35,0,0,0
2019-08-15 10:30,88,55,33,0,0,0
2019-08-15 10:45,101,70,31,0,0,0
2019-08-15 11:00,71,35,36,0,0,0
2019-08-15 11:15,84,40,44,0,0,0
2019-08-15 11:30,88,50,38,0,0,0
2019-08-15 11:45,96,67,29,0,0,0
2019-08-15 12:00,102,56,46,0,0,0
2019-08-15 12:15,101,66,35,0,0,0
2019-08-15 12:30,122,63,59,0,0,0
2019-08-15 12:45,126,69,57,0,0,0
2019-08-15 13:00,104,44,60,0,0,0
2019-08-15 13:15,185,57,128,0,0,0
2019-08-15 13:30,141,78,63,0,0,0
2019-08-15 13:45,118,58,60,0,0,0
2019-08-15 14:00,105,65,40,0,0,0
2019-08-15 14:15,129,69,60,0,0,0
2019-08-15 14:30,142,69,73,0,0,0
2019-08-15 14:45,123,62,61,0,0,0
2019-08-15 15:00,103,41,62,0,0,0
2019-08-15 15:15,135,81,54,0,0,0
2019-08-15 15:30,149,81,68,0,0,0
2019-08-15 15:45,155,83,72,0,0,0
2019-08-15 16:00,135,81,54,0,0,0
2019-08-15 16:15,172,82,90,0,0,0
2019-08-15 16:30,173,71,102,0,0,0
2019-08-15 16:45,207,97,110,0,0,0
2019-08-15 17:00,192,98,94,0,0,0
2019-08-15 17:15,182,99,83,0,0,0
2019-08-15 17:30,161,86,75,0,0,0
2019-08-15 17:45,213,111,102,0,0,0
2019-08-15 18:00,167,68,99,0,0,0
2019-08-15 18:15,162,75,87,0,0,0
2019-08-15 18:30,172,88,84,0,0,0
2019-08-15 18:45,182,100,82,0,0,0
2019-08-15 19:00,131,35,96,0,0,0
2019-08-15 19:15,104,49,55,0,0,0
2019-08-15 19:30,138,81,57,0,0,0
2019-08-15 19:45,142,74,68,0,0,0
2019-08-15 20:00,135,52,83,0,0,0
2019-08-15 20:15,138,63,75,0,0,0
2019-08-15 20:30,79,33,46,0,0,0
2019-08-15 20:45,100,42,58,0,0,0
2019-08-15 21:00,79,40,39,0,0,0
2019-08-15 21:15,71,27,44,0,0,0
2019-08-15 21:30,65,30,35,0,0,0
2019-08-15 21:45,58,16,42,0,0,0
2019-08-15 22:00,71,27,44,0,0,0
2019-08-15 22:15,53,17,36,0,0,0
2019-08-15 22:30,66,17,49,0,0,0
2019-08-15 22:45,58,14,44,0,0,0
2019-08-15 23:00,46,17,29,0,0,0
2019-08-15 23:15,55,17,38,0,0,0
2019-08-15 23:30,83,12,71,0,0,0
2019-08-15 23:45,34,10,24,0,0,0
2019-08-16 00:00,47,14,33,0,0,0
2019-08-16 00:15,39,3,36,0,0,0
2019-08-16 00:30,17,3,14,0,0,0
2019-08-16 00:45,11,6,5,0,0,0
2019-08-16 01:00,26,4,22,0,0,0
2019-08-16 01:15,18,3,15,0,0,0
2019-08-16 01:30,16,5,11,0,0,0
2019-08-16 01:45,11,1,10,0,0,0
2019-08-16 02:00,8,6,2,0,0,0
2019-08-16 02:15,19,5,14,0,0,0
2019-08-16 02:30,12,1,11,0,0,0
2019-08-16 02:45,4,3,1,0,0,0
2019-08-16 03:00,4,2,2,0,0,0
2019-08-16 03:15,1,0,1,0,0,0
2019-08-16 03:30,3,1,2,0,0,0
2019-08-16 03:45,3,0,3,0,0,0
2019-08-16 04:00,4,0,4,0,0,0
2019-08-16 04:15,5,0,5,0,0,0
2019-08-16 04:30,8,5,3,0,0,0
2019-08-16 04:45,11,4,7,0,0,0
2019-08-16 05:00,9,5,4,0,0,0
2019-08-16 05:15,6,5,1,0,0,0
2019-08-16 05:30,17,14,3,0,0,0
2019-08-16 05:45,20,14,6,0,0,0
2019-08-16 06:00,30,19,11,0,0,0
2019-08-16 06:15,38,25,13,0,0,0
2019-08-16 06:30,44,31,13,0,0,0
2019-08-16 06:45,75,51,24,0,0,0
2019-08-16 07:00,79,52,27,0,0,0
2019-08-16 07:15,89,67,22,0,0,0
2019-08-16 07:30,135,89,46,0,0,0
2019-08-16 07:45,221,141,80,0,0,0
2019-08-16 08:00,115,66,49,0,0,0
2019-08-16 08:15,168,106,62,0,0,0
2019-08-16 08:30,171,110,61,0,0,0
2019-08-16 08:45,203,110,93,0,0,0
2019-08-16 09:00,113,68,45,0,0,0
2019-08-16 09:15,126,86,40,0,0,0
2019-08-16 09:30,145,89,56,0,0,0
2019-08-16 09:45,132,84,48,0,0,0
2019-08-16 10:00,113,75,38,0,0,0
2019-08-16 10:15,124,77,47,0,0,0
2019-08-16 10:30,124,81,43,0,0,0
2019-08-16 10:45,139,74,65,0,0,0
2019-08-16 11:00,110,64,46,0,0,0
2019-08-16 11:15,148,88,60,0,0,0
2019-08-16 11:30,139,73,66,0,0,0
2019-08-16 11:45,134,76,58,0,0,0
2019-08-16 12:00,143,76,67,0,0,0
2019-08-16 12:15,159,93,66,0,0,0
2019-08-16 12:30,159,92,67,0,0,0
2019-08-16 12:45,160,90,70,0,0,0
2019-08-16 13:00,167,88,79,0,0,0
2019-08-16 13:15,170,91,79,0,0,0
2019-08-16 13:30,149,79,70,0,0,0
2019-08-16 13:45,209,121,88,0,0,0
2019-08-16 14:00,164,80,84,0,0,0
2019-08-16 14:15,186,107,79,0,0,0
2019-08-16 14:30,172,84,88,0,0,0
2019-08-16 14:45,196,91,105,0,0,0
2019-08-16 15:00,175,95,80,0,0,0
2019-08-16 15:15,196,87,109,0,0,0
2019-08-16 15:30,190,91,99,0,0,0
2019-08-16 15:45,226,125,101,0,0,0
2019-08-16 16:00,194,89,105,0,0,0
2019-08-16 16:15,213,118,95,0,0,0
2019-08-16 16:30,166,91,75,0,0,0
2019-08-16 16:45,176,92,84,0,0,0
2019-08-16 17:00,169,86,83,0,0,0
2019-08-16 17:15,192,95,97,0,0,0
2019-08-16 17:30,191,96,95,0,0,0
2019-08-16 17:45,257,124,133,0,0,0
2019-08-16 18:00,205,104,101,0,0,0
2019-08-16 18:15,214,107,107,0,0,0
2019-08-16 18:30,170,95,75,0,0,0
2019-08-16 18:45,231,143,88,0,0,0
2019-08-16 19:00,182,94,88,0,0,0
2019-08-16 19:15,188,94,94,0,0,0
2019-08-16 19:30,169,93,76,0,0,0
2019-08-16 19:45,195,134,61,0,0,0
2019-08-16 20:00,166,89,77,0,0,0
2019-08-16 20:15,172,95,77,0,0,0
2019-08-16 20:30,138,82,56,0,0,0
2019-08-16 20:45,140,72,68,0,0,0
2019-08-16 21:00,84,47,37,0,0,0
2019-08-16 21:15,99,46,53,0,0,0
2019-08-16 21:30,94,35,59,0,0,0
2019-08-16 21:45,81,46,35,0,0,0
2019-08-16 22:00,77,33,44,0,0,0
2019-08-16 22:15,120,53,67,0,0,0
2019-08-16 22:30,85,34,51,0,0,0
2019-08-16 22:45,79,26,53,0,0,0
2019-08-16 23:00,66,21,45,0,0,0
2019-08-16 23:15,72,29,43,0,0,0
2019-08-16 23:30,78,26,52,0,0,0
2019-08-16 23:45,96,29,67,0,0,0
2019-08-17 00:00,97,10,87,0,0,0
2019-08-17 00:15,116,12,104,0,0,0
2019-08-17 00:30,96,29,67,0,0,0
2019-08-17 00:45,91,14,77,0,0,0
2019-08-17 01:00,63,8,55,0,0,0
2019-08-17 01:15,63,15,48,0,0,0
2019-08-17 01:30,58,6,52,0,0,0
2019-08-17 01:45,45,11,34,0,0,0
2019-08-17 02:00,34,8,26,0,0,0
2019-08-17 02:15,54,11,43,0,0,0
2019-08-17 02:30,47,10,37,0,0,0
2019-08-17 02:45,34,9,25,0,0,0
2019-08-17 03:00,25,2,23,0,0,0
2019-08-17 03:15,27,8,19,0,0,0
2019-08-17 03:30,34,6,28,0,0,0
2019-08-17 03:45,25,8,17,0,0,0
2019-08-17 04:00,17,2,15,0,0,0
2019-08-17 04:15,18,2,16,0,0,0
2019-08-17 04:30,10,4,6,0,0,0
2019-08-17 04:45,18,5,13,0,0,0
2019-08-17 05:00,21,5,16,0,0,0
2019-08-17 05:15,18,12,6,0,0,0
2019-08-17 05:30,13,8,5,0,0,0
2019-08-17 05:45,21,10,11,0,0,0
2019-08-17 06:00,19,14,5,0,0,0
2019-08-17 06:15,18,11,7,0,0,0
2019-08-17 06:30,13,7,6,0,0,0
2019-08-17 06:45,20,12,8,0,0,0
2019-08-17 07:00,15,10,5,0,0,0
2019-08-17 07:15,16,12,4,0,0,0
2019-08-17 07:30,29,24,5,0,0,0
2019-08-17 07:45,38,34,4,0,0,0
2019-08-17 08:00,40,30,10,0,0,0
2019-08-17 08:15,51,39,12,0,0,0
2019-08-17 08:30,60,46,14,0,0,0
2019-08-17 08:45,81,66,15,0,0,0
2019-08-17 09:00,78,57,21,0,0,0
2019-08-17 09:15,74,62,12,0,0,0
2019-08-17 09:30,111,82,29,0,0,0
2019-08-17 09:45,142,107,35,0,0,0
2019-08-17 10:00,124,87,37,0,0,0
2019-08-17 10:15,153,108,45,0,0,0
2019-08-17 10:30,128,89,39,0,0,0
2019-08-17 10:45,127,88,39,0,0,0
2019-08-17 11:00,146,94,52,0,0,0
2019-08-17 11:15,129,83,46,0,0,0
2019-08-17 11:30,145,84,61,0,0,0
2019-08-17 11:45,169,94,75,0,0,0
2019-08-17 12:00,146,81,65,0,0,0
2019-08-17 12:15,144,83,61,0,0,0
2019-08-17 12:30,128,80,48,0,0,0
2019-08-17 12:45,126,72,54,0,0,0
2019-08-17 13:00,159,78,81,0,0,0
2019-08-17 13:15,146,68,78,0,0,0
2019-08-17 13:30,138,62,76,0,0,0
2019-08-17 13:45,176,77,99,0,0,0
2019-08-17 14:00,138,69,69,0,0,0
2019-08-17 14:15,129,62,67,0,0,0
2019-08-17 14:30,145,71,74,0,0,0
2019-08-17 14:45,130,53,77,0,0,0
2019-08-17 15:00,121,38,83,0,0,0
2019-08-17 15:15,100,38,62,0,0,0
2019-08-17 15:30,100,33,67,0,0,0
2019-08-17 15:45,137,70,67,0,0,0
2019-08-17 16:00,110,60,50,0,0,0
2019-08-17 16:15,112,40,72,0,0,0
2019-08-17 16:30,113,56,57,0,0,0
2019-08-17 16:45,100,40,60,0,0,0
2019-08-17 17:00,102,49,53,0,0,0
2019-08-17 17:15,103,50,53,0,0,0
2019-08-17 17:30,112,47,65,0,0,0
2019-08-17 17:45,136,77,59,0,0,0
2019-08-17 18:00,120,50,70,0,0,0
2019-08-17 18:15,116,67,49,0,0,0
2019-08-17 18:30,111,49,62,0,0,0
2019-08-17 18:45,121,73,48,0,0,0
2019-08-17 19:00,103,58,45,0,0,0
2019-08-17 19:15,113,64,49,0,0,0
2019-08-17 19:30,80,39,41,0,0,0
2019-08-17 19:45,92,52,40,0,0,0
2019-08-17 20:00,88,48,40,0,0,0
2019-08-17 20:15,117,60,57,0,0,0
2019-08-17 20:30,81,41,40,0,0,0
2019-08-17 20:45,90,46,44,0,0,0
2019-08-17 21:00,60,34,26,0,0,0
2019-08-17 21:15,61,24,37,0,0,0
2019-08-17 21:30,44,22,22,0,0,0
2019-08-17 21:45,61,29,32,0,0,0
2019-08-17 22:00,50,23,27,0,0,0
2019-08-17 22:15,44,17,27,0,0,0
2019-08-17 22:30,45,16,29,0,0,0
2019-08-17 22:45,46,15,31,0,0,0
2019-08-17 23:00,71,20,51,0,0,0
2019-08-17 23:15,68,21,47,0,0,0
2019-08-17 23:30,44,12,32,0,0,0
2019-08-17 23:45,56,10,46,0,0,0
2019-08-18 00:00,59,14,45,0,0,0
2019-08-18 00:15,102,27,75,0,0,0
2019-08-18 00:30,74,13,61,0,0,0
2019-08-18 00:45,48,8,40,0,0,0
2019-08-18 01:00,49,9,40,0,0,0
2019-08-18 01:15,36,3,33,0,0,0
2019-08-18 01:30,19,5,14,0,0,0
2019-08-18 01:45,30,9,21,0,0,0
2019-08-18 02:00,32,11,21,0,0,0
2019-08-18 02:15,50,11,39,0,0,0
2019-08-18 02:30,23,4,19,0,0,0
2019-08-18 02:45,24,9,15,0,0,0
2019-08-18 03:00,21,7,14,0,0,0
2019-08-18 03:15,28,12,16,0,0,0
2019-08-18 03:30,18,1,17,0,0,0
2019-08-18 03:45,21,6,15,0,0,0
2019-08-18 04:00,10,1,9,0,0,0
2019-08-18 04:15,21,7,14,0,0,0
2019-08-18 04:30,13,1,12,0,0,0
2019-08-18 04:45,7,1,6,0,0,0
2019-08-18 05:00,6,0,6,0,0,0
2019-08-18 05:15,8,2,6,0,0,0
2019-08-18 05:30,13,4,9,0,0,0
2019-08-18 05:45,10,3,7,0,0,0
2019-08-18 06:00,8,3,5,0,0,0
2019-08-18 06:15,8,5,3,0,0,0
2019-08-18 06:30,4,2,2,0,0,0
2019-08-18 06:45,9,1,8,0,0,0
2019-08-18 07:00,5,2,3,0,0,0
2019-08-18 07:15,8,7,1,0,0,0
2019-08-18 07:30,11,6,5,0,0,0
2019-08-18 07:45,17,11,6,0,0,0
2019-08-18 08:00,11,5,6,0,0,0
2019-08-18 08:15,13,7,6,0,0,0
2019-08-18 08:30,15,11,4,0,0,0
2019-08-18 08:45,19,11,8,0,0,0
2019-08-18 09:00,20,11,9,0,0,0
2019-08-18 09:15,25,15,10,0,0,0
2019-08-18 09:30,38,24,14,0,0,0
2019-08-18 09:45,46,36,10,0,0,0
2019-08-18 10:00,40,32,8,0,0,0
2019-08-18 10:15,41,29,12,0,0,0
2019-08-18 10:30,45,18,27,0,0,0
2019-08-18 10:45,28,18,10,0,0,0
2019-08-18 11:00,36,23,13,0,0,0
2019-08-18 11:15,19,15,4,0,0,0
2019-08-18 11:30,40,22,18,0,0,0
2019-08-18 11:45,55,32,23,0,0,0
2019-08-18 12:00,33,22,11,0,0,0
2019-08-18 12:15,26,17,9,0,0,0
2019-08-18 12:30,26,15,11,0,0,0
2019-08-18 12:45,41,21,20,0,0,0
2019-08-18 13:00,35,14,21,0,0,0
2019-08-18 13:15,23,13,10,0,0,0
2019-08-18 13:30,35,16,19,0,0,0
2019-08-18 13:45,40,21,19,0,0,0
2019-08-18 14:00,81,32,49,0,0,0
2019-08-18 14:15,39,19,20,0,0,0
2019-08-18 14:30,66,44,22,0,0,0
2019-08-18 14:45,57,30,27,0,0,0
2019-08-18 15:00,66,36,30,0,0,0
2019-08-18 15:15,64,46,18,0,0,0
2019-08-18 15:30,70,39,31,0,0,0
2019-08-18 15:45,79,44,35,0,0,0
2019-08-18 16:00,78,43,35,0,0,0
2019-08-18 16:15,79,48,31,0,0,0
2019-08-18 16:30,56,30,26,0,0,0
2019-08-18 16:45,78,43,35,0,0,0
2019-08-18 17:00,82,46,36,0,0,0
2019-08-18 17:15,117,58,59,0,0,0
2019-08-18 17:30,88,57,31,0,0,0
2019-08-18 17:45,108,65,43,0,0,0
2019-08-18 18:00,102,48,54,0,0,0
2019-08-18 18:15,74,39,35,0,0,0
2019-08-18 18:30,83,38,45,0,0,0
2019-08-18 18:45,100,63,37,0,0,0
2019-08-18 19:00,86,49,37,0,0,0
2019-08-18 19:15,121,73,48,0,0,0
2019-08-18 19:30,85,51,34,0,0,0
2019-08-18 19:45,115,48,67,0,0,0
2019-08-18 20:00,68,35,33,0,0,0
2019-08-18 20:15,76,35,41,0,0,0
2019-08-18 20:30,71,35,36,0,0,0
2019-08-18 20:45,63,16,47,0,0,0
2019-08-18 21:00,64,25,39,0,0,0
2019-08-18 21:15,51,23,28,0,0,0
2019-08-18 21:30,43,14,29,0,0,0
2019-08-18 21:45,38,8,30,0,0,0
2019-08-18 22:00,46,12,34,0,0,0
2019-08-18 22:15,41,13,28,0,0,0
2019-08-18 22:30,59,11,48,0,0,0
2019-08-18 22:45,82,12,70,0,0,0
2019-08-18 23:00,42,7,35,0,0,0
2019-08-18 23:15,25,6,19,0,0,0
2019-08-18 23:30,100,17,83,0,0,0
2019-08-18 23:45,16,5,11,0,0,0
2019-08-19 00:00,23,7,16,0,0,0
2019-08-19 00:15,20,4,16,0,0,0
2019-08-19 00:30,7,4,3,0,0,0
2019-08-19 00:45,12,4,8,0,0,0
2019-08-19 01:00,6,0,6,0,0,0
2019-08-19 01:15,6,1,5,0,0,0
2019-08-19 01:30,12,4,8,0,0,0
2019-08-19 01:45,9,1,8,0,0,0
2019-08-19 02:00,9,2,7,0,0,0
2019-08-19 02:15,3,1,2,0,0,0
2019-08-19 02:30,3,0,3,0,0,0
2019-08-19 02:45,6,2,4,0,0,0
2019-08-19 03:00,0,0,0,0,0,0
2019-08-19 03:15,1,1,0,0,0,0
2019-08-19 03:30,9,1,8,0,0,0
2019-08-19 03:45,4,4,0,0,0,0
2019-08-19 04:00,2,2,0,0,0,0
2019-08-19 04:15,3,1,2,0,0,0
2019-08-19 04:30,3,1,2,0,0,0
2019-08-19 04:45,13,7,6,0,0,0
2019-08-19 05:00,6,5,1,0,0,0
2019-08-19 05:15,17,10,7,0,0,0
2019-08-19 05:30,17,10,7,0,0,0
2019-08-19 05:45,18,12,6,0,0,0
2019-08-19 06:00,39,25,14,0,0,0
2019-08-19 06:15,62,44,18,0,0,0
2019-08-19 06:30,57,39,18,0,0,0
2019-08-19 06:45,85,51,34,0,0,0
2019-08-19 07:00,163,126,37,0,0,0
2019-08-19 07:15,153,117,36,0,0,0
2019-08-19 07:30,172,104,68,0,0,0
2019-08-19 07:45,246,147,99,0,0,0
2019-08-19 08:00,201,118,83,0,0,0
2019-08-19 08:15,178,110,68,0,0,0
2019-08-19 08:30,162,106,56,0,0,0
2019-08-19 08:45,200,118,82,0,0,0
2019-08-19 09:00,180,114,66,0,0,0
2019-08-19 09:15,126,88,38,0,0,0
2019-08-19 09:30,132,93,39,0,0,0
2019-08-19 09:45,136,88,48,0,0,0
2019-08-19 10:00,126,73,53,0,0,0
2019-08-19 10:15,120,72,48,0,0,0
2019-08-19 10:30,109,65,44,0,0,0
2019-08-19 10:45,137,70,67,0,0,0
2019-08-19 11:00,216,60,156,0,0,0
2019-08-19 11:15,141,71,70,0,0,0
2019-08-19 11:30,117,63,54,0,0,0
2019-08-19 11:45,167,92,75,0,0,0
2019-08-19 12:00,143,70,73,0,0,0
2019-08-19 12:15,160,91,69,0,0,0
2019-08-19 12:30,158,75,83,0,0,0
2019-08-19 12:45,166,83,83,0,0,0
2019-08-19 13:00,153,71,82,0,0,0
2019-08-19 13:15,117,61,56,0,0,0
2019-08-19 13:30,149,77,72,0,0,0
2019-08-19 13:45,153,77,76,0,0,0
2019-08-19 14:00,122,61,61,0,0,0
2019-08-19 14:15,150,87,63,0,0,0
2019-08-19 14:30,148,79,69,0,0,0
2019-08-19 14:45,184,98,86,0,0,0
2019-08-19 15:00,155,76,79,0,0,0
2019-08-19 15:15,157,75,82,0,0,0
2019-08-19 15:30,193,91,102,0,0,0
2019-08-19 15:45,204,104,100,0,0,0
2019-08-19 16:00,218,98,120,0,0,0
2019-08-19 16:15,221,114,107,0,0,0
2019-08-19 16:30,211,92,119,0,0,0
2019-08-19 16:45,211,99,112,0,0,0
2019-08-19 17:00,217,118,99,0,0,0
2019-08-19 17:15,262,112,150,0,0,0
2019-08-19 17:30,224,111,113,0,0,0
2019-08-19 17:45,249,115,134,0,0,0
2019-08-19 18:00,236,93,143,0,0,0
2019-08-19 18:15,270,112,158,0,0,0
2019-08-19 18:30,221,101,120,0,0,0
2019-08-19 18:45,220,127,93,0,0,0
2019-08-19 19:00,194,86,108,0,0,0
2019-08-19 19:15,167,78,89,0,0,0
2019-08-19 19:30,163,76,87,0,0,0
2019-08-19 19:45,155,58,97,0,0,0
2019-08-19 20:00,141,53,88,0,0,0
2019-08-19 20:15,131,40,91,0,0,0
2019-08-19 20:30,102,57,45,0,0,0
2019-08-19 20:45,86,37,49,0,0,0
2019-08-19 21:00,78,32,46,0,0,0
2019-08-19 21:15,70,34,36,0,0,0
2019-08-19 21:30,67,16,51,0,0,0
2019-08-19 21:45,61,19,42,0,0,0
2019-08-19 22:00,68,26,42,0,0,0
2019-08-19 22:15,56,20,36,0,0,0
2019-08-19 22:30,59,26,33,0,0,0
2019-08-19 22:45,36,7,29,0,0,0
2019-08-19 23:00,49,22,27,0,0,0
2019-08-19 23:15,37,12,25,0,0,0
2019-08-19 23:30,103,16,87,0,0,0
2019-08-19 23:45,22,6,16,0,0,0
2019-08-20 00:00,45,13,32,0,0,0
2019-08-20 00:15,26,7,19,0,0,0
2019-08-20 00:30,32,1,31,0,0,0
2019-08-20 00:45,17,3,14,0,0,0
2019-08-20 01:00,13,1,12,0,0,0
2019-08-20 01:15,18,2,16,0,0,0
2019-08-20 01:30,12,1,11,0,0,0
2019-08-20 01:45,12,3,9,0,0,0
2019-08-20 02:00,4,0,4,0,0,0
2019-08-20 02:15,11,0,11,0,0,0
2019-08-20 02:30,8,4,4,0,0,0
2019-08-20 02:45,3,1,2,0,0,0
2019-08-20 03:00,4,2,2,0,0,0
2019-08-20 03:15,10,3,7,0,0,0
2019-08-20 03:30,5,4,1,0,0,0
2019-08-20 03:45,3,1,2,0,0,0
2019-08-20 04:00,3,3,0,0,0,0
2019-08-20 04:15,3,0,3,0,0,0
2019-08-20 04:30,6,3,3,0,0,0
2019-08-20 04:45,9,6,3,0,0,0
2019-08-20 05:00,12,7,5,0,0,0
2019-08-20 05:15,15,7,8,0,0,0
2019-08-20 05:30,15,10,5,0,0,0
2019-08-20 05:45,24,15,9,0,0,0
2019-08-20 06:00,37,30,7,0,0,0
2019-08-20 06:15,47,32,15,0,0,0
2019-08-20 06:30,69,49,20,0,0,0
2019-08-20 06:45,100,66,34,0,0,0
2019-08-20 07:00,109,72,37,0,0,0
2019-08-20 07:15,119,72,47,0,0,0
2019-08-20 07:30,160,101,59,0,0,0
2019-08-20 07:45,252,158,94,0,0,0
2019-08-20 08:00,180,107,73,0,0,0
2019-08-20 08:15,188,125,63,0,0,0
2019-08-20 08:30,197,139,58,0,0,0
2019-08-20 08:45,222,126,96,0,0,0
2019-08-20 09:00,195,117,78,0,0,0
2019-08-20 09:15,130,91,39,0,0,0
2019-08-20 09:30,131,86,45,0,0,0
2019-08-20 09:45,168,112,56,0,0,0
2019-08-20 10:00,136,83,53,0,0,0
2019-08-20 10:15,122,72,50,0,0,0
2019-08-20 10:30,128,85,43,0,0,0
2019-08-20 10:45,135,75,60,0,0,0
2019-08-20 11:00,110,67,43,0,0,0
2019-08-20 11:15,120,73,47,0,0,0
2019-08-20 11:30,128,78,50,0,0,0
2019-08-20 11:45,149,104,45,0,0,0
2019-08-20 12:00,154,74,80,0,0,0
2019-08-20 12:15,160,90,70,0,0,0
2019-08-20 12:30,182,105,77,0,0,0
2019-08-20 12:45,169,88,81,0,0,0
2019-08-20 13:00,134,59,75,0,0,0
2019-08-20 13:15,175,96,79,0,0,0
2019-08-20 13:30,295,228,67,0,0,0
2019-08-20 13:45,205,99,106,0,0,0
2019-08-20 14:00,179,88,91,0,0,0
2019-08-20 14:15,158,91,67,0,0,0
2019-08-20 14:30,174,83,91,0,0,0
2019-08-20 14:45,160,87,73,0,0,0
2019-08-20 15:00,162,76,86,0,0,0
2019-08-20 15:15,189,97,92,0,0,0
2019-08-20 15:30,182,70,112,0,0,0
2019-08-20 15:45,192,98,94,0,0,0
2019-08-20 16:00,225,105,120,0,0,0
2019-08-20 16:15,198,97,101,0,0,0
2019-08-20 16:30,236,123,113,0,0,0
2019-08-20 16:45,236,127,109,0,0,0
2019-08-20 17:00,237,96,141,0,0,0
2019-08-20 17:15,333,113,220,0,0,0
2019-08-20 17:30,331,124,207,0,0,0
2019-08-20 17:45,310,136,174,0,0,0
2019-08-20 18:00,291,120,171,0,0,0
2019-08-20 18:15,223,91,132,0,0,0
2019-08-20 18:30,190,84,106,0,0,0
2019-08-20 18:45,201,85,116,0,0,0
2019-08-20 19:00,170,72,98,0,0,0
2019-08-20 19:15,179,92,87,0,0,0
2019-08-20 19:30,152,44,108,0,0,0
2019-08-20 19:45,143,81,62,0,0,0
2019-08-20 20:00,131,67,64,0,0,0
2019-08-20 20:15,112,43,69,0,0,0
2019-08-20 20:30,89,40,49,0,0,0
2019-08-20 20:45,92,34,58,0,0,0
2019-08-20 21:00,100,38,62,0,0,0
2019-08-20 21:15,84,28,56,0,0,0
2019-08-20 21:30,82,30,52,0,0,0
2019-08-20 21:45,72,17,55,0,0,0
2019-08-20 22:00,104,32,72,0,0,0
2019-08-20 22:15,71,27,44,0,0,0
2019-08-20 22:30,72,21,51,0,0,0
2019-08-20 22:45,55,18,37,0,0,0
2019-08-20 23:00,50,16,34,0,0,0
2019-08-20 23:15,67,11,56,0,0,0
2019-08-20 23:30,46,15,31,0,0,0
2019-08-20 23:45,38,9,29,0,0,0
2019-08-21 00:00,22,6,16,0,0,0
2019-08-21 00:15,23,5,18,0,0,0
2019-08-21 00:30,19,6,13,0,0,0
2019-08-21 00:45,16,4,12,0,0,0
2019-08-21 01:00,10,2,8,0,0,0
2019-08-21 01:15,15,2,13,0,0,0
2019-08-21 01:30,9,0,9,0,0,0
2019-08-21 01:45,13,2,11,0,0,0
2019-08-21 02:00,6,2,4,0,0,0
2019-08-21 02:15,10,3,7,0,0,0
2019-08-21 02:30,4,2,2,0,0,0
2019-08-21 02:45,7,4,3,0,0,0
2019-08-21 03:00,5,1,4,0,0,0
2019-08-21 03:15,3,1,2,0,0,0
2019-08-21 03:30,4,2,2,0,0,0
2019-08-21 03:45,2,2,0,0,0,0
2019-08-21 04:00,0,0,0,0,0,0
2019-08-21 04:15,3,1,2,0,0,0
2019-08-21 04:30,4,3,1,0,0,0
2019-08-21 04:45,9,7,2,0,0,0
2019-08-21 05:00,5,4,1,0,0,0
2019-08-21 05:15,12,9,3,0,0,0
2019-08-21 05:30,22,12,10,0,0,0
2019-08-21 05:45,24,16,8,0,0,0
2019-08-21 06:00,41,24,17,0,0,0
2019-08-21 06:15,48,33,15,0,0,0
2019-08-21 06:30,58,39,19,0,0,0
2019-08-21 06:45,89,62,27,0,0,0
2019-08-21 07:00,76,59,17,0,0,0
2019-08-21 07:15,119,71,48,0,0,0
2019-08-21 07:30,168,107,61,0,0,0
2019-08-21 07:45,230,150,80,0,0,0
2019-08-21 08:00,174,102,72,0,0,0
2019-08-21 08:15,211,131,80,0,0,0
2019-08-21 08:30,196,127,69,0,0,0
2019-08-21 08:45,245,161,84,0,0,0
2019-08-21 09:00,178,102,76,0,0,0
2019-08-21 09:15,135,91,44,0,0,0
2019-08-21 09:30,140,94,46,0,0,0
2019-08-21 09:45,204,133,71,0,0,0
2019-08-21 10:00,121,77,44,0,0,0
2019-08-21 10:15,132,86,46,0,0,0
2019-08-21 10:30,155,99,56,0,0,0
2019-08-21 10:45,168,116,52,0,0,0
2019-08-21 11:00,139,70,69,0,0,0
2019-08-21 11:15,149,83,66,0,0,0
2019-08-21 11:30,160,91,69,0,0,0
2019-08-21 11:45,165,92,73,0,0,0
2019-08-21 12:00,164,83,81,0,0,0
2019-08-21 12:15,194,109,85,0,0,0
2019-08-21 12:30,161,97,64,0,0,0
2019-08-21 12:45,235,116,119,0,0,0
2019-08-21 13:00,187,114,73,0,0,0
2019-08-21 13:15,241,142,99,0,0,0
2019-08-21 13:30,253,172,81,0,0,0
2019-08-21 13:45,188,98,90,0,0,0
2019-08-21 14:00,172,72,100,0,0,0
2019-08-21 14:15,178,97,81,0,0,0
2019-08-21 14:30,185,86,99,0,0,0
2019-08-21 14:45,185,85,100,0,0,0
2019-08-21 15:00,188,97,91,0,0,0
2019-08-21 15:15,172,71,101,0,0,0
2019-08-21 15:30,182,91,91,0,0,0
2019-08-21 15:45,233,103,130,0,0,0
2019-08-21 16:00,218,95,123,0,0,0
2019-08-21 16:15,233,96,137,0,0,0
2019-08-21 16:30,252,106,146,0,0,0
2019-08-21 16:45,236,121,115,0,0,0
2019-08-21 17:00,266,135,131,0,0,0
2019-08-21 17:15,353,135,218,0,0,0
2019-08-21 17:30,289,121,168,0,0,0
2019-08-21 17:45,288,116,172,0,0,0
2019-08-21 18:00,241,96,145,0,0,0
2019-08-21 18:15,260,116,144,0,0,0
2019-08-21 18:30,214,96,118,0,0,0
2019-08-21 18:45,258,135,123,0,0,0
2019-08-21 19:00,235,125,110,0,0,0
2019-08-21 19:15,218,116,102,0,0,0
2019-08-21 19:30,163,75,88,0,0,0
2019-08-21 19:45,200,111,89,0,0,0
2019-08-21 20:00,181,93,88,0,0,0
2019-08-21 20:15,167,75,92,0,0,0
2019-08-21 20:30,142,69,73,0,0,0
2019-08-21 20:45,112,44,68,0,0,0
2019-08-21 21:00,104,49,55,0,0,0
2019-08-21 21:15,107,54,53,0,0,0
2019-08-21 21:30,98,35,63,0,0,0
2019-08-21 21:45,72,30,42,0,0,0
2019-08-21 22:00,96,39,57,0,0,0
2019-08-21 22:15,79,39,40,0,0,0
2019-08-21 22:30,103,35,68,0,0,0
2019-08-21 22:45,71,21,50,0,0,0
2019-08-21 23:00,82,25,57,0,0,0
2019-08-21 23:15,37,14,23,0,0,0
2019-08-21 23:30,65,14,51,0,0,0
2019-08-21 23:45,189,52,137,0,0,0
2019-08-22 00:00,56,20,36,0,0,0
2019-08-22 00:15,31,7,24,0,0,0
2019-08-22 00:30,33,11,22,0,0,0
2019-08-22 00:45,23,6,17,0,0,0
2019-08-22 01:00,29,9,20,0,0,0
2019-08-22 01:15,35,9,26,0,0,0
2019-08-22 01:30,30,6,24,0,0,0
2019-08-22 01:45,18,1,17,0,0,0
2019-08-22 02:00,29,5,24,0,0,0
2019-08-22 02:15,34,12,22,0,0,0
2019-08-22 02:30,17,2,15,0,0,0
2019-08-22 02:45,17,1,16,0,0,0
2019-08-22 03:00,15,3,12,0,0,0
2019-08-22 03:15,18,5,13,0,0,0
2019-08-22 03:30,10,4,6,0,0,0
2019-08-22 03:45,7,2,5,0,0,0
2019-08-22 04:00,20,1,19,0,0,0
2019-08-22 04:15,4,0,4,0,0,0
2019-08-22 04:30,14,5,9,0,0,0
2019-08-22 04:45,9,4,5,0,0,0
2019-08-22 05:00,13,8,5,0,0,0
2019-08-22 05:15,9,3,6,0,0,0
2019-08-22 05:30,23,13,10,0,0,0
2019-08-22 05:45,30,15,15,0,0,0
2019-08-22 06:00,36,27,9,0,0,0
2019-08-22 06:15,53,29,24,0,0,0
2019-08-22 06:30,61,39,22,0,0,0
2019-08-22 06:45,79,54,25,0,0,0
2019-08-22 07:00,96,64,32,0,0,0
2019-08-22 07:15,116,70,46,0,0,0
2019-08-22 07:30,161,101,60,0,0,0
2019-08-22 07:45,239,139,100,0,0,0
2019-08-22 08:00,189,113,76,0,0,0
2019-08-22 08:15,197,113,84,0,0,0
2019-08-22 08:30,204,131,73,0,0,0
2019-08-22 08:45,224,139,85,0,0,0
2019-08-22 09:00,158,99,59,0,0,0
2019-08-22 09:15,129,94,35,0,0,0
2019-08-22 09:30,140,85,55,0,0,0
2019-08-22 09:45,163,111,52,0,0,0
2019-08-22 10:00,121,80,41,0,0,0
2019-08-22 10:15,109,63,46,0,0,0
2019-08-22 10:30,110,61,49,0,0,0
2019-08-22 10:45,155,89,66,0,0,0
2019-08-22 11:00,132,83,49,0,0,0
2019-08-22 11:15,131,82,49,0,0,0
2019-08-22 11:30,129,74,55,0,0,0
2019-08-22 11:45,131,78,53,0,0,0
2019-08-22 12:00,153,103,50,0,0,0
2019-08-22 12:15,166,100,66,0,0,0
2019-08-22 12:30,159,84,75,0,0,0
2019-08-22 12:45,175,114,61,0,0,0
2019-08-22 13:00,182,108,74,0,0,0
2019-08-22 13:15,264,179,85,0,0,0
2019-08-22 13:30,235,143,92,0,0,0
2019-08-22 13:45,179,83,96,0,0,0
2019-08-22 14:00,182,108,74,0,0,0
2019-08-22 14:15,203,100,103,0,0,0
2019-08-22 14:30,212,115,97,0,0,0
2019-08-22 14:45,170,94,76,0,0,0
2019-08-22 15:00,194,84,110,0,0,0
2019-08-22 15:15,162,85,77,0,0,0
2019-08-22 15:30,210,118,92,0,0,0
2019-08-22 15:45,225,116,109,0,0,0
2019-08-22 16:00,208,98,110,0,0,0
2019-08-22 16:15,213,104,109,0,0,0
2019-08-22 16:30,215,95,120,0,0,0
2019-08-22 16:45,269,146,123,0,0,0
2019-08-22 17:00,264,123,141,0,0,0
2019-08-22 17:15,403,115,288,0,0,0
2019-08-22 17:30,273,119,154,0,0,0
2019-08-22 17:45,308,142,166,0,0,0
2019-08-22 18:00,284,118,166,0,0,0
2019-08-22 18:15,238,119,119,0,0,0
2019-08-22 18:30,247,119,128,0,0,0
2019-08-22 18:45,286,152,134,0,0,0
2019-08-22 19:00,200,83,117,0,0,0
2019-08-22 19:15,211,109,102,0,0,0
2019-08-22 19:30,191,93,98,0,0,0
2019-08-22 19:45,205,110,95,0,0,0
2019-08-22 20:00,142,59,83,0,0,0
2019-08-22 20:15,129,68,61,0,0,0
2019-08-22 20:30,109,53,56,0,0,0
2019-08-22 20:45,112,41,71,0,0,0
2019-08-22 21:00,114,39,75,0,0,0
2019-08-22 21:15,106,54,52,0,0,0
2019-08-22 21:30,94,40,54,0,0,0
2019-08-22 21:45,87,24,63,0,0,0
2019-08-22 22:00,88,34,54,0,0,0
2019-08-22 22:15,68,21,47,0,0,0
2019-08-22 22:30,101,37,64,0,0,0
2019-08-22 22:45,76,17,59,0,0,0
2019-08-22 23:00,71,15,56,0,0,0
2019-08-22 23:15,102,25,77,0,0,0
2019-08-22 23:30,68,19,49,0,0,0
2019-08-22 23:45,45,14,31,0,0,0
2019-08-23 00:00,34,12,22,0,0,0
2019-08-23 00:15,30,6,24,0,0,0
2019-08-23 00:30,32,7,25,0,0,0
2019-08-23 00:45,22,8,14,0,0,0
2019-08-23 01:00,27,4,23,0,0,0
2019-08-23 01:15,12,2,10,0,0,0
2019-08-23 01:30,15,3,12,0,0,0
2019-08-23 01:45,21,2,19,0,0,0
2019-08-23 02:00,4,2,2,0,0,0
2019-08-23 02:15,7,2,5,0,0,0
2019-08-23 02:30,6,2,4,0,0,0
2019-08-23 02:45,7,0,7,0,0,0
2019-08-23 03:00,3,3,0,0,0,0
2019-08-23 03:15,4,2,2,0,0,0
2019-08-23 03:30,4,3,1,0,0,0
2019-08-23 03:45,2,1,1,0,0,0
2019-08-23 04:00,4,2,2,0,0,0
2019-08-23 04:15,3,0,3,0,0,0
2019-08-23 04:30,5,2,3,0,0,0
2019-08-23 04:45,9,7,2,0,0,0
2019-08-23 05:00,7,5,2,0,0,0
2019-08-23 05:15,15,7,8,0,0,0
2019-08-23 05:30,17,8,9,0,0,0
2019-08-23 05:45,19,10,9,0,0,0
2019-08-23 06:00,33,27,6,0,0,0
2019-08-23 06:15,44,25,19,0,0,0
2019-08-23 06:30,61,39,22,0,0,0
2019-08-23 06:45,95,64,31,0,0,0
2019-08-23 07:00,146,115,31,0,0,0
2019-08-23 07:15,121,81,40,0,0,0
2019-08-23 07:30,159,99,60,0,0,0
2019-08-23 07:45,221,133,88,0,0,0
2019-08-23 08:00,177,92,85,0,0,0
2019-08-23 08:15,190,112,78,0,0,0
2019-08-23 08:30,167,116,51,0,0,0
2019-08-23 08:45,225,138,87,0,0,0
2019-08-23 09:00,140,92,48,0,0,0
2019-08-23 09:15,114,74,40,0,0,0
2019-08-23 09:30,152,98,54,0,0,0
2019-08-23 09:45,173,117,56,0,0,0
2019-08-23 10:00,124,74,50,0,0,0
2019-08-23 10:15,110,77,33,0,0,0
2019-08-23 10:30,139,88,51,0,0,0
2019-08-23 10:45,136,83,53,0,0,0
2019-08-23 11:00,99,60,39,0,0,0
2019-08-23 11:15,147,71,76,0,0,0
2019-08-23 11:30,133,73,60,0,0,0
2019-08-23 11:45,129,79,50,0,0,0
2019-08-23 12:00,162,88,74,0,0,0
2019-08-23 12:15,199,112,87,0,0,0
2019-08-23 12:30,192,97,95,0,0,0
2019-08-23 12:45,262,90,172,0,0,0
2019-08-23 13:00,168,71,97,0,0,0
2019-08-23 13:15,185,95,90,0,0,0
2019-08-23 13:30,192,99,93,0,0,0
2019-08-23 13:45,188,94,94,0,0,0
2019-08-23 14:00,205,113,92,0,0,0
2019-08-23 14:15,196,97,99,0,0,0
2019-08-23 14:30,215,94,121,0,0,0
2019-08-23 14:45,201,103,98,0,0,0
2019-08-23 15:00,219,94,125,0,0,0
2019-08-23 15:15,183,94,89,0,0,0
2019-08-23 15:30,209,86,123,0,0,0
2019-08-23 15:45,209,108,101,0,0,0
2019-08-23 16:00,192,110,82,0,0,0
2019-08-23 16:15,160,81,79,0,0,0
2019-08-23 16:30,184,94,90,0,0,0
2019-08-23 16:45,217,125,92,0,0,0
2019-08-23 17:00,213,102,111,0,0,0
2019-08-23 17:15,198,111,87,0,0,0
2019-08-23 17:30,171,100,71,0,0,0
2019-08-23 17:45,208,105,103,0,0,0
2019-08-23 18:00,198,99,99,0,0,0
2019-08-23 18:15,216,121,95,0,0,0
2019-08-23 18:30,198,123,75,0,0,0
2019-08-23 18:45,248,130,118,0,0,0
2019-08-23 19:00,195,116,79,0,0,0
2019-08-23 19:15,213,122,91,0,0,0
2019-08-23 19:30,145,73,72,0,0,0
2019-08-23 19:45,140,89,51,0,0,0
2019-08-23 20:00,155,80,75,0,0,0
2019-08-23 20:15,173,86,87,0,0,0
2019-08-23 20:30,135,72,63,0,0,0
2019-08-23 20:45,85,44,41,0,0,0
2019-08-23 21:00,111,61,50,0,0,0
2019-08-23 21:15,105,44,61,0,0,0
2019-08-23 21:30,76,32,44,0,0,0
2019-08-23 21:45,100,43,57,0,0,0
2019-08-23 22:00,110,52,58,0,0,0
2019-08-23 22:15,51,25,26,0,0,0
2019-08-23 22:30,93,28,65,0,0,0
2019-08-23 22:45,96,42,54,0,0,0
2019-08-23 23:00,88,42,46,0,0,0
2019-08-23 23:15,62,22,40,0,0,0
2019-08-23 23:30,61,27,34,0,0,0
2019-08-23 23:45,103,27,76,0,0,0
2019-08-24 00:00,175,36,139,0,0,0
2019-08-24 00:15,70,19,51,0,0,0
2019-08-24 00:30,50,20,30,0,0,0
2019-08-24 00:45,48,11,37,0,0,0
2019-08-24 01:00,37,15,22,0,0,0
2019-08-24 01:15,76,31,45,0,0,0
2019-08-24 01:30,51,17,34,0,0,0
2019-08-24 01:45,32,7,25,0,0,0
2019-08-24 02:00,44,8,36,0,0,0
2019-08-24 02:15,49,5,44,0,0,0
2019-08-24 02:30,42,10,32,0,0,0
2019-08-24 02:45,33,10,23,0,0,0
2019-08-24 03:00,14,1,13,0,0,0
2019-08-24 03:15,15,4,11,0,0,0
2019-08-24 03:30,16,1,15,0,0,0
2019-08-24 03:45,19,5,14,0,0,0
2019-08-24 04:00,23,3,20,0,0,0
2019-08-24 04:15,14,1,13,0,0,0
2019-08-24 04:30,11,4,7,0,0,0
2019-08-24 04:45,16,3,13,0,0,0
2019-08-24 05:00,14,3,11,0,0,0
2019-08-24 05:15,10,5,5,0,0,0
2019-08-24 05:30,10,3,7,0,0,0
2019-08-24 05:45,20,8,12,0,0,0
2019-08-24 06:00,18,7,11,0,0,0
2019-08-24 06:15,18,11,7,0,0,0
2019-08-24 06:30,16,12,4,0,0,0
2019-08-24 06:45,13,7,6,0,0,0
2019-08-24 07:00,13,8,5,0,0,0
2019-08-24 07:15,22,13,9,0,0,0
2019-08-24 07:30,26,17,9,0,0,0
2019-08-24 07:45,43,25,18,0,0,0
2019-08-24 08:00,33,24,9,0,0,0
2019-08-24 08:15,47,30,17,0,0,0
2019-08-24 08:30,53,36,17,0,0,0
2019-08-24 08:45,73,50,23,0,0,0
2019-08-24 09:00,68,46,22,0,0,0
2019-08-24 09:15,89,53,36,0,0,0
2019-08-24 09:30,123,88,35,0,0,0
2019-08-24 09:45,135,89,46,0,0,0
2019-08-24 10:00,106,76,30,0,0,0
2019-08-24 10:15,135,101,34,0,0,0
2019-08-24 10:30,135,87,48,0,0,0
2019-08-24 10:45,172,126,46,0,0,0
2019-08-24 11:00,174,101,73,0,0,0
2019-08-24 11:15,132,76,56,0,0,0
2019-08-24 11:30,149,104,45,0,0,0
2019-08-24 11:45,166,90,76,0,0,0
2019-08-24 12:00,136,74,62,0,0,0
2019-08-24 12:15,185,115,70,0,0,0
2019-08-24 12:30,156,100,56,0,0,0
2019-08-24 12:45,172,91,81,0,0,0
2019-08-24 13:00,184,97,87,0,0,0
2019-08-24 13:15,143,90,53,0,0,0
2019-08-24 13:30,134,71,63,0,0,0
2019-08-24 13:45,148,74,74,0,0,0
2019-08-24 14:00,156,83,73,0,0,0
2019-08-24 14:15,143,75,68,0,0,0
2019-08-24 14:30,159,69,90,0,0,0
2019-08-24 14:45,146,74,72,0,0,0
2019-08-24 15:00,140,74,66,0,0,0
2019-08-24 15:15,158,69,89,0,0,0
2019-08-24 15:30,137,52,85,0,0,0
2019-08-24 15:45,130,61,69,0,0,0
2019-08-24 16:00,143,71,72,0,0,0
2019-08-24 16:15,165,63,102,0,0,0
2019-08-24 16:30,134,62,72,0,0,0
2019-08-24 16:45,136,61,75,0,0,0
2019-08-24 17:00,134,55,79,0,0,0
2019-08-24 17:15,132,52,80,0,0,0
2019-08-24 17:30,117,49,68,0,0,0
2019-08-24 17:45,161,88,73,0,0,0
2019-08-24 18:00,175,90,85,0,0,0
2019-08-24 18:15,169,82,87,0,0,0
2019-08-24 18:30,186,107,79,0,0,0
2019-08-24 18:45,160,85,75,0,0,0
2019-08-24 19:00,153,96,57,0,0,0
2019-08-24 19:15,153,87,66,0,0,0
2019-08-24 19:30,141,81,60,0,0,0
2019-08-24 19:45,187,111,76,0,0,0
2019-08-24 20:00,138,80,58,0,0,0
2019-08-24 20:15,132,81,51,0,0,0
2019-08-24 20:30,109,43,66,0,0,0
2019-08-24 20:45,118,63,55,0,0,0
2019-08-24 21:00,94,56,38,0,0,0
2019-08-24 21:15,90,36,54,0,0,0
2019-08-24 21:30,78,41,37,0,0,0
2019-08-24 21:45,91,38,53,0,0,0
2019-08-24 22:00,80,37,43,0,0,0
2019-08-24 22:15,62,30,32,0,0,0
2019-08-24 22:30,87,27,60,0,0,0
2019-08-24 22:45,83,34,49,0,0,0
2019-08-24 23:00,70,23,47,0,0,0
2019-08-24 23:15,88,26,62,0,0,0
2019-08-24 23:30,142,34,108,0,0,0
2019-08-24 23:45,47,21,26,0,0,0
2019-08-25 00:00,85,38,47,0,0,0
2019-08-25 00:15,50,14,36,0,0,0
2019-08-25 00:30,35,11,24,0,0,0
2019-08-25 00:45,45,12,33,0,0,0
2019-08-25 01:00,58,22,36,0,0,0
2019-08-25 01:15,48,22,26,0,0,0
2019-08-25 01:30,34,4,30,0,0,0
2019-08-25 01:45,25,5,20,0,0,0
2019-08-25 02:00,39,12,27,0,0,0
2019-08-25 02:15,43,7,36,0,0,0
2019-08-25 02:30,35,12,23,0,0,0
2019-08-25 02:45,36,9,27,0,0,0
2019-08-25 03:00,31,5,26,0,0,0
2019-08-25 03:15,24,6,18,0,0,0
2019-08-25 03:30,18,3,15,0,0,0
2019-08-25 03:45,22,6,16,0,0,0
2019-08-25 04:00,19,3,16,0,0,0
2019-08-25 04:15,10,1,9,0,0,0
2019-08-25 04:30,10,2,8,0,0,0
2019-08-25 04:45,15,2,13,0,0,0
2019-08-25 05:00,11,1,10,0,0,0
2019-08-25 05:15,4,4,0,0,0,0
2019-08-25 05:30,14,8,6,0,0,0
2019-08-25 05:45,13,5,8,0,0,0
2019-08-25 06:00,12,5,7,0,0,0
2019-08-25 06:15,7,5,2,0,0,0
2019-08-25 06:30,10,6,4,0,0,0
2019-08-25 06:45,10,4,6,0,0,0
2019-08-25 07:00,14,7,7,0,0,0
2019-08-25 07:15,14,11,3,0,0,0
2019-08-25 07:30,12,8,4,0,0,0
2019-08-25 07:45,16,6,10,0,0,0
2019-08-25 08:00,20,14,6,0,0,0
2019-08-25 08:15,19,9,10,0,0,0
2019-08-25 08:30,30,18,12,0,0,0
2019-08-25 08:45,41,19,22,0,0,0
2019-08-25 09:00,53,29,24,0,0,0
2019-08-25 09:15,42,26,16,0,0,0
2019-08-25 09:30,58,37,21,0,0,0
2019-08-25 09:45,73,44,29,0,0,0
2019-08-25 10:00,90,56,34,0,0,0
2019-08-25 10:15,59,41,18,0,0,0
2019-08-25 10:30,75,51,24,0,0,0
2019-08-25 10:45,85,39,46,0,0,0
2019-08-25 11:00,72,45,27,0,0,0
2019-08-25 11:15,77,37,40,0,0,0
2019-08-25 11:30,85,48,37,0,0,0
2019-08-25 11:45,80,46,34,0,0,0
2019-08-25 12:00,131,70,61,0,0,0
2019-08-25 12:15,90,45,45,0,0,0
2019-08-25 12:30,119,55,64,0,0,0
2019-08-25 12:45,85,47,38,0,0,0
2019-08-25 13:00,116,51,65,0,0,0
2019-08-25 13:15,104,67,37,0,0,0
2019-08-25 13:30,107,60,47,0,0,0
2019-08-25 13:45,95,53,42,0,0,0
2019-08-25 14:00,119,62,57,0,0,0
2019-08-25 14:15,88,47,41,0,0,0
2019-08-25 14:30,113,66,47,0,0,0
2019-08-25 14:45,141,77,64,0,0,0
2019-08-25 15:00,128,85,43,0,0,0
2019-08-25 15:15,91,58,33,0,0,0
2019-08-25 15:30,127,60,67,0,0,0
2019-08-25 15:45,144,81,63,0,0,0
2019-08-25 16:00,107,70,37,0,0,0
2019-08-25 16:15,106,66,40,0,0,0
2019-08-25 16:30,130,63,67,0,0,0
2019-08-25 16:45,125,63,62,0,0,0
2019-08-25 17:00,109,70,39,0,0,0
2019-08-25 17:15,120,81,39,0,0,0
2019-08-25 17:30,136,84,52,0,0,0
2019-08-25 17:45,150,86,64,0,0,0
2019-08-25 18:00,128,63,65,0,0,0
2019-08-25 18:15,112,68,44,0,0,0
2019-08-25 18:30,103,38,65,0,0,0
2019-08-25 18:45,127,60,67,0,0,0
2019-08-25 19:00,153,74,79,0,0,0
2019-08-25 19:15,118,63,55,0,0,0
2019-08-25 19:30,100,47,53,0,0,0
2019-08-25 19:45,131,75,56,0,0,0
2019-08-25 20:00,111,53,58,0,0,0
2019-08-25 20:15,93,45,48,0,0,0
2019-08-25 20:30,77,40,37,0,0,0
2019-08-25 20:45,63,33,30,0,0,0
2019-08-25 21:00,80,20,60,0,0,0
2019-08-25 21:15,68,23,45,0,0,0
2019-08-25 21:30,71,25,46,0,0,0
2019-08-25 21:45,38,14,24,0,0,0
2019-08-25 22:00,63,17,46,0,0,0
2019-08-25 22:15,55,19,36,0,0,0
2019-08-25 22:30,52,14,38,0,0,0
2019-08-25 22:45,99,18,81,0,0,0
2019-08-25 23:00,52,15,37,0,0,0
2019-08-25 23:15,38,11,27,0,0,0
2019-08-25 23:30,34,6,28,0,0,0
2019-08-25 23:45,21,2,19,0,0,0
2019-08-26 00:00,26,9,17,0,0,0
2019-08-26 00:15,25,8,17,0,0,0
2019-08-26 00:30,26,15,11,0,0,0
2019-08-26 00:45,5,2,3,0,0,0
2019-08-26 01:00,9,7,2,0,0,0
2019-08-26 01:15,14,0,14,0,0,0
2019-08-26 01:30,9,0,9,0,0,0
2019-08-26 01:45,3,0,3,0,0,0
2019-08-26 02:00,4,2,2,0,0,0
2019-08-26 02:15,7,1,6,0,0,0
2019-08-26 02:30,4,2,2,0,0,0
2019-08-26 02:45,8,4,4,0,0,0
2019-08-26 03:00,3,0,3,0,0,0
2019-08-26 03:15,2,0,2,0,0,0
2019-08-26 03:30,1,1,0,0,0,0
2019-08-26 03:45,4,3,1,0,0,0
2019-08-26 04:00,3,2,1,0,0,0
2019-08-26 04:15,4,3,1,0,0,0
2019-08-26 04:30,8,4,4,0,0,0
2019-08-26 04:45,12,9,3,0,0,0
2019-08-26 05:00,2,0,2,0,0,0
2019-08-26 05:15,12,10,2,0,0,0
2019-08-26 05:30,25,17,8,0,0,0
2019-08-26 05:45,29,19,10,0,0,0
2019-08-26 06:00,46,33,13,0,0,0
2019-08-26 06:15,57,40,17,0,0,0
2019-08-26 06:30,53,37,16,0,0,0
2019-08-26 06:45,116,86,30,0,0,0
2019-08-26 07:00,264,222,42,0,0,0
2019-08-26 07:15,139,86,53,0,0,0
2019-08-26 07:30,139,72,67,0,0,0
2019-08-26 07:45,240,138,102,0,0,0
2019-08-26 08:00,235,144,91,0,0,0
2019-08-26 08:15,206,119,87,0,0,0
2019-08-26 08:30,200,125,75,0,0,0
2019-08-26 08:45,257,149,108,0,0,0
2019-08-26 09:00,192,119,73,0,0,0
2019-08-26 09:15,125,77,48,0,0,0
2019-08-26 09:30,159,92,67,0,0,0
2019-08-26 09:45,144,92,52,0,0,0
2019-08-26 10:00,120,77,43,0,0,0
2019-08-26 10:15,157,98,59,0,0,0
2019-08-26 10:30,114,69,45,0,0,0
2019-08-26 10:45,138,76,62,0,0,0
2019-08-26 11:00,309,78,231,0,0,0
2019-08-26 11:15,178,77,101,0,0,0
2019-08-26 11:30,137,69,68,0,0,0
2019-08-26 11:45,156,84,72,0,0,0
2019-08-26 12:00,166,96,70,0,0,0
2019-08-26 12:15,132,66,66,0,0,0
2019-08-26 12:30,140,79,61,0,0,0
2019-08-26 12:45,158,90,68,0,0,0
2019-08-26 13:00,167,95,72,0,0,0
2019-08-26 13:15,179,84,95,0,0,0
2019-08-26 13:30,100,22,78,0,0,0
2019-08-26 13:45,101,27,74,0,0,0
2019-08-26 14:00,144,72,72,0,0,0
2019-08-26 14:15,158,91,67,0,0,0
2019-08-26 14:30,194,99,95,0,0,0
2019-08-26 14:45,199,111,88,0,0,0
2019-08-26 15:00,163,74,89,0,0,0
2019-08-26 15:15,179,69,110,0,0,0
2019-08-26 15:30,241,116,125,0,0,0
2019-08-26 15:45,245,101,144,0,0,0
2019-08-26 16:00,193,100,93,0,0,0
2019-08-26 16:15,251,130,121,0,0,0
2019-08-26 16:30,232,129,103,0,0,0
2019-08-26 16:45,238,118,120,0,0,0
2019-08-26 17:00,259,130,129,0,0,0
2019-08-26 17:15,267,126,141,0,0,0
2019-08-26 17:30,254,130,124,0,0,0
2019-08-26 17:45,282,141,141,0,0,0
2019-08-26 18:00,267,131,136,0,0,0
2019-08-26 18:15,236,116,120,0,0,0
2019-08-26 18:30,213,106,107,0,0,0
2019-08-26 18:45,266,137,129,0,0,0
2019-08-26 19:00,220,99,121,0,0,0
2019-08-26 19:15,226,122,104,0,0,0
2019-08-26 19:30,170,85,85,0,0,0
2019-08-26 19:45,183,90,93,0,0,0
2019-08-26 20:00,153,80,73,0,0,0
2019-08-26 20:15,134,56,78,0,0,0
2019-08-26 20:30,131,69,62,0,0,0
2019-08-26 20:45,117,58,59,0,0,0
2019-08-26 21:00,118,54,64,0,0,0
2019-08-26 21:15,102,44,58,0,0,0
2019-08-26 21:30,118,55,63,0,0,0
2019-08-26 21:45,68,22,46,0,0,0
2019-08-26 22:00,79,32,47,0,0,0
2019-08-26 22:15,78,39,39,0,0,0
2019-08-26 22:30,88,33,55,0,0,0
2019-08-26 22:45,82,25,57,0,0,0
2019-08-26 23:00,65,18,47,0,0,0
2019-08-26 23:15,84,17,67,0,0,0
2019-08-26 23:30,73,9,64,0,0,0
2019-08-26 23:45,37,11,26,0,0,0
2019-08-27 00:00,34,11,23,0,0,0
2019-08-27 00:15,27,8,19,0,0,0
2019-08-27 00:30,20,5,15,0,0,0
2019-08-27 00:45,17,7,10,0,0,0
2019-08-27 01:00,18,5,13,0,0,0
2019-08-27 01:15,9,4,5,0,0,0
2019-08-27 01:30,20,3,17,0,0,0
2019-08-27 01:45,16,3,13,0,0,0
2019-08-27 02:00,17,6,11,0,0,0
2019-08-27 02:15,8,4,4,0,0,0
2019-08-27 02:30,4,1,3,0,0,0
2019-08-27 02:45,3,2,1,0,0,0
2019-08-27 03:00,3,1,2,0,0,0
2019-08-27 03:15,2,2,0,0,0,0
2019-08-27 03:30,3,2,1,0,0,0
2019-08-27 03:45,6,4,2,0,0,0
2019-08-27 04:00,8,5,3,0,0,0
2019-08-27 04:15,4,2,2,0,0,0
2019-08-27 04:30,8,4,4,0,0,0
2019-08-27 04:45,9,5,4,0,0,0
2019-08-27 05:00,8,7,1,0,0,0
2019-08-27 05:15,11,6,5,0,0,0
2019-08-27 05:30,18,12,6,0,0,0
2019-08-27 05:45,23,15,8,0,0,0
2019-08-27 06:00,36,25,11,0,0,0
2019-08-27 06:15,47,33,14,0,0,0
2019-08-27 06:30,82,52,30,0,0,0
2019-08-27 06:45,113,66,47,0,0,0
2019-08-27 07:00,123,86,37,0,0,0
2019-08-27 07:15,111,73,38,0,0,0
2019-08-27 07:30,186,120,66,0,0,0
2019-08-27 07:45,291,175,116,0,0,0
2019-08-27 08:00,221,131,90,0,0,0
2019-08-27 08:15,219,132,87,0,0,0
2019-08-27 08:30,202,137,65,0,0,0
2019-08-27 08:45,274,149,125,0,0,0
2019-08-27 09:00,188,115,73,0,0,0
2019-08-27 09:15,166,103,63,0,0,0
2019-08-27 09:30,160,97,63,0,0,0
2019-08-27 09:45,177,110,67,0,0,0
2019-08-27 10:00,158,89,69,0,0,0
2019-08-27 10:15,145,82,63,0,0,0
2019-08-27 10:30,158,99,59,0,0,0
2019-08-27 10:45,151,90,61,0,0,0
2019-08-27 11:00,143,90,53,0,0,0
2019-08-27 11:15,138,59,79,0,0,0
2019-08-27 11:30,151,84,67,0,0,0
2019-08-27 11:45,150,98,52,0,0,0
2019-08-27 12:00,182,87,95,0,0,0
2019-08-27 12:15,163,99,64,0,0,0
2019-08-27 12:30,153,97,56,0,0,0
2019-08-27 12:45,211,125,86,0,0,0
2019-08-27 13:00,247,159,88,0,0,0
2019-08-27 13:15,244,151,93,0,0,0
2019-08-27 13:30,169,84,85,0,0,0
2019-08-27 13:45,180,93,87,0,0,0
2019-08-27 14:00,166,83,83,0,0,0
2019-08-27 14:15,172,101,71,0,0,0
2019-08-27 14:30,204,100,104,0,0,0
2019-08-27 14:45,239,126,113,0,0,0
2019-08-27 15:00,180,78,102,0,0,0
2019-08-27 15:15,167,82,85,0,0,0
2019-08-27 15:30,190,105,85,0,0,0
2019-08-27 15:45,186,104,82,0,0,0
2019-08-27 16:00,235,99,136,0,0,0
2019-08-27 16:15,276,149,127,0,0,0
2019-08-27 16:30,248,132,116,0,0,0
2019-08-27 16:45,278,136,142,0,0,0
2019-08-27 17:00,269,142,127,0,0,0
2019-08-27 17:15,344,154,190,0,0,0
2019-08-27 17:30,296,134,162,0,0,0
2019-08-27 17:45,269,109,160,0,0,0
2019-08-27 18:00,282,115,167,0,0,0
2019-08-27 18:15,238,108,130,0,0,0
2019-08-27 18:30,107,36,71,0,0,0
2019-08-27 18:45,118,65,53,0,0,0
2019-08-27 19:00,175,69,106,0,0,0
2019-08-27 19:15,206,107,99,0,0,0
2019-08-27 19:30,225,99,126,0,0,0
2019-08-27 19:45,213,111,102,0,0,0
2019-08-27 20:00,174,83,91,0,0,0
2019-08-27 20:15,133,55,78,0,0,0
2019-08-27 20:30,100,49,51,0,0,0
2019-08-27 20:45,78,35,43,0,0,0
2019-08-27 21:00,114,51,63,0,0,0
2019-08-27 21:15,78,35,43,0,0,0
2019-08-27 21:30,80,42,38,0,0,0
2019-08-27 21:45,67,24,43,0,0,0
2019-08-27 22:00,81,37,44,0,0,0
2019-08-27 22:15,109,51,58,0,0,0
2019-08-27 22:30,53,16,37,0,0,0
2019-08-27 22:45,61,15,46,0,0,0
2019-08-27 23:00,56,18,38,0,0,0
2019-08-27 23:15,53,24,29,0,0,0
2019-08-27 23:30,83,23,60,0,0,0
2019-08-27 23:45,36,8,28,0,0,0
2019-08-28 00:00,31,12,19,0,0,0
2019-08-28 00:15,31,11,20,0,0,0
2019-08-28 00:30,17,8,9,0,0,0
2019-08-28 00:45,11,7,4,0,0,0
2019-08-28 01:00,21,10,11,0,0,0
2019-08-28 01:15,7,2,5,0,0,0
2019-08-28 01:30,12,7,5,0,0,0
2019-08-28 01:45,13,2,11,0,0,0
2019-08-28 02:00,4,0,4,0,0,0
2019-08-28 02:15,4,2,2,0,0,0
2019-08-28 02:30,1,0,1,0,0,0
2019-08-28 02:45,4,1,3,0,0,0
2019-08-28 03:00,1,0,1,0,0,0
2019-08-28 03:15,3,1,2,0,0,0
2019-08-28 03:30,4,1,3,0,0,0
2019-08-28 03:45,7,6,1,0,0,0
2019-08-28 04:00,1,0,1,0,0,0
2019-08-28 04:15,4,3,1,0,0,0
2019-08-28 04:30,6,5,1,0,0,0
2019-08-28 04:45,8,4,4,0,0,0
2019-08-28 05:00,5,5,0,0,0,0
2019-08-28 05:15,12,6,6,0,0,0
2019-08-28 05:30,22,17,5,0,0,0
2019-08-28 05:45,28,18,10,0,0,0
2019-08-28 06:00,34,25,9,0,0,0
2019-08-28 06:15,51,39,12,0,0,0
2019-08-28 06:30,66,45,21,0,0,0
2019-08-28 06:45,127,97,30,0,0,0
2019-08-28 07:00,109,82,27,0,0,0
2019-08-28 07:15,210,141,69,0,0,0
2019-08-28 07:30,274,205,69,0,0,0
2019-08-28 07:45,303,206,97,0,0,0
2019-08-28 08:00,200,112,88,0,0,0
2019-08-28 08:15,220,148,72,0,0,0
2019-08-28 08:30,229,159,70,0,0,0
2019-08-28 08:45,275,154,121,0,0,0
2019-08-28 09:00,184,101,83,0,0,0
2019-08-28 09:15,144,82,62,0,0,0
2019-08-28 09:30,185,123,62,0,0,0
2019-08-28 09:45,216,155,61,0,0,0
2019-08-28 10:00,135,82,53,0,0,0
2019-08-28 10:15,142,91,51,0,0,0
2019-08-28 10:30,130,85,45,0,0,0
2019-08-28 10:45,174,102,72,0,0,0
2019-08-28 11:00,130,74,56,0,0,0
2019-08-28 11:15,149,83,66,0,0,0
2019-08-28 11:30,164,99,65,0,0,0
2019-08-28 11:45,209,129,80,0,0,0
2019-08-28 12:00,176,101,75,0,0,0
2019-08-28 12:15,176,101,75,0,0,0
2019-08-28 12:30,188,95,93,0,0,0
2019-08-28 12:45,198,121,77,0,0,0
2019-08-28 13:00,293,153,140,0,0,0
2019-08-28 13:15,336,170,166,0,0,0
2019-08-28 13:30,174,83,91,0,0,0
2019-08-28 13:45,213,116,97,0,0,0
2019-08-28 14:00,181,68,113,0,0,0
2019-08-28 14:15,160,77,83,0,0,0
2019-08-28 14:30,181,91,90,0,0,0
2019-08-28 14:45,250,131,119,0,0,0
2019-08-28 15:00,194,91,103,0,0,0
2019-08-28 15:15,213,110,103,0,0,0
2019-08-28 15:30,209,106,103,0,0,0
2019-08-28 15:45,212,109,103,0,0,0
2019-08-28 16:00,231,110,121,0,0,0
2019-08-28 16:15,254,129,125,0,0,0
2019-08-28 16:30,229,103,126,0,0,0
2019-08-28 16:45,269,134,135,0,0,0
2019-08-28 17:00,390,148,242,0,0,0
2019-08-28 17:15,253,110,143,0,0,0
2019-08-28 17:30,287,142,145,0,0,0
2019-08-28 17:45,289,138,151,0,0,0
2019-08-28 18:00,262,121,141,0,0,0
2019-08-28 18:15,265,130,135,0,0,0
2019-08-28 18:30,261,135,126,0,0,0
2019-08-28 18:45,263,138,125,0,0,0
2019-08-28 19:00,236,116,120,0,0,0
2019-08-28 19:15,239,138,101,0,0,0
2019-08-28 19:30,215,112,103,0,0,0
2019-08-28 19:45,246,134,112,0,0,0
2019-08-28 20:00,204,105,99,0,0,0
2019-08-28 20:15,173,91,82,0,0,0
2019-08-28 20:30,143,68,75,0,0,0
2019-08-28 20:45,109,49,60,0,0,0
2019-08-28 21:00,130,51,79,0,0,0
2019-08-28 21:15,102,46,56,0,0,0
2019-08-28 21:30,98,41,57,0,0,0
2019-08-28 21:45,100,48,52,0,0,0
2019-08-28 22:00,90,31,59,0,0,0
2019-08-28 22:15,116,49,67,0,0,0
2019-08-28 22:30,119,63,56,0,0,0
2019-08-28 22:45,87,37,50,0,0,0
2019-08-28 23:00,110,41,69,0,0,0
2019-08-28 23:15,79,33,46,0,0,0
2019-08-28 23:30,161,35,126,0,0,0
2019-08-28 23:45,53,15,38,0,0,0
2019-08-29 00:00,53,14,39,0,0,0
2019-08-29 00:15,53,22,31,0,0,0
2019-08-29 00:30,35,9,26,0,0,0
2019-08-29 00:45,27,6,21,0,0,0
2019-08-29 01:00,31,5,26,0,0,0
2019-08-29 01:15,32,14,18,0,0,0
2019-08-29 01:30,26,3,23,0,0,0
2019-08-29 01:45,40,9,31,0,0,0
2019-08-29 02:00,15,1,14,0,0,0
2019-08-29 02:15,14,2,12,0,0,0
2019-08-29 02:30,17,1,16,0,0,0
2019-08-29 02:45,9,2,7,0,0,0
2019-08-29 03:00,19,3,16,0,0,0
2019-08-29 03:15,16,5,11,0,0,0
2019-08-29 03:30,13,4,9,0,0,0
2019-08-29 03:45,12,2,10,0,0,0
2019-08-29 04:00,7,4,3,0,0,0
2019-08-29 04:15,4,1,3,0,0,0
2019-08-29 04:30,7,6,1,0,0,0
2019-08-29 04:45,17,7,10,0,0,0
2019-08-29 05:00,6,0,6,0,0,0
2019-08-29 05:15,5,5,0,0,0,0
2019-08-29 05:30,8,5,3,0,0,0
2019-08-29 05:45,15,9,6,0,0,0
2019-08-29 06:00,27,18,9,0,0,0
2019-08-29 06:15,19,16,3,0,0,0
2019-08-29 06:30,44,33,11,0,0,0
2019-08-29 06:45,69,47,22,0,0,0
2019-08-29 07:00,90,66,24,0,0,0
2019-08-29 07:15,107,73,34,0,0,0
2019-08-29 07:30,232,178,54,0,0,0
2019-08-29 07:45,235,155,80,0,0,0
2019-08-29 08:00,187,117,70,0,0,0
2019-08-29 08:15,160,94,66,0,0,0
2019-08-29 08:30,193,133,60,0,0,0
2019-08-29 08:45,215,128,87,0,0,0
2019-08-29 09:00,179,107,72,0,0,0
2019-08-29 09:15,145,101,44,0,0,0
2019-08-29 09:30,156,105,51,0,0,0
2019-08-29 09:45,158,100,58,0,0,0
2019-08-29 10:00,128,72,56,0,0,0
2019-08-29 10:15,94,59,35,0,0,0
2019-08-29 10:30,105,73,32,0,0,0
2019-08-29 10:45,134,90,44,0,0,0
2019-08-29 11:00,190,86,104,0,0,0
2019-08-29 11:15,122,76,46,0,0,0
2019-08-29 11:30,122,71,51,0,0,0
2019-08-29 11:45,166,100,66,0,0,0
2019-08-29 12:00,144,82,62,0,0,0
2019-08-29 12:15,153,84,69,0,0,0
2019-08-29 12:30,170,88,82,0,0,0
2019-08-29 12:45,185,108,77,0,0,0
2019-08-29 13:00,197,78,119,0,0,0
2019-08-29 13:15,170,77,93,0,0,0
2019-08-29 13:30,164,89,75,0,0,0
2019-08-29 13:45,206,99,107,0,0,0
2019-08-29 14:00,167,66,101,0,0,0
2019-08-29 14:15,158,76,82,0,0,0
2019-08-29 14:30,170,94,76,0,0,0
2019-08-29 14:45,166,76,90,0,0,0
2019-08-29 15:00,166,90,76,0,0,0
2019-08-29 15:15,154,74,80,0,0,0
2019-08-29 15:30,215,100,115,0,0,0
2019-08-29 15:45,198,114,84,0,0,0
2019-08-29 16:00,229,114,115,0,0,0
2019-08-29 16:15,222,119,103,0,0,0
2019-08-29 16:30,205,103,102,0,0,0
2019-08-29 16:45,244,124,120,0,0,0
2019-08-29 17:00,233,117,116,0,0,0
2019-08-29 17:15,245,130,115,0,0,0
2019-08-29 17:30,258,128,130,0,0,0
2019-08-29 17:45,255,117,138,0,0,0
2019-08-29 18:00,259,123,136,0,0,0
2019-08-29 18:15,270,113,157,0,0,0
2019-08-29 18:30,219,84,135,0,0,0
2019-08-29 18:45,219,112,107,0,0,0
2019-08-29 19:00,224,122,102,0,0,0
2019-08-29 19:15,215,104,111,0,0,0
2019-08-29 19:30,173,90,83,0,0,0
2019-08-29 19:45,189,88,101,0,0,0
2019-08-29 20:00,168,85,83,0,0,0
2019-08-29 20:15,158,69,89,0,0,0
2019-08-29 20:30,130,62,68,0,0,0
2019-08-29 20:45,123,52,71,0,0,0
2019-08-29 21:00,102,52,50,0,0,0
2019-08-29 21:15,104,52,52,0,0,0
2019-08-29 21:30,77,29,48,0,0,0
2019-08-29 21:45,88,34,54,0,0,0
2019-08-29 22:00,109,39,70,0,0,0
2019-08-29 22:15,115,54,61,0,0,0
2019-08-29 22:30,72,27,45,0,0,0
2019-08-29 22:45,58,22,36,0,0,0
2019-08-29 23:00,105,28,77,0,0,0
2019-08-29 23:15,72,29,43,0,0,0
2019-08-29 23:30,56,17,39,0,0,0
2019-08-29 23:45,33,10,23,0,0,0
2019-08-30 00:00,40,14,26,0,0,0
2019-08-30 00:15,27,8,19,0,0,0
2019-08-30 00:30,26,8,18,0,0,0
2019-08-30 00:45,16,4,12,0,0,0
2019-08-30 01:00,21,6,15,0,0,0
2019-08-30 01:15,18,6,12,0,0,0
2019-08-30 01:30,16,0,16,0,0,0
2019-08-30 01:45,12,5,7,0,0,0
2019-08-30 02:00,13,1,12,0,0,0
2019-08-30 02:15,11,2,9,0,0,0
2019-08-30 02:30,5,1,4,0,0,0
2019-08-30 02:45,0,0,0,0,0,0
2019-08-30 03:00,3,2,1,0,0,0
2019-08-30 03:15,1,0,1,0,0,0
2019-08-30 03:30,4,1,3,0,0,0
2019-08-30 03:45,3,2,1,0,0,0
2019-08-30 04:00,6,4,2,0,0,0
2019-08-30 04:15,3,1,2,0,0,0
2019-08-30 04:30,8,7,1,0,0,0
2019-08-30 04:45,9,4,5,0,0,0
2019-08-30 05:00,13,10,3,0,0,0
2019-08-30 05:15,13,7,6,0,0,0
2019-08-30 05:30,20,13,7,0,0,0
2019-08-30 05:45,24,13,11,0,0,0
2019-08-30 06:00,36,27,9,0,0,0
2019-08-30 06:15,45,29,16,0,0,0
2019-08-30 06:30,57,42,15,0,0,0
2019-08-30 06:45,111,79,32,0,0,0
2019-08-30 07:00,163,128,35,0,0,0
2019-08-30 07:15,208,160,48,0,0,0
2019-08-30 07:30,261,189,72,0,0,0
2019-08-30 07:45,258,140,118,0,0,0
2019-08-30 08:00,195,108,87,0,0,0
2019-08-30 08:15,178,103,75,0,0,0
2019-08-30 08:30,180,117,63,0,0,0
2019-08-30 08:45,219,148,71,0,0,0
2019-08-30 09:00,161,107,54,0,0,0
2019-08-30 09:15,160,86,74,0,0,0
2019-08-30 09:30,129,82,47,0,0,0
2019-08-30 09:45,191,119,72,0,0,0
2019-08-30 10:00,153,108,45,0,0,0
2019-08-30 10:15,151,90,61,0,0,0
2019-08-30 10:30,118,67,51,0,0,0
2019-08-30 10:45,132,81,51,0,0,0
2019-08-30 11:00,128,79,49,0,0,0
2019-08-30 11:15,149,79,70,0,0,0
2019-08-30 11:30,144,78,66,0,0,0
2019-08-30 11:45,152,93,59,0,0,0
2019-08-30 12:00,164,87,77,0,0,0
2019-08-30 12:15,174,82,92,0,0,0
2019-08-30 12:30,210,97,113,0,0,0
2019-08-30 12:45,274,95,179,0,0,0
2019-08-30 13:00,265,101,164,0,0,0
2019-08-30 13:15,233,99,134,0,0,0
2019-08-30 13:30,191,100,91,0,0,0
2019-08-30 13:45,218,120,98,0,0,0
2019-08-30 14:00,210,90,120,0,0,0
2019-08-30 14:15,193,103,90,0,0,0
2019-08-30 14:30,191,88,103,0,0,0
2019-08-30 14:45,208,100,108,0,0,0
2019-08-30 15:00,211,94,117,0,0,0
2019-08-30 15:15,181,81,100,0,0,0
2019-08-30 15:30,216,97,119,0,0,0
2019-08-30 15:45,230,119,111,0,0,0
2019-08-30 16:00,209,103,106,0,0,0
2019-08-30 16:15,206,100,106,0,0,0
2019-08-30 16:30,187,89,98,0,0,0
2019-08-30 16:45,238,117,121,0,0,0
2019-08-30 17:00,217,116,101,0,0,0
2019-08-30 17:15,204,96,108,0,0,0
2019-08-30 17:30,219,108,111,0,0,0
2019-08-30 17:45,248,124,124,0,0,0
2019-08-30 18:00,230,105,125,0,0,0
2019-08-30 18:15,245,161,84,0,0,0
2019-08-30 18:30,246,143,103,0,0,0
2019-08-30 18:45,230,119,111,0,0,0
2019-08-30 19:00,232,124,108,0,0,0
2019-08-30 19:15,186,101,85,0,0,0
2019-08-30 19:30,194,116,78,0,0,0
2019-08-30 19:45,219,139,80,0,0,0
2019-08-30 20:00,184,103,81,0,0,0
2019-08-30 20:15,151,68,83,0,0,0
2019-08-30 20:30,127,61,66,0,0,0
2019-08-30 20:45,129,68,61,0,0,0
2019-08-30 21:00,128,56,72,0,0,0
2019-08-30 21:15,90,36,54,0,0,0
2019-08-30 21:30,110,42,68,0,0,0
2019-08-30 21:45,89,36,53,0,0,0
2019-08-30 22:00,72,35,37,0,0,0
2019-08-30 22:15,73,41,32,0,0,0
2019-08-30 22:30,82,33,49,0,0,0
2019-08-30 22:45,100,40,60,0,0,0
2019-08-30 23:00,73,23,50,0,0,0
2019-08-30 23:15,81,26,55,0,0,0
2019-08-30 23:30,69,21,48,0,0,0
2019-08-30 23:45,87,53,34,0,0,0
2019-08-31 00:00,68,35,33,0,0,0
2019-08-31 00:15,82,36,46,0,0,0
2019-08-31 00:30,223,52,171,0,0,0
2019-08-31 00:45,63,16,47,0,0,0
2019-08-31 01:00,71,29,42,0,0,0
2019-08-31 01:15,71,25,46,0,0,0
2019-08-31 01:30,33,10,23,0,0,0
2019-08-31 01:45,45,16,29,0,0,0
2019-08-31 02:00,36,16,20,0,0,0
2019-08-31 02:15,42,6,36,0,0,0
2019-08-31 02:30,35,2,33,0,0,0
2019-08-31 02:45,29,5,24,0,0,0
2019-08-31 03:00,31,8,23,0,0,0
2019-08-31 03:15,25,5,20,0,0,0
2019-08-31 03:30,18,4,14,0,0,0
2019-08-31 03:45,16,2,14,0,0,0
2019-08-31 04:00,28,6,22,0,0,0
2019-08-31 04:15,18,4,14,0,0,0
2019-08-31 04:30,8,2,6,0,0,0
2019-08-31 04:45,10,2,8,0,0,0
2019-08-31 05:00,13,3,10,0,0,0
2019-08-31 05:15,9,2,7,0,0,0
2019-08-31 05:30,18,7,11,0,0,0
2019-08-31 05:45,13,10,3,0,0,0
2019-08-31 06:00,14,4,10,0,0,0
2019-08-31 06:15,16,6,10,0,0,0
2019-08-31 06:30,13,6,7,0,0,0
2019-08-31 06:45,22,13,9,0,0,0
2019-08-31 07:00,13,10,3,0,0,0
2019-08-31 07:15,13,11,2,0,0,0
2019-08-31 07:30,20,16,4,0,0,0
2019-08-31 07:45,47,38,9,0,0,0
2019-08-31 08:00,31,24,7,0,0,0
2019-08-31 08:15,45,33,12,0,0,0
2019-08-31 08:30,60,42,18,0,0,0
2019-08-31 08:45,94,67,27,0,0,0
2019-08-31 09:00,58,41,17,0,0,0
2019-08-31 09:15,103,64,39,0,0,0
2019-08-31 09:30,104,67,37,0,0,0
2019-08-31 09:45,135,98,37,0,0,0
2019-08-31 10:00,114,87,27,0,0,0
2019-08-31 10:15,120,91,29,0,0,0
2019-08-31 10:30,133,90,43,0,0,0
2019-08-31 10:45,173,111,62,0,0,0
2019-08-31 11:00,159,101,58,0,0,0
2019-08-31 11:15,163,113,50,0,0,0
2019-08-31 11:30,163,93,70,0,0,0
2019-08-31 11:45,171,99,72,0,0,0
2019-08-31 12:00,135,72,63,0,0,0
2019-08-31 12:15,173,108,65,0,0,0
2019-08-31 12:30,175,104,71,0,0,0
2019-08-31 12:45,185,108,77,0,0,0
2019-08-31 13:00,158,96,62,0,0,0
2019-08-31 13:15,167,95,72,0,0,0
2019-08-31 13:30,161,89,72,0,0,0
2019-08-31 13:45,140,82,58,0,0,0
2019-08-31 14:00,162,89,73,0,0,0
2019-08-31 14:15,184,101,83,0,0,0
2019-08-31 14:30,174,89,85,0,0,0
2019-08-31 14:45,171,98,73,0,0,0
2019-08-31 15:00,170,84,86,0,0,0
2019-08-31 15:15,110,63,47,0,0,0
2019-08-31 15:30,156,89,67,0,0,0
2019-08-31 15:45,157,76,81,0,0,0
2019-08-31 16:00,139,59,80,0,0,0
2019-08-31 16:15,131,74,57,0,0,0
2019-08-31 16:30,129,62,67,0,0,0
2019-08-31 16:45,143,80,63,0,0,0
2019-08-31 17:00,133,63,70,0,0,0
2019-08-31 17:15,153,83,70,0,0,0
2019-08-31 17:30,138,71,67,0,0,0
2019-08-31 17:45,173,91,82,0,0,0
2019-08-31 18:00,169,68,101,0,0,0
2019-08-31 18:15,192,95,97,0,0,0
2019-08-31 18:30,160,81,79,0,0,0
2019-08-31 18:45,148,76,72,0,0,0
2019-08-31 19:00,124,69,55,0,0,0
2019-08-31 19:15,158,81,77,0,0,0
2019-08-31 19:30,118,67,51,0,0,0
2019-08-31 19:45,133,86,47,0,0,0
2019-08-31 20:00,143,73,70,0,0,0
2019-08-31 20:15,138,63,75,0,0,0
2019-08-31 20:30,115,56,59,0,0,0
2019-08-31 20:45,121,66,55,0,0,0
2019-08-31 21:00,102,50,52,0,0,0
2019-08-31 21:15,107,45,62,0,0,0
2019-08-31 21:30,77,26,51,0,0,0
2019-08-31 21:45,87,40,47,0,0,0
2019-08-31 22:00,78,32,46,0,0,0
2019-08-31 22:15,85,21,64,0,0,0
2019-08-31 22:30,51,11,40,0,0,0
2019-08-31 22:45,27,8,19,0,0,0
2019-08-31 23:00,50,22,28,0,0,0
2019-08-31 23:15,65,23,42,0,0,0
2019-08-31 23:30,74,40,34,0,0,0
2019-08-31 23:45,53,26,27,0,0,0
