Datetime,100035541 (Neutor),101035541 (Neutor stadteinwÃ¤rts),102035541 (Neutor stadtauswÃ¤rts),100035541-status,101035541-status,102035541-status
2019-10-01 00:00,84,20,64,0,0,0
2019-10-01 00:15,67,13,54,0,0,0
2019-10-01 00:30,54,6,48,0,0,0
2019-10-01 00:45,46,9,37,0,0,0
2019-10-01 01:00,50,12,38,0,0,0
2019-10-01 01:15,54,1,53,0,0,0
2019-10-01 01:30,31,6,25,0,0,0
2019-10-01 01:45,36,5,31,0,0,0
2019-10-01 02:00,45,2,43,0,0,0
2019-10-01 02:15,22,4,18,0,0,0
2019-10-01 02:30,18,4,14,0,0,0
2019-10-01 02:45,10,1,9,0,0,0
2019-10-01 03:00,7,3,4,0,0,0
2019-10-01 03:15,9,5,4,0,0,0
2019-10-01 03:30,14,4,10,0,0,0
2019-10-01 03:45,1,1,0,0,0,0
2019-10-01 04:00,2,0,2,0,0,0
2019-10-01 04:15,1,1,0,0,0,0
2019-10-01 04:30,6,4,2,0,0,0
2019-10-01 04:45,10,8,2,0,0,0
2019-10-01 05:00,5,2,3,0,0,0
2019-10-01 05:15,8,5,3,0,0,0
2019-10-01 05:30,13,8,5,0,0,0
2019-10-01 05:45,15,11,4,0,0,0
2019-10-01 06:00,22,16,6,0,0,0
2019-10-01 06:15,29,23,6,0,0,0
2019-10-01 06:30,52,30,22,0,0,0
2019-10-01 06:45,57,38,19,0,0,0
2019-10-01 07:00,74,45,29,0,0,0
2019-10-01 07:15,149,110,39,0,0,0
2019-10-01 07:30,231,184,47,0,0,0
2019-10-01 07:45,346,227,119,0,0,0
2019-10-01 08:00,205,121,84,0,0,0
2019-10-01 08:15,200,120,80,0,0,0
2019-10-01 08:30,209,118,91,0,0,0
2019-10-01 08:45,216,111,105,0,0,0
2019-10-01 09:00,117,68,49,0,0,0
2019-10-01 09:15,139,72,67,0,0,0
2019-10-01 09:30,149,73,76,0,0,0
2019-10-01 09:45,214,104,110,0,0,0
2019-10-01 10:00,105,45,60,0,0,0
2019-10-01 10:15,99,49,50,0,0,0
2019-10-01 10:30,93,38,55,0,0,0
2019-10-01 10:45,125,61,64,0,0,0
2019-10-01 11:00,99,62,37,0,0,0
2019-10-01 11:15,83,47,36,0,0,0
2019-10-01 11:30,100,48,52,0,0,0
2019-10-01 11:45,136,86,50,0,0,0
2019-10-01 12:00,122,74,48,0,0,0
2019-10-01 12:15,132,51,81,0,0,0
2019-10-01 12:30,149,74,75,0,0,0
2019-10-01 12:45,195,110,85,0,0,0
2019-10-01 13:00,207,103,104,0,0,0
2019-10-01 13:15,214,88,126,0,0,0
2019-10-01 13:30,174,88,86,0,0,0
2019-10-01 13:45,189,109,80,0,0,0
2019-10-01 14:00,178,86,92,0,0,0
2019-10-01 14:15,169,99,70,0,0,0
2019-10-01 14:30,153,72,81,0,0,0
2019-10-01 14:45,223,108,115,0,0,0
2019-10-01 15:00,187,88,99,0,0,0
2019-10-01 15:15,169,74,95,0,0,0
2019-10-01 15:30,213,123,90,0,0,0
2019-10-01 15:45,261,133,128,0,0,0
2019-10-01 16:00,250,116,134,0,0,0
2019-10-01 16:15,276,122,154,0,0,0
2019-10-01 16:30,230,112,118,0,0,0
2019-10-01 16:45,241,118,123,0,0,0
2019-10-01 17:00,241,117,124,0,0,0
2019-10-01 17:15,287,147,140,0,0,0
2019-10-01 17:30,285,140,145,0,0,0
2019-10-01 17:45,322,137,185,0,0,0
2019-10-01 18:00,261,112,149,0,0,0
2019-10-01 18:15,236,99,137,0,0,0
2019-10-01 18:30,235,118,117,0,0,0
2019-10-01 18:45,273,145,128,0,0,0
2019-10-01 19:00,222,122,100,0,0,0
2019-10-01 19:15,250,123,127,0,0,0
2019-10-01 19:30,233,124,109,0,0,0
2019-10-01 19:45,219,128,91,0,0,0
2019-10-01 20:00,210,115,95,0,0,0
2019-10-01 20:15,244,139,105,0,0,0
2019-10-01 20:30,179,97,82,0,0,0
2019-10-01 20:45,158,77,81,0,0,0
2019-10-01 21:00,175,90,85,0,0,0
2019-10-01 21:15,155,84,71,0,0,0
2019-10-01 21:30,94,37,57,0,0,0
2019-10-01 21:45,104,51,53,0,0,0
2019-10-01 22:00,132,35,97,0,0,0
2019-10-01 22:15,168,47,121,0,0,0
2019-10-01 22:30,154,19,135,0,0,0
2019-10-01 22:45,212,23,189,0,0,0
2019-10-01 23:00,150,38,112,0,0,0
2019-10-01 23:15,139,34,105,0,0,0
2019-10-01 23:30,149,19,130,0,0,0
2019-10-01 23:45,99,30,69,0,0,0
2019-10-02 00:00,102,29,73,0,0,0
2019-10-02 00:15,60,21,39,0,0,0
2019-10-02 00:30,56,15,41,0,0,0
2019-10-02 00:45,87,37,50,0,0,0
2019-10-02 01:00,75,17,58,0,0,0
2019-10-02 01:15,62,14,48,0,0,0
2019-10-02 01:30,68,26,42,0,0,0
2019-10-02 01:45,66,34,32,0,0,0
2019-10-02 02:00,72,39,33,0,0,0
2019-10-02 02:15,70,39,31,0,0,0
2019-10-02 02:30,51,17,34,0,0,0
2019-10-02 02:45,66,33,33,0,0,0
2019-10-02 03:00,40,20,20,0,0,0
2019-10-02 03:15,50,26,24,0,0,0
2019-10-02 03:30,30,15,15,0,0,0
2019-10-02 03:45,39,18,21,0,0,0
2019-10-02 04:00,21,8,13,0,0,0
2019-10-02 04:15,20,7,13,0,0,0
2019-10-02 04:30,25,13,12,0,0,0
2019-10-02 04:45,17,11,6,0,0,0
2019-10-02 05:00,15,9,6,0,0,0
2019-10-02 05:15,9,5,4,0,0,0
2019-10-02 05:30,15,9,6,0,0,0
2019-10-02 05:45,27,15,12,0,0,0
2019-10-02 06:00,32,23,9,0,0,0
2019-10-02 06:15,33,23,10,0,0,0
2019-10-02 06:30,56,29,27,0,0,0
2019-10-02 06:45,89,59,30,0,0,0
2019-10-02 07:00,75,42,33,0,0,0
2019-10-02 07:15,153,112,41,0,0,0
2019-10-02 07:30,258,205,53,0,0,0
2019-10-02 07:45,293,178,115,0,0,0
2019-10-02 08:00,199,113,86,0,0,0
2019-10-02 08:15,224,131,93,0,0,0
2019-10-02 08:30,209,119,90,0,0,0
2019-10-02 08:45,286,144,142,0,0,0
2019-10-02 09:00,179,102,77,0,0,0
2019-10-02 09:15,173,98,75,0,0,0
2019-10-02 09:30,226,104,122,0,0,0
2019-10-02 09:45,417,161,256,0,0,0
2019-10-02 10:00,213,105,108,0,0,0
2019-10-02 10:15,179,116,63,0,0,0
2019-10-02 10:30,188,112,76,0,0,0
2019-10-02 10:45,249,156,93,0,0,0
2019-10-02 11:00,200,91,109,0,0,0
2019-10-02 11:15,194,102,92,0,0,0
2019-10-02 11:30,259,130,129,0,0,0
2019-10-02 11:45,349,172,177,0,0,0
2019-10-02 12:00,263,149,114,0,0,0
2019-10-02 12:15,292,195,97,0,0,0
2019-10-02 12:30,267,150,117,0,0,0
2019-10-02 12:45,322,162,160,0,0,0
2019-10-02 13:00,267,131,136,0,0,0
2019-10-02 13:15,254,125,129,0,0,0
2019-10-02 13:30,288,150,138,0,0,0
2019-10-02 13:45,398,162,236,0,0,0
2019-10-02 14:00,276,132,144,0,0,0
2019-10-02 14:15,252,120,132,0,0,0
2019-10-02 14:30,229,130,99,0,0,0
2019-10-02 14:45,300,133,167,0,0,0
2019-10-02 15:00,262,131,131,0,0,0
2019-10-02 15:15,261,133,128,0,0,0
2019-10-02 15:30,285,126,159,0,0,0
2019-10-02 15:45,322,168,154,0,0,0
2019-10-02 16:00,289,153,136,0,0,0
2019-10-02 16:15,353,185,168,0,0,0
2019-10-02 16:30,329,176,153,0,0,0
2019-10-02 16:45,302,156,146,0,0,0
2019-10-02 17:00,263,135,128,0,0,0
2019-10-02 17:15,287,143,144,0,0,0
2019-10-02 17:30,291,138,153,0,0,0
2019-10-02 17:45,366,214,152,0,0,0
2019-10-02 18:00,331,175,156,0,0,0
2019-10-02 18:15,293,143,150,0,0,0
2019-10-02 18:30,252,118,134,0,0,0
2019-10-02 18:45,326,155,171,0,0,0
2019-10-02 19:00,265,136,129,0,0,0
2019-10-02 19:15,235,127,108,0,0,0
2019-10-02 19:30,206,97,109,0,0,0
2019-10-02 19:45,253,134,119,0,0,0
2019-10-02 20:00,208,108,100,0,0,0
2019-10-02 20:15,207,127,80,0,0,0
2019-10-02 20:30,187,116,71,0,0,0
2019-10-02 20:45,184,123,61,0,0,0
2019-10-02 21:00,211,123,88,0,0,0
2019-10-02 21:15,126,62,64,0,0,0
2019-10-02 21:30,131,68,63,0,0,0
2019-10-02 21:45,127,48,79,0,0,0
2019-10-02 22:00,84,40,44,0,0,0
2019-10-02 22:15,89,60,29,0,0,0
2019-10-02 22:30,128,73,55,0,0,0
2019-10-02 22:45,101,53,48,0,0,0
2019-10-02 23:00,106,41,65,0,0,0
2019-10-02 23:15,120,66,54,0,0,0
2019-10-02 23:30,104,42,62,0,0,0
2019-10-02 23:45,135,77,58,0,0,0
2019-10-03 00:00,101,46,55,0,0,0
2019-10-03 00:15,143,96,47,0,0,0
2019-10-03 00:30,109,55,54,0,0,0
2019-10-03 00:45,109,55,54,0,0,0
2019-10-03 01:00,99,45,54,0,0,0
2019-10-03 01:15,91,34,57,0,0,0
2019-10-03 01:30,103,26,77,0,0,0
2019-10-03 01:45,65,17,48,0,0,0
2019-10-03 02:00,97,23,74,0,0,0
2019-10-03 02:15,73,17,56,0,0,0
2019-10-03 02:30,60,15,45,0,0,0
2019-10-03 02:45,69,20,49,0,0,0
2019-10-03 03:00,72,11,61,0,0,0
2019-10-03 03:15,53,10,43,0,0,0
2019-10-03 03:30,74,7,67,0,0,0
2019-10-03 03:45,54,1,53,0,0,0
2019-10-03 04:00,46,9,37,0,0,0
2019-10-03 04:15,30,8,22,0,0,0
2019-10-03 04:30,35,5,30,0,0,0
2019-10-03 04:45,20,5,15,0,0,0
2019-10-03 05:00,20,5,15,0,0,0
2019-10-03 05:15,25,8,17,0,0,0
2019-10-03 05:30,33,13,20,0,0,0
2019-10-03 05:45,24,5,19,0,0,0
2019-10-03 06:00,9,2,7,0,0,0
2019-10-03 06:15,11,4,7,0,0,0
2019-10-03 06:30,21,16,5,0,0,0
2019-10-03 06:45,34,27,7,0,0,0
2019-10-03 07:00,35,27,8,0,0,0
2019-10-03 07:15,42,28,14,0,0,0
2019-10-03 07:30,54,32,22,0,0,0
2019-10-03 07:45,56,45,11,0,0,0
2019-10-03 08:00,56,38,18,0,0,0
2019-10-03 08:15,75,52,23,0,0,0
2019-10-03 08:30,80,46,34,0,0,0
2019-10-03 08:45,124,93,31,0,0,0
2019-10-03 09:00,46,25,21,0,0,0
2019-10-03 09:15,35,25,10,0,0,0
2019-10-03 09:30,52,33,19,0,0,0
2019-10-03 09:45,95,62,33,0,0,0
2019-10-03 10:00,81,57,24,0,0,0
2019-10-03 10:15,109,71,38,0,0,0
2019-10-03 10:30,92,61,31,0,0,0
2019-10-03 10:45,154,93,61,0,0,0
2019-10-03 11:00,161,107,54,0,0,0
2019-10-03 11:15,225,138,87,0,0,0
2019-10-03 11:30,223,175,48,0,0,0
2019-10-03 11:45,224,164,60,0,0,0
2019-10-03 12:00,228,168,60,0,0,0
2019-10-03 12:15,221,154,67,0,0,0
2019-10-03 12:30,237,152,85,0,0,0
2019-10-03 12:45,240,138,102,0,0,0
2019-10-03 13:00,225,159,66,0,0,0
2019-10-03 13:15,219,145,74,0,0,0
2019-10-03 13:30,233,158,75,0,0,0
2019-10-03 13:45,275,187,88,0,0,0
2019-10-03 14:00,232,134,98,0,0,0
2019-10-03 14:15,206,137,69,0,0,0
2019-10-03 14:30,174,110,64,0,0,0
2019-10-03 14:45,189,125,64,0,0,0
2019-10-03 15:00,195,137,58,0,0,0
2019-10-03 15:15,179,109,70,0,0,0
2019-10-03 15:30,174,111,63,0,0,0
2019-10-03 15:45,264,196,68,0,0,0
2019-10-03 16:00,156,95,61,0,0,0
2019-10-03 16:15,94,69,25,0,0,0
2019-10-03 16:30,174,94,80,0,0,0
2019-10-03 16:45,204,90,114,0,0,0
2019-10-03 17:00,186,82,104,0,0,0
2019-10-03 17:15,130,41,89,0,0,0
2019-10-03 17:30,131,52,79,0,0,0
2019-10-03 17:45,178,65,113,0,0,0
2019-10-03 18:00,149,65,84,0,0,0
2019-10-03 18:15,143,80,63,0,0,0
2019-10-03 18:30,162,83,79,0,0,0
2019-10-03 18:45,172,92,80,0,0,0
2019-10-03 19:00,139,55,84,0,0,0
2019-10-03 19:15,137,80,57,0,0,0
2019-10-03 19:30,118,54,64,0,0,0
2019-10-03 19:45,139,74,65,0,0,0
2019-10-03 20:00,118,56,62,0,0,0
2019-10-03 20:15,121,52,69,0,0,0
2019-10-03 20:30,93,46,47,0,0,0
2019-10-03 20:45,109,55,54,0,0,0
2019-10-03 21:00,85,40,45,0,0,0
2019-10-03 21:15,108,36,72,0,0,0
2019-10-03 21:30,60,22,38,0,0,0
2019-10-03 21:45,60,35,25,0,0,0
2019-10-03 22:00,76,31,45,0,0,0
2019-10-03 22:15,70,23,47,0,0,0
2019-10-03 22:30,78,35,43,0,0,0
2019-10-03 22:45,69,25,44,0,0,0
2019-10-03 23:00,89,43,46,0,0,0
2019-10-03 23:15,71,35,36,0,0,0
2019-10-03 23:30,75,43,32,0,0,0
2019-10-03 23:45,61,35,26,0,0,0
2019-10-04 00:00,80,50,30,0,0,0
2019-10-04 00:15,69,27,42,0,0,0
2019-10-04 00:30,62,38,24,0,0,0
2019-10-04 00:45,47,32,15,0,0,0
2019-10-04 01:00,27,4,23,0,0,0
2019-10-04 01:15,25,9,16,0,0,0
2019-10-04 01:30,28,3,25,0,0,0
2019-10-04 01:45,31,8,23,0,0,0
2019-10-04 02:00,40,5,35,0,0,0
2019-10-04 02:15,55,4,51,0,0,0
2019-10-04 02:30,35,4,31,0,0,0
2019-10-04 02:45,32,5,27,0,0,0
2019-10-04 03:00,22,4,18,0,0,0
2019-10-04 03:15,27,4,23,0,0,0
2019-10-04 03:30,15,2,13,0,0,0
2019-10-04 03:45,27,3,24,0,0,0
2019-10-04 04:00,20,2,18,0,0,0
2019-10-04 04:15,14,1,13,0,0,0
2019-10-04 04:30,17,2,15,0,0,0
2019-10-04 04:45,24,7,17,0,0,0
2019-10-04 05:00,15,8,7,0,0,0
2019-10-04 05:15,13,7,6,0,0,0
2019-10-04 05:30,8,4,4,0,0,0
2019-10-04 05:45,14,8,6,0,0,0
2019-10-04 06:00,16,5,11,0,0,0
2019-10-04 06:15,20,11,9,0,0,0
2019-10-04 06:30,36,21,15,0,0,0
2019-10-04 06:45,48,36,12,0,0,0
2019-10-04 07:00,51,40,11,0,0,0
2019-10-04 07:15,81,61,20,0,0,0
2019-10-04 07:30,155,129,26,0,0,0
2019-10-04 07:45,177,106,71,0,0,0
2019-10-04 08:00,132,70,62,0,0,0
2019-10-04 08:15,113,71,42,0,0,0
2019-10-04 08:30,114,83,31,0,0,0
2019-10-04 08:45,169,87,82,0,0,0
2019-10-04 09:00,128,72,56,0,0,0
2019-10-04 09:15,112,63,49,0,0,0
2019-10-04 09:30,122,76,46,0,0,0
2019-10-04 09:45,184,128,56,0,0,0
2019-10-04 10:00,120,75,45,0,0,0
2019-10-04 10:15,130,76,54,0,0,0
2019-10-04 10:30,108,74,34,0,0,0
2019-10-04 10:45,164,90,74,0,0,0
2019-10-04 11:00,117,68,49,0,0,0
2019-10-04 11:15,130,47,83,0,0,0
2019-10-04 11:30,142,73,69,0,0,0
2019-10-04 11:45,138,81,57,0,0,0
2019-10-04 12:00,100,50,50,0,0,0
2019-10-04 12:15,116,73,43,0,0,0
2019-10-04 12:30,147,94,53,0,0,0
2019-10-04 12:45,186,98,88,0,0,0
2019-10-04 13:00,168,66,102,0,0,0
2019-10-04 13:15,157,51,106,0,0,0
2019-10-04 13:30,105,53,52,0,0,0
2019-10-04 13:45,134,60,74,0,0,0
2019-10-04 14:00,140,62,78,0,0,0
2019-10-04 14:15,140,67,73,0,0,0
2019-10-04 14:30,165,90,75,0,0,0
2019-10-04 14:45,167,89,78,0,0,0
2019-10-04 15:00,142,63,79,0,0,0
2019-10-04 15:15,126,67,59,0,0,0
2019-10-04 15:30,129,61,68,0,0,0
2019-10-04 15:45,145,57,88,0,0,0
2019-10-04 16:00,114,51,63,0,0,0
2019-10-04 16:15,140,77,63,0,0,0
2019-10-04 16:30,132,47,85,0,0,0
2019-10-04 16:45,142,69,73,0,0,0
2019-10-04 17:00,128,53,75,0,0,0
2019-10-04 17:15,118,40,78,0,0,0
2019-10-04 17:30,134,55,79,0,0,0
2019-10-04 17:45,129,60,69,0,0,0
2019-10-04 18:00,121,44,77,0,0,0
2019-10-04 18:15,124,61,63,0,0,0
2019-10-04 18:30,126,53,73,0,0,0
2019-10-04 18:45,121,60,61,0,0,0
2019-10-04 19:00,88,44,44,0,0,0
2019-10-04 19:15,98,40,58,0,0,0
2019-10-04 19:30,78,34,44,0,0,0
2019-10-04 19:45,69,34,35,0,0,0
2019-10-04 20:00,95,44,51,0,0,0
2019-10-04 20:15,74,31,43,0,0,0
2019-10-04 20:30,65,30,35,0,0,0
2019-10-04 20:45,67,35,32,0,0,0
2019-10-04 21:00,51,27,24,0,0,0
2019-10-04 21:15,58,27,31,0,0,0
2019-10-04 21:30,57,29,28,0,0,0
2019-10-04 21:45,62,26,36,0,0,0
2019-10-04 22:00,48,26,22,0,0,0
2019-10-04 22:15,46,23,23,0,0,0
2019-10-04 22:30,52,21,31,0,0,0
2019-10-04 22:45,51,26,25,0,0,0
2019-10-04 23:00,47,17,30,0,0,0
2019-10-04 23:15,58,16,42,0,0,0
2019-10-04 23:30,35,13,22,0,0,0
2019-10-04 23:45,48,20,28,0,0,0
2019-10-05 00:00,45,26,19,0,0,0
2019-10-05 00:15,40,21,19,0,0,0
2019-10-05 00:30,51,22,29,0,0,0
2019-10-05 00:45,31,11,20,0,0,0
2019-10-05 01:00,53,28,25,0,0,0
2019-10-05 01:15,24,5,19,0,0,0
2019-10-05 01:30,28,5,23,0,0,0
2019-10-05 01:45,31,5,26,0,0,0
2019-10-05 02:00,32,11,21,0,0,0
2019-10-05 02:15,35,1,34,0,0,0
2019-10-05 02:30,19,3,16,0,0,0
2019-10-05 02:45,23,3,20,0,0,0
2019-10-05 03:00,26,1,25,0,0,0
2019-10-05 03:15,25,5,20,0,0,0
2019-10-05 03:30,14,2,12,0,0,0
2019-10-05 03:45,29,8,21,0,0,0
2019-10-05 04:00,31,9,22,0,0,0
2019-10-05 04:15,23,3,20,0,0,0
2019-10-05 04:30,16,4,12,0,0,0
2019-10-05 04:45,20,5,15,0,0,0
2019-10-05 05:00,11,0,11,0,0,0
2019-10-05 05:15,21,9,12,0,0,0
2019-10-05 05:30,11,3,8,0,0,0
2019-10-05 05:45,17,11,6,0,0,0
2019-10-05 06:00,15,9,6,0,0,0
2019-10-05 06:15,9,5,4,0,0,0
2019-10-05 06:30,11,6,5,0,0,0
2019-10-05 06:45,14,9,5,0,0,0
2019-10-05 07:00,14,8,6,0,0,0
2019-10-05 07:15,20,18,2,0,0,0
2019-10-05 07:30,22,12,10,0,0,0
2019-10-05 07:45,30,19,11,0,0,0
2019-10-05 08:00,48,30,18,0,0,0
2019-10-05 08:15,40,24,16,0,0,0
2019-10-05 08:30,46,31,15,0,0,0
2019-10-05 08:45,57,40,17,0,0,0
2019-10-05 09:00,57,31,26,0,0,0
2019-10-05 09:15,88,67,21,0,0,0
2019-10-05 09:30,78,58,20,0,0,0
2019-10-05 09:45,140,102,38,0,0,0
2019-10-05 10:00,105,74,31,0,0,0
2019-10-05 10:15,99,72,27,0,0,0
2019-10-05 10:30,105,71,34,0,0,0
2019-10-05 10:45,130,68,62,0,0,0
2019-10-05 11:00,104,61,43,0,0,0
2019-10-05 11:15,121,83,38,0,0,0
2019-10-05 11:30,131,74,57,0,0,0
2019-10-05 11:45,138,85,53,0,0,0
2019-10-05 12:00,141,82,59,0,0,0
2019-10-05 12:15,164,99,65,0,0,0
2019-10-05 12:30,132,86,46,0,0,0
2019-10-05 12:45,178,121,57,0,0,0
2019-10-05 13:00,156,93,63,0,0,0
2019-10-05 13:15,140,88,52,0,0,0
2019-10-05 13:30,163,105,58,0,0,0
2019-10-05 13:45,151,81,70,0,0,0
2019-10-05 14:00,168,82,86,0,0,0
2019-10-05 14:15,136,68,68,0,0,0
2019-10-05 14:30,150,60,90,0,0,0
2019-10-05 14:45,184,99,85,0,0,0
2019-10-05 15:00,171,62,109,0,0,0
2019-10-05 15:15,169,71,98,0,0,0
2019-10-05 15:30,162,65,97,0,0,0
2019-10-05 15:45,165,82,83,0,0,0
2019-10-05 16:00,163,72,91,0,0,0
2019-10-05 16:15,165,76,89,0,0,0
2019-10-05 16:30,118,43,75,0,0,0
2019-10-05 16:45,177,74,103,0,0,0
2019-10-05 17:00,156,65,91,0,0,0
2019-10-05 17:15,142,57,85,0,0,0
2019-10-05 17:30,149,80,69,0,0,0
2019-10-05 17:45,168,66,102,0,0,0
2019-10-05 18:00,161,64,97,0,0,0
2019-10-05 18:15,151,74,77,0,0,0
2019-10-05 18:30,150,66,84,0,0,0
2019-10-05 18:45,138,75,63,0,0,0
2019-10-05 19:00,132,52,80,0,0,0
2019-10-05 19:15,115,44,71,0,0,0
2019-10-05 19:30,138,56,82,0,0,0
2019-10-05 19:45,100,35,65,0,0,0
2019-10-05 20:00,109,50,59,0,0,0
2019-10-05 20:15,135,65,70,0,0,0
2019-10-05 20:30,97,30,67,0,0,0
2019-10-05 20:45,73,34,39,0,0,0
2019-10-05 21:00,78,25,53,0,0,0
2019-10-05 21:15,72,36,36,0,0,0
2019-10-05 21:30,87,38,49,0,0,0
2019-10-05 21:45,79,37,42,0,0,0
2019-10-05 22:00,69,27,42,0,0,0
2019-10-05 22:15,58,18,40,0,0,0
2019-10-05 22:30,64,26,38,0,0,0
2019-10-05 22:45,74,21,53,0,0,0
2019-10-05 23:00,59,21,38,0,0,0
2019-10-05 23:15,73,31,42,0,0,0
2019-10-05 23:30,65,26,39,0,0,0
2019-10-05 23:45,50,13,37,0,0,0
2019-10-06 00:00,65,25,40,0,0,0
2019-10-06 00:15,55,22,33,0,0,0
2019-10-06 00:30,76,26,50,0,0,0
2019-10-06 00:45,63,25,38,0,0,0
2019-10-06 01:00,72,24,48,0,0,0
2019-10-06 01:15,44,12,32,0,0,0
2019-10-06 01:30,56,19,37,0,0,0
2019-10-06 01:45,52,30,22,0,0,0
2019-10-06 02:00,53,25,28,0,0,0
2019-10-06 02:15,38,15,23,0,0,0
2019-10-06 02:30,31,10,21,0,0,0
2019-10-06 02:45,31,6,25,0,0,0
2019-10-06 03:00,29,12,17,0,0,0
2019-10-06 03:15,34,11,23,0,0,0
2019-10-06 03:30,14,5,9,0,0,0
2019-10-06 03:45,27,13,14,0,0,0
2019-10-06 04:00,24,12,12,0,0,0
2019-10-06 04:15,22,11,11,0,0,0
2019-10-06 04:30,9,3,6,0,0,0
2019-10-06 04:45,20,1,19,0,0,0
2019-10-06 05:00,10,2,8,0,0,0
2019-10-06 05:15,15,6,9,0,0,0
2019-10-06 05:30,21,6,15,0,0,0
2019-10-06 05:45,7,4,3,0,0,0
2019-10-06 06:00,7,2,5,0,0,0
2019-10-06 06:15,9,5,4,0,0,0
2019-10-06 06:30,18,4,14,0,0,0
2019-10-06 06:45,4,0,4,0,0,0
2019-10-06 07:00,9,6,3,0,0,0
2019-10-06 07:15,12,7,5,0,0,0
2019-10-06 07:30,11,8,3,0,0,0
2019-10-06 07:45,7,5,2,0,0,0
2019-10-06 08:00,11,7,4,0,0,0
2019-10-06 08:15,22,16,6,0,0,0
2019-10-06 08:30,16,12,4,0,0,0
2019-10-06 08:45,39,27,12,0,0,0
2019-10-06 09:00,29,21,8,0,0,0
2019-10-06 09:15,32,19,13,0,0,0
2019-10-06 09:30,43,28,15,0,0,0
2019-10-06 09:45,77,59,18,0,0,0
2019-10-06 10:00,53,38,15,0,0,0
2019-10-06 10:15,72,44,28,0,0,0
2019-10-06 10:30,63,47,16,0,0,0
2019-10-06 10:45,56,37,19,0,0,0
2019-10-06 11:00,62,33,29,0,0,0
2019-10-06 11:15,61,36,25,0,0,0
2019-10-06 11:30,79,45,34,0,0,0
2019-10-06 11:45,87,41,46,0,0,0
2019-10-06 12:00,56,28,28,0,0,0
2019-10-06 12:15,76,35,41,0,0,0
2019-10-06 12:30,85,42,43,0,0,0
2019-10-06 12:45,106,61,45,0,0,0
2019-10-06 13:00,69,31,38,0,0,0
2019-10-06 13:15,76,42,34,0,0,0
2019-10-06 13:30,83,35,48,0,0,0
2019-10-06 13:45,115,65,50,0,0,0
2019-10-06 14:00,100,49,51,0,0,0
2019-10-06 14:15,103,48,55,0,0,0
2019-10-06 14:30,84,49,35,0,0,0
2019-10-06 14:45,115,65,50,0,0,0
2019-10-06 15:00,113,59,54,0,0,0
2019-10-06 15:15,99,56,43,0,0,0
2019-10-06 15:30,89,54,35,0,0,0
2019-10-06 15:45,88,44,44,0,0,0
2019-10-06 16:00,89,44,45,0,0,0
2019-10-06 16:15,81,42,39,0,0,0
2019-10-06 16:30,114,40,74,0,0,0
2019-10-06 16:45,119,48,71,0,0,0
2019-10-06 17:00,94,42,52,0,0,0
2019-10-06 17:15,85,37,48,0,0,0
2019-10-06 17:30,88,47,41,0,0,0
2019-10-06 17:45,118,68,50,0,0,0
2019-10-06 18:00,79,37,42,0,0,0
2019-10-06 18:15,95,36,59,0,0,0
2019-10-06 18:30,94,44,50,0,0,0
2019-10-06 18:45,110,60,50,0,0,0
2019-10-06 19:00,71,37,34,0,0,0
2019-10-06 19:15,61,24,37,0,0,0
2019-10-06 19:30,58,22,36,0,0,0
2019-10-06 19:45,104,34,70,0,0,0
2019-10-06 20:00,78,27,51,0,0,0
2019-10-06 20:15,75,27,48,0,0,0
2019-10-06 20:30,46,12,34,0,0,0
2019-10-06 20:45,49,13,36,0,0,0
2019-10-06 21:00,47,11,36,0,0,0
2019-10-06 21:15,55,19,36,0,0,0
2019-10-06 21:30,48,19,29,0,0,0
2019-10-06 21:45,43,7,36,0,0,0
2019-10-06 22:00,45,14,31,0,0,0
2019-10-06 22:15,42,15,27,0,0,0
2019-10-06 22:30,25,4,21,0,0,0
2019-10-06 22:45,38,10,28,0,0,0
2019-10-06 23:00,20,4,16,0,0,0
2019-10-06 23:15,18,6,12,0,0,0
2019-10-06 23:30,10,7,3,0,0,0
2019-10-06 23:45,16,4,12,0,0,0
2019-10-07 00:00,12,5,7,0,0,0
2019-10-07 00:15,14,7,7,0,0,0
2019-10-07 00:30,10,3,7,0,0,0
2019-10-07 00:45,14,2,12,0,0,0
2019-10-07 01:00,9,3,6,0,0,0
2019-10-07 01:15,4,1,3,0,0,0
2019-10-07 01:30,4,1,3,0,0,0
2019-10-07 01:45,1,1,0,0,0,0
2019-10-07 02:00,2,0,2,0,0,0
2019-10-07 02:15,7,2,5,0,0,0
2019-10-07 02:30,0,0,0,0,0,0
2019-10-07 02:45,1,0,1,0,0,0
2019-10-07 03:00,1,0,1,0,0,0
2019-10-07 03:15,0,0,0,0,0,0
2019-10-07 03:30,1,0,1,0,0,0
2019-10-07 03:45,2,1,1,0,0,0
2019-10-07 04:00,1,1,0,0,0,0
2019-10-07 04:15,2,1,1,0,0,0
2019-10-07 04:30,3,3,0,0,0,0
2019-10-07 04:45,10,7,3,0,0,0
2019-10-07 05:00,10,8,2,0,0,0
2019-10-07 05:15,16,11,5,0,0,0
2019-10-07 05:30,13,9,4,0,0,0
2019-10-07 05:45,25,15,10,0,0,0
2019-10-07 06:00,24,20,4,0,0,0
2019-10-07 06:15,34,23,11,0,0,0
2019-10-07 06:30,55,39,16,0,0,0
2019-10-07 06:45,82,60,22,0,0,0
2019-10-07 07:00,92,49,43,0,0,0
2019-10-07 07:15,158,103,55,0,0,0
2019-10-07 07:30,310,233,77,0,0,0
2019-10-07 07:45,456,238,218,0,0,0
2019-10-07 08:00,363,178,185,0,0,0
2019-10-07 08:15,274,147,127,0,0,0
2019-10-07 08:30,236,144,92,0,0,0
2019-10-07 08:45,346,173,173,0,0,0
2019-10-07 09:00,215,113,102,0,0,0
2019-10-07 09:15,221,116,105,0,0,0
2019-10-07 09:30,253,150,103,0,0,0
2019-10-07 09:45,411,224,187,0,0,0
2019-10-07 10:00,355,225,130,0,0,0
2019-10-07 10:15,220,136,84,0,0,0
2019-10-07 10:30,180,106,74,0,0,0
2019-10-07 10:45,195,115,80,0,0,0
2019-10-07 11:00,172,90,82,0,0,0
2019-10-07 11:15,172,90,82,0,0,0
2019-10-07 11:30,259,102,157,0,0,0
2019-10-07 11:45,383,203,180,0,0,0
2019-10-07 12:00,329,163,166,0,0,0
2019-10-07 12:15,256,127,129,0,0,0
2019-10-07 12:30,272,132,140,0,0,0
2019-10-07 12:45,261,148,113,0,0,0
2019-10-07 13:00,294,133,161,0,0,0
2019-10-07 13:15,318,161,157,0,0,0
2019-10-07 13:30,303,163,140,0,0,0
2019-10-07 13:45,536,246,290,0,0,0
2019-10-07 14:00,361,193,168,0,0,0
2019-10-07 14:15,270,115,155,0,0,0
2019-10-07 14:30,254,117,137,0,0,0
2019-10-07 14:45,306,151,155,0,0,0
2019-10-07 15:00,270,111,159,0,0,0
2019-10-07 15:15,302,128,174,0,0,0
2019-10-07 15:30,309,131,178,0,0,0
2019-10-07 15:45,589,256,333,0,0,0
2019-10-07 16:00,451,218,233,0,0,0
2019-10-07 16:15,335,144,191,0,0,0
2019-10-07 16:30,353,166,187,0,0,0
2019-10-07 16:45,351,183,168,0,0,0
2019-10-07 17:00,340,190,150,0,0,0
2019-10-07 17:15,436,212,224,0,0,0
2019-10-07 17:30,390,195,195,0,0,0
2019-10-07 17:45,449,235,214,0,0,0
2019-10-07 18:00,364,174,190,0,0,0
2019-10-07 18:15,332,148,184,0,0,0
2019-10-07 18:30,252,120,132,0,0,0
2019-10-07 18:45,345,175,170,0,0,0
2019-10-07 19:00,226,103,123,0,0,0
2019-10-07 19:15,273,104,169,0,0,0
2019-10-07 19:30,232,92,140,0,0,0
2019-10-07 19:45,268,136,132,0,0,0
2019-10-07 20:00,185,58,127,0,0,0
2019-10-07 20:15,170,67,103,0,0,0
2019-10-07 20:30,155,58,97,0,0,0
2019-10-07 20:45,108,47,61,0,0,0
2019-10-07 21:00,110,71,39,0,0,0
2019-10-07 21:15,107,36,71,0,0,0
2019-10-07 21:30,139,42,97,0,0,0
2019-10-07 21:45,93,31,62,0,0,0
2019-10-07 22:00,106,41,65,0,0,0
2019-10-07 22:15,132,57,75,0,0,0
2019-10-07 22:30,92,27,65,0,0,0
2019-10-07 22:45,78,23,55,0,0,0
2019-10-07 23:00,86,29,57,0,0,0
2019-10-07 23:15,90,15,75,0,0,0
2019-10-07 23:30,72,10,62,0,0,0
2019-10-07 23:45,66,9,57,0,0,0
2019-10-08 00:00,45,10,35,0,0,0
2019-10-08 00:15,53,16,37,0,0,0
2019-10-08 00:30,47,6,41,0,0,0
2019-10-08 00:45,33,6,27,0,0,0
2019-10-08 01:00,25,5,20,0,0,0
2019-10-08 01:15,19,0,19,0,0,0
2019-10-08 01:30,16,2,14,0,0,0
2019-10-08 01:45,31,5,26,0,0,0
2019-10-08 02:00,12,3,9,0,0,0
2019-10-08 02:15,14,2,12,0,0,0
2019-10-08 02:30,2,0,2,0,0,0
2019-10-08 02:45,6,1,5,0,0,0
2019-10-08 03:00,5,3,2,0,0,0
2019-10-08 03:15,9,2,7,0,0,0
2019-10-08 03:30,3,0,3,0,0,0
2019-10-08 03:45,5,3,2,0,0,0
2019-10-08 04:00,4,2,2,0,0,0
2019-10-08 04:15,1,1,0,0,0,0
2019-10-08 04:30,1,1,0,0,0,0
2019-10-08 04:45,6,4,2,0,0,0
2019-10-08 05:00,8,8,0,0,0,0
2019-10-08 05:15,13,11,2,0,0,0
2019-10-08 05:30,18,10,8,0,0,0
2019-10-08 05:45,19,11,8,0,0,0
2019-10-08 06:00,22,16,6,0,0,0
2019-10-08 06:15,37,26,11,0,0,0
2019-10-08 06:30,44,31,13,0,0,0
2019-10-08 06:45,75,50,25,0,0,0
2019-10-08 07:00,80,48,32,0,0,0
2019-10-08 07:15,130,82,48,0,0,0
2019-10-08 07:30,251,166,85,0,0,0
2019-10-08 07:45,496,229,267,0,0,0
2019-10-08 08:00,481,164,317,0,0,0
2019-10-08 08:15,236,144,92,0,0,0
2019-10-08 08:30,206,133,73,0,0,0
2019-10-08 08:45,286,153,133,0,0,0
2019-10-08 09:00,173,93,80,0,0,0
2019-10-08 09:15,120,63,57,0,0,0
2019-10-08 09:30,204,112,92,0,0,0
2019-10-08 09:45,383,185,198,0,0,0
2019-10-08 10:00,468,286,182,0,0,0
2019-10-08 10:15,167,106,61,0,0,0
2019-10-08 10:30,133,77,56,0,0,0
2019-10-08 10:45,194,118,76,0,0,0
2019-10-08 11:00,204,102,102,0,0,0
2019-10-08 11:15,214,113,101,0,0,0
2019-10-08 11:30,221,110,111,0,0,0
2019-10-08 11:45,393,216,177,0,0,0
2019-10-08 12:00,422,234,188,0,0,0
2019-10-08 12:15,224,114,110,0,0,0
2019-10-08 12:30,182,79,103,0,0,0
2019-10-08 12:45,257,155,102,0,0,0
2019-10-08 13:00,349,157,192,0,0,0
2019-10-08 13:15,266,103,163,0,0,0
2019-10-08 13:30,313,175,138,0,0,0
2019-10-08 13:45,427,202,225,0,0,0
2019-10-08 14:00,415,201,214,0,0,0
2019-10-08 14:15,211,111,100,0,0,0
2019-10-08 14:30,252,135,117,0,0,0
2019-10-08 14:45,242,126,116,0,0,0
2019-10-08 15:00,219,111,108,0,0,0
2019-10-08 15:15,218,122,96,0,0,0
2019-10-08 15:30,287,152,135,0,0,0
2019-10-08 15:45,565,370,195,0,0,0
2019-10-08 16:00,399,254,145,0,0,0
2019-10-08 16:15,285,143,142,0,0,0
2019-10-08 16:30,299,160,139,0,0,0
2019-10-08 16:45,305,174,131,0,0,0
2019-10-08 17:00,301,158,143,0,0,0
2019-10-08 17:15,311,157,154,0,0,0
2019-10-08 17:30,333,206,127,0,0,0
2019-10-08 17:45,518,215,303,0,0,0
2019-10-08 18:00,457,190,267,0,0,0
2019-10-08 18:15,328,152,176,0,0,0
2019-10-08 18:30,237,132,105,0,0,0
2019-10-08 18:45,306,176,130,0,0,0
2019-10-08 19:00,250,116,134,0,0,0
2019-10-08 19:15,262,157,105,0,0,0
2019-10-08 19:30,227,119,108,0,0,0
2019-10-08 19:45,249,142,107,0,0,0
2019-10-08 20:00,163,83,80,0,0,0
2019-10-08 20:15,153,66,87,0,0,0
2019-10-08 20:30,95,32,63,0,0,0
2019-10-08 20:45,114,49,65,0,0,0
2019-10-08 21:00,138,62,76,0,0,0
2019-10-08 21:15,101,39,62,0,0,0
2019-10-08 21:30,158,47,111,0,0,0
2019-10-08 21:45,112,49,63,0,0,0
2019-10-08 22:00,117,45,72,0,0,0
2019-10-08 22:15,139,63,76,0,0,0
2019-10-08 22:30,106,27,79,0,0,0
2019-10-08 22:45,99,27,72,0,0,0
2019-10-08 23:00,60,21,39,0,0,0
2019-10-08 23:15,74,16,58,0,0,0
2019-10-08 23:30,72,22,50,0,0,0
2019-10-08 23:45,68,20,48,0,0,0
2019-10-09 00:00,77,18,59,0,0,0
2019-10-09 00:15,73,5,68,0,0,0
2019-10-09 00:30,84,6,78,0,0,0
2019-10-09 00:45,84,4,80,0,0,0
2019-10-09 01:00,58,2,56,0,0,0
2019-10-09 01:15,41,4,37,0,0,0
2019-10-09 01:30,32,6,26,0,0,0
2019-10-09 01:45,50,2,48,0,0,0
2019-10-09 02:00,31,7,24,0,0,0
2019-10-09 02:15,20,3,17,0,0,0
2019-10-09 02:30,12,2,10,0,0,0
2019-10-09 02:45,15,4,11,0,0,0
2019-10-09 03:00,12,2,10,0,0,0
2019-10-09 03:15,8,2,6,0,0,0
2019-10-09 03:30,9,1,8,0,0,0
2019-10-09 03:45,7,2,5,0,0,0
2019-10-09 04:00,6,0,6,0,0,0
2019-10-09 04:15,7,1,6,0,0,0
2019-10-09 04:30,11,4,7,0,0,0
2019-10-09 04:45,8,3,5,0,0,0
2019-10-09 05:00,13,12,1,0,0,0
2019-10-09 05:15,16,13,3,0,0,0
2019-10-09 05:30,22,15,7,0,0,0
2019-10-09 05:45,28,17,11,0,0,0
2019-10-09 06:00,35,27,8,0,0,0
2019-10-09 06:15,52,36,16,0,0,0
2019-10-09 06:30,51,39,12,0,0,0
2019-10-09 06:45,89,58,31,0,0,0
2019-10-09 07:00,94,52,42,0,0,0
2019-10-09 07:15,163,98,65,0,0,0
2019-10-09 07:30,325,221,104,0,0,0
2019-10-09 07:45,529,304,225,0,0,0
2019-10-09 08:00,459,185,274,0,0,0
2019-10-09 08:15,283,172,111,0,0,0
2019-10-09 08:30,214,128,86,0,0,0
2019-10-09 08:45,353,183,170,0,0,0
2019-10-09 09:00,185,110,75,0,0,0
2019-10-09 09:15,158,84,74,0,0,0
2019-10-09 09:30,213,106,107,0,0,0
2019-10-09 09:45,476,250,226,0,0,0
2019-10-09 10:00,484,265,219,0,0,0
2019-10-09 10:15,246,140,106,0,0,0
2019-10-09 10:30,179,107,72,0,0,0
2019-10-09 10:45,190,105,85,0,0,0
2019-10-09 11:00,200,112,88,0,0,0
2019-10-09 11:15,211,133,78,0,0,0
2019-10-09 11:30,271,143,128,0,0,0
2019-10-09 11:45,448,228,220,0,0,0
2019-10-09 12:00,382,194,188,0,0,0
2019-10-09 12:15,233,120,113,0,0,0
2019-10-09 12:30,230,119,111,0,0,0
2019-10-09 12:45,289,135,154,0,0,0
2019-10-09 13:00,287,155,132,0,0,0
2019-10-09 13:15,293,147,146,0,0,0
2019-10-09 13:30,282,130,152,0,0,0
2019-10-09 13:45,371,186,185,0,0,0
2019-10-09 14:00,358,182,176,0,0,0
2019-10-09 14:15,283,148,135,0,0,0
2019-10-09 14:30,268,127,141,0,0,0
2019-10-09 14:45,258,105,153,0,0,0
2019-10-09 15:00,236,87,149,0,0,0
2019-10-09 15:15,161,76,85,0,0,0
2019-10-09 15:30,199,71,128,0,0,0
2019-10-09 15:45,345,166,179,0,0,0
2019-10-09 16:00,380,165,215,0,0,0
2019-10-09 16:15,279,110,169,0,0,0
2019-10-09 16:30,287,149,138,0,0,0
2019-10-09 16:45,346,176,170,0,0,0
2019-10-09 17:00,290,147,143,0,0,0
2019-10-09 17:15,305,169,136,0,0,0
2019-10-09 17:30,381,192,189,0,0,0
2019-10-09 17:45,458,222,236,0,0,0
2019-10-09 18:00,372,162,210,0,0,0
2019-10-09 18:15,308,150,158,0,0,0
2019-10-09 18:30,266,138,128,0,0,0
2019-10-09 18:45,325,190,135,0,0,0
2019-10-09 19:00,240,128,112,0,0,0
2019-10-09 19:15,240,119,121,0,0,0
2019-10-09 19:30,261,133,128,0,0,0
2019-10-09 19:45,297,163,134,0,0,0
2019-10-09 20:00,227,113,114,0,0,0
2019-10-09 20:15,190,74,116,0,0,0
2019-10-09 20:30,134,64,70,0,0,0
2019-10-09 20:45,155,58,97,0,0,0
2019-10-09 21:00,166,71,95,0,0,0
2019-10-09 21:15,127,51,76,0,0,0
2019-10-09 21:30,112,39,73,0,0,0
2019-10-09 21:45,132,58,74,0,0,0
2019-10-09 22:00,118,44,74,0,0,0
2019-10-09 22:15,136,58,78,0,0,0
2019-10-09 22:30,107,36,71,0,0,0
2019-10-09 22:45,108,37,71,0,0,0
2019-10-09 23:00,115,39,76,0,0,0
2019-10-09 23:15,75,31,44,0,0,0
2019-10-09 23:30,61,18,43,0,0,0
2019-10-09 23:45,76,43,33,0,0,0
2019-10-10 00:00,79,19,60,0,0,0
2019-10-10 00:15,77,31,46,0,0,0
2019-10-10 00:30,63,29,34,0,0,0
2019-10-10 00:45,55,21,34,0,0,0
2019-10-10 01:00,55,7,48,0,0,0
2019-10-10 01:15,55,8,47,0,0,0
2019-10-10 01:30,40,0,40,0,0,0
2019-10-10 01:45,53,5,48,0,0,0
2019-10-10 02:00,34,6,28,0,0,0
2019-10-10 02:15,47,9,38,0,0,0
2019-10-10 02:30,60,8,52,0,0,0
2019-10-10 02:45,58,5,53,0,0,0
2019-10-10 03:00,36,0,36,0,0,0
2019-10-10 03:15,44,1,43,0,0,0
2019-10-10 03:30,44,5,39,0,0,0
2019-10-10 03:45,32,2,30,0,0,0
2019-10-10 04:00,18,1,17,0,0,0
2019-10-10 04:15,15,1,14,0,0,0
2019-10-10 04:30,12,5,7,0,0,0
2019-10-10 04:45,21,7,14,0,0,0
2019-10-10 05:00,13,2,11,0,0,0
2019-10-10 05:15,14,9,5,0,0,0
2019-10-10 05:30,9,4,5,0,0,0
2019-10-10 05:45,17,8,9,0,0,0
2019-10-10 06:00,27,22,5,0,0,0
2019-10-10 06:15,45,26,19,0,0,0
2019-10-10 06:30,38,29,9,0,0,0
2019-10-10 06:45,90,53,37,0,0,0
2019-10-10 07:00,96,56,40,0,0,0
2019-10-10 07:15,129,81,48,0,0,0
2019-10-10 07:30,254,169,85,0,0,0
2019-10-10 07:45,487,210,277,0,0,0
2019-10-10 08:00,473,183,290,0,0,0
2019-10-10 08:15,301,167,134,0,0,0
2019-10-10 08:30,239,130,109,0,0,0
2019-10-10 08:45,353,158,195,0,0,0
2019-10-10 09:00,221,112,109,0,0,0
2019-10-10 09:15,201,103,98,0,0,0
2019-10-10 09:30,232,129,103,0,0,0
2019-10-10 09:45,431,210,221,0,0,0
2019-10-10 10:00,504,330,174,0,0,0
2019-10-10 10:15,159,90,69,0,0,0
2019-10-10 10:30,153,91,62,0,0,0
2019-10-10 10:45,156,97,59,0,0,0
2019-10-10 11:00,251,134,117,0,0,0
2019-10-10 11:15,141,78,63,0,0,0
2019-10-10 11:30,238,124,114,0,0,0
2019-10-10 11:45,359,194,165,0,0,0
2019-10-10 12:00,361,174,187,0,0,0
2019-10-10 12:15,241,129,112,0,0,0
2019-10-10 12:30,224,123,101,0,0,0
2019-10-10 12:45,248,129,119,0,0,0
2019-10-10 13:00,272,144,128,0,0,0
2019-10-10 13:15,293,154,139,0,0,0
2019-10-10 13:30,254,144,110,0,0,0
2019-10-10 13:45,424,232,192,0,0,0
2019-10-10 14:00,386,195,191,0,0,0
2019-10-10 14:15,260,116,144,0,0,0
2019-10-10 14:30,244,108,136,0,0,0
2019-10-10 14:45,268,124,144,0,0,0
2019-10-10 15:00,275,124,151,0,0,0
2019-10-10 15:15,246,121,125,0,0,0
2019-10-10 15:30,331,150,181,0,0,0
2019-10-10 15:45,481,249,232,0,0,0
2019-10-10 16:00,446,245,201,0,0,0
2019-10-10 16:15,330,173,157,0,0,0
2019-10-10 16:30,284,147,137,0,0,0
2019-10-10 16:45,313,190,123,0,0,0
2019-10-10 17:00,325,175,150,0,0,0
2019-10-10 17:15,361,184,177,0,0,0
2019-10-10 17:30,330,199,131,0,0,0
2019-10-10 17:45,422,227,195,0,0,0
2019-10-10 18:00,267,134,133,0,0,0
2019-10-10 18:15,318,168,150,0,0,0
2019-10-10 18:30,260,139,121,0,0,0
2019-10-10 18:45,274,135,139,0,0,0
2019-10-10 19:00,214,98,116,0,0,0
2019-10-10 19:15,192,99,93,0,0,0
2019-10-10 19:30,205,111,94,0,0,0
2019-10-10 19:45,324,139,185,0,0,0
2019-10-10 20:00,209,79,130,0,0,0
2019-10-10 20:15,152,58,94,0,0,0
2019-10-10 20:30,122,51,71,0,0,0
2019-10-10 20:45,130,57,73,0,0,0
2019-10-10 21:00,127,55,72,0,0,0
2019-10-10 21:15,104,41,63,0,0,0
2019-10-10 21:30,113,32,81,0,0,0
2019-10-10 21:45,99,32,67,0,0,0
2019-10-10 22:00,91,35,56,0,0,0
2019-10-10 22:15,87,31,56,0,0,0
2019-10-10 22:30,104,38,66,0,0,0
2019-10-10 22:45,128,36,92,0,0,0
2019-10-10 23:00,74,22,52,0,0,0
2019-10-10 23:15,67,22,45,0,0,0
2019-10-10 23:30,58,17,41,0,0,0
2019-10-10 23:45,73,25,48,0,0,0
2019-10-11 00:00,77,19,58,0,0,0
2019-10-11 00:15,107,11,96,0,0,0
2019-10-11 00:30,71,9,62,0,0,0
2019-10-11 00:45,53,7,46,0,0,0
2019-10-11 01:00,66,8,58,0,0,0
2019-10-11 01:15,38,8,30,0,0,0
2019-10-11 01:30,62,6,56,0,0,0
2019-10-11 01:45,35,4,31,0,0,0
2019-10-11 02:00,16,3,13,0,0,0
2019-10-11 02:15,32,3,29,0,0,0
2019-10-11 02:30,25,3,22,0,0,0
2019-10-11 02:45,20,2,18,0,0,0
2019-10-11 03:00,12,3,9,0,0,0
2019-10-11 03:15,15,0,15,0,0,0
2019-10-11 03:30,23,2,21,0,0,0
2019-10-11 03:45,11,0,11,0,0,0
2019-10-11 04:00,9,2,7,0,0,0
2019-10-11 04:15,4,0,4,0,0,0
2019-10-11 04:30,8,6,2,0,0,0
2019-10-11 04:45,10,3,7,0,0,0
2019-10-11 05:00,6,5,1,0,0,0
2019-10-11 05:15,12,7,5,0,0,0
2019-10-11 05:30,14,12,2,0,0,0
2019-10-11 05:45,22,12,10,0,0,0
2019-10-11 06:00,19,13,6,0,0,0
2019-10-11 06:15,33,27,6,0,0,0
2019-10-11 06:30,49,33,16,0,0,0
2019-10-11 06:45,63,36,27,0,0,0
2019-10-11 07:00,97,60,37,0,0,0
2019-10-11 07:15,129,81,48,0,0,0
2019-10-11 07:30,234,170,64,0,0,0
2019-10-11 07:45,397,203,194,0,0,0
2019-10-11 08:00,292,104,188,0,0,0
2019-10-11 08:15,217,111,106,0,0,0
2019-10-11 08:30,186,106,80,0,0,0
2019-10-11 08:45,242,126,116,0,0,0
2019-10-11 09:00,170,99,71,0,0,0
2019-10-11 09:15,131,75,56,0,0,0
2019-10-11 09:30,184,92,92,0,0,0
2019-10-11 09:45,362,160,202,0,0,0
2019-10-11 10:00,383,240,143,0,0,0
2019-10-11 10:15,174,91,83,0,0,0
2019-10-11 10:30,132,66,66,0,0,0
2019-10-11 10:45,136,69,67,0,0,0
2019-10-11 11:00,197,84,113,0,0,0
2019-10-11 11:15,180,84,96,0,0,0
2019-10-11 11:30,199,94,105,0,0,0
2019-10-11 11:45,381,209,172,0,0,0
2019-10-11 12:00,311,166,145,0,0,0
2019-10-11 12:15,221,121,100,0,0,0
2019-10-11 12:30,219,109,110,0,0,0
2019-10-11 12:45,223,121,102,0,0,0
2019-10-11 13:00,259,120,139,0,0,0
2019-10-11 13:15,303,121,182,0,0,0
2019-10-11 13:30,258,133,125,0,0,0
2019-10-11 13:45,353,219,134,0,0,0
2019-10-11 14:00,276,134,142,0,0,0
2019-10-11 14:15,241,123,118,0,0,0
2019-10-11 14:30,206,111,95,0,0,0
2019-10-11 14:45,216,118,98,0,0,0
2019-10-11 15:00,216,104,112,0,0,0
2019-10-11 15:15,209,112,97,0,0,0
2019-10-11 15:30,212,108,104,0,0,0
2019-10-11 15:45,233,131,102,0,0,0
2019-10-11 16:00,219,102,117,0,0,0
2019-10-11 16:15,207,113,94,0,0,0
2019-10-11 16:30,234,114,120,0,0,0
2019-10-11 16:45,211,114,97,0,0,0
2019-10-11 17:00,205,100,105,0,0,0
2019-10-11 17:15,190,90,100,0,0,0
2019-10-11 17:30,183,96,87,0,0,0
2019-10-11 17:45,224,126,98,0,0,0
2019-10-11 18:00,189,81,108,0,0,0
2019-10-11 18:15,172,80,92,0,0,0
2019-10-11 18:30,151,73,78,0,0,0
2019-10-11 18:45,217,116,101,0,0,0
2019-10-11 19:00,148,78,70,0,0,0
2019-10-11 19:15,195,110,85,0,0,0
2019-10-11 19:30,139,71,68,0,0,0
2019-10-11 19:45,155,77,78,0,0,0
2019-10-11 20:00,168,91,77,0,0,0
2019-10-11 20:15,152,72,80,0,0,0
2019-10-11 20:30,127,68,59,0,0,0
2019-10-11 20:45,121,65,56,0,0,0
2019-10-11 21:00,87,34,53,0,0,0
2019-10-11 21:15,116,59,57,0,0,0
2019-10-11 21:30,67,31,36,0,0,0
2019-10-11 21:45,78,30,48,0,0,0
2019-10-11 22:00,72,27,45,0,0,0
2019-10-11 22:15,100,39,61,0,0,0
2019-10-11 22:30,65,36,29,0,0,0
2019-10-11 22:45,72,32,40,0,0,0
2019-10-11 23:00,53,11,42,0,0,0
2019-10-11 23:15,79,25,54,0,0,0
2019-10-11 23:30,81,36,45,0,0,0
2019-10-11 23:45,84,28,56,0,0,0
2019-10-12 00:00,62,19,43,0,0,0
2019-10-12 00:15,79,35,44,0,0,0
2019-10-12 00:30,51,9,42,0,0,0
2019-10-12 00:45,82,34,48,0,0,0
2019-10-12 01:00,57,16,41,0,0,0
2019-10-12 01:15,56,16,40,0,0,0
2019-10-12 01:30,56,15,41,0,0,0
2019-10-12 01:45,61,19,42,0,0,0
2019-10-12 02:00,60,11,49,0,0,0
2019-10-12 02:15,51,10,41,0,0,0
2019-10-12 02:30,48,7,41,0,0,0
2019-10-12 02:45,38,7,31,0,0,0
2019-10-12 03:00,40,9,31,0,0,0
2019-10-12 03:15,35,6,29,0,0,0
2019-10-12 03:30,24,4,20,0,0,0
2019-10-12 03:45,27,1,26,0,0,0
2019-10-12 04:00,17,2,15,0,0,0
2019-10-12 04:15,16,1,15,0,0,0
2019-10-12 04:30,15,3,12,0,0,0
2019-10-12 04:45,12,4,8,0,0,0
2019-10-12 05:00,8,0,8,0,0,0
2019-10-12 05:15,14,4,10,0,0,0
2019-10-12 05:30,13,3,10,0,0,0
2019-10-12 05:45,22,11,11,0,0,0
2019-10-12 06:00,13,9,4,0,0,0
2019-10-12 06:15,13,6,7,0,0,0
2019-10-12 06:30,12,9,3,0,0,0
2019-10-12 06:45,8,4,4,0,0,0
2019-10-12 07:00,13,8,5,0,0,0
2019-10-12 07:15,17,11,6,0,0,0
2019-10-12 07:30,25,13,12,0,0,0
2019-10-12 07:45,48,35,13,0,0,0
2019-10-12 08:00,49,24,25,0,0,0
2019-10-12 08:15,55,42,13,0,0,0
2019-10-12 08:30,62,42,20,0,0,0
2019-10-12 08:45,74,54,20,0,0,0
2019-10-12 09:00,59,43,16,0,0,0
2019-10-12 09:15,67,46,21,0,0,0
2019-10-12 09:30,77,59,18,0,0,0
2019-10-12 09:45,139,104,35,0,0,0
2019-10-12 10:00,114,80,34,0,0,0
2019-10-12 10:15,111,88,23,0,0,0
2019-10-12 10:30,121,80,41,0,0,0
2019-10-12 10:45,127,93,34,0,0,0
2019-10-12 11:00,133,100,33,0,0,0
2019-10-12 11:15,113,78,35,0,0,0
2019-10-12 11:30,144,87,57,0,0,0
2019-10-12 11:45,173,115,58,0,0,0
2019-10-12 12:00,147,98,49,0,0,0
2019-10-12 12:15,156,95,61,0,0,0
2019-10-12 12:30,189,128,61,0,0,0
2019-10-12 12:45,175,101,74,0,0,0
2019-10-12 13:00,137,65,72,0,0,0
2019-10-12 13:15,179,91,88,0,0,0
2019-10-12 13:30,159,70,89,0,0,0
2019-10-12 13:45,191,91,100,0,0,0
2019-10-12 14:00,178,84,94,0,0,0
2019-10-12 14:15,169,77,92,0,0,0
2019-10-12 14:30,158,71,87,0,0,0
2019-10-12 14:45,169,89,80,0,0,0
2019-10-12 15:00,148,62,86,0,0,0
2019-10-12 15:15,164,83,81,0,0,0
2019-10-12 15:30,171,79,92,0,0,0
2019-10-12 15:45,160,84,76,0,0,0
2019-10-12 16:00,160,70,90,0,0,0
2019-10-12 16:15,145,52,93,0,0,0
2019-10-12 16:30,121,70,51,0,0,0
2019-10-12 16:45,160,80,80,0,0,0
2019-10-12 17:00,140,72,68,0,0,0
2019-10-12 17:15,162,78,84,0,0,0
2019-10-12 17:30,175,89,86,0,0,0
2019-10-12 17:45,171,64,107,0,0,0
2019-10-12 18:00,160,60,100,0,0,0
2019-10-12 18:15,154,75,79,0,0,0
2019-10-12 18:30,174,88,86,0,0,0
2019-10-12 18:45,157,78,79,0,0,0
2019-10-12 19:00,173,67,106,0,0,0
2019-10-12 19:15,123,66,57,0,0,0
2019-10-12 19:30,119,56,63,0,0,0
2019-10-12 19:45,145,79,66,0,0,0
2019-10-12 20:00,121,49,72,0,0,0
2019-10-12 20:15,106,54,52,0,0,0
2019-10-12 20:30,90,41,49,0,0,0
2019-10-12 20:45,108,59,49,0,0,0
2019-10-12 21:00,94,39,55,0,0,0
2019-10-12 21:15,118,61,57,0,0,0
2019-10-12 21:30,73,34,39,0,0,0
2019-10-12 21:45,87,25,62,0,0,0
2019-10-12 22:00,119,42,77,0,0,0
2019-10-12 22:15,67,20,47,0,0,0
2019-10-12 22:30,118,45,73,0,0,0
2019-10-12 22:45,91,41,50,0,0,0
2019-10-12 23:00,92,33,59,0,0,0
2019-10-12 23:15,101,15,86,0,0,0
2019-10-12 23:30,99,26,73,0,0,0
2019-10-12 23:45,90,32,58,0,0,0
2019-10-13 00:00,103,31,72,0,0,0
2019-10-13 00:15,99,15,84,0,0,0
2019-10-13 00:30,117,34,83,0,0,0
2019-10-13 00:45,95,24,71,0,0,0
2019-10-13 01:00,115,21,94,0,0,0
2019-10-13 01:15,111,30,81,0,0,0
2019-10-13 01:30,117,36,81,0,0,0
2019-10-13 01:45,63,15,48,0,0,0
2019-10-13 02:00,68,20,48,0,0,0
2019-10-13 02:15,67,20,47,0,0,0
2019-10-13 02:30,79,24,55,0,0,0
2019-10-13 02:45,61,19,42,0,0,0
2019-10-13 03:00,59,16,43,0,0,0
2019-10-13 03:15,65,26,39,0,0,0
2019-10-13 03:30,66,32,34,0,0,0
2019-10-13 03:45,41,16,25,0,0,0
2019-10-13 04:00,50,29,21,0,0,0
2019-10-13 04:15,44,20,24,0,0,0
2019-10-13 04:30,40,22,18,0,0,0
2019-10-13 04:45,54,30,24,0,0,0
2019-10-13 05:00,33,13,20,0,0,0
2019-10-13 05:15,35,26,9,0,0,0
2019-10-13 05:30,41,25,16,0,0,0
2019-10-13 05:45,26,22,4,0,0,0
2019-10-13 06:00,28,17,11,0,0,0
2019-10-13 06:15,23,16,7,0,0,0
2019-10-13 06:30,12,10,2,0,0,0
2019-10-13 06:45,24,16,8,0,0,0
2019-10-13 07:00,15,14,1,0,0,0
2019-10-13 07:15,23,22,1,0,0,0
2019-10-13 07:30,22,19,3,0,0,0
2019-10-13 07:45,33,14,19,0,0,0
2019-10-13 08:00,26,17,9,0,0,0
2019-10-13 08:15,21,13,8,0,0,0
2019-10-13 08:30,38,26,12,0,0,0
2019-10-13 08:45,57,40,17,0,0,0
2019-10-13 09:00,40,26,14,0,0,0
2019-10-13 09:15,40,29,11,0,0,0
2019-10-13 09:30,55,37,18,0,0,0
2019-10-13 09:45,86,67,19,0,0,0
2019-10-13 10:00,45,33,12,0,0,0
2019-10-13 10:15,66,54,12,0,0,0
2019-10-13 10:30,57,45,12,0,0,0
2019-10-13 10:45,83,55,28,0,0,0
2019-10-13 11:00,68,38,30,0,0,0
2019-10-13 11:15,80,43,37,0,0,0
2019-10-13 11:30,87,35,52,0,0,0
2019-10-13 11:45,101,47,54,0,0,0
2019-10-13 12:00,113,42,71,0,0,0
2019-10-13 12:15,102,44,58,0,0,0
2019-10-13 12:30,109,53,56,0,0,0
2019-10-13 12:45,132,58,74,0,0,0
2019-10-13 13:00,107,40,67,0,0,0
2019-10-13 13:15,125,56,69,0,0,0
2019-10-13 13:30,108,56,52,0,0,0
2019-10-13 13:45,168,96,72,0,0,0
2019-10-13 14:00,97,54,43,0,0,0
2019-10-13 14:15,110,51,59,0,0,0
2019-10-13 14:30,116,68,48,0,0,0
2019-10-13 14:45,200,114,86,0,0,0
2019-10-13 15:00,158,100,58,0,0,0
2019-10-13 15:15,153,86,67,0,0,0
2019-10-13 15:30,147,79,68,0,0,0
2019-10-13 15:45,154,98,56,0,0,0
2019-10-13 16:00,160,83,77,0,0,0
2019-10-13 16:15,148,85,63,0,0,0
2019-10-13 16:30,146,80,66,0,0,0
2019-10-13 16:45,197,123,74,0,0,0
2019-10-13 17:00,172,86,86,0,0,0
2019-10-13 17:15,156,77,79,0,0,0
2019-10-13 17:30,175,98,77,0,0,0
2019-10-13 17:45,186,105,81,0,0,0
2019-10-13 18:00,151,63,88,0,0,0
2019-10-13 18:15,159,79,80,0,0,0
2019-10-13 18:30,137,60,77,0,0,0
2019-10-13 18:45,196,102,94,0,0,0
2019-10-13 19:00,110,49,61,0,0,0
2019-10-13 19:15,107,49,58,0,0,0
2019-10-13 19:30,109,42,67,0,0,0
2019-10-13 19:45,145,55,90,0,0,0
2019-10-13 20:00,113,51,62,0,0,0
2019-10-13 20:15,116,50,66,0,0,0
2019-10-13 20:30,85,35,50,0,0,0
2019-10-13 20:45,91,37,54,0,0,0
2019-10-13 21:00,49,22,27,0,0,0
2019-10-13 21:15,37,13,24,0,0,0
2019-10-13 21:30,62,24,38,0,0,0
2019-10-13 21:45,70,20,50,0,0,0
2019-10-13 22:00,65,17,48,0,0,0
2019-10-13 22:15,55,11,44,0,0,0
2019-10-13 22:30,57,14,43,0,0,0
2019-10-13 22:45,50,12,38,0,0,0
2019-10-13 23:00,55,18,37,0,0,0
2019-10-13 23:15,21,4,17,0,0,0
2019-10-13 23:30,16,6,10,0,0,0
2019-10-13 23:45,32,9,23,0,0,0
2019-10-14 00:00,27,12,15,0,0,0
2019-10-14 00:15,14,2,12,0,0,0
2019-10-14 00:30,6,3,3,0,0,0
2019-10-14 00:45,23,5,18,0,0,0
2019-10-14 01:00,15,9,6,0,0,0
2019-10-14 01:15,8,2,6,0,0,0
2019-10-14 01:30,7,1,6,0,0,0
2019-10-14 01:45,7,3,4,0,0,0
2019-10-14 02:00,4,1,3,0,0,0
2019-10-14 02:15,6,4,2,0,0,0
2019-10-14 02:30,3,1,2,0,0,0
2019-10-14 02:45,4,2,2,0,0,0
2019-10-14 03:00,2,0,2,0,0,0
2019-10-14 03:15,1,1,0,0,0,0
2019-10-14 03:30,1,1,0,0,0,0
2019-10-14 03:45,2,2,0,0,0,0
2019-10-14 04:00,5,2,3,0,0,0
2019-10-14 04:15,0,0,0,0,0,0
2019-10-14 04:30,6,4,2,0,0,0
2019-10-14 04:45,9,2,7,0,0,0
2019-10-14 05:00,4,3,1,0,0,0
2019-10-14 05:15,11,7,4,0,0,0
2019-10-14 05:30,21,14,7,0,0,0
2019-10-14 05:45,19,11,8,0,0,0
2019-10-14 06:00,29,21,8,0,0,0
2019-10-14 06:15,42,26,16,0,0,0
2019-10-14 06:30,63,39,24,0,0,0
2019-10-14 06:45,77,53,24,0,0,0
2019-10-14 07:00,82,46,36,0,0,0
2019-10-14 07:15,126,84,42,0,0,0
2019-10-14 07:30,222,127,95,0,0,0
2019-10-14 07:45,450,217,233,0,0,0
2019-10-14 08:00,540,236,304,0,0,0
2019-10-14 08:15,309,150,159,0,0,0
2019-10-14 08:30,209,120,89,0,0,0
2019-10-14 08:45,339,178,161,0,0,0
2019-10-14 09:00,221,113,108,0,0,0
2019-10-14 09:15,212,104,108,0,0,0
2019-10-14 09:30,276,140,136,0,0,0
2019-10-14 09:45,679,408,271,0,0,0
2019-10-14 10:00,641,444,197,0,0,0
2019-10-14 10:15,171,99,72,0,0,0
2019-10-14 10:30,160,82,78,0,0,0
2019-10-14 10:45,156,74,82,0,0,0
2019-10-14 11:00,258,137,121,0,0,0
2019-10-14 11:15,208,118,90,0,0,0
2019-10-14 11:30,322,179,143,0,0,0
2019-10-14 11:45,581,297,284,0,0,0
2019-10-14 12:00,611,348,263,0,0,0
2019-10-14 12:15,242,123,119,0,0,0
2019-10-14 12:30,223,116,107,0,0,0
2019-10-14 12:45,243,126,117,0,0,0
2019-10-14 13:00,270,149,121,0,0,0
2019-10-14 13:15,275,173,102,0,0,0
2019-10-14 13:30,279,134,145,0,0,0
2019-10-14 13:45,651,287,364,0,0,0
2019-10-14 14:00,551,263,288,0,0,0
2019-10-14 14:15,299,157,142,0,0,0
2019-10-14 14:30,249,125,124,0,0,0
2019-10-14 14:45,236,108,128,0,0,0
2019-10-14 15:00,236,108,128,0,0,0
2019-10-14 15:15,230,98,132,0,0,0
2019-10-14 15:30,332,167,165,0,0,0
2019-10-14 15:45,681,388,293,0,0,0
2019-10-14 16:00,603,330,273,0,0,0
2019-10-14 16:15,371,183,188,0,0,0
2019-10-14 16:30,320,161,159,0,0,0
2019-10-14 16:45,346,167,179,0,0,0
2019-10-14 17:00,311,152,159,0,0,0
2019-10-14 17:15,408,231,177,0,0,0
2019-10-14 17:30,421,213,208,0,0,0
2019-10-14 17:45,662,295,367,0,0,0
2019-10-14 18:00,443,219,224,0,0,0
2019-10-14 18:15,312,158,154,0,0,0
2019-10-14 18:30,299,141,158,0,0,0
2019-10-14 18:45,325,146,179,0,0,0
2019-10-14 19:00,289,148,141,0,0,0
2019-10-14 19:15,301,139,162,0,0,0
2019-10-14 19:30,278,128,150,0,0,0
2019-10-14 19:45,395,162,233,0,0,0
2019-10-14 20:00,251,95,156,0,0,0
2019-10-14 20:15,249,92,157,0,0,0
2019-10-14 20:30,186,76,110,0,0,0
2019-10-14 20:45,163,91,72,0,0,0
2019-10-14 21:00,118,46,72,0,0,0
2019-10-14 21:15,134,52,82,0,0,0
2019-10-14 21:30,124,37,87,0,0,0
2019-10-14 21:45,150,45,105,0,0,0
2019-10-14 22:00,111,45,66,0,0,0
2019-10-14 22:15,138,64,74,0,0,0
2019-10-14 22:30,125,31,94,0,0,0
2019-10-14 22:45,99,29,70,0,0,0
2019-10-14 23:00,79,22,57,0,0,0
2019-10-14 23:15,90,35,55,0,0,0
2019-10-14 23:30,37,15,22,0,0,0
2019-10-14 23:45,60,18,42,0,0,0
2019-10-15 00:00,37,8,29,0,0,0
2019-10-15 00:15,43,19,24,0,0,0
2019-10-15 00:30,35,19,16,0,0,0
2019-10-15 00:45,29,13,16,0,0,0
2019-10-15 01:00,7,4,3,0,0,0
2019-10-15 01:15,23,2,21,0,0,0
2019-10-15 01:30,19,6,13,0,0,0
2019-10-15 01:45,38,7,31,0,0,0
2019-10-15 02:00,19,9,10,0,0,0
2019-10-15 02:15,8,0,8,0,0,0
2019-10-15 02:30,7,1,6,0,0,0
2019-10-15 02:45,7,2,5,0,0,0
2019-10-15 03:00,11,5,6,0,0,0
2019-10-15 03:15,1,0,1,0,0,0
2019-10-15 03:30,1,1,0,0,0,0
2019-10-15 03:45,3,2,1,0,0,0
2019-10-15 04:00,3,0,3,0,0,0
2019-10-15 04:15,2,1,1,0,0,0
2019-10-15 04:30,5,5,0,0,0,0
2019-10-15 04:45,8,5,3,0,0,0
2019-10-15 05:00,9,7,2,0,0,0
2019-10-15 05:15,13,9,4,0,0,0
2019-10-15 05:30,22,15,7,0,0,0
2019-10-15 05:45,19,10,9,0,0,0
2019-10-15 06:00,27,16,11,0,0,0
2019-10-15 06:15,50,36,14,0,0,0
2019-10-15 06:30,62,41,21,0,0,0
2019-10-15 06:45,89,62,27,0,0,0
2019-10-15 07:00,93,55,38,0,0,0
2019-10-15 07:15,117,75,42,0,0,0
2019-10-15 07:30,231,118,113,0,0,0
2019-10-15 07:45,557,282,275,0,0,0
2019-10-15 08:00,703,319,384,0,0,0
2019-10-15 08:15,301,181,120,0,0,0
2019-10-15 08:30,252,149,103,0,0,0
2019-10-15 08:45,323,165,158,0,0,0
2019-10-15 09:00,267,126,141,0,0,0
2019-10-15 09:15,247,103,144,0,0,0
2019-10-15 09:30,354,147,207,0,0,0
2019-10-15 09:45,851,397,454,0,0,0
2019-10-15 10:00,671,404,267,0,0,0
2019-10-15 10:15,223,99,124,0,0,0
2019-10-15 10:30,170,84,86,0,0,0
2019-10-15 10:45,187,98,89,0,0,0
2019-10-15 11:00,279,137,142,0,0,0
2019-10-15 11:15,220,133,87,0,0,0
2019-10-15 11:30,318,160,158,0,0,0
2019-10-15 11:45,726,419,307,0,0,0
2019-10-15 12:00,657,380,277,0,0,0
2019-10-15 12:15,312,150,162,0,0,0
2019-10-15 12:30,237,118,119,0,0,0
2019-10-15 12:45,250,135,115,0,0,0
2019-10-15 13:00,318,170,148,0,0,0
2019-10-15 13:15,268,153,115,0,0,0
2019-10-15 13:30,370,178,192,0,0,0
2019-10-15 13:45,726,372,354,0,0,0
2019-10-15 14:00,533,283,250,0,0,0
2019-10-15 14:15,270,124,146,0,0,0
2019-10-15 14:30,256,118,138,0,0,0
2019-10-15 14:45,266,128,138,0,0,0
2019-10-15 15:00,252,138,114,0,0,0
2019-10-15 15:15,306,154,152,0,0,0
2019-10-15 15:30,385,200,185,0,0,0
2019-10-15 15:45,705,373,332,0,0,0
2019-10-15 16:00,605,314,291,0,0,0
2019-10-15 16:15,345,174,171,0,0,0
2019-10-15 16:30,319,142,177,0,0,0
2019-10-15 16:45,352,149,203,0,0,0
2019-10-15 17:00,304,145,159,0,0,0
2019-10-15 17:15,274,177,97,0,0,0
2019-10-15 17:30,326,298,28,0,0,0
2019-10-15 17:45,638,292,346,0,0,0
2019-10-15 18:00,522,232,290,0,0,0
2019-10-15 18:15,351,144,207,0,0,0
2019-10-15 18:30,305,133,172,0,0,0
2019-10-15 18:45,329,126,203,0,0,0
2019-10-15 19:00,260,130,130,0,0,0
2019-10-15 19:15,258,135,123,0,0,0
2019-10-15 19:30,275,129,146,0,0,0
2019-10-15 19:45,278,112,166,0,0,0
2019-10-15 20:00,233,92,141,0,0,0
2019-10-15 20:15,198,93,105,0,0,0
2019-10-15 20:30,141,56,85,0,0,0
2019-10-15 20:45,117,65,52,0,0,0
2019-10-15 21:00,138,55,83,0,0,0
2019-10-15 21:15,113,41,72,0,0,0
2019-10-15 21:30,99,38,61,0,0,0
2019-10-15 21:45,111,40,71,0,0,0
2019-10-15 22:00,98,39,59,0,0,0
2019-10-15 22:15,142,74,68,0,0,0
2019-10-15 22:30,89,38,51,0,0,0
2019-10-15 22:45,86,32,54,0,0,0
2019-10-15 23:00,64,18,46,0,0,0
2019-10-15 23:15,60,23,37,0,0,0
2019-10-15 23:30,48,12,36,0,0,0
2019-10-15 23:45,66,32,34,0,0,0
2019-10-16 00:00,41,24,17,0,0,0
2019-10-16 00:15,30,14,16,0,0,0
2019-10-16 00:30,52,27,25,0,0,0
2019-10-16 00:45,32,18,14,0,0,0
2019-10-16 01:00,23,9,14,0,0,0
2019-10-16 01:15,27,18,9,0,0,0
2019-10-16 01:30,13,2,11,0,0,0
2019-10-16 01:45,11,1,10,0,0,0
2019-10-16 02:00,16,4,12,0,0,0
2019-10-16 02:15,10,2,8,0,0,0
2019-10-16 02:30,5,0,5,0,0,0
2019-10-16 02:45,13,1,12,0,0,0
2019-10-16 03:00,9,1,8,0,0,0
2019-10-16 03:15,13,0,13,0,0,0
2019-10-16 03:30,28,1,27,0,0,0
2019-10-16 03:45,12,5,7,0,0,0
2019-10-16 04:00,25,2,23,0,0,0
2019-10-16 04:15,6,1,5,0,0,0
2019-10-16 04:30,21,5,16,0,0,0
2019-10-16 04:45,15,9,6,0,0,0
2019-10-16 05:00,11,4,7,0,0,0
2019-10-16 05:15,11,7,4,0,0,0
2019-10-16 05:30,19,12,7,0,0,0
2019-10-16 05:45,19,8,11,0,0,0
2019-10-16 06:00,25,12,13,0,0,0
2019-10-16 06:15,34,28,6,0,0,0
2019-10-16 06:30,58,38,20,0,0,0
2019-10-16 06:45,65,50,15,0,0,0
2019-10-16 07:00,86,55,31,0,0,0
2019-10-16 07:15,124,76,48,0,0,0
2019-10-16 07:30,205,106,99,0,0,0
2019-10-16 07:45,504,307,197,0,0,0
2019-10-16 08:00,635,277,358,0,0,0
2019-10-16 08:15,362,183,179,0,0,0
2019-10-16 08:30,217,139,78,0,0,0
2019-10-16 08:45,328,170,158,0,0,0
2019-10-16 09:00,198,97,101,0,0,0
2019-10-16 09:15,150,68,82,0,0,0
2019-10-16 09:30,220,132,88,0,0,0
2019-10-16 09:45,637,336,301,0,0,0
2019-10-16 10:00,624,322,302,0,0,0
2019-10-16 10:15,196,107,89,0,0,0
2019-10-16 10:30,144,77,67,0,0,0
2019-10-16 10:45,200,104,96,0,0,0
2019-10-16 11:00,189,103,86,0,0,0
2019-10-16 11:15,218,133,85,0,0,0
2019-10-16 11:30,295,173,122,0,0,0
2019-10-16 11:45,603,299,304,0,0,0
2019-10-16 12:00,484,273,211,0,0,0
2019-10-16 12:15,251,144,107,0,0,0
2019-10-16 12:30,253,121,132,0,0,0
2019-10-16 12:45,284,159,125,0,0,0
2019-10-16 13:00,272,145,127,0,0,0
2019-10-16 13:15,270,128,142,0,0,0
2019-10-16 13:30,274,159,115,0,0,0
2019-10-16 13:45,580,359,221,0,0,0
2019-10-16 14:00,513,300,213,0,0,0
2019-10-16 14:15,246,128,118,0,0,0
2019-10-16 14:30,224,87,137,0,0,0
2019-10-16 14:45,228,100,128,0,0,0
2019-10-16 15:00,215,87,128,0,0,0
2019-10-16 15:15,310,133,177,0,0,0
2019-10-16 15:30,305,132,173,0,0,0
2019-10-16 15:45,603,335,268,0,0,0
2019-10-16 16:00,504,240,264,0,0,0
2019-10-16 16:15,283,119,164,0,0,0
2019-10-16 16:30,257,119,138,0,0,0
2019-10-16 16:45,287,133,154,0,0,0
2019-10-16 17:00,327,136,191,0,0,0
2019-10-16 17:15,313,153,160,0,0,0
2019-10-16 17:30,383,178,205,0,0,0
2019-10-16 17:45,539,281,258,0,0,0
2019-10-16 18:00,387,173,214,0,0,0
2019-10-16 18:15,329,130,199,0,0,0
2019-10-16 18:30,265,120,145,0,0,0
2019-10-16 18:45,286,146,140,0,0,0
2019-10-16 19:00,251,120,131,0,0,0
2019-10-16 19:15,284,147,137,0,0,0
2019-10-16 19:30,243,124,119,0,0,0
2019-10-16 19:45,325,123,202,0,0,0
2019-10-16 20:00,257,108,149,0,0,0
2019-10-16 20:15,246,109,137,0,0,0
2019-10-16 20:30,187,84,103,0,0,0
2019-10-16 20:45,186,76,110,0,0,0
2019-10-16 21:00,179,58,121,0,0,0
2019-10-16 21:15,124,48,76,0,0,0
2019-10-16 21:30,131,55,76,0,0,0
2019-10-16 21:45,110,58,52,0,0,0
2019-10-16 22:00,142,73,69,0,0,0
2019-10-16 22:15,124,58,66,0,0,0
2019-10-16 22:30,165,42,123,0,0,0
2019-10-16 22:45,104,43,61,0,0,0
2019-10-16 23:00,97,45,52,0,0,0
2019-10-16 23:15,110,49,61,0,0,0
2019-10-16 23:30,105,28,77,0,0,0
2019-10-16 23:45,111,46,65,0,0,0
2019-10-17 00:00,98,52,46,0,0,0
2019-10-17 00:15,104,55,49,0,0,0
2019-10-17 00:30,78,30,48,0,0,0
2019-10-17 00:45,55,23,32,0,0,0
2019-10-17 01:00,65,31,34,0,0,0
2019-10-17 01:15,51,21,30,0,0,0
2019-10-17 01:30,58,29,29,0,0,0
2019-10-17 01:45,38,13,25,0,0,0
2019-10-17 02:00,52,14,38,0,0,0
2019-10-17 02:15,49,15,34,0,0,0
2019-10-17 02:30,77,20,57,0,0,0
2019-10-17 02:45,58,18,40,0,0,0
2019-10-17 03:00,49,22,27,0,0,0
2019-10-17 03:15,52,11,41,0,0,0
2019-10-17 03:30,21,5,16,0,0,0
2019-10-17 03:45,32,6,26,0,0,0
2019-10-17 04:00,19,8,11,0,0,0
2019-10-17 04:15,22,4,18,0,0,0
2019-10-17 04:30,18,7,11,0,0,0
2019-10-17 04:45,27,6,21,0,0,0
2019-10-17 05:00,12,4,8,0,0,0
2019-10-17 05:15,29,10,19,0,0,0
2019-10-17 05:30,24,8,16,0,0,0
2019-10-17 05:45,17,12,5,0,0,0
2019-10-17 06:00,25,20,5,0,0,0
2019-10-17 06:15,38,24,14,0,0,0
2019-10-17 06:30,47,30,17,0,0,0
2019-10-17 06:45,83,53,30,0,0,0
2019-10-17 07:00,83,44,39,0,0,0
2019-10-17 07:15,101,63,38,0,0,0
2019-10-17 07:30,192,95,97,0,0,0
2019-10-17 07:45,414,175,239,0,0,0
2019-10-17 08:00,556,231,325,0,0,0
2019-10-17 08:15,275,121,154,0,0,0
2019-10-17 08:30,191,115,76,0,0,0
2019-10-17 08:45,259,121,138,0,0,0
2019-10-17 09:00,188,90,98,0,0,0
2019-10-17 09:15,175,102,73,0,0,0
2019-10-17 09:30,193,118,75,0,0,0
2019-10-17 09:45,536,290,246,0,0,0
2019-10-17 10:00,746,466,280,0,0,0
2019-10-17 10:15,159,75,84,0,0,0
2019-10-17 10:30,91,42,49,0,0,0
2019-10-17 10:45,132,73,59,0,0,0
2019-10-17 11:00,220,103,117,0,0,0
2019-10-17 11:15,149,87,62,0,0,0
2019-10-17 11:30,252,99,153,0,0,0
2019-10-17 11:45,495,292,203,0,0,0
2019-10-17 12:00,474,245,229,0,0,0
2019-10-17 12:15,222,108,114,0,0,0
2019-10-17 12:30,176,84,92,0,0,0
2019-10-17 12:45,182,101,81,0,0,0
2019-10-17 13:00,161,98,63,0,0,0
2019-10-17 13:15,191,101,90,0,0,0
2019-10-17 13:30,241,109,132,0,0,0
2019-10-17 13:45,557,285,272,0,0,0
2019-10-17 14:00,486,280,206,0,0,0
2019-10-17 14:15,222,105,117,0,0,0
2019-10-17 14:30,206,102,104,0,0,0
2019-10-17 14:45,188,100,88,0,0,0
2019-10-17 15:00,200,94,106,0,0,0
2019-10-17 15:15,237,124,113,0,0,0
2019-10-17 15:30,297,153,144,0,0,0
2019-10-17 15:45,564,332,232,0,0,0
2019-10-17 16:00,464,262,202,0,0,0
2019-10-17 16:15,278,142,136,0,0,0
2019-10-17 16:30,265,135,130,0,0,0
2019-10-17 16:45,269,132,137,0,0,0
2019-10-17 17:00,262,122,140,0,0,0
2019-10-17 17:15,277,128,149,0,0,0
2019-10-17 17:30,370,200,170,0,0,0
2019-10-17 17:45,463,230,233,0,0,0
2019-10-17 18:00,358,196,162,0,0,0
2019-10-17 18:15,269,137,132,0,0,0
2019-10-17 18:30,245,132,113,0,0,0
2019-10-17 18:45,260,145,115,0,0,0
2019-10-17 19:00,248,117,131,0,0,0
2019-10-17 19:15,224,126,98,0,0,0
2019-10-17 19:30,242,124,118,0,0,0
2019-10-17 19:45,258,175,83,0,0,0
2019-10-17 20:00,124,123,1,0,0,0
2019-10-17 20:15,101,99,2,0,0,0
2019-10-17 20:30,149,80,69,0,0,0
2019-10-17 20:45,138,62,76,0,0,0
2019-10-17 21:00,116,59,57,0,0,0
2019-10-17 21:15,119,49,70,0,0,0
2019-10-17 21:30,123,56,67,0,0,0
2019-10-17 21:45,117,44,73,0,0,0
2019-10-17 22:00,105,41,64,0,0,0
2019-10-17 22:15,132,63,69,0,0,0
2019-10-17 22:30,76,19,57,0,0,0
2019-10-17 22:45,92,28,64,0,0,0
2019-10-17 23:00,92,20,72,0,0,0
2019-10-17 23:15,64,21,43,0,0,0
2019-10-17 23:30,85,24,61,0,0,0
2019-10-17 23:45,94,29,65,0,0,0
2019-10-18 00:00,58,16,42,0,0,0
2019-10-18 00:15,55,10,45,0,0,0
2019-10-18 00:30,40,11,29,0,0,0
2019-10-18 00:45,36,10,26,0,0,0
2019-10-18 01:00,33,12,21,0,0,0
2019-10-18 01:15,19,0,19,0,0,0
2019-10-18 01:30,31,3,28,0,0,0
2019-10-18 01:45,21,8,13,0,0,0
2019-10-18 02:00,24,5,19,0,0,0
2019-10-18 02:15,12,2,10,0,0,0
2019-10-18 02:30,13,3,10,0,0,0
2019-10-18 02:45,9,0,9,0,0,0
2019-10-18 03:00,9,2,7,0,0,0
2019-10-18 03:15,24,4,20,0,0,0
2019-10-18 03:30,15,1,14,0,0,0
2019-10-18 03:45,10,3,7,0,0,0
2019-10-18 04:00,10,1,9,0,0,0
2019-10-18 04:15,2,0,2,0,0,0
2019-10-18 04:30,15,6,9,0,0,0
2019-10-18 04:45,14,7,7,0,0,0
2019-10-18 05:00,14,8,6,0,0,0
2019-10-18 05:15,7,5,2,0,0,0
2019-10-18 05:30,17,8,9,0,0,0
2019-10-18 05:45,25,14,11,0,0,0
2019-10-18 06:00,33,17,16,0,0,0
2019-10-18 06:15,42,23,19,0,0,0
2019-10-18 06:30,49,34,15,0,0,0
2019-10-18 06:45,68,43,25,0,0,0
2019-10-18 07:00,69,42,27,0,0,0
2019-10-18 07:15,103,54,49,0,0,0
2019-10-18 07:30,158,87,71,0,0,0
2019-10-18 07:45,369,175,194,0,0,0
2019-10-18 08:00,453,180,273,0,0,0
2019-10-18 08:15,241,101,140,0,0,0
2019-10-18 08:30,187,105,82,0,0,0
2019-10-18 08:45,241,123,118,0,0,0
2019-10-18 09:00,201,102,99,0,0,0
2019-10-18 09:15,150,83,67,0,0,0
2019-10-18 09:30,179,103,76,0,0,0
2019-10-18 09:45,382,233,149,0,0,0
2019-10-18 10:00,502,329,173,0,0,0
2019-10-18 10:15,187,108,79,0,0,0
2019-10-18 10:30,127,73,54,0,0,0
2019-10-18 10:45,157,98,59,0,0,0
2019-10-18 11:00,233,113,120,0,0,0
2019-10-18 11:15,164,77,87,0,0,0
2019-10-18 11:30,205,101,104,0,0,0
2019-10-18 11:45,381,218,163,0,0,0
2019-10-18 12:00,349,181,168,0,0,0
2019-10-18 12:15,236,129,107,0,0,0
2019-10-18 12:30,226,121,105,0,0,0
2019-10-18 12:45,264,148,116,0,0,0
2019-10-18 13:00,139,58,81,0,0,0
2019-10-18 13:15,213,106,107,0,0,0
2019-10-18 13:30,239,126,113,0,0,0
2019-10-18 13:45,343,202,141,0,0,0
2019-10-18 14:00,285,137,148,0,0,0
2019-10-18 14:15,195,102,93,0,0,0
2019-10-18 14:30,200,104,96,0,0,0
2019-10-18 14:45,165,78,87,0,0,0
2019-10-18 15:00,212,98,114,0,0,0
2019-10-18 15:15,175,100,75,0,0,0
2019-10-18 15:30,198,104,94,0,0,0
2019-10-18 15:45,313,171,142,0,0,0
2019-10-18 16:00,235,124,111,0,0,0
2019-10-18 16:15,214,102,112,0,0,0
2019-10-18 16:30,180,92,88,0,0,0
2019-10-18 16:45,223,114,109,0,0,0
2019-10-18 17:00,194,95,99,0,0,0
2019-10-18 17:15,237,108,129,0,0,0
2019-10-18 17:30,211,101,110,0,0,0
2019-10-18 17:45,241,118,123,0,0,0
2019-10-18 18:00,240,116,124,0,0,0
2019-10-18 18:15,242,118,124,0,0,0
2019-10-18 18:30,183,87,96,0,0,0
2019-10-18 18:45,204,108,96,0,0,0
2019-10-18 19:00,198,89,109,0,0,0
2019-10-18 19:15,199,90,109,0,0,0
2019-10-18 19:30,141,72,69,0,0,0
2019-10-18 19:45,172,107,65,0,0,0
2019-10-18 20:00,142,81,61,0,0,0
2019-10-18 20:15,166,85,81,0,0,0
2019-10-18 20:30,106,53,53,0,0,0
2019-10-18 20:45,115,52,63,0,0,0
2019-10-18 21:00,108,42,66,0,0,0
2019-10-18 21:15,123,63,60,0,0,0
2019-10-18 21:30,80,34,46,0,0,0
2019-10-18 21:45,84,32,52,0,0,0
2019-10-18 22:00,78,28,50,0,0,0
2019-10-18 22:15,91,25,66,0,0,0
2019-10-18 22:30,75,26,49,0,0,0
2019-10-18 22:45,87,30,57,0,0,0
2019-10-18 23:00,85,23,62,0,0,0
2019-10-18 23:15,70,29,41,0,0,0
2019-10-18 23:30,60,27,33,0,0,0
2019-10-18 23:45,72,23,49,0,0,0
2019-10-19 00:00,100,28,72,0,0,0
2019-10-19 00:15,80,23,57,0,0,0
2019-10-19 00:30,70,26,44,0,0,0
2019-10-19 00:45,62,25,37,0,0,0
2019-10-19 01:00,69,27,42,0,0,0
2019-10-19 01:15,61,26,35,0,0,0
2019-10-19 01:30,73,26,47,0,0,0
2019-10-19 01:45,58,11,47,0,0,0
2019-10-19 02:00,68,16,52,0,0,0
2019-10-19 02:15,54,7,47,0,0,0
2019-10-19 02:30,47,12,35,0,0,0
2019-10-19 02:45,51,8,43,0,0,0
2019-10-19 03:00,46,8,38,0,0,0
2019-10-19 03:15,50,10,40,0,0,0
2019-10-19 03:30,30,14,16,0,0,0
2019-10-19 03:45,56,14,42,0,0,0
2019-10-19 04:00,38,9,29,0,0,0
2019-10-19 04:15,29,4,25,0,0,0
2019-10-19 04:30,16,5,11,0,0,0
2019-10-19 04:45,22,3,19,0,0,0
2019-10-19 05:00,12,4,8,0,0,0
2019-10-19 05:15,15,3,12,0,0,0
2019-10-19 05:30,26,12,14,0,0,0
2019-10-19 05:45,15,13,2,0,0,0
2019-10-19 06:00,18,14,4,0,0,0
2019-10-19 06:15,20,8,12,0,0,0
2019-10-19 06:30,8,3,5,0,0,0
2019-10-19 06:45,11,9,2,0,0,0
2019-10-19 07:00,10,8,2,0,0,0
2019-10-19 07:15,12,7,5,0,0,0
2019-10-19 07:30,15,12,3,0,0,0
2019-10-19 07:45,32,25,7,0,0,0
2019-10-19 08:00,37,26,11,0,0,0
2019-10-19 08:15,56,40,16,0,0,0
2019-10-19 08:30,53,45,8,0,0,0
2019-10-19 08:45,84,57,27,0,0,0
2019-10-19 09:00,72,49,23,0,0,0
2019-10-19 09:15,63,40,23,0,0,0
2019-10-19 09:30,89,68,21,0,0,0
2019-10-19 09:45,114,96,18,0,0,0
2019-10-19 10:00,94,68,26,0,0,0
2019-10-19 10:15,74,55,19,0,0,0
2019-10-19 10:30,78,56,22,0,0,0
2019-10-19 10:45,89,59,30,0,0,0
2019-10-19 11:00,95,59,36,0,0,0
2019-10-19 11:15,116,72,44,0,0,0
2019-10-19 11:30,97,56,41,0,0,0
2019-10-19 11:45,131,95,36,0,0,0
2019-10-19 12:00,117,82,35,0,0,0
2019-10-19 12:15,118,64,54,0,0,0
2019-10-19 12:30,134,79,55,0,0,0
2019-10-19 12:45,164,107,57,0,0,0
2019-10-19 13:00,129,67,62,0,0,0
2019-10-19 13:15,140,81,59,0,0,0
2019-10-19 13:30,107,62,45,0,0,0
2019-10-19 13:45,144,76,68,0,0,0
2019-10-19 14:00,130,60,70,0,0,0
2019-10-19 14:15,129,64,65,0,0,0
2019-10-19 14:30,100,55,45,0,0,0
2019-10-19 14:45,137,57,80,0,0,0
2019-10-19 15:00,127,44,83,0,0,0
2019-10-19 15:15,110,42,68,0,0,0
2019-10-19 15:30,86,40,46,0,0,0
2019-10-19 15:45,121,64,57,0,0,0
2019-10-19 16:00,127,54,73,0,0,0
2019-10-19 16:15,116,47,69,0,0,0
2019-10-19 16:30,101,36,65,0,0,0
2019-10-19 16:45,125,53,72,0,0,0
2019-10-19 17:00,90,36,54,0,0,0
2019-10-19 17:15,110,33,77,0,0,0
2019-10-19 17:30,98,36,62,0,0,0
2019-10-19 17:45,136,60,76,0,0,0
2019-10-19 18:00,132,51,81,0,0,0
2019-10-19 18:15,124,48,76,0,0,0
2019-10-19 18:30,102,47,55,0,0,0
2019-10-19 18:45,104,48,56,0,0,0
2019-10-19 19:00,104,50,54,0,0,0
2019-10-19 19:15,107,50,57,0,0,0
2019-10-19 19:30,86,37,49,0,0,0
2019-10-19 19:45,121,62,59,0,0,0
2019-10-19 20:00,99,53,46,0,0,0
2019-10-19 20:15,71,30,41,0,0,0
2019-10-19 20:30,96,46,50,0,0,0
2019-10-19 20:45,95,56,39,0,0,0
2019-10-19 21:00,96,35,61,0,0,0
2019-10-19 21:15,85,34,51,0,0,0
2019-10-19 21:30,53,24,29,0,0,0
2019-10-19 21:45,49,28,21,0,0,0
2019-10-19 22:00,77,32,45,0,0,0
2019-10-19 22:15,47,17,30,0,0,0
2019-10-19 22:30,51,25,26,0,0,0
2019-10-19 22:45,42,14,28,0,0,0
2019-10-19 23:00,41,22,19,0,0,0
2019-10-19 23:15,79,25,54,0,0,0
2019-10-19 23:30,49,23,26,0,0,0
2019-10-19 23:45,43,22,21,0,0,0
2019-10-20 00:00,47,8,39,0,0,0
2019-10-20 00:15,60,15,45,0,0,0
2019-10-20 00:30,41,16,25,0,0,0
2019-10-20 00:45,53,16,37,0,0,0
2019-10-20 01:00,68,23,45,0,0,0
2019-10-20 01:15,45,14,31,0,0,0
2019-10-20 01:30,53,16,37,0,0,0
2019-10-20 01:45,37,15,22,0,0,0
2019-10-20 02:00,63,35,28,0,0,0
2019-10-20 02:15,33,11,22,0,0,0
2019-10-20 02:30,40,8,32,0,0,0
2019-10-20 02:45,37,6,31,0,0,0
2019-10-20 03:00,19,3,16,0,0,0
2019-10-20 03:15,24,4,20,0,0,0
2019-10-20 03:30,26,8,18,0,0,0
2019-10-20 03:45,30,10,20,0,0,0
2019-10-20 04:00,34,1,33,0,0,0
2019-10-20 04:15,42,9,33,0,0,0
2019-10-20 04:30,19,4,15,0,0,0
2019-10-20 04:45,15,3,12,0,0,0
2019-10-20 05:00,19,3,16,0,0,0
2019-10-20 05:15,11,1,10,0,0,0
2019-10-20 05:30,14,3,11,0,0,0
2019-10-20 05:45,4,2,2,0,0,0
2019-10-20 06:00,7,1,6,0,0,0
2019-10-20 06:15,7,2,5,0,0,0
2019-10-20 06:30,16,7,9,0,0,0
2019-10-20 06:45,21,9,12,0,0,0
2019-10-20 07:00,8,7,1,0,0,0
2019-10-20 07:15,10,6,4,0,0,0
2019-10-20 07:30,8,2,6,0,0,0
2019-10-20 07:45,15,9,6,0,0,0
2019-10-20 08:00,11,9,2,0,0,0
2019-10-20 08:15,10,6,4,0,0,0
2019-10-20 08:30,21,13,8,0,0,0
2019-10-20 08:45,28,21,7,0,0,0
2019-10-20 09:00,18,12,6,0,0,0
2019-10-20 09:15,22,19,3,0,0,0
2019-10-20 09:30,36,28,8,0,0,0
2019-10-20 09:45,69,57,12,0,0,0
2019-10-20 10:00,51,35,16,0,0,0
2019-10-20 10:15,53,38,15,0,0,0
2019-10-20 10:30,53,30,23,0,0,0
2019-10-20 10:45,65,49,16,0,0,0
2019-10-20 11:00,55,30,25,0,0,0
2019-10-20 11:15,64,45,19,0,0,0
2019-10-20 11:30,38,23,15,0,0,0
2019-10-20 11:45,72,33,39,0,0,0
2019-10-20 12:00,58,38,20,0,0,0
2019-10-20 12:15,65,33,32,0,0,0
2019-10-20 12:30,67,29,38,0,0,0
2019-10-20 12:45,63,39,24,0,0,0
2019-10-20 13:00,69,31,38,0,0,0
2019-10-20 13:15,57,34,23,0,0,0
2019-10-20 13:30,73,34,39,0,0,0
2019-10-20 13:45,62,33,29,0,0,0
2019-10-20 14:00,74,34,40,0,0,0
2019-10-20 14:15,60,24,36,0,0,0
2019-10-20 14:30,77,30,47,0,0,0
2019-10-20 14:45,85,51,34,0,0,0
2019-10-20 15:00,75,25,50,0,0,0
2019-10-20 15:15,57,21,36,0,0,0
2019-10-20 15:30,51,28,23,0,0,0
2019-10-20 15:45,58,34,24,0,0,0
2019-10-20 16:00,65,25,40,0,0,0
2019-10-20 16:15,55,32,23,0,0,0
2019-10-20 16:30,60,22,38,0,0,0
2019-10-20 16:45,57,31,26,0,0,0
2019-10-20 17:00,67,21,46,0,0,0
2019-10-20 17:15,68,24,44,0,0,0
2019-10-20 17:30,42,30,12,0,0,0
2019-10-20 17:45,77,35,42,0,0,0
2019-10-20 18:00,62,25,37,0,0,0
2019-10-20 18:15,58,26,32,0,0,0
2019-10-20 18:30,72,33,39,0,0,0
2019-10-20 18:45,78,41,37,0,0,0
2019-10-20 19:00,77,28,49,0,0,0
2019-10-20 19:15,63,33,30,0,0,0
2019-10-20 19:30,55,26,29,0,0,0
2019-10-20 19:45,64,23,41,0,0,0
2019-10-20 20:00,51,25,26,0,0,0
2019-10-20 20:15,53,18,35,0,0,0
2019-10-20 20:30,42,13,29,0,0,0
2019-10-20 20:45,30,10,20,0,0,0
2019-10-20 21:00,42,16,26,0,0,0
2019-10-20 21:15,31,9,22,0,0,0
2019-10-20 21:30,38,11,27,0,0,0
2019-10-20 21:45,36,15,21,0,0,0
2019-10-20 22:00,38,13,25,0,0,0
2019-10-20 22:15,57,18,39,0,0,0
2019-10-20 22:30,34,12,22,0,0,0
2019-10-20 22:45,25,6,19,0,0,0
2019-10-20 23:00,29,12,17,0,0,0
2019-10-20 23:15,30,5,25,0,0,0
2019-10-20 23:30,14,2,12,0,0,0
2019-10-20 23:45,17,8,9,0,0,0
2019-10-21 00:00,9,5,4,0,0,0
2019-10-21 00:15,3,1,2,0,0,0
2019-10-21 00:30,11,5,6,0,0,0
2019-10-21 00:45,5,2,3,0,0,0
2019-10-21 01:00,10,0,10,0,0,0
2019-10-21 01:15,3,1,2,0,0,0
2019-10-21 01:30,3,1,2,0,0,0
2019-10-21 01:45,1,1,0,0,0,0
2019-10-21 02:00,3,1,2,0,0,0
2019-10-21 02:15,0,0,0,0,0,0
2019-10-21 02:30,8,6,2,0,0,0
2019-10-21 02:45,1,0,1,0,0,0
2019-10-21 03:00,1,1,0,0,0,0
2019-10-21 03:15,1,0,1,0,0,0
2019-10-21 03:30,0,0,0,0,0,0
2019-10-21 03:45,2,0,2,0,0,0
2019-10-21 04:00,1,1,0,0,0,0
2019-10-21 04:15,1,1,0,0,0,0
2019-10-21 04:30,6,4,2,0,0,0
2019-10-21 04:45,10,7,3,0,0,0
2019-10-21 05:00,6,3,3,0,0,0
2019-10-21 05:15,11,8,3,0,0,0
2019-10-21 05:30,14,6,8,0,0,0
2019-10-21 05:45,25,15,10,0,0,0
2019-10-21 06:00,28,21,7,0,0,0
2019-10-21 06:15,30,17,13,0,0,0
2019-10-21 06:30,57,39,18,0,0,0
2019-10-21 06:45,81,54,27,0,0,0
2019-10-21 07:00,82,54,28,0,0,0
2019-10-21 07:15,100,57,43,0,0,0
2019-10-21 07:30,150,84,66,0,0,0
2019-10-21 07:45,394,204,190,0,0,0
2019-10-21 08:00,506,229,277,0,0,0
2019-10-21 08:15,301,158,143,0,0,0
2019-10-21 08:30,166,93,73,0,0,0
2019-10-21 08:45,298,160,138,0,0,0
2019-10-21 09:00,194,90,104,0,0,0
2019-10-21 09:15,156,75,81,0,0,0
2019-10-21 09:30,227,126,101,0,0,0
2019-10-21 09:45,497,272,225,0,0,0
2019-10-21 10:00,662,406,256,0,0,0
2019-10-21 10:15,159,79,80,0,0,0
2019-10-21 10:30,110,61,49,0,0,0
2019-10-21 10:45,135,72,63,0,0,0
2019-10-21 11:00,208,112,96,0,0,0
2019-10-21 11:15,164,76,88,0,0,0
2019-10-21 11:30,189,109,80,0,0,0
2019-10-21 11:45,548,299,249,0,0,0
2019-10-21 12:00,516,275,241,0,0,0
2019-10-21 12:15,238,108,130,0,0,0
2019-10-21 12:30,209,115,94,0,0,0
2019-10-21 12:45,210,100,110,0,0,0
2019-10-21 13:00,215,114,101,0,0,0
2019-10-21 13:15,238,124,114,0,0,0
2019-10-21 13:30,245,110,135,0,0,0
2019-10-21 13:45,609,275,334,0,0,0
2019-10-21 14:00,577,279,298,0,0,0
2019-10-21 14:15,222,102,120,0,0,0
2019-10-21 14:30,212,88,124,0,0,0
2019-10-21 14:45,215,97,118,0,0,0
2019-10-21 15:00,201,85,116,0,0,0
2019-10-21 15:15,229,109,120,0,0,0
2019-10-21 15:30,265,145,120,0,0,0
2019-10-21 15:45,690,385,305,0,0,0
2019-10-21 16:00,587,296,291,0,0,0
2019-10-21 16:15,343,167,176,0,0,0
2019-10-21 16:30,266,150,116,0,0,0
2019-10-21 16:45,316,171,145,0,0,0
2019-10-21 17:00,335,163,172,0,0,0
2019-10-21 17:15,349,174,175,0,0,0
2019-10-21 17:30,402,212,190,0,0,0
2019-10-21 17:45,768,383,385,0,0,0
2019-10-21 18:00,497,246,251,0,0,0
2019-10-21 18:15,382,186,196,0,0,0
2019-10-21 18:30,387,170,217,0,0,0
2019-10-21 18:45,371,154,217,0,0,0
2019-10-21 19:00,340,167,173,0,0,0
2019-10-21 19:15,372,196,176,0,0,0
2019-10-21 19:30,392,208,184,0,0,0
2019-10-21 19:45,456,216,240,0,0,0
2019-10-21 20:00,275,119,156,0,0,0
2019-10-21 20:15,260,134,126,0,0,0
2019-10-21 20:30,201,120,81,0,0,0
2019-10-21 20:45,164,88,76,0,0,0
2019-10-21 21:00,133,73,60,0,0,0
2019-10-21 21:15,112,47,65,0,0,0
2019-10-21 21:30,121,38,83,0,0,0
2019-10-21 21:45,106,36,70,0,0,0
2019-10-21 22:00,111,43,68,0,0,0
2019-10-21 22:15,133,60,73,0,0,0
2019-10-21 22:30,115,27,88,0,0,0
2019-10-21 22:45,111,34,77,0,0,0
2019-10-21 23:00,95,29,66,0,0,0
2019-10-21 23:15,95,27,68,0,0,0
2019-10-21 23:30,132,22,110,0,0,0
2019-10-21 23:45,103,19,84,0,0,0
2019-10-22 00:00,107,17,90,0,0,0
2019-10-22 00:15,105,24,81,0,0,0
2019-10-22 00:30,119,32,87,0,0,0
2019-10-22 00:45,104,35,69,0,0,0
2019-10-22 01:00,78,15,63,0,0,0
2019-10-22 01:15,55,19,36,0,0,0
2019-10-22 01:30,54,18,36,0,0,0
2019-10-22 01:45,60,3,57,0,0,0
2019-10-22 02:00,44,6,38,0,0,0
2019-10-22 02:15,50,14,36,0,0,0
2019-10-22 02:30,32,6,26,0,0,0
2019-10-22 02:45,22,5,17,0,0,0
2019-10-22 03:00,15,5,10,0,0,0
2019-10-22 03:15,18,2,16,0,0,0
2019-10-22 03:30,16,3,13,0,0,0
2019-10-22 03:45,9,0,9,0,0,0
2019-10-22 04:00,12,1,11,0,0,0
2019-10-22 04:15,4,3,1,0,0,0
2019-10-22 04:30,10,3,7,0,0,0
2019-10-22 04:45,11,6,5,0,0,0
2019-10-22 05:00,10,6,4,0,0,0
2019-10-22 05:15,13,2,11,0,0,0
2019-10-22 05:30,24,14,10,0,0,0
2019-10-22 05:45,30,19,11,0,0,0
2019-10-22 06:00,24,17,7,0,0,0
2019-10-22 06:15,31,17,14,0,0,0
2019-10-22 06:30,46,36,10,0,0,0
2019-10-22 06:45,83,48,35,0,0,0
2019-10-22 07:00,96,59,37,0,0,0
2019-10-22 07:15,112,64,48,0,0,0
2019-10-22 07:30,194,108,86,0,0,0
2019-10-22 07:45,433,229,204,0,0,0
2019-10-22 08:00,670,305,365,0,0,0
2019-10-22 08:15,348,209,139,0,0,0
2019-10-22 08:30,209,118,91,0,0,0
2019-10-22 08:45,329,173,156,0,0,0
2019-10-22 09:00,245,154,91,0,0,0
2019-10-22 09:15,141,79,62,0,0,0
2019-10-22 09:30,219,111,108,0,0,0
2019-10-22 09:45,680,318,362,0,0,0
2019-10-22 10:00,668,402,266,0,0,0
2019-10-22 10:15,200,94,106,0,0,0
2019-10-22 10:30,167,75,92,0,0,0
2019-10-22 10:45,161,88,73,0,0,0
2019-10-22 11:00,263,135,128,0,0,0
2019-10-22 11:15,173,89,84,0,0,0
2019-10-22 11:30,217,120,97,0,0,0
2019-10-22 11:45,682,347,335,0,0,0
2019-10-22 12:00,594,298,296,0,0,0
2019-10-22 12:15,296,123,173,0,0,0
2019-10-22 12:30,269,130,139,0,0,0
2019-10-22 12:45,265,129,136,0,0,0
2019-10-22 13:00,263,160,103,0,0,0
2019-10-22 13:15,303,123,180,0,0,0
2019-10-22 13:30,305,162,143,0,0,0
2019-10-22 13:45,690,352,338,0,0,0
2019-10-22 14:00,498,272,226,0,0,0
2019-10-22 14:15,251,124,127,0,0,0
2019-10-22 14:30,211,86,125,0,0,0
2019-10-22 14:45,244,119,125,0,0,0
2019-10-22 15:00,198,104,94,0,0,0
2019-10-22 15:15,235,125,110,0,0,0
2019-10-22 15:30,336,204,132,0,0,0
2019-10-22 15:45,658,374,284,0,0,0
2019-10-22 16:00,555,250,305,0,0,0
2019-10-22 16:15,331,142,189,0,0,0
2019-10-22 16:30,311,163,148,0,0,0
2019-10-22 16:45,351,171,180,0,0,0
2019-10-22 17:00,324,171,153,0,0,0
2019-10-22 17:15,369,179,190,0,0,0
2019-10-22 17:30,396,223,173,0,0,0
2019-10-22 17:45,690,329,361,0,0,0
2019-10-22 18:00,507,230,277,0,0,0
2019-10-22 18:15,340,155,185,0,0,0
2019-10-22 18:30,308,153,155,0,0,0
2019-10-22 18:45,331,144,187,0,0,0
2019-10-22 19:00,261,131,130,0,0,0
2019-10-22 19:15,268,138,130,0,0,0
2019-10-22 19:30,295,126,169,0,0,0
2019-10-22 19:45,352,133,219,0,0,0
2019-10-22 20:00,301,130,171,0,0,0
2019-10-22 20:15,232,97,135,0,0,0
2019-10-22 20:30,136,61,75,0,0,0
2019-10-22 20:45,153,59,94,0,0,0
2019-10-22 21:00,112,54,58,0,0,0
2019-10-22 21:15,161,55,106,0,0,0
2019-10-22 21:30,113,44,69,0,0,0
2019-10-22 21:45,117,52,65,0,0,0
2019-10-22 22:00,132,37,95,0,0,0
2019-10-22 22:15,127,60,67,0,0,0
2019-10-22 22:30,131,42,89,0,0,0
2019-10-22 22:45,108,51,57,0,0,0
2019-10-22 23:00,113,36,77,0,0,0
2019-10-22 23:15,77,28,49,0,0,0
2019-10-22 23:30,80,22,58,0,0,0
2019-10-22 23:45,46,17,29,0,0,0
2019-10-23 00:00,44,13,31,0,0,0
2019-10-23 00:15,57,18,39,0,0,0
2019-10-23 00:30,42,20,22,0,0,0
2019-10-23 00:45,30,11,19,0,0,0
2019-10-23 01:00,44,12,32,0,0,0
2019-10-23 01:15,15,7,8,0,0,0
2019-10-23 01:30,13,3,10,0,0,0
2019-10-23 01:45,14,6,8,0,0,0
2019-10-23 02:00,18,1,17,0,0,0
2019-10-23 02:15,14,1,13,0,0,0
2019-10-23 02:30,16,3,13,0,0,0
2019-10-23 02:45,16,4,12,0,0,0
2019-10-23 03:00,14,2,12,0,0,0
2019-10-23 03:15,9,0,9,0,0,0
2019-10-23 03:30,12,2,10,0,0,0
2019-10-23 03:45,17,3,14,0,0,0
2019-10-23 04:00,10,3,7,0,0,0
2019-10-23 04:15,2,0,2,0,0,0
2019-10-23 04:30,5,3,2,0,0,0
2019-10-23 04:45,13,9,4,0,0,0
2019-10-23 05:00,7,2,5,0,0,0
2019-10-23 05:15,16,9,7,0,0,0
2019-10-23 05:30,19,10,9,0,0,0
2019-10-23 05:45,30,16,14,0,0,0
2019-10-23 06:00,20,12,8,0,0,0
2019-10-23 06:15,49,30,19,0,0,0
2019-10-23 06:30,59,44,15,0,0,0
2019-10-23 06:45,80,48,32,0,0,0
2019-10-23 07:00,96,58,38,0,0,0
2019-10-23 07:15,122,74,48,0,0,0
2019-10-23 07:30,180,92,88,0,0,0
2019-10-23 07:45,454,250,204,0,0,0
2019-10-23 08:00,648,290,358,0,0,0
2019-10-23 08:15,351,190,161,0,0,0
2019-10-23 08:30,216,143,73,0,0,0
2019-10-23 08:45,327,175,152,0,0,0
2019-10-23 09:00,195,108,87,0,0,0
2019-10-23 09:15,189,97,92,0,0,0
2019-10-23 09:30,237,138,99,0,0,0
2019-10-23 09:45,574,309,265,0,0,0
2019-10-23 10:00,636,330,306,0,0,0
2019-10-23 10:15,225,123,102,0,0,0
2019-10-23 10:30,192,112,80,0,0,0
2019-10-23 10:45,187,100,87,0,0,0
2019-10-23 11:00,176,94,82,0,0,0
2019-10-23 11:15,200,119,81,0,0,0
2019-10-23 11:30,224,134,90,0,0,0
2019-10-23 11:45,577,300,277,0,0,0
2019-10-23 12:00,562,302,260,0,0,0
2019-10-23 12:15,243,123,120,0,0,0
2019-10-23 12:30,235,115,120,0,0,0
2019-10-23 12:45,272,124,148,0,0,0
2019-10-23 13:00,255,157,98,0,0,0
2019-10-23 13:15,254,127,127,0,0,0
2019-10-23 13:30,277,149,128,0,0,0
2019-10-23 13:45,545,306,239,0,0,0
2019-10-23 14:00,561,308,253,0,0,0
2019-10-23 14:15,298,146,152,0,0,0
2019-10-23 14:30,254,113,141,0,0,0
2019-10-23 14:45,246,102,144,0,0,0
2019-10-23 15:00,249,118,131,0,0,0
2019-10-23 15:15,258,133,125,0,0,0
2019-10-23 15:30,276,147,129,0,0,0
2019-10-23 15:45,493,233,260,0,0,0
2019-10-23 16:00,564,269,295,0,0,0
2019-10-23 16:15,363,172,191,0,0,0
2019-10-23 16:30,277,144,133,0,0,0
2019-10-23 16:45,380,178,202,0,0,0
2019-10-23 17:00,358,173,185,0,0,0
2019-10-23 17:15,348,183,165,0,0,0
2019-10-23 17:30,427,219,208,0,0,0
2019-10-23 17:45,662,372,290,0,0,0
2019-10-23 18:00,469,216,253,0,0,0
2019-10-23 18:15,374,166,208,0,0,0
2019-10-23 18:30,316,119,197,0,0,0
2019-10-23 18:45,352,152,200,0,0,0
2019-10-23 19:00,298,148,150,0,0,0
2019-10-23 19:15,325,173,152,0,0,0
2019-10-23 19:30,367,131,236,0,0,0
2019-10-23 19:45,353,151,202,0,0,0
2019-10-23 20:00,287,129,158,0,0,0
2019-10-23 20:15,226,92,134,0,0,0
2019-10-23 20:30,179,85,94,0,0,0
2019-10-23 20:45,196,103,93,0,0,0
2019-10-23 21:00,136,63,73,0,0,0
2019-10-23 21:15,121,58,63,0,0,0
2019-10-23 21:30,120,62,58,0,0,0
2019-10-23 21:45,144,62,82,0,0,0
2019-10-23 22:00,195,84,111,0,0,0
2019-10-23 22:15,150,72,78,0,0,0
2019-10-23 22:30,128,39,89,0,0,0
2019-10-23 22:45,135,57,78,0,0,0
2019-10-23 23:00,111,36,75,0,0,0
2019-10-23 23:15,130,58,72,0,0,0
2019-10-23 23:30,119,38,81,0,0,0
2019-10-23 23:45,105,41,64,0,0,0
2019-10-24 00:00,75,38,37,0,0,0
2019-10-24 00:15,91,40,51,0,0,0
2019-10-24 00:30,52,15,37,0,0,0
2019-10-24 00:45,73,28,45,0,0,0
2019-10-24 01:00,52,14,38,0,0,0
2019-10-24 01:15,53,6,47,0,0,0
2019-10-24 01:30,37,12,25,0,0,0
2019-10-24 01:45,49,6,43,0,0,0
2019-10-24 02:00,52,15,37,0,0,0
2019-10-24 02:15,62,25,37,0,0,0
2019-10-24 02:30,55,14,41,0,0,0
2019-10-24 02:45,38,3,35,0,0,0
2019-10-24 03:00,51,3,48,0,0,0
2019-10-24 03:15,33,2,31,0,0,0
2019-10-24 03:30,30,5,25,0,0,0
2019-10-24 03:45,15,6,9,0,0,0
2019-10-24 04:00,29,3,26,0,0,0
2019-10-24 04:15,12,4,8,0,0,0
2019-10-24 04:30,21,6,15,0,0,0
2019-10-24 04:45,14,5,9,0,0,0
2019-10-24 05:00,17,7,10,0,0,0
2019-10-24 05:15,19,7,12,0,0,0
2019-10-24 05:30,28,13,15,0,0,0
2019-10-24 05:45,34,15,19,0,0,0
2019-10-24 06:00,28,22,6,0,0,0
2019-10-24 06:15,43,25,18,0,0,0
2019-10-24 06:30,52,33,19,0,0,0
2019-10-24 06:45,71,49,22,0,0,0
2019-10-24 07:00,88,53,35,0,0,0
2019-10-24 07:15,93,52,41,0,0,0
2019-10-24 07:30,181,100,81,0,0,0
2019-10-24 07:45,379,172,207,0,0,0
2019-10-24 08:00,570,221,349,0,0,0
2019-10-24 08:15,340,176,164,0,0,0
2019-10-24 08:30,219,137,82,0,0,0
2019-10-24 08:45,268,127,141,0,0,0
2019-10-24 09:00,203,110,93,0,0,0
2019-10-24 09:15,157,88,69,0,0,0
2019-10-24 09:30,212,127,85,0,0,0
2019-10-24 09:45,545,314,231,0,0,0
2019-10-24 10:00,704,450,254,0,0,0
2019-10-24 10:15,217,85,132,0,0,0
2019-10-24 10:30,143,88,55,0,0,0
2019-10-24 10:45,166,106,60,0,0,0
2019-10-24 11:00,259,130,129,0,0,0
2019-10-24 11:15,173,88,85,0,0,0
2019-10-24 11:30,240,127,113,0,0,0
2019-10-24 11:45,534,305,229,0,0,0
2019-10-24 12:00,568,253,315,0,0,0
2019-10-24 12:15,238,111,127,0,0,0
2019-10-24 12:30,198,108,90,0,0,0
2019-10-24 12:45,246,120,126,0,0,0
2019-10-24 13:00,229,126,103,0,0,0
2019-10-24 13:15,228,117,111,0,0,0
2019-10-24 13:30,290,146,144,0,0,0
2019-10-24 13:45,621,325,296,0,0,0
2019-10-24 14:00,535,264,271,0,0,0
2019-10-24 14:15,314,154,160,0,0,0
2019-10-24 14:30,235,128,107,0,0,0
2019-10-24 14:45,264,137,127,0,0,0
2019-10-24 15:00,237,120,117,0,0,0
2019-10-24 15:15,266,147,119,0,0,0
2019-10-24 15:30,314,172,142,0,0,0
2019-10-24 15:45,694,389,305,0,0,0
2019-10-24 16:00,593,331,262,0,0,0
2019-10-24 16:15,320,164,156,0,0,0
2019-10-24 16:30,322,161,161,0,0,0
2019-10-24 16:45,385,219,166,0,0,0
2019-10-24 17:00,325,166,159,0,0,0
2019-10-24 17:15,347,171,176,0,0,0
2019-10-24 17:30,380,176,204,0,0,0
2019-10-24 17:45,656,353,303,0,0,0
2019-10-24 18:00,525,236,289,0,0,0
2019-10-24 18:15,368,171,197,0,0,0
2019-10-24 18:30,306,133,173,0,0,0
2019-10-24 18:45,310,151,159,0,0,0
2019-10-24 19:00,270,122,148,0,0,0
2019-10-24 19:15,258,122,136,0,0,0
2019-10-24 19:30,255,108,147,0,0,0
2019-10-24 19:45,346,147,199,0,0,0
2019-10-24 20:00,244,99,145,0,0,0
2019-10-24 20:15,200,92,108,0,0,0
2019-10-24 20:30,157,57,100,0,0,0
2019-10-24 20:45,141,56,85,0,0,0
2019-10-24 21:00,147,60,87,0,0,0
2019-10-24 21:15,151,66,85,0,0,0
2019-10-24 21:30,155,55,100,0,0,0
2019-10-24 21:45,148,42,106,0,0,0
2019-10-24 22:00,119,52,67,0,0,0
2019-10-24 22:15,144,56,88,0,0,0
2019-10-24 22:30,102,40,62,0,0,0
2019-10-24 22:45,116,38,78,0,0,0
2019-10-24 23:00,117,50,67,0,0,0
2019-10-24 23:15,115,43,72,0,0,0
2019-10-24 23:30,100,42,58,0,0,0
2019-10-24 23:45,60,19,41,0,0,0
2019-10-25 00:00,68,34,34,0,0,0
2019-10-25 00:15,51,24,27,0,0,0
2019-10-25 00:30,61,38,23,0,0,0
2019-10-25 00:45,48,14,34,0,0,0
2019-10-25 01:00,51,17,34,0,0,0
2019-10-25 01:15,32,8,24,0,0,0
2019-10-25 01:30,32,4,28,0,0,0
2019-10-25 01:45,37,17,20,0,0,0
2019-10-25 02:00,40,9,31,0,0,0
2019-10-25 02:15,19,2,17,0,0,0
2019-10-25 02:30,35,7,28,0,0,0
2019-10-25 02:45,21,0,21,0,0,0
2019-10-25 03:00,24,5,19,0,0,0
2019-10-25 03:15,18,2,16,0,0,0
2019-10-25 03:30,26,2,24,0,0,0
2019-10-25 03:45,9,1,8,0,0,0
2019-10-25 04:00,7,3,4,0,0,0
2019-10-25 04:15,17,5,12,0,0,0
2019-10-25 04:30,14,2,12,0,0,0
2019-10-25 04:45,15,9,6,0,0,0
2019-10-25 05:00,11,8,3,0,0,0
2019-10-25 05:15,14,4,10,0,0,0
2019-10-25 05:30,18,8,10,0,0,0
2019-10-25 05:45,28,15,13,0,0,0
2019-10-25 06:00,24,11,13,0,0,0
2019-10-25 06:15,46,27,19,0,0,0
2019-10-25 06:30,40,27,13,0,0,0
2019-10-25 06:45,71,42,29,0,0,0
2019-10-25 07:00,98,61,37,0,0,0
2019-10-25 07:15,90,53,37,0,0,0
2019-10-25 07:30,169,92,77,0,0,0
2019-10-25 07:45,307,162,145,0,0,0
2019-10-25 08:00,465,171,294,0,0,0
2019-10-25 08:15,275,123,152,0,0,0
2019-10-25 08:30,199,113,86,0,0,0
2019-10-25 08:45,313,148,165,0,0,0
2019-10-25 09:00,194,107,87,0,0,0
2019-10-25 09:15,164,105,59,0,0,0
2019-10-25 09:30,183,92,91,0,0,0
2019-10-25 09:45,358,204,154,0,0,0
2019-10-25 10:00,515,332,183,0,0,0
2019-10-25 10:15,194,119,75,0,0,0
2019-10-25 10:30,131,95,36,0,0,0
2019-10-25 10:45,161,84,77,0,0,0
2019-10-25 11:00,206,97,109,0,0,0
2019-10-25 11:15,168,90,78,0,0,0
2019-10-25 11:30,188,93,95,0,0,0
2019-10-25 11:45,427,225,202,0,0,0
2019-10-25 12:00,425,199,226,0,0,0
2019-10-25 12:15,272,144,128,0,0,0
2019-10-25 12:30,182,100,82,0,0,0
2019-10-25 12:45,250,139,111,0,0,0
2019-10-25 13:00,257,149,108,0,0,0
2019-10-25 13:15,216,125,91,0,0,0
2019-10-25 13:30,265,151,114,0,0,0
2019-10-25 13:45,440,274,166,0,0,0
2019-10-25 14:00,363,203,160,0,0,0
2019-10-25 14:15,268,140,128,0,0,0
2019-10-25 14:30,257,116,141,0,0,0
2019-10-25 14:45,275,129,146,0,0,0
2019-10-25 15:00,237,136,101,0,0,0
2019-10-25 15:15,214,98,116,0,0,0
2019-10-25 15:30,252,132,120,0,0,0
2019-10-25 15:45,401,203,198,0,0,0
2019-10-25 16:00,310,158,152,0,0,0
2019-10-25 16:15,265,142,123,0,0,0
2019-10-25 16:30,224,116,108,0,0,0
2019-10-25 16:45,283,155,128,0,0,0
2019-10-25 17:00,233,106,127,0,0,0
2019-10-25 17:15,243,111,132,0,0,0
2019-10-25 17:30,262,122,140,0,0,0
2019-10-25 17:45,305,155,150,0,0,0
2019-10-25 18:00,234,96,138,0,0,0
2019-10-25 18:15,272,123,149,0,0,0
2019-10-25 18:30,226,107,119,0,0,0
2019-10-25 18:45,258,143,115,0,0,0
2019-10-25 19:00,201,103,98,0,0,0
2019-10-25 19:15,197,87,110,0,0,0
2019-10-25 19:30,187,110,77,0,0,0
2019-10-25 19:45,234,127,107,0,0,0
2019-10-25 20:00,181,83,98,0,0,0
2019-10-25 20:15,184,104,80,0,0,0
2019-10-25 20:30,169,83,86,0,0,0
2019-10-25 20:45,125,62,63,0,0,0
2019-10-25 21:00,117,48,69,0,0,0
2019-10-25 21:15,109,45,64,0,0,0
2019-10-25 21:30,96,40,56,0,0,0
2019-10-25 21:45,91,30,61,0,0,0
2019-10-25 22:00,113,50,63,0,0,0
2019-10-25 22:15,91,30,61,0,0,0
2019-10-25 22:30,130,39,91,0,0,0
2019-10-25 22:45,93,40,53,0,0,0
2019-10-25 23:00,79,29,50,0,0,0
2019-10-25 23:15,85,33,52,0,0,0
2019-10-25 23:30,77,21,56,0,0,0
2019-10-25 23:45,90,31,59,0,0,0
2019-10-26 00:00,112,26,86,0,0,0
2019-10-26 00:15,91,24,67,0,0,0
2019-10-26 00:30,72,32,40,0,0,0
2019-10-26 00:45,69,17,52,0,0,0
2019-10-26 01:00,65,26,39,0,0,0
2019-10-26 01:15,49,24,25,0,0,0
2019-10-26 01:30,49,21,28,0,0,0
2019-10-26 01:45,66,19,47,0,0,0
2019-10-26 02:00,91,26,65,0,0,0
2019-10-26 02:15,69,19,50,0,0,0
2019-10-26 02:30,64,24,40,0,0,0
2019-10-26 02:45,64,17,47,0,0,0
2019-10-26 03:00,38,8,30,0,0,0
2019-10-26 03:15,49,14,35,0,0,0
2019-10-26 03:30,48,13,35,0,0,0
2019-10-26 03:45,36,11,25,0,0,0
2019-10-26 04:00,19,3,16,0,0,0
2019-10-26 04:15,19,8,11,0,0,0
2019-10-26 04:30,13,3,10,0,0,0
2019-10-26 04:45,15,6,9,0,0,0
2019-10-26 05:00,10,4,6,0,0,0
2019-10-26 05:15,10,4,6,0,0,0
2019-10-26 05:30,12,5,7,0,0,0
2019-10-26 05:45,16,9,7,0,0,0
2019-10-26 06:00,10,6,4,0,0,0
2019-10-26 06:15,16,8,8,0,0,0
2019-10-26 06:30,12,6,6,0,0,0
2019-10-26 06:45,19,11,8,0,0,0
2019-10-26 07:00,19,16,3,0,0,0
2019-10-26 07:15,20,13,7,0,0,0
2019-10-26 07:30,24,20,4,0,0,0
2019-10-26 07:45,33,25,8,0,0,0
2019-10-26 08:00,37,27,10,0,0,0
2019-10-26 08:15,55,35,20,0,0,0
2019-10-26 08:30,63,42,21,0,0,0
2019-10-26 08:45,105,56,49,0,0,0
2019-10-26 09:00,79,59,20,0,0,0
2019-10-26 09:15,100,65,35,0,0,0
2019-10-26 09:30,90,62,28,0,0,0
2019-10-26 09:45,186,127,59,0,0,0
2019-10-26 10:00,143,97,46,0,0,0
2019-10-26 10:15,115,80,35,0,0,0
2019-10-26 10:30,107,79,28,0,0,0
2019-10-26 10:45,158,111,47,0,0,0
2019-10-26 11:00,120,75,45,0,0,0
2019-10-26 11:15,161,112,49,0,0,0
2019-10-26 11:30,139,83,56,0,0,0
2019-10-26 11:45,189,92,97,0,0,0
2019-10-26 12:00,177,96,81,0,0,0
2019-10-26 12:15,184,104,80,0,0,0
2019-10-26 12:30,183,122,61,0,0,0
2019-10-26 12:45,198,140,58,0,0,0
2019-10-26 13:00,172,102,70,0,0,0
2019-10-26 13:15,179,111,68,0,0,0
2019-10-26 13:30,183,95,88,0,0,0
2019-10-26 13:45,197,111,86,0,0,0
2019-10-26 14:00,207,109,98,0,0,0
2019-10-26 14:15,216,115,101,0,0,0
2019-10-26 14:30,209,93,116,0,0,0
2019-10-26 14:45,243,111,132,0,0,0
2019-10-26 15:00,235,110,125,0,0,0
2019-10-26 15:15,269,107,162,0,0,0
2019-10-26 15:30,169,101,68,0,0,0
2019-10-26 15:45,202,99,103,0,0,0
2019-10-26 16:00,206,94,112,0,0,0
2019-10-26 16:15,180,86,94,0,0,0
2019-10-26 16:30,176,92,84,0,0,0
2019-10-26 16:45,212,89,123,0,0,0
2019-10-26 17:00,203,63,140,0,0,0
2019-10-26 17:15,212,104,108,0,0,0
2019-10-26 17:30,204,82,122,0,0,0
2019-10-26 17:45,272,135,137,0,0,0
2019-10-26 18:00,183,84,99,0,0,0
2019-10-26 18:15,182,83,99,0,0,0
2019-10-26 18:30,199,91,108,0,0,0
2019-10-26 18:45,202,111,91,0,0,0
2019-10-26 19:00,179,88,91,0,0,0
2019-10-26 19:15,165,89,76,0,0,0
2019-10-26 19:30,167,77,90,0,0,0
2019-10-26 19:45,177,78,99,0,0,0
2019-10-26 20:00,204,76,128,0,0,0
2019-10-26 20:15,158,72,86,0,0,0
2019-10-26 20:30,149,75,74,0,0,0
2019-10-26 20:45,138,68,70,0,0,0
2019-10-26 21:00,105,49,56,0,0,0
2019-10-26 21:15,105,50,55,0,0,0
2019-10-26 21:30,117,51,66,0,0,0
2019-10-26 21:45,115,49,66,0,0,0
2019-10-26 22:00,108,38,70,0,0,0
2019-10-26 22:15,105,43,62,0,0,0
2019-10-26 22:30,124,43,81,0,0,0
2019-10-26 22:45,101,48,53,0,0,0
2019-10-26 23:00,79,35,44,0,0,0
2019-10-26 23:15,67,38,29,0,0,0
2019-10-26 23:30,69,13,56,0,0,0
2019-10-26 23:45,58,19,39,0,0,0
2019-10-27 00:00,87,20,67,0,0,0
2019-10-27 00:15,83,21,62,0,0,0
2019-10-27 00:30,91,23,68,0,0,0
2019-10-27 00:45,60,21,39,0,0,0
2019-10-27 01:00,73,28,45,0,0,0
2019-10-27 01:15,50,16,34,0,0,0
2019-10-27 01:30,53,17,36,0,0,0
2019-10-27 01:45,62,10,52,0,0,0
2019-10-27 02:00,115,39,76,0,0,0
2019-10-27 02:15,126,27,99,0,0,0
2019-10-27 02:30,101,29,72,0,0,0
2019-10-27 02:45,48,8,40,0,0,0
2019-10-27 03:00,27,8,19,0,0,0
2019-10-27 03:15,26,10,16,0,0,0
2019-10-27 03:30,15,8,7,0,0,0
2019-10-27 03:45,21,3,18,0,0,0
2019-10-27 04:00,9,0,9,0,0,0
2019-10-27 04:15,16,2,14,0,0,0
2019-10-27 04:30,8,2,6,0,0,0
2019-10-27 04:45,8,2,6,0,0,0
2019-10-27 05:00,1,1,0,0,0,0
2019-10-27 05:15,6,2,4,0,0,0
2019-10-27 05:30,7,0,7,0,0,0
2019-10-27 05:45,4,0,4,0,0,0
2019-10-27 06:00,7,2,5,0,0,0
2019-10-27 06:15,7,4,3,0,0,0
2019-10-27 06:30,6,5,1,0,0,0
2019-10-27 06:45,9,3,6,0,0,0
2019-10-27 07:00,6,6,0,0,0,0
2019-10-27 07:15,13,6,7,0,0,0
2019-10-27 07:30,9,7,2,0,0,0
2019-10-27 07:45,24,19,5,0,0,0
2019-10-27 08:00,21,16,5,0,0,0
2019-10-27 08:15,28,14,14,0,0,0
2019-10-27 08:30,28,16,12,0,0,0
2019-10-27 08:45,36,25,11,0,0,0
2019-10-27 09:00,30,19,11,0,0,0
2019-10-27 09:15,46,31,15,0,0,0
2019-10-27 09:30,56,32,24,0,0,0
2019-10-27 09:45,98,66,32,0,0,0
2019-10-27 10:00,76,53,23,0,0,0
2019-10-27 10:15,70,52,18,0,0,0
2019-10-27 10:30,71,42,29,0,0,0
2019-10-27 10:45,107,64,43,0,0,0
2019-10-27 11:00,63,31,32,0,0,0
2019-10-27 11:15,101,60,41,0,0,0
2019-10-27 11:30,87,56,31,0,0,0
2019-10-27 11:45,100,62,38,0,0,0
2019-10-27 12:00,108,65,43,0,0,0
2019-10-27 12:15,88,60,28,0,0,0
2019-10-27 12:30,96,49,47,0,0,0
2019-10-27 12:45,125,77,48,0,0,0
2019-10-27 13:00,113,55,58,0,0,0
2019-10-27 13:15,112,42,70,0,0,0
2019-10-27 13:30,113,65,48,0,0,0
2019-10-27 13:45,162,81,81,0,0,0
2019-10-27 14:00,139,74,65,0,0,0
2019-10-27 14:15,158,87,71,0,0,0
2019-10-27 14:30,138,83,55,0,0,0
2019-10-27 14:45,155,87,68,0,0,0
2019-10-27 15:00,142,77,65,0,0,0
2019-10-27 15:15,152,94,58,0,0,0
2019-10-27 15:30,121,79,42,0,0,0
2019-10-27 15:45,157,91,66,0,0,0
2019-10-27 16:00,144,86,58,0,0,0
2019-10-27 16:15,152,71,81,0,0,0
2019-10-27 16:30,176,86,90,0,0,0
2019-10-27 16:45,156,78,78,0,0,0
2019-10-27 17:00,154,61,93,0,0,0
2019-10-27 17:15,167,68,99,0,0,0
2019-10-27 17:30,143,63,80,0,0,0
2019-10-27 17:45,179,81,98,0,0,0
2019-10-27 18:00,164,66,98,0,0,0
2019-10-27 18:15,132,57,75,0,0,0
2019-10-27 18:30,157,67,90,0,0,0
2019-10-27 18:45,164,69,95,0,0,0
2019-10-27 19:00,139,52,87,0,0,0
2019-10-27 19:15,141,60,81,0,0,0
2019-10-27 19:30,127,37,90,0,0,0
2019-10-27 19:45,118,53,65,0,0,0
2019-10-27 20:00,107,41,66,0,0,0
2019-10-27 20:15,112,46,66,0,0,0
2019-10-27 20:30,72,20,52,0,0,0
2019-10-27 20:45,94,26,68,0,0,0
2019-10-27 21:00,62,18,44,0,0,0
2019-10-27 21:15,70,29,41,0,0,0
2019-10-27 21:30,60,18,42,0,0,0
2019-10-27 21:45,69,23,46,0,0,0
2019-10-27 22:00,71,17,54,0,0,0
2019-10-27 22:15,65,24,41,0,0,0
2019-10-27 22:30,67,17,50,0,0,0
2019-10-27 22:45,62,12,50,0,0,0
2019-10-27 23:00,33,9,24,0,0,0
2019-10-27 23:15,31,10,21,0,0,0
2019-10-27 23:30,23,11,12,0,0,0
2019-10-27 23:45,32,9,23,0,0,0
2019-10-28 00:00,13,5,8,0,0,0
2019-10-28 00:15,11,1,10,0,0,0
2019-10-28 00:30,16,5,11,0,0,0
2019-10-28 00:45,6,0,6,0,0,0
2019-10-28 01:00,12,2,10,0,0,0
2019-10-28 01:15,8,3,5,0,0,0
2019-10-28 01:30,4,3,1,0,0,0
2019-10-28 01:45,1,0,1,0,0,0
2019-10-28 02:00,1,0,1,0,0,0
2019-10-28 02:15,3,0,3,0,0,0
2019-10-28 02:30,7,1,6,0,0,0
2019-10-28 02:45,4,1,3,0,0,0
2019-10-28 03:00,2,1,1,0,0,0
2019-10-28 03:15,0,0,0,0,0,0
2019-10-28 03:30,1,0,1,0,0,0
2019-10-28 03:45,0,0,0,0,0,0
2019-10-28 04:00,1,0,1,0,0,0
2019-10-28 04:15,1,0,1,0,0,0
2019-10-28 04:30,2,0,2,0,0,0
2019-10-28 04:45,3,0,3,0,0,0
2019-10-28 05:00,10,6,4,0,0,0
2019-10-28 05:15,9,4,5,0,0,0
2019-10-28 05:30,20,10,10,0,0,0
2019-10-28 05:45,20,14,6,0,0,0
2019-10-28 06:00,34,26,8,0,0,0
2019-10-28 06:15,52,36,16,0,0,0
2019-10-28 06:30,62,43,19,0,0,0
2019-10-28 06:45,106,72,34,0,0,0
2019-10-28 07:00,110,72,38,0,0,0
2019-10-28 07:15,221,159,62,0,0,0
2019-10-28 07:30,335,237,98,0,0,0
2019-10-28 07:45,423,220,203,0,0,0
2019-10-28 08:00,550,258,292,0,0,0
2019-10-28 08:15,359,187,172,0,0,0
2019-10-28 08:30,207,109,98,0,0,0
2019-10-28 08:45,337,168,169,0,0,0
2019-10-28 09:00,204,113,91,0,0,0
2019-10-28 09:15,188,103,85,0,0,0
2019-10-28 09:30,175,89,86,0,0,0
2019-10-28 09:45,520,310,210,0,0,0
2019-10-28 10:00,650,449,201,0,0,0
2019-10-28 10:15,165,101,64,0,0,0
2019-10-28 10:30,144,73,71,0,0,0
2019-10-28 10:45,154,74,80,0,0,0
2019-10-28 11:00,235,118,117,0,0,0
2019-10-28 11:15,166,83,83,0,0,0
2019-10-28 11:30,206,114,92,0,0,0
2019-10-28 11:45,554,291,263,0,0,0
2019-10-28 12:00,538,212,326,0,0,0
2019-10-28 12:15,270,106,164,0,0,0
2019-10-28 12:30,227,105,122,0,0,0
2019-10-28 12:45,274,118,156,0,0,0
2019-10-28 13:00,235,125,110,0,0,0
2019-10-28 13:15,227,99,128,0,0,0
2019-10-28 13:30,246,126,120,0,0,0
2019-10-28 13:45,589,247,342,0,0,0
2019-10-28 14:00,555,269,286,0,0,0
2019-10-28 14:15,290,137,153,0,0,0
2019-10-28 14:30,233,91,142,0,0,0
2019-10-28 14:45,238,90,148,0,0,0
2019-10-28 15:00,216,89,127,0,0,0
2019-10-28 15:15,223,98,125,0,0,0
2019-10-28 15:30,322,143,179,0,0,0
2019-10-28 15:45,713,378,335,0,0,0
2019-10-28 16:00,596,289,307,0,0,0
2019-10-28 16:15,326,148,178,0,0,0
2019-10-28 16:30,319,141,178,0,0,0
2019-10-28 16:45,338,149,189,0,0,0
2019-10-28 17:00,311,137,174,0,0,0
2019-10-28 17:15,405,198,207,0,0,0
2019-10-28 17:30,401,231,170,0,0,0
2019-10-28 17:45,659,317,342,0,0,0
2019-10-28 18:00,458,228,230,0,0,0
2019-10-28 18:15,327,152,175,0,0,0
2019-10-28 18:30,278,112,166,0,0,0
2019-10-28 18:45,328,155,173,0,0,0
2019-10-28 19:00,257,120,137,0,0,0
2019-10-28 19:15,306,149,157,0,0,0
2019-10-28 19:30,332,141,191,0,0,0
2019-10-28 19:45,418,193,225,0,0,0
2019-10-28 20:00,256,108,148,0,0,0
2019-10-28 20:15,224,80,144,0,0,0
2019-10-28 20:30,168,54,114,0,0,0
2019-10-28 20:45,173,69,104,0,0,0
2019-10-28 21:00,130,47,83,0,0,0
2019-10-28 21:15,146,61,85,0,0,0
2019-10-28 21:30,101,31,70,0,0,0
2019-10-28 21:45,123,31,92,0,0,0
2019-10-28 22:00,183,85,98,0,0,0
2019-10-28 22:15,116,53,63,0,0,0
2019-10-28 22:30,102,21,81,0,0,0
2019-10-28 22:45,78,24,54,0,0,0
2019-10-28 23:00,116,29,87,0,0,0
2019-10-28 23:15,57,20,37,0,0,0
2019-10-28 23:30,57,15,42,0,0,0
2019-10-28 23:45,32,12,20,0,0,0
2019-10-29 00:00,25,8,17,0,0,0
2019-10-29 00:15,28,13,15,0,0,0
2019-10-29 00:30,25,4,21,0,0,0
2019-10-29 00:45,19,7,12,0,0,0
2019-10-29 01:00,16,3,13,0,0,0
2019-10-29 01:15,19,5,14,0,0,0
2019-10-29 01:30,12,4,8,0,0,0
2019-10-29 01:45,6,2,4,0,0,0
2019-10-29 02:00,11,5,6,0,0,0
2019-10-29 02:15,6,4,2,0,0,0
2019-10-29 02:30,9,6,3,0,0,0
2019-10-29 02:45,14,11,3,0,0,0
2019-10-29 03:00,5,4,1,0,0,0
2019-10-29 03:15,2,2,0,0,0,0
2019-10-29 03:30,0,0,0,0,0,0
2019-10-29 03:45,0,0,0,0,0,0
2019-10-29 04:00,0,0,0,0,0,0
2019-10-29 04:15,0,0,0,0,0,0
2019-10-29 04:30,8,8,0,0,0,0
2019-10-29 04:45,10,7,3,0,0,0
2019-10-29 05:00,4,4,0,0,0,0
2019-10-29 05:15,9,6,3,0,0,0
2019-10-29 05:30,20,10,10,0,0,0
2019-10-29 05:45,17,13,4,0,0,0
2019-10-29 06:00,38,30,8,0,0,0
2019-10-29 06:15,57,40,17,0,0,0
2019-10-29 06:30,55,36,19,0,0,0
2019-10-29 06:45,90,59,31,0,0,0
2019-10-29 07:00,119,70,49,0,0,0
2019-10-29 07:15,162,116,46,0,0,0
2019-10-29 07:30,328,224,104,0,0,0
2019-10-29 07:45,484,247,237,0,0,0
2019-10-29 08:00,714,360,354,0,0,0
2019-10-29 08:15,388,220,168,0,0,0
2019-10-29 08:30,223,134,89,0,0,0
2019-10-29 08:45,324,191,133,0,0,0
2019-10-29 09:00,276,154,122,0,0,0
2019-10-29 09:15,177,104,73,0,0,0
2019-10-29 09:30,206,126,80,0,0,0
2019-10-29 09:45,751,316,435,0,0,0
2019-10-29 10:00,743,420,323,0,0,0
2019-10-29 10:15,200,110,90,0,0,0
2019-10-29 10:30,154,79,75,0,0,0
2019-10-29 10:45,185,103,82,0,0,0
2019-10-29 11:00,243,132,111,0,0,0
2019-10-29 11:15,180,100,80,0,0,0
2019-10-29 11:30,247,135,112,0,0,0
2019-10-29 11:45,637,350,287,0,0,0
2019-10-29 12:00,589,314,275,0,0,0
2019-10-29 12:15,267,121,146,0,0,0
2019-10-29 12:30,207,100,107,0,0,0
2019-10-29 12:45,297,147,150,0,0,0
2019-10-29 13:00,293,146,147,0,0,0
2019-10-29 13:15,296,94,202,0,0,0
2019-10-29 13:30,321,150,171,0,0,0
2019-10-29 13:45,656,353,303,0,0,0
2019-10-29 14:00,574,272,302,0,0,0
2019-10-29 14:15,258,122,136,0,0,0
2019-10-29 14:30,246,135,111,0,0,0
2019-10-29 14:45,249,116,133,0,0,0
2019-10-29 15:00,263,116,147,0,0,0
2019-10-29 15:15,244,124,120,0,0,0
2019-10-29 15:30,336,166,170,0,0,0
2019-10-29 15:45,686,399,287,0,0,0
2019-10-29 16:00,614,302,312,0,0,0
2019-10-29 16:15,328,183,145,0,0,0
2019-10-29 16:30,331,153,178,0,0,0
2019-10-29 16:45,393,169,224,0,0,0
2019-10-29 17:00,351,171,180,0,0,0
2019-10-29 17:15,363,155,208,0,0,0
2019-10-29 17:30,411,227,184,0,0,0
2019-10-29 17:45,673,365,308,0,0,0
2019-10-29 18:00,629,299,330,0,0,0
2019-10-29 18:15,418,208,210,0,0,0
2019-10-29 18:30,335,163,172,0,0,0
2019-10-29 18:45,322,143,179,0,0,0
2019-10-29 19:00,322,168,154,0,0,0
2019-10-29 19:15,324,189,135,0,0,0
2019-10-29 19:30,249,129,120,0,0,0
2019-10-29 19:45,352,176,176,0,0,0
2019-10-29 20:00,300,140,160,0,0,0
2019-10-29 20:15,240,100,140,0,0,0
2019-10-29 20:30,157,66,91,0,0,0
2019-10-29 20:45,160,58,102,0,0,0
2019-10-29 21:00,181,65,116,0,0,0
2019-10-29 21:15,161,45,116,0,0,0
2019-10-29 21:30,124,39,85,0,0,0
2019-10-29 21:45,153,35,118,0,0,0
2019-10-29 22:00,167,37,130,0,0,0
2019-10-29 22:15,167,82,85,0,0,0
2019-10-29 22:30,137,39,98,0,0,0
2019-10-29 22:45,116,37,79,0,0,0
2019-10-29 23:00,104,34,70,0,0,0
2019-10-29 23:15,60,26,34,0,0,0
2019-10-29 23:30,98,45,53,0,0,0
2019-10-29 23:45,58,17,41,0,0,0
2019-10-30 00:00,59,12,47,0,0,0
2019-10-30 00:15,39,13,26,0,0,0
2019-10-30 00:30,26,8,18,0,0,0
2019-10-30 00:45,25,12,13,0,0,0
2019-10-30 01:00,23,2,21,0,0,0
2019-10-30 01:15,16,1,15,0,0,0
2019-10-30 01:30,13,6,7,0,0,0
2019-10-30 01:45,12,4,8,0,0,0
2019-10-30 02:00,26,3,23,0,0,0
2019-10-30 02:15,12,3,9,0,0,0
2019-10-30 02:30,21,6,15,0,0,0
2019-10-30 02:45,16,9,7,0,0,0
2019-10-30 03:00,17,2,15,0,0,0
2019-10-30 03:15,4,1,3,0,0,0
2019-10-30 03:30,12,1,11,0,0,0
2019-10-30 03:45,15,0,15,0,0,0
2019-10-30 04:00,6,1,5,0,0,0
2019-10-30 04:15,2,2,0,0,0,0
2019-10-30 04:30,8,8,0,0,0,0
2019-10-30 04:45,11,8,3,0,0,0
2019-10-30 05:00,7,4,3,0,0,0
2019-10-30 05:15,7,5,2,0,0,0
2019-10-30 05:30,28,16,12,0,0,0
2019-10-30 05:45,26,20,6,0,0,0
2019-10-30 06:00,34,29,5,0,0,0
2019-10-30 06:15,63,45,18,0,0,0
2019-10-30 06:30,60,41,19,0,0,0
2019-10-30 06:45,92,69,23,0,0,0
2019-10-30 07:00,100,64,36,0,0,0
2019-10-30 07:15,184,127,57,0,0,0
2019-10-30 07:30,338,254,84,0,0,0
2019-10-30 07:45,503,304,199,0,0,0
2019-10-30 08:00,720,381,339,0,0,0
2019-10-30 08:15,420,214,206,0,0,0
2019-10-30 08:30,249,152,97,0,0,0
2019-10-30 08:45,326,188,138,0,0,0
2019-10-30 09:00,248,156,92,0,0,0
2019-10-30 09:15,212,122,90,0,0,0
2019-10-30 09:30,225,131,94,0,0,0
2019-10-30 09:45,646,313,333,0,0,0
2019-10-30 10:00,639,361,278,0,0,0
2019-10-30 10:15,237,116,121,0,0,0
2019-10-30 10:30,148,80,68,0,0,0
2019-10-30 10:45,181,95,86,0,0,0
2019-10-30 11:00,146,89,57,0,0,0
2019-10-30 11:15,200,126,74,0,0,0
2019-10-30 11:30,261,169,92,0,0,0
2019-10-30 11:45,582,310,272,0,0,0
2019-10-30 12:00,513,264,249,0,0,0
2019-10-30 12:15,284,141,143,0,0,0
2019-10-30 12:30,236,113,123,0,0,0
2019-10-30 12:45,263,120,143,0,0,0
2019-10-30 13:00,247,131,116,0,0,0
2019-10-30 13:15,260,144,116,0,0,0
2019-10-30 13:30,271,154,117,0,0,0
2019-10-30 13:45,545,328,217,0,0,0
2019-10-30 14:00,528,286,242,0,0,0
2019-10-30 14:15,277,143,134,0,0,0
2019-10-30 14:30,231,104,127,0,0,0
2019-10-30 14:45,260,111,149,0,0,0
2019-10-30 15:00,259,131,128,0,0,0
2019-10-30 15:15,245,117,128,0,0,0
2019-10-30 15:30,290,128,162,0,0,0
2019-10-30 15:45,686,301,385,0,0,0
2019-10-30 16:00,595,278,317,0,0,0
2019-10-30 16:15,347,136,211,0,0,0
2019-10-30 16:30,337,147,190,0,0,0
2019-10-30 16:45,329,156,173,0,0,0
2019-10-30 17:00,359,169,190,0,0,0
2019-10-30 17:15,344,169,175,0,0,0
2019-10-30 17:30,355,179,176,0,0,0
2019-10-30 17:45,544,294,250,0,0,0
2019-10-30 18:00,438,212,226,0,0,0
2019-10-30 18:15,348,145,203,0,0,0
2019-10-30 18:30,310,164,146,0,0,0
2019-10-30 18:45,343,186,157,0,0,0
2019-10-30 19:00,335,157,178,0,0,0
2019-10-30 19:15,303,153,150,0,0,0
2019-10-30 19:30,314,142,172,0,0,0
2019-10-30 19:45,392,197,195,0,0,0
2019-10-30 20:00,335,171,164,0,0,0
2019-10-30 20:15,232,104,128,0,0,0
2019-10-30 20:30,195,81,114,0,0,0
2019-10-30 20:45,203,84,119,0,0,0
2019-10-30 21:00,193,76,117,0,0,0
2019-10-30 21:15,164,62,102,0,0,0
2019-10-30 21:30,179,79,100,0,0,0
2019-10-30 21:45,223,71,152,0,0,0
2019-10-30 22:00,221,79,142,0,0,0
2019-10-30 22:15,178,75,103,0,0,0
2019-10-30 22:30,114,33,81,0,0,0
2019-10-30 22:45,155,47,108,0,0,0
2019-10-30 23:00,145,55,90,0,0,0
2019-10-30 23:15,117,37,80,0,0,0
2019-10-30 23:30,67,19,48,0,0,0
2019-10-30 23:45,87,34,53,0,0,0
2019-10-31 00:00,67,22,45,0,0,0
2019-10-31 00:15,67,31,36,0,0,0
2019-10-31 00:30,51,19,32,0,0,0
2019-10-31 00:45,46,27,19,0,0,0
2019-10-31 01:00,35,16,19,0,0,0
2019-10-31 01:15,33,9,24,0,0,0
2019-10-31 01:30,27,10,17,0,0,0
2019-10-31 01:45,25,6,19,0,0,0
2019-10-31 02:00,32,15,17,0,0,0
2019-10-31 02:15,21,1,20,0,0,0
2019-10-31 02:30,22,4,18,0,0,0
2019-10-31 02:45,45,13,32,0,0,0
2019-10-31 03:00,25,6,19,0,0,0
2019-10-31 03:15,13,0,13,0,0,0
2019-10-31 03:30,14,5,9,0,0,0
2019-10-31 03:45,18,11,7,0,0,0
2019-10-31 04:00,4,2,2,0,0,0
2019-10-31 04:15,14,3,11,0,0,0
2019-10-31 04:30,7,6,1,0,0,0
2019-10-31 04:45,14,7,7,0,0,0
2019-10-31 05:00,11,4,7,0,0,0
2019-10-31 05:15,15,10,5,0,0,0
2019-10-31 05:30,18,11,7,0,0,0
2019-10-31 05:45,27,16,11,0,0,0
2019-10-31 06:00,28,23,5,0,0,0
2019-10-31 06:15,49,34,15,0,0,0
2019-10-31 06:30,52,33,19,0,0,0
2019-10-31 06:45,78,55,23,0,0,0
2019-10-31 07:00,75,46,29,0,0,0
2019-10-31 07:15,151,102,49,0,0,0
2019-10-31 07:30,315,226,89,0,0,0
2019-10-31 07:45,412,224,188,0,0,0
2019-10-31 08:00,573,265,308,0,0,0
2019-10-31 08:15,332,174,158,0,0,0
2019-10-31 08:30,193,123,70,0,0,0
2019-10-31 08:45,287,156,131,0,0,0
2019-10-31 09:00,241,140,101,0,0,0
2019-10-31 09:15,151,99,52,0,0,0
2019-10-31 09:30,192,111,81,0,0,0
2019-10-31 09:45,530,300,230,0,0,0
2019-10-31 10:00,663,395,268,0,0,0
2019-10-31 10:15,204,107,97,0,0,0
2019-10-31 10:30,123,62,61,0,0,0
2019-10-31 10:45,173,105,68,0,0,0
2019-10-31 11:00,224,124,100,0,0,0
2019-10-31 11:15,209,121,88,0,0,0
2019-10-31 11:30,224,143,81,0,0,0
2019-10-31 11:45,503,278,225,0,0,0
2019-10-31 12:00,510,272,238,0,0,0
2019-10-31 12:15,281,124,157,0,0,0
2019-10-31 12:30,211,116,95,0,0,0
2019-10-31 12:45,225,122,103,0,0,0
2019-10-31 13:00,217,108,109,0,0,0
2019-10-31 13:15,232,104,128,0,0,0
2019-10-31 13:30,267,134,133,0,0,0
2019-10-31 13:45,552,300,252,0,0,0
2019-10-31 14:00,584,249,335,0,0,0
2019-10-31 14:15,297,142,155,0,0,0
2019-10-31 14:30,247,131,116,0,0,0
2019-10-31 14:45,211,95,116,0,0,0
2019-10-31 15:00,239,102,137,0,0,0
2019-10-31 15:15,237,100,137,0,0,0
2019-10-31 15:30,341,183,158,0,0,0
2019-10-31 15:45,666,353,313,0,0,0
2019-10-31 16:00,591,325,266,0,0,0
2019-10-31 16:15,323,148,175,0,0,0
2019-10-31 16:30,334,157,177,0,0,0
2019-10-31 16:45,345,158,187,0,0,0
2019-10-31 17:00,319,134,185,0,0,0
2019-10-31 17:15,289,134,155,0,0,0
2019-10-31 17:30,298,165,133,0,0,0
2019-10-31 17:45,520,242,278,0,0,0
2019-10-31 18:00,378,179,199,0,0,0
2019-10-31 18:15,321,152,169,0,0,0
2019-10-31 18:30,219,98,121,0,0,0
2019-10-31 18:45,233,129,104,0,0,0
2019-10-31 19:00,239,109,130,0,0,0
2019-10-31 19:15,233,124,109,0,0,0
2019-10-31 19:30,186,105,81,0,0,0
2019-10-31 19:45,308,151,157,0,0,0
2019-10-31 20:00,277,129,148,0,0,0
2019-10-31 20:15,251,113,138,0,0,0
2019-10-31 20:30,210,96,114,0,0,0
2019-10-31 20:45,221,93,128,0,0,0
2019-10-31 21:00,160,65,95,0,0,0
2019-10-31 21:15,189,86,103,0,0,0
2019-10-31 21:30,122,56,66,0,0,0
2019-10-31 21:45,192,88,104,0,0,0
2019-10-31 22:00,155,73,82,0,0,0
2019-10-31 22:15,134,75,59,0,0,0
2019-10-31 22:30,107,60,47,0,0,0
2019-10-31 22:45,104,48,56,0,0,0
2019-10-31 23:00,110,42,68,0,0,0
2019-10-31 23:15,103,38,65,0,0,0
2019-10-31 23:30,110,46,64,0,0,0
2019-10-31 23:45,126,72,54,0,0,0
