Datetime,100035541 (Neutor),101035541 (Neutor stadteinwÃ¤rts),102035541 (Neutor stadtauswÃ¤rts),100035541-status,101035541-status,102035541-status
2020-10-01 00:00,59,26,33,0,0,0
2020-10-01 00:15,36,16,20,0,0,0
2020-10-01 00:30,37,11,26,0,0,0
2020-10-01 00:45,37,11,26,0,0,0
2020-10-01 01:00,32,7,25,0,0,0
2020-10-01 01:15,32,9,23,0,0,0
2020-10-01 01:30,24,5,19,0,0,0
2020-10-01 01:45,29,11,18,0,0,0
2020-10-01 02:00,32,6,26,0,0,0
2020-10-01 02:15,26,10,16,0,0,0
2020-10-01 02:30,5,2,3,0,0,0
2020-10-01 02:45,19,1,18,0,0,0
2020-10-01 03:00,10,2,8,0,0,0
2020-10-01 03:15,4,1,3,0,0,0
2020-10-01 03:30,6,2,4,0,0,0
2020-10-01 03:45,6,4,2,0,0,0
2020-10-01 04:00,3,1,2,0,0,0
2020-10-01 04:15,10,4,6,0,0,0
2020-10-01 04:30,4,3,1,0,0,0
2020-10-01 04:45,12,6,6,0,0,0
2020-10-01 05:00,7,5,2,0,0,0
2020-10-01 05:15,13,10,3,0,0,0
2020-10-01 05:30,29,17,12,0,0,0
2020-10-01 05:45,16,13,3,0,0,0
2020-10-01 06:00,38,31,7,0,0,0
2020-10-01 06:15,45,27,18,0,0,0
2020-10-01 06:30,68,40,28,0,0,0
2020-10-01 06:45,73,46,27,0,0,0
2020-10-01 07:00,115,69,46,0,0,0
2020-10-01 07:15,177,119,58,0,0,0
2020-10-01 07:30,352,263,89,0,0,0
2020-10-01 07:45,275,179,96,0,0,0
2020-10-01 08:00,197,101,96,0,0,0
2020-10-01 08:15,210,135,75,0,0,0
2020-10-01 08:30,198,112,86,0,0,0
2020-10-01 08:45,252,154,98,0,0,0
2020-10-01 09:00,159,111,48,0,0,0
2020-10-01 09:15,144,94,50,0,0,0
2020-10-01 09:30,156,85,71,0,0,0
2020-10-01 09:45,181,106,75,0,0,0
2020-10-01 10:00,103,57,46,0,0,0
2020-10-01 10:15,118,66,52,0,0,0
2020-10-01 10:30,120,64,56,0,0,0
2020-10-01 10:45,150,78,72,0,0,0
2020-10-01 11:00,138,77,61,0,0,0
2020-10-01 11:15,122,64,58,0,0,0
2020-10-01 11:30,140,81,59,0,0,0
2020-10-01 11:45,163,94,69,0,0,0
2020-10-01 12:00,172,107,65,0,0,0
2020-10-01 12:15,173,96,77,0,0,0
2020-10-01 12:30,150,76,74,0,0,0
2020-10-01 12:45,180,85,95,0,0,0
2020-10-01 13:00,198,79,119,0,0,0
2020-10-01 13:15,175,82,93,0,0,0
2020-10-01 13:30,231,94,137,0,0,0
2020-10-01 13:45,209,96,113,0,0,0
2020-10-01 14:00,227,93,134,0,0,0
2020-10-01 14:15,195,86,109,0,0,0
2020-10-01 14:30,179,82,97,0,0,0
2020-10-01 14:45,207,90,117,0,0,0
2020-10-01 15:00,184,72,112,0,0,0
2020-10-01 15:15,192,85,107,0,0,0
2020-10-01 15:30,283,98,185,0,0,0
2020-10-01 15:45,242,108,134,0,0,0
2020-10-01 16:00,232,97,135,0,0,0
2020-10-01 16:15,257,108,149,0,0,0
2020-10-01 16:30,239,113,126,0,0,0
2020-10-01 16:45,248,109,139,0,0,0
2020-10-01 17:00,178,62,116,0,0,0
2020-10-01 17:15,199,78,121,0,0,0
2020-10-01 17:30,191,66,125,0,0,0
2020-10-01 17:45,198,82,116,0,0,0
2020-10-01 18:00,179,68,111,0,0,0
2020-10-01 18:15,183,70,113,0,0,0
2020-10-01 18:30,133,64,69,0,0,0
2020-10-01 18:45,184,83,101,0,0,0
2020-10-01 19:00,201,94,107,0,0,0
2020-10-01 19:15,150,75,75,0,0,0
2020-10-01 19:30,139,64,75,0,0,0
2020-10-01 19:45,115,52,63,0,0,0
2020-10-01 20:00,94,34,60,0,0,0
2020-10-01 20:15,67,31,36,0,0,0
2020-10-01 20:30,73,27,46,0,0,0
2020-10-01 20:45,67,19,48,0,0,0
2020-10-01 21:00,67,21,46,0,0,0
2020-10-01 21:15,65,28,37,0,0,0
2020-10-01 21:30,75,33,42,0,0,0
2020-10-01 21:45,56,15,41,0,0,0
2020-10-01 22:00,52,16,36,0,0,0
2020-10-01 22:15,57,12,45,0,0,0
2020-10-01 22:30,57,10,47,0,0,0
2020-10-01 22:45,57,17,40,0,0,0
2020-10-01 23:00,53,13,40,0,0,0
2020-10-01 23:15,41,18,23,0,0,0
2020-10-01 23:30,33,14,19,0,0,0
2020-10-01 23:45,24,9,15,0,0,0
2020-10-02 00:00,43,9,34,0,0,0
2020-10-02 00:15,29,7,22,0,0,0
2020-10-02 00:30,23,6,17,0,0,0
2020-10-02 00:45,12,1,11,0,0,0
2020-10-02 01:00,18,3,15,0,0,0
2020-10-02 01:15,16,7,9,0,0,0
2020-10-02 01:30,12,3,9,0,0,0
2020-10-02 01:45,9,1,8,0,0,0
2020-10-02 02:00,10,3,7,0,0,0
2020-10-02 02:15,12,4,8,0,0,0
2020-10-02 02:30,11,6,5,0,0,0
2020-10-02 02:45,8,5,3,0,0,0
2020-10-02 03:00,14,7,7,0,0,0
2020-10-02 03:15,3,1,2,0,0,0
2020-10-02 03:30,4,1,3,0,0,0
2020-10-02 03:45,4,1,3,0,0,0
2020-10-02 04:00,4,1,3,0,0,0
2020-10-02 04:15,0,0,0,0,0,0
2020-10-02 04:30,8,4,4,0,0,0
2020-10-02 04:45,6,3,3,0,0,0
2020-10-02 05:00,10,8,2,0,0,0
2020-10-02 05:15,17,11,6,0,0,0
2020-10-02 05:30,14,7,7,0,0,0
2020-10-02 05:45,30,24,6,0,0,0
2020-10-02 06:00,31,24,7,0,0,0
2020-10-02 06:15,50,32,18,0,0,0
2020-10-02 06:30,50,35,15,0,0,0
2020-10-02 06:45,93,55,38,0,0,0
2020-10-02 07:00,92,59,33,0,0,0
2020-10-02 07:15,158,118,40,0,0,0
2020-10-02 07:30,313,235,78,0,0,0
2020-10-02 07:45,264,162,102,0,0,0
2020-10-02 08:00,169,99,70,0,0,0
2020-10-02 08:15,177,111,66,0,0,0
2020-10-02 08:30,171,100,71,0,0,0
2020-10-02 08:45,192,120,72,0,0,0
2020-10-02 09:00,156,103,53,0,0,0
2020-10-02 09:15,156,103,53,0,0,0
2020-10-02 09:30,153,97,56,0,0,0
2020-10-02 09:45,169,94,75,0,0,0
2020-10-02 10:00,124,72,52,0,0,0
2020-10-02 10:15,166,98,68,0,0,0
2020-10-02 10:30,149,96,53,0,0,0
2020-10-02 10:45,142,93,49,0,0,0
2020-10-02 11:00,123,65,58,0,0,0
2020-10-02 11:15,151,81,70,0,0,0
2020-10-02 11:30,162,95,67,0,0,0
2020-10-02 11:45,166,93,73,0,0,0
2020-10-02 12:00,181,102,79,0,0,0
2020-10-02 12:15,164,71,93,0,0,0
2020-10-02 12:30,211,107,104,0,0,0
2020-10-02 12:45,228,108,120,0,0,0
2020-10-02 13:00,293,105,188,0,0,0
2020-10-02 13:15,269,97,172,0,0,0
2020-10-02 13:30,184,84,100,0,0,0
2020-10-02 13:45,259,122,137,0,0,0
2020-10-02 14:00,232,109,123,0,0,0
2020-10-02 14:15,190,95,95,0,0,0
2020-10-02 14:30,193,93,100,0,0,0
2020-10-02 14:45,214,94,120,0,0,0
2020-10-02 15:00,178,74,104,0,0,0
2020-10-02 15:15,223,93,130,0,0,0
2020-10-02 15:30,218,84,134,0,0,0
2020-10-02 15:45,211,97,114,0,0,0
2020-10-02 16:00,212,97,115,0,0,0
2020-10-02 16:15,241,103,138,0,0,0
2020-10-02 16:30,185,97,88,0,0,0
2020-10-02 16:45,216,106,110,0,0,0
2020-10-02 17:00,222,95,127,0,0,0
2020-10-02 17:15,217,92,125,0,0,0
2020-10-02 17:30,199,84,115,0,0,0
2020-10-02 17:45,191,83,108,0,0,0
2020-10-02 18:00,191,78,113,0,0,0
2020-10-02 18:15,187,95,92,0,0,0
2020-10-02 18:30,165,77,88,0,0,0
2020-10-02 18:45,200,91,109,0,0,0
2020-10-02 19:00,202,74,128,0,0,0
2020-10-02 19:15,179,74,105,0,0,0
2020-10-02 19:30,170,78,92,0,0,0
2020-10-02 19:45,165,75,90,0,0,0
2020-10-02 20:00,125,60,65,0,0,0
2020-10-02 20:15,123,54,69,0,0,0
2020-10-02 20:30,109,41,68,0,0,0
2020-10-02 20:45,86,34,52,0,0,0
2020-10-02 21:00,79,37,42,0,0,0
2020-10-02 21:15,58,21,37,0,0,0
2020-10-02 21:30,75,35,40,0,0,0
2020-10-02 21:45,68,24,44,0,0,0
2020-10-02 22:00,66,28,38,0,0,0
2020-10-02 22:15,60,22,38,0,0,0
2020-10-02 22:30,58,18,40,0,0,0
2020-10-02 22:45,67,18,49,0,0,0
2020-10-02 23:00,61,23,38,0,0,0
2020-10-02 23:15,69,9,60,0,0,0
2020-10-02 23:30,62,14,48,0,0,0
2020-10-02 23:45,69,32,37,0,0,0
2020-10-03 00:00,56,18,38,0,0,0
2020-10-03 00:15,60,20,40,0,0,0
2020-10-03 00:30,60,16,44,0,0,0
2020-10-03 00:45,85,27,58,0,0,0
2020-10-03 01:00,46,19,27,0,0,0
2020-10-03 01:15,59,23,36,0,0,0
2020-10-03 01:30,64,18,46,0,0,0
2020-10-03 01:45,30,8,22,0,0,0
2020-10-03 02:00,60,24,36,0,0,0
2020-10-03 02:15,60,17,43,0,0,0
2020-10-03 02:30,39,13,26,0,0,0
2020-10-03 02:45,24,11,13,0,0,0
2020-10-03 03:00,24,7,17,0,0,0
2020-10-03 03:15,26,11,15,0,0,0
2020-10-03 03:30,24,11,13,0,0,0
2020-10-03 03:45,28,10,18,0,0,0
2020-10-03 04:00,14,3,11,0,0,0
2020-10-03 04:15,20,3,17,0,0,0
2020-10-03 04:30,11,4,7,0,0,0
2020-10-03 04:45,7,3,4,0,0,0
2020-10-03 05:00,12,6,6,0,0,0
2020-10-03 05:15,14,4,10,0,0,0
2020-10-03 05:30,16,8,8,0,0,0
2020-10-03 05:45,6,4,2,0,0,0
2020-10-03 06:00,7,4,3,0,0,0
2020-10-03 06:15,5,3,2,0,0,0
2020-10-03 06:30,9,6,3,0,0,0
2020-10-03 06:45,6,3,3,0,0,0
2020-10-03 07:00,6,4,2,0,0,0
2020-10-03 07:15,12,5,7,0,0,0
2020-10-03 07:30,14,9,5,0,0,0
2020-10-03 07:45,27,21,6,0,0,0
2020-10-03 08:00,11,10,1,0,0,0
2020-10-03 08:15,18,12,6,0,0,0
2020-10-03 08:30,28,14,14,0,0,0
2020-10-03 08:45,40,20,20,0,0,0
2020-10-03 09:00,32,17,15,0,0,0
2020-10-03 09:15,44,28,16,0,0,0
2020-10-03 09:30,48,28,20,0,0,0
2020-10-03 09:45,76,58,18,0,0,0
2020-10-03 10:00,40,23,17,0,0,0
2020-10-03 10:15,74,39,35,0,0,0
2020-10-03 10:30,61,37,24,0,0,0
2020-10-03 10:45,77,46,31,0,0,0
2020-10-03 11:00,73,53,20,0,0,0
2020-10-03 11:15,54,33,21,0,0,0
2020-10-03 11:30,85,56,29,0,0,0
2020-10-03 11:45,105,53,52,0,0,0
2020-10-03 12:00,93,48,45,0,0,0
2020-10-03 12:15,86,51,35,0,0,0
2020-10-03 12:30,108,60,48,0,0,0
2020-10-03 12:45,125,67,58,0,0,0
2020-10-03 13:00,103,45,58,0,0,0
2020-10-03 13:15,136,60,76,0,0,0
2020-10-03 13:30,79,33,46,0,0,0
2020-10-03 13:45,101,53,48,0,0,0
2020-10-03 14:00,117,54,63,0,0,0
2020-10-03 14:15,98,47,51,0,0,0
2020-10-03 14:30,109,50,59,0,0,0
2020-10-03 14:45,137,76,61,0,0,0
2020-10-03 15:00,123,52,71,0,0,0
2020-10-03 15:15,107,44,63,0,0,0
2020-10-03 15:30,87,38,49,0,0,0
2020-10-03 15:45,67,38,29,0,0,0
2020-10-03 16:00,57,24,33,0,0,0
2020-10-03 16:15,75,35,40,0,0,0
2020-10-03 16:30,39,16,23,0,0,0
2020-10-03 16:45,50,18,32,0,0,0
2020-10-03 17:00,58,33,25,0,0,0
2020-10-03 17:15,58,19,39,0,0,0
2020-10-03 17:30,67,31,36,0,0,0
2020-10-03 17:45,102,40,62,0,0,0
2020-10-03 18:00,95,35,60,0,0,0
2020-10-03 18:15,72,23,49,0,0,0
2020-10-03 18:30,70,28,42,0,0,0
2020-10-03 18:45,80,45,35,0,0,0
2020-10-03 19:00,68,28,40,0,0,0
2020-10-03 19:15,85,47,38,0,0,0
2020-10-03 19:30,89,40,49,0,0,0
2020-10-03 19:45,107,57,50,0,0,0
2020-10-03 20:00,81,43,38,0,0,0
2020-10-03 20:15,77,43,34,0,0,0
2020-10-03 20:30,92,51,41,0,0,0
2020-10-03 20:45,67,44,23,0,0,0
2020-10-03 21:00,41,22,19,0,0,0
2020-10-03 21:15,42,25,17,0,0,0
2020-10-03 21:30,43,25,18,0,0,0
2020-10-03 21:45,24,8,16,0,0,0
2020-10-03 22:00,49,25,24,0,0,0
2020-10-03 22:15,52,28,24,0,0,0
2020-10-03 22:30,40,16,24,0,0,0
2020-10-03 22:45,40,12,28,0,0,0
2020-10-03 23:00,50,14,36,0,0,0
2020-10-03 23:15,59,20,39,0,0,0
2020-10-03 23:30,38,8,30,0,0,0
2020-10-03 23:45,45,10,35,0,0,0
2020-10-04 00:00,57,12,45,0,0,0
2020-10-04 00:15,32,9,23,0,0,0
2020-10-04 00:30,48,10,38,0,0,0
2020-10-04 00:45,56,19,37,0,0,0
2020-10-04 01:00,45,17,28,0,0,0
2020-10-04 01:15,32,8,24,0,0,0
2020-10-04 01:30,30,7,23,0,0,0
2020-10-04 01:45,31,7,24,0,0,0
2020-10-04 02:00,34,9,25,0,0,0
2020-10-04 02:15,27,7,20,0,0,0
2020-10-04 02:30,16,7,9,0,0,0
2020-10-04 02:45,42,10,32,0,0,0
2020-10-04 03:00,26,10,16,0,0,0
2020-10-04 03:15,18,2,16,0,0,0
2020-10-04 03:30,12,6,6,0,0,0
2020-10-04 03:45,14,5,9,0,0,0
2020-10-04 04:00,3,1,2,0,0,0
2020-10-04 04:15,12,2,10,0,0,0
2020-10-04 04:30,7,1,6,0,0,0
2020-10-04 04:45,4,1,3,0,0,0
2020-10-04 05:00,9,5,4,0,0,0
2020-10-04 05:15,6,2,4,0,0,0
2020-10-04 05:30,14,8,6,0,0,0
2020-10-04 05:45,5,2,3,0,0,0
2020-10-04 06:00,9,5,4,0,0,0
2020-10-04 06:15,6,2,4,0,0,0
2020-10-04 06:30,7,4,3,0,0,0
2020-10-04 06:45,3,2,1,0,0,0
2020-10-04 07:00,4,2,2,0,0,0
2020-10-04 07:15,12,5,7,0,0,0
2020-10-04 07:30,16,10,6,0,0,0
2020-10-04 07:45,17,12,5,0,0,0
2020-10-04 08:00,11,8,3,0,0,0
2020-10-04 08:15,14,7,7,0,0,0
2020-10-04 08:30,14,11,3,0,0,0
2020-10-04 08:45,22,20,2,0,0,0
2020-10-04 09:00,26,18,8,0,0,0
2020-10-04 09:15,23,14,9,0,0,0
2020-10-04 09:30,50,32,18,0,0,0
2020-10-04 09:45,62,47,15,0,0,0
2020-10-04 10:00,49,35,14,0,0,0
2020-10-04 10:15,43,28,15,0,0,0
2020-10-04 10:30,65,35,30,0,0,0
2020-10-04 10:45,72,51,21,0,0,0
2020-10-04 11:00,65,31,34,0,0,0
2020-10-04 11:15,41,16,25,0,0,0
2020-10-04 11:30,43,25,18,0,0,0
2020-10-04 11:45,70,46,24,0,0,0
2020-10-04 12:00,69,33,36,0,0,0
2020-10-04 12:15,54,31,23,0,0,0
2020-10-04 12:30,71,29,42,0,0,0
2020-10-04 12:45,100,51,49,0,0,0
2020-10-04 13:00,54,32,22,0,0,0
2020-10-04 13:15,81,32,49,0,0,0
2020-10-04 13:30,76,42,34,0,0,0
2020-10-04 13:45,66,37,29,0,0,0
2020-10-04 14:00,68,38,30,0,0,0
2020-10-04 14:15,100,61,39,0,0,0
2020-10-04 14:30,121,68,53,0,0,0
2020-10-04 14:45,128,62,66,0,0,0
2020-10-04 15:00,91,44,47,0,0,0
2020-10-04 15:15,97,43,54,0,0,0
2020-10-04 15:30,123,76,47,0,0,0
2020-10-04 15:45,116,66,50,0,0,0
2020-10-04 16:00,120,72,48,0,0,0
2020-10-04 16:15,96,49,47,0,0,0
2020-10-04 16:30,104,50,54,0,0,0
2020-10-04 16:45,106,53,53,0,0,0
2020-10-04 17:00,118,55,63,0,0,0
2020-10-04 17:15,128,49,79,0,0,0
2020-10-04 17:30,119,56,63,0,0,0
2020-10-04 17:45,122,55,67,0,0,0
2020-10-04 18:00,88,36,52,0,0,0
2020-10-04 18:15,89,46,43,0,0,0
2020-10-04 18:30,100,52,48,0,0,0
2020-10-04 18:45,128,58,70,0,0,0
2020-10-04 19:00,86,42,44,0,0,0
2020-10-04 19:15,98,65,33,0,0,0
2020-10-04 19:30,98,47,51,0,0,0
2020-10-04 19:45,79,32,47,0,0,0
2020-10-04 20:00,78,29,49,0,0,0
2020-10-04 20:15,52,27,25,0,0,0
2020-10-04 20:30,55,19,36,0,0,0
2020-10-04 20:45,53,18,35,0,0,0
2020-10-04 21:00,49,16,33,0,0,0
2020-10-04 21:15,44,21,23,0,0,0
2020-10-04 21:30,34,10,24,0,0,0
2020-10-04 21:45,30,12,18,0,0,0
2020-10-04 22:00,44,18,26,0,0,0
2020-10-04 22:15,35,12,23,0,0,0
2020-10-04 22:30,43,12,31,0,0,0
2020-10-04 22:45,32,18,14,0,0,0
2020-10-04 23:00,22,6,16,0,0,0
2020-10-04 23:15,26,4,22,0,0,0
2020-10-04 23:30,10,4,6,0,0,0
2020-10-04 23:45,14,10,4,0,0,0
2020-10-05 00:00,16,6,10,0,0,0
2020-10-05 00:15,10,3,7,0,0,0
2020-10-05 00:30,11,5,6,0,0,0
2020-10-05 00:45,10,4,6,0,0,0
2020-10-05 01:00,4,1,3,0,0,0
2020-10-05 01:15,7,2,5,0,0,0
2020-10-05 01:30,13,6,7,0,0,0
2020-10-05 01:45,5,1,4,0,0,0
2020-10-05 02:00,5,1,4,0,0,0
2020-10-05 02:15,6,2,4,0,0,0
2020-10-05 02:30,6,4,2,0,0,0
2020-10-05 02:45,1,0,1,0,0,0
2020-10-05 03:00,3,0,3,0,0,0
2020-10-05 03:15,1,0,1,0,0,0
2020-10-05 03:30,2,0,2,0,0,0
2020-10-05 03:45,5,1,4,0,0,0
2020-10-05 04:00,2,1,1,0,0,0
2020-10-05 04:15,4,3,1,0,0,0
2020-10-05 04:30,6,5,1,0,0,0
2020-10-05 04:45,6,3,3,0,0,0
2020-10-05 05:00,3,3,0,0,0,0
2020-10-05 05:15,20,13,7,0,0,0
2020-10-05 05:30,20,14,6,0,0,0
2020-10-05 05:45,19,15,4,0,0,0
2020-10-05 06:00,28,21,7,0,0,0
2020-10-05 06:15,45,30,15,0,0,0
2020-10-05 06:30,54,37,17,0,0,0
2020-10-05 06:45,102,65,37,0,0,0
2020-10-05 07:00,107,57,50,0,0,0
2020-10-05 07:15,197,146,51,0,0,0
2020-10-05 07:30,330,240,90,0,0,0
2020-10-05 07:45,265,164,101,0,0,0
2020-10-05 08:00,228,144,84,0,0,0
2020-10-05 08:15,222,134,88,0,0,0
2020-10-05 08:30,181,106,75,0,0,0
2020-10-05 08:45,202,115,87,0,0,0
2020-10-05 09:00,122,70,52,0,0,0
2020-10-05 09:15,145,96,49,0,0,0
2020-10-05 09:30,172,95,77,0,0,0
2020-10-05 09:45,155,96,59,0,0,0
2020-10-05 10:00,125,75,50,0,0,0
2020-10-05 10:15,105,56,49,0,0,0
2020-10-05 10:30,126,77,49,0,0,0
2020-10-05 10:45,116,66,50,0,0,0
2020-10-05 11:00,106,72,34,0,0,0
2020-10-05 11:15,136,77,59,0,0,0
2020-10-05 11:30,131,70,61,0,0,0
2020-10-05 11:45,145,76,69,0,0,0
2020-10-05 12:00,148,75,73,0,0,0
2020-10-05 12:15,128,63,65,0,0,0
2020-10-05 12:30,169,88,81,0,0,0
2020-10-05 12:45,177,96,81,0,0,0
2020-10-05 13:00,168,78,90,0,0,0
2020-10-05 13:15,188,90,98,0,0,0
2020-10-05 13:30,177,71,106,0,0,0
2020-10-05 13:45,201,104,97,0,0,0
2020-10-05 14:00,182,79,103,0,0,0
2020-10-05 14:15,182,77,105,0,0,0
2020-10-05 14:30,183,79,104,0,0,0
2020-10-05 14:45,179,82,97,0,0,0
2020-10-05 15:00,182,101,81,0,0,0
2020-10-05 15:15,179,70,109,0,0,0
2020-10-05 15:30,260,95,165,0,0,0
2020-10-05 15:45,221,118,103,0,0,0
2020-10-05 16:00,262,124,138,0,0,0
2020-10-05 16:15,241,118,123,0,0,0
2020-10-05 16:30,250,117,133,0,0,0
2020-10-05 16:45,252,122,130,0,0,0
2020-10-05 17:00,240,113,127,0,0,0
2020-10-05 17:15,233,125,108,0,0,0
2020-10-05 17:30,245,100,145,0,0,0
2020-10-05 17:45,232,119,113,0,0,0
2020-10-05 18:00,246,107,139,0,0,0
2020-10-05 18:15,241,123,118,0,0,0
2020-10-05 18:30,222,112,110,0,0,0
2020-10-05 18:45,236,118,118,0,0,0
2020-10-05 19:00,156,74,82,0,0,0
2020-10-05 19:15,163,78,85,0,0,0
2020-10-05 19:30,172,71,101,0,0,0
2020-10-05 19:45,174,89,85,0,0,0
2020-10-05 20:00,177,79,98,0,0,0
2020-10-05 20:15,123,50,73,0,0,0
2020-10-05 20:30,94,42,52,0,0,0
2020-10-05 20:45,63,18,45,0,0,0
2020-10-05 21:00,70,19,51,0,0,0
2020-10-05 21:15,59,23,36,0,0,0
2020-10-05 21:30,81,27,54,0,0,0
2020-10-05 21:45,90,34,56,0,0,0
2020-10-05 22:00,73,28,45,0,0,0
2020-10-05 22:15,48,18,30,0,0,0
2020-10-05 22:30,64,16,48,0,0,0
2020-10-05 22:45,46,16,30,0,0,0
2020-10-05 23:00,47,16,31,0,0,0
2020-10-05 23:15,42,12,30,0,0,0
2020-10-05 23:30,42,17,25,0,0,0
2020-10-05 23:45,34,9,25,0,0,0
2020-10-06 00:00,37,10,27,0,0,0
2020-10-06 00:15,17,5,12,0,0,0
2020-10-06 00:30,17,10,7,0,0,0
2020-10-06 00:45,13,4,9,0,0,0
2020-10-06 01:00,11,4,7,0,0,0
2020-10-06 01:15,19,10,9,0,0,0
2020-10-06 01:30,9,4,5,0,0,0
2020-10-06 01:45,5,3,2,0,0,0
2020-10-06 02:00,5,2,3,0,0,0
2020-10-06 02:15,5,2,3,0,0,0
2020-10-06 02:30,10,3,7,0,0,0
2020-10-06 02:45,7,4,3,0,0,0
2020-10-06 03:00,0,0,0,0,0,0
2020-10-06 03:15,7,0,7,0,0,0
2020-10-06 03:30,0,0,0,0,0,0
2020-10-06 03:45,1,0,1,0,0,0
2020-10-06 04:00,5,1,4,0,0,0
2020-10-06 04:15,4,0,4,0,0,0
2020-10-06 04:30,2,1,1,0,0,0
2020-10-06 04:45,7,5,2,0,0,0
2020-10-06 05:00,7,6,1,0,0,0
2020-10-06 05:15,13,7,6,0,0,0
2020-10-06 05:30,22,13,9,0,0,0
2020-10-06 05:45,22,18,4,0,0,0
2020-10-06 06:00,31,23,8,0,0,0
2020-10-06 06:15,53,36,17,0,0,0
2020-10-06 06:30,59,34,25,0,0,0
2020-10-06 06:45,79,48,31,0,0,0
2020-10-06 07:00,87,56,31,0,0,0
2020-10-06 07:15,169,117,52,0,0,0
2020-10-06 07:30,324,248,76,0,0,0
2020-10-06 07:45,317,172,145,0,0,0
2020-10-06 08:00,239,131,108,0,0,0
2020-10-06 08:15,209,124,85,0,0,0
2020-10-06 08:30,181,110,71,0,0,0
2020-10-06 08:45,196,119,77,0,0,0
2020-10-06 09:00,123,78,45,0,0,0
2020-10-06 09:15,161,103,58,0,0,0
2020-10-06 09:30,132,73,59,0,0,0
2020-10-06 09:45,168,110,58,0,0,0
2020-10-06 10:00,122,84,38,0,0,0
2020-10-06 10:15,102,65,37,0,0,0
2020-10-06 10:30,119,60,59,0,0,0
2020-10-06 10:45,116,64,52,0,0,0
2020-10-06 11:00,113,56,57,0,0,0
2020-10-06 11:15,119,58,61,0,0,0
2020-10-06 11:30,119,66,53,0,0,0
2020-10-06 11:45,156,90,66,0,0,0
2020-10-06 12:00,140,70,70,0,0,0
2020-10-06 12:15,140,64,76,0,0,0
2020-10-06 12:30,178,79,99,0,0,0
2020-10-06 12:45,169,88,81,0,0,0
2020-10-06 13:00,264,93,171,0,0,0
2020-10-06 13:15,190,74,116,0,0,0
2020-10-06 13:30,186,85,101,0,0,0
2020-10-06 13:45,213,112,101,0,0,0
2020-10-06 14:00,157,64,93,0,0,0
2020-10-06 14:15,174,90,84,0,0,0
2020-10-06 14:30,181,96,85,0,0,0
2020-10-06 14:45,191,94,97,0,0,0
2020-10-06 15:00,190,95,95,0,0,0
2020-10-06 15:15,172,88,84,0,0,0
2020-10-06 15:30,191,90,101,0,0,0
2020-10-06 15:45,196,118,78,0,0,0
2020-10-06 16:00,207,96,111,0,0,0
2020-10-06 16:15,244,105,139,0,0,0
2020-10-06 16:30,257,150,107,0,0,0
2020-10-06 16:45,251,119,132,0,0,0
2020-10-06 17:00,238,110,128,0,0,0
2020-10-06 17:15,277,134,143,0,0,0
2020-10-06 17:30,189,72,117,0,0,0
2020-10-06 17:45,245,128,117,0,0,0
2020-10-06 18:00,252,119,133,0,0,0
2020-10-06 18:15,196,89,107,0,0,0
2020-10-06 18:30,178,73,105,0,0,0
2020-10-06 18:45,226,126,100,0,0,0
2020-10-06 19:00,194,95,99,0,0,0
2020-10-06 19:15,174,84,90,0,0,0
2020-10-06 19:30,151,78,73,0,0,0
2020-10-06 19:45,136,65,71,0,0,0
2020-10-06 20:00,128,67,61,0,0,0
2020-10-06 20:15,117,61,56,0,0,0
2020-10-06 20:30,89,43,46,0,0,0
2020-10-06 20:45,61,33,28,0,0,0
2020-10-06 21:00,86,29,57,0,0,0
2020-10-06 21:15,76,25,51,0,0,0
2020-10-06 21:30,79,28,51,0,0,0
2020-10-06 21:45,59,19,40,0,0,0
2020-10-06 22:00,51,18,33,0,0,0
2020-10-06 22:15,69,30,39,0,0,0
2020-10-06 22:30,72,18,54,0,0,0
2020-10-06 22:45,69,22,47,0,0,0
2020-10-06 23:00,43,16,27,0,0,0
2020-10-06 23:15,43,18,25,0,0,0
2020-10-06 23:30,47,14,33,0,0,0
2020-10-06 23:45,27,10,17,0,0,0
2020-10-07 00:00,40,6,34,0,0,0
2020-10-07 00:15,28,10,18,0,0,0
2020-10-07 00:30,16,8,8,0,0,0
2020-10-07 00:45,13,3,10,0,0,0
2020-10-07 01:00,19,9,10,0,0,0
2020-10-07 01:15,8,2,6,0,0,0
2020-10-07 01:30,9,2,7,0,0,0
2020-10-07 01:45,9,3,6,0,0,0
2020-10-07 02:00,13,1,12,0,0,0
2020-10-07 02:15,3,2,1,0,0,0
2020-10-07 02:30,10,1,9,0,0,0
2020-10-07 02:45,7,3,4,0,0,0
2020-10-07 03:00,5,1,4,0,0,0
2020-10-07 03:15,2,0,2,0,0,0
2020-10-07 03:30,4,3,1,0,0,0
2020-10-07 03:45,2,1,1,0,0,0
2020-10-07 04:00,1,1,0,0,0,0
2020-10-07 04:15,5,4,1,0,0,0
2020-10-07 04:30,1,1,0,0,0,0
2020-10-07 04:45,10,6,4,0,0,0
2020-10-07 05:00,6,6,0,0,0,0
2020-10-07 05:15,12,6,6,0,0,0
2020-10-07 05:30,11,11,0,0,0,0
2020-10-07 05:45,25,18,7,0,0,0
2020-10-07 06:00,26,21,5,0,0,0
2020-10-07 06:15,38,24,14,0,0,0
2020-10-07 06:30,66,47,19,0,0,0
2020-10-07 06:45,97,61,36,0,0,0
2020-10-07 07:00,111,66,45,0,0,0
2020-10-07 07:15,203,152,51,0,0,0
2020-10-07 07:30,309,230,79,0,0,0
2020-10-07 07:45,273,188,85,0,0,0
2020-10-07 08:00,228,130,98,0,0,0
2020-10-07 08:15,213,134,79,0,0,0
2020-10-07 08:30,227,120,107,0,0,0
2020-10-07 08:45,242,136,106,0,0,0
2020-10-07 09:00,138,71,67,0,0,0
2020-10-07 09:15,124,74,50,0,0,0
2020-10-07 09:30,145,78,67,0,0,0
2020-10-07 09:45,172,122,50,0,0,0
2020-10-07 10:00,115,66,49,0,0,0
2020-10-07 10:15,107,69,38,0,0,0
2020-10-07 10:30,125,83,42,0,0,0
2020-10-07 10:45,153,93,60,0,0,0
2020-10-07 11:00,133,81,52,0,0,0
2020-10-07 11:15,149,68,81,0,0,0
2020-10-07 11:30,131,61,70,0,0,0
2020-10-07 11:45,185,96,89,0,0,0
2020-10-07 12:00,189,110,79,0,0,0
2020-10-07 12:15,191,85,106,0,0,0
2020-10-07 12:30,165,79,86,0,0,0
2020-10-07 12:45,211,124,87,0,0,0
2020-10-07 13:00,153,67,86,0,0,0
2020-10-07 13:15,214,85,129,0,0,0
2020-10-07 13:30,182,87,95,0,0,0
2020-10-07 13:45,213,96,117,0,0,0
2020-10-07 14:00,193,78,115,0,0,0
2020-10-07 14:15,161,84,77,0,0,0
2020-10-07 14:30,137,72,65,0,0,0
2020-10-07 14:45,143,58,85,0,0,0
2020-10-07 15:00,148,59,89,0,0,0
2020-10-07 15:15,119,50,69,0,0,0
2020-10-07 15:30,190,48,142,0,0,0
2020-10-07 15:45,159,63,96,0,0,0
2020-10-07 16:00,190,83,107,0,0,0
2020-10-07 16:15,213,103,110,0,0,0
2020-10-07 16:30,169,73,96,0,0,0
2020-10-07 16:45,224,129,95,0,0,0
2020-10-07 17:00,182,74,108,0,0,0
2020-10-07 17:15,205,96,109,0,0,0
2020-10-07 17:30,209,101,108,0,0,0
2020-10-07 17:45,243,129,114,0,0,0
2020-10-07 18:00,210,109,101,0,0,0
2020-10-07 18:15,224,102,122,0,0,0
2020-10-07 18:30,210,83,127,0,0,0
2020-10-07 18:45,211,115,96,0,0,0
2020-10-07 19:00,180,82,98,0,0,0
2020-10-07 19:15,195,91,104,0,0,0
2020-10-07 19:30,167,84,83,0,0,0
2020-10-07 19:45,171,75,96,0,0,0
2020-10-07 20:00,172,77,95,0,0,0
2020-10-07 20:15,158,63,95,0,0,0
2020-10-07 20:30,127,55,72,0,0,0
2020-10-07 20:45,101,53,48,0,0,0
2020-10-07 21:00,84,46,38,0,0,0
2020-10-07 21:15,90,44,46,0,0,0
2020-10-07 21:30,92,28,64,0,0,0
2020-10-07 21:45,58,22,36,0,0,0
2020-10-07 22:00,75,29,46,0,0,0
2020-10-07 22:15,85,22,63,0,0,0
2020-10-07 22:30,80,34,46,0,0,0
2020-10-07 22:45,51,22,29,0,0,0
2020-10-07 23:00,56,22,34,0,0,0
2020-10-07 23:15,76,26,50,0,0,0
2020-10-07 23:30,48,12,36,0,0,0
2020-10-07 23:45,32,6,26,0,0,0
2020-10-08 00:00,25,6,19,0,0,0
2020-10-08 00:15,36,14,22,0,0,0
2020-10-08 00:30,24,6,18,0,0,0
2020-10-08 00:45,44,19,25,0,0,0
2020-10-08 01:00,22,12,10,0,0,0
2020-10-08 01:15,44,5,39,0,0,0
2020-10-08 01:30,14,5,9,0,0,0
2020-10-08 01:45,19,5,14,0,0,0
2020-10-08 02:00,19,4,15,0,0,0
2020-10-08 02:15,19,4,15,0,0,0
2020-10-08 02:30,17,2,15,0,0,0
2020-10-08 02:45,19,7,12,0,0,0
2020-10-08 03:00,17,6,11,0,0,0
2020-10-08 03:15,11,2,9,0,0,0
2020-10-08 03:30,7,6,1,0,0,0
2020-10-08 03:45,3,1,2,0,0,0
2020-10-08 04:00,9,4,5,0,0,0
2020-10-08 04:15,2,2,0,0,0,0
2020-10-08 04:30,5,2,3,0,0,0
2020-10-08 04:45,8,4,4,0,0,0
2020-10-08 05:00,8,7,1,0,0,0
2020-10-08 05:15,13,8,5,0,0,0
2020-10-08 05:30,18,14,4,0,0,0
2020-10-08 05:45,25,22,3,0,0,0
2020-10-08 06:00,40,27,13,0,0,0
2020-10-08 06:15,47,30,17,0,0,0
2020-10-08 06:30,60,45,15,0,0,0
2020-10-08 06:45,86,51,35,0,0,0
2020-10-08 07:00,100,58,42,0,0,0
2020-10-08 07:15,159,124,35,0,0,0
2020-10-08 07:30,325,243,82,0,0,0
2020-10-08 07:45,302,181,121,0,0,0
2020-10-08 08:00,179,97,82,0,0,0
2020-10-08 08:15,209,124,85,0,0,0
2020-10-08 08:30,180,116,64,0,0,0
2020-10-08 08:45,197,120,77,0,0,0
2020-10-08 09:00,136,77,59,0,0,0
2020-10-08 09:15,108,53,55,0,0,0
2020-10-08 09:30,108,56,52,0,0,0
2020-10-08 09:45,134,75,59,0,0,0
2020-10-08 10:00,114,74,40,0,0,0
2020-10-08 10:15,81,49,32,0,0,0
2020-10-08 10:30,92,49,43,0,0,0
2020-10-08 10:45,95,60,35,0,0,0
2020-10-08 11:00,88,52,36,0,0,0
2020-10-08 11:15,76,30,46,0,0,0
2020-10-08 11:30,93,64,29,0,0,0
2020-10-08 11:45,120,63,57,0,0,0
2020-10-08 12:00,152,79,73,0,0,0
2020-10-08 12:15,148,68,80,0,0,0
2020-10-08 12:30,112,60,52,0,0,0
2020-10-08 12:45,140,79,61,0,0,0
2020-10-08 13:00,166,80,86,0,0,0
2020-10-08 13:15,165,68,97,0,0,0
2020-10-08 13:30,163,75,88,0,0,0
2020-10-08 13:45,194,103,91,0,0,0
2020-10-08 14:00,170,75,95,0,0,0
2020-10-08 14:15,173,79,94,0,0,0
2020-10-08 14:30,163,83,80,0,0,0
2020-10-08 14:45,177,93,84,0,0,0
2020-10-08 15:00,157,63,94,0,0,0
2020-10-08 15:15,197,93,104,0,0,0
2020-10-08 15:30,250,69,181,0,0,0
2020-10-08 15:45,224,107,117,0,0,0
2020-10-08 16:00,168,74,94,0,0,0
2020-10-08 16:15,169,77,92,0,0,0
2020-10-08 16:30,180,89,91,0,0,0
2020-10-08 16:45,215,110,105,0,0,0
2020-10-08 17:00,222,96,126,0,0,0
2020-10-08 17:15,194,98,96,0,0,0
2020-10-08 17:30,204,88,116,0,0,0
2020-10-08 17:45,196,82,114,0,0,0
2020-10-08 18:00,164,66,98,0,0,0
2020-10-08 18:15,152,61,91,0,0,0
2020-10-08 18:30,148,65,83,0,0,0
2020-10-08 18:45,153,80,73,0,0,0
2020-10-08 19:00,138,64,74,0,0,0
2020-10-08 19:15,153,60,93,0,0,0
2020-10-08 19:30,102,40,62,0,0,0
2020-10-08 19:45,126,55,71,0,0,0
2020-10-08 20:00,96,40,56,0,0,0
2020-10-08 20:15,86,26,60,0,0,0
2020-10-08 20:30,63,34,29,0,0,0
2020-10-08 20:45,61,31,30,0,0,0
2020-10-08 21:00,71,33,38,0,0,0
2020-10-08 21:15,65,27,38,0,0,0
2020-10-08 21:30,64,21,43,0,0,0
2020-10-08 21:45,61,22,39,0,0,0
2020-10-08 22:00,53,17,36,0,0,0
2020-10-08 22:15,46,15,31,0,0,0
2020-10-08 22:30,59,13,46,0,0,0
2020-10-08 22:45,40,13,27,0,0,0
2020-10-08 23:00,44,6,38,0,0,0
2020-10-08 23:15,27,10,17,0,0,0
2020-10-08 23:30,32,10,22,0,0,0
2020-10-08 23:45,23,7,16,0,0,0
2020-10-09 00:00,51,5,46,0,0,0
2020-10-09 00:15,28,6,22,0,0,0
2020-10-09 00:30,23,7,16,0,0,0
2020-10-09 00:45,35,6,29,0,0,0
2020-10-09 01:00,28,11,17,0,0,0
2020-10-09 01:15,22,3,19,0,0,0
2020-10-09 01:30,18,7,11,0,0,0
2020-10-09 01:45,9,2,7,0,0,0
2020-10-09 02:00,12,3,9,0,0,0
2020-10-09 02:15,7,2,5,0,0,0
2020-10-09 02:30,25,6,19,0,0,0
2020-10-09 02:45,9,8,1,0,0,0
2020-10-09 03:00,4,2,2,0,0,0
2020-10-09 03:15,4,2,2,0,0,0
2020-10-09 03:30,5,1,4,0,0,0
2020-10-09 03:45,3,3,0,0,0,0
2020-10-09 04:00,6,3,3,0,0,0
2020-10-09 04:15,3,0,3,0,0,0
2020-10-09 04:30,2,1,1,0,0,0
2020-10-09 04:45,11,6,5,0,0,0
2020-10-09 05:00,6,4,2,0,0,0
2020-10-09 05:15,6,4,2,0,0,0
2020-10-09 05:30,13,10,3,0,0,0
2020-10-09 05:45,26,19,7,0,0,0
2020-10-09 06:00,36,26,10,0,0,0
2020-10-09 06:15,43,32,11,0,0,0
2020-10-09 06:30,64,45,19,0,0,0
2020-10-09 06:45,71,46,25,0,0,0
2020-10-09 07:00,73,52,21,0,0,0
2020-10-09 07:15,141,97,44,0,0,0
2020-10-09 07:30,271,206,65,0,0,0
2020-10-09 07:45,253,159,94,0,0,0
2020-10-09 08:00,183,113,70,0,0,0
2020-10-09 08:15,171,103,68,0,0,0
2020-10-09 08:30,146,94,52,0,0,0
2020-10-09 08:45,194,123,71,0,0,0
2020-10-09 09:00,140,96,44,0,0,0
2020-10-09 09:15,135,82,53,0,0,0
2020-10-09 09:30,130,68,62,0,0,0
2020-10-09 09:45,150,76,74,0,0,0
2020-10-09 10:00,142,99,43,0,0,0
2020-10-09 10:15,101,62,39,0,0,0
2020-10-09 10:30,107,58,49,0,0,0
2020-10-09 10:45,140,72,68,0,0,0
2020-10-09 11:00,122,63,59,0,0,0
2020-10-09 11:15,136,78,58,0,0,0
2020-10-09 11:30,154,89,65,0,0,0
2020-10-09 11:45,204,116,88,0,0,0
2020-10-09 12:00,162,84,78,0,0,0
2020-10-09 12:15,192,86,106,0,0,0
2020-10-09 12:30,183,101,82,0,0,0
2020-10-09 12:45,189,86,103,0,0,0
2020-10-09 13:00,227,87,140,0,0,0
2020-10-09 13:15,251,117,134,0,0,0
2020-10-09 13:30,212,95,117,0,0,0
2020-10-09 13:45,205,115,90,0,0,0
2020-10-09 14:00,234,116,118,0,0,0
2020-10-09 14:15,200,109,91,0,0,0
2020-10-09 14:30,193,81,112,0,0,0
2020-10-09 14:45,210,113,97,0,0,0
2020-10-09 15:00,145,62,83,0,0,0
2020-10-09 15:15,207,101,106,0,0,0
2020-10-09 15:30,170,73,97,0,0,0
2020-10-09 15:45,199,95,104,0,0,0
2020-10-09 16:00,203,101,102,0,0,0
2020-10-09 16:15,192,89,103,0,0,0
2020-10-09 16:30,203,74,129,0,0,0
2020-10-09 16:45,205,83,122,0,0,0
2020-10-09 17:00,237,129,108,0,0,0
2020-10-09 17:15,229,105,124,0,0,0
2020-10-09 17:30,214,101,113,0,0,0
2020-10-09 17:45,224,109,115,0,0,0
2020-10-09 18:00,168,63,105,0,0,0
2020-10-09 18:15,188,92,96,0,0,0
2020-10-09 18:30,169,74,95,0,0,0
2020-10-09 18:45,204,102,102,0,0,0
2020-10-09 19:00,191,92,99,0,0,0
2020-10-09 19:15,153,76,77,0,0,0
2020-10-09 19:30,162,83,79,0,0,0
2020-10-09 19:45,167,77,90,0,0,0
2020-10-09 20:00,140,75,65,0,0,0
2020-10-09 20:15,113,52,61,0,0,0
2020-10-09 20:30,142,66,76,0,0,0
2020-10-09 20:45,100,66,34,0,0,0
2020-10-09 21:00,82,40,42,0,0,0
2020-10-09 21:15,76,26,50,0,0,0
2020-10-09 21:30,55,31,24,0,0,0
2020-10-09 21:45,74,22,52,0,0,0
2020-10-09 22:00,55,16,39,0,0,0
2020-10-09 22:15,69,26,43,0,0,0
2020-10-09 22:30,73,35,38,0,0,0
2020-10-09 22:45,83,20,63,0,0,0
2020-10-09 23:00,48,17,31,0,0,0
2020-10-09 23:15,60,28,32,0,0,0
2020-10-09 23:30,41,16,25,0,0,0
2020-10-09 23:45,64,24,40,0,0,0
2020-10-10 00:00,67,26,41,0,0,0
2020-10-10 00:15,72,27,45,0,0,0
2020-10-10 00:30,58,21,37,0,0,0
2020-10-10 00:45,68,18,50,0,0,0
2020-10-10 01:00,40,13,27,0,0,0
2020-10-10 01:15,49,11,38,0,0,0
2020-10-10 01:30,34,12,22,0,0,0
2020-10-10 01:45,34,10,24,0,0,0
2020-10-10 02:00,34,16,18,0,0,0
2020-10-10 02:15,45,14,31,0,0,0
2020-10-10 02:30,52,18,34,0,0,0
2020-10-10 02:45,38,8,30,0,0,0
2020-10-10 03:00,27,11,16,0,0,0
2020-10-10 03:15,39,6,33,0,0,0
2020-10-10 03:30,8,0,8,0,0,0
2020-10-10 03:45,17,2,15,0,0,0
2020-10-10 04:00,18,5,13,0,0,0
2020-10-10 04:15,9,4,5,0,0,0
2020-10-10 04:30,8,4,4,0,0,0
2020-10-10 04:45,6,2,4,0,0,0
2020-10-10 05:00,13,6,7,0,0,0
2020-10-10 05:15,8,3,5,0,0,0
2020-10-10 05:30,14,9,5,0,0,0
2020-10-10 05:45,16,12,4,0,0,0
2020-10-10 06:00,15,4,11,0,0,0
2020-10-10 06:15,10,3,7,0,0,0
2020-10-10 06:30,12,8,4,0,0,0
2020-10-10 06:45,12,8,4,0,0,0
2020-10-10 07:00,14,11,3,0,0,0
2020-10-10 07:15,21,10,11,0,0,0
2020-10-10 07:30,24,15,9,0,0,0
2020-10-10 07:45,43,31,12,0,0,0
2020-10-10 08:00,32,20,12,0,0,0
2020-10-10 08:15,24,19,5,0,0,0
2020-10-10 08:30,48,31,17,0,0,0
2020-10-10 08:45,55,30,25,0,0,0
2020-10-10 09:00,56,41,15,0,0,0
2020-10-10 09:15,73,41,32,0,0,0
2020-10-10 09:30,88,60,28,0,0,0
2020-10-10 09:45,129,99,30,0,0,0
2020-10-10 10:00,106,80,26,0,0,0
2020-10-10 10:15,109,75,34,0,0,0
2020-10-10 10:30,121,86,35,0,0,0
2020-10-10 10:45,151,107,44,0,0,0
2020-10-10 11:00,125,89,36,0,0,0
2020-10-10 11:15,110,77,33,0,0,0
2020-10-10 11:30,141,104,37,0,0,0
2020-10-10 11:45,164,102,62,0,0,0
2020-10-10 12:00,204,108,96,0,0,0
2020-10-10 12:15,162,100,62,0,0,0
2020-10-10 12:30,172,122,50,0,0,0
2020-10-10 12:45,170,101,69,0,0,0
2020-10-10 13:00,158,84,74,0,0,0
2020-10-10 13:15,152,77,75,0,0,0
2020-10-10 13:30,210,110,100,0,0,0
2020-10-10 13:45,199,108,91,0,0,0
2020-10-10 14:00,157,86,71,0,0,0
2020-10-10 14:15,178,89,89,0,0,0
2020-10-10 14:30,173,75,98,0,0,0
2020-10-10 14:45,230,115,115,0,0,0
2020-10-10 15:00,188,83,105,0,0,0
2020-10-10 15:15,165,86,79,0,0,0
2020-10-10 15:30,160,76,84,0,0,0
2020-10-10 15:45,166,87,79,0,0,0
2020-10-10 16:00,146,60,86,0,0,0
2020-10-10 16:15,133,51,82,0,0,0
2020-10-10 16:30,140,59,81,0,0,0
2020-10-10 16:45,121,44,77,0,0,0
2020-10-10 17:00,153,44,109,0,0,0
2020-10-10 17:15,123,35,88,0,0,0
2020-10-10 17:30,109,45,64,0,0,0
2020-10-10 17:45,134,57,77,0,0,0
2020-10-10 18:00,118,45,73,0,0,0
2020-10-10 18:15,125,47,78,0,0,0
2020-10-10 18:30,88,41,47,0,0,0
2020-10-10 18:45,130,56,74,0,0,0
2020-10-10 19:00,93,35,58,0,0,0
2020-10-10 19:15,97,44,53,0,0,0
2020-10-10 19:30,124,45,79,0,0,0
2020-10-10 19:45,99,54,45,0,0,0
2020-10-10 20:00,85,39,46,0,0,0
2020-10-10 20:15,93,48,45,0,0,0
2020-10-10 20:30,43,22,21,0,0,0
2020-10-10 20:45,59,25,34,0,0,0
2020-10-10 21:00,49,23,26,0,0,0
2020-10-10 21:15,49,10,39,0,0,0
2020-10-10 21:30,39,10,29,0,0,0
2020-10-10 21:45,24,11,13,0,0,0
2020-10-10 22:00,32,11,21,0,0,0
2020-10-10 22:15,49,17,32,0,0,0
2020-10-10 22:30,33,12,21,0,0,0
2020-10-10 22:45,39,16,23,0,0,0
2020-10-10 23:00,43,11,32,0,0,0
2020-10-10 23:15,55,19,36,0,0,0
2020-10-10 23:30,48,25,23,0,0,0
2020-10-10 23:45,54,27,27,0,0,0
2020-10-11 00:00,42,17,25,0,0,0
2020-10-11 00:15,50,21,29,0,0,0
2020-10-11 00:30,37,14,23,0,0,0
2020-10-11 00:45,32,12,20,0,0,0
2020-10-11 01:00,26,4,22,0,0,0
2020-10-11 01:15,45,18,27,0,0,0
2020-10-11 01:30,46,20,26,0,0,0
2020-10-11 01:45,27,13,14,0,0,0
2020-10-11 02:00,31,10,21,0,0,0
2020-10-11 02:15,27,10,17,0,0,0
2020-10-11 02:30,23,8,15,0,0,0
2020-10-11 02:45,20,5,15,0,0,0
2020-10-11 03:00,28,6,22,0,0,0
2020-10-11 03:15,27,11,16,0,0,0
2020-10-11 03:30,18,6,12,0,0,0
2020-10-11 03:45,19,6,13,0,0,0
2020-10-11 04:00,10,2,8,0,0,0
2020-10-11 04:15,12,6,6,0,0,0
2020-10-11 04:30,5,5,0,0,0,0
2020-10-11 04:45,8,5,3,0,0,0
2020-10-11 05:00,13,2,11,0,0,0
2020-10-11 05:15,2,2,0,0,0,0
2020-10-11 05:30,7,5,2,0,0,0
2020-10-11 05:45,8,4,4,0,0,0
2020-10-11 06:00,10,4,6,0,0,0
2020-10-11 06:15,4,2,2,0,0,0
2020-10-11 06:30,13,6,7,0,0,0
2020-10-11 06:45,8,5,3,0,0,0
2020-10-11 07:00,6,4,2,0,0,0
2020-10-11 07:15,7,5,2,0,0,0
2020-10-11 07:30,12,3,9,0,0,0
2020-10-11 07:45,13,10,3,0,0,0
2020-10-11 08:00,12,6,6,0,0,0
2020-10-11 08:15,11,5,6,0,0,0
2020-10-11 08:30,8,7,1,0,0,0
2020-10-11 08:45,21,14,7,0,0,0
2020-10-11 09:00,23,15,8,0,0,0
2020-10-11 09:15,29,23,6,0,0,0
2020-10-11 09:30,39,23,16,0,0,0
2020-10-11 09:45,65,38,27,0,0,0
2020-10-11 10:00,40,30,10,0,0,0
2020-10-11 10:15,40,26,14,0,0,0
2020-10-11 10:30,53,40,13,0,0,0
2020-10-11 10:45,62,45,17,0,0,0
2020-10-11 11:00,43,30,13,0,0,0
2020-10-11 11:15,63,46,17,0,0,0
2020-10-11 11:30,65,44,21,0,0,0
2020-10-11 11:45,69,52,17,0,0,0
2020-10-11 12:00,71,40,31,0,0,0
2020-10-11 12:15,81,48,33,0,0,0
2020-10-11 12:30,90,47,43,0,0,0
2020-10-11 12:45,78,41,37,0,0,0
2020-10-11 13:00,86,52,34,0,0,0
2020-10-11 13:15,92,51,41,0,0,0
2020-10-11 13:30,123,53,70,0,0,0
2020-10-11 13:45,114,65,49,0,0,0
2020-10-11 14:00,108,58,50,0,0,0
2020-10-11 14:15,98,56,42,0,0,0
2020-10-11 14:30,132,66,66,0,0,0
2020-10-11 14:45,125,68,57,0,0,0
2020-10-11 15:00,105,55,50,0,0,0
2020-10-11 15:15,99,46,53,0,0,0
2020-10-11 15:30,84,37,47,0,0,0
2020-10-11 15:45,109,47,62,0,0,0
2020-10-11 16:00,87,35,52,0,0,0
2020-10-11 16:15,102,45,57,0,0,0
2020-10-11 16:30,111,44,67,0,0,0
2020-10-11 16:45,103,48,55,0,0,0
2020-10-11 17:00,79,38,41,0,0,0
2020-10-11 17:15,87,36,51,0,0,0
2020-10-11 17:30,82,33,49,0,0,0
2020-10-11 17:45,100,42,58,0,0,0
2020-10-11 18:00,105,36,69,0,0,0
2020-10-11 18:15,77,43,34,0,0,0
2020-10-11 18:30,92,39,53,0,0,0
2020-10-11 18:45,86,52,34,0,0,0
2020-10-11 19:00,98,55,43,0,0,0
2020-10-11 19:15,90,43,47,0,0,0
2020-10-11 19:30,75,27,48,0,0,0
2020-10-11 19:45,75,38,37,0,0,0
2020-10-11 20:00,83,31,52,0,0,0
2020-10-11 20:15,67,26,41,0,0,0
2020-10-11 20:30,55,17,38,0,0,0
2020-10-11 20:45,56,18,38,0,0,0
2020-10-11 21:00,52,24,28,0,0,0
2020-10-11 21:15,44,15,29,0,0,0
2020-10-11 21:30,42,8,34,0,0,0
2020-10-11 21:45,51,14,37,0,0,0
2020-10-11 22:00,26,9,17,0,0,0
2020-10-11 22:15,38,15,23,0,0,0
2020-10-11 22:30,33,11,22,0,0,0
2020-10-11 22:45,37,13,24,0,0,0
2020-10-11 23:00,35,12,23,0,0,0
2020-10-11 23:15,16,6,10,0,0,0
2020-10-11 23:30,29,3,26,0,0,0
2020-10-11 23:45,12,4,8,0,0,0
2020-10-12 00:00,19,6,13,0,0,0
2020-10-12 00:15,12,4,8,0,0,0
2020-10-12 00:30,15,7,8,0,0,0
2020-10-12 00:45,16,5,11,0,0,0
2020-10-12 01:00,7,2,5,0,0,0
2020-10-12 01:15,12,2,10,0,0,0
2020-10-12 01:30,10,3,7,0,0,0
2020-10-12 01:45,4,1,3,0,0,0
2020-10-12 02:00,3,2,1,0,0,0
2020-10-12 02:15,7,5,2,0,0,0
2020-10-12 02:30,2,1,1,0,0,0
2020-10-12 02:45,7,0,7,0,0,0
2020-10-12 03:00,2,1,1,0,0,0
2020-10-12 03:15,1,0,1,0,0,0
2020-10-12 03:30,1,1,0,0,0,0
2020-10-12 03:45,1,0,1,0,0,0
2020-10-12 04:00,2,0,2,0,0,0
2020-10-12 04:15,1,1,0,0,0,0
2020-10-12 04:30,4,3,1,0,0,0
2020-10-12 04:45,8,4,4,0,0,0
2020-10-12 05:00,8,2,6,0,0,0
2020-10-12 05:15,9,4,5,0,0,0
2020-10-12 05:30,19,14,5,0,0,0
2020-10-12 05:45,23,18,5,0,0,0
2020-10-12 06:00,36,25,11,0,0,0
2020-10-12 06:15,31,22,9,0,0,0
2020-10-12 06:30,62,39,23,0,0,0
2020-10-12 06:45,77,50,27,0,0,0
2020-10-12 07:00,74,46,28,0,0,0
2020-10-12 07:15,91,54,37,0,0,0
2020-10-12 07:30,140,83,57,0,0,0
2020-10-12 07:45,180,106,74,0,0,0
2020-10-12 08:00,163,89,74,0,0,0
2020-10-12 08:15,182,111,71,0,0,0
2020-10-12 08:30,154,103,51,0,0,0
2020-10-12 08:45,187,106,81,0,0,0
2020-10-12 09:00,117,76,41,0,0,0
2020-10-12 09:15,121,83,38,0,0,0
2020-10-12 09:30,120,61,59,0,0,0
2020-10-12 09:45,127,72,55,0,0,0
2020-10-12 10:00,84,46,38,0,0,0
2020-10-12 10:15,133,77,56,0,0,0
2020-10-12 10:30,118,77,41,0,0,0
2020-10-12 10:45,107,61,46,0,0,0
2020-10-12 11:00,99,51,48,0,0,0
2020-10-12 11:15,118,63,55,0,0,0
2020-10-12 11:30,114,66,48,0,0,0
2020-10-12 11:45,143,80,63,0,0,0
2020-10-12 12:00,156,74,82,0,0,0
2020-10-12 12:15,143,81,62,0,0,0
2020-10-12 12:30,175,91,84,0,0,0
2020-10-12 12:45,162,98,64,0,0,0
2020-10-12 13:00,154,74,80,0,0,0
2020-10-12 13:15,166,92,74,0,0,0
2020-10-12 13:30,159,77,82,0,0,0
2020-10-12 13:45,191,101,90,0,0,0
2020-10-12 14:00,156,80,76,0,0,0
2020-10-12 14:15,189,90,99,0,0,0
2020-10-12 14:30,147,90,57,0,0,0
2020-10-12 14:45,207,107,100,0,0,0
2020-10-12 15:00,155,78,77,0,0,0
2020-10-12 15:15,190,96,94,0,0,0
2020-10-12 15:30,181,84,97,0,0,0
2020-10-12 15:45,210,112,98,0,0,0
2020-10-12 16:00,224,113,111,0,0,0
2020-10-12 16:15,203,104,99,0,0,0
2020-10-12 16:30,241,113,128,0,0,0
2020-10-12 16:45,241,124,117,0,0,0
2020-10-12 17:00,240,118,122,0,0,0
2020-10-12 17:15,254,130,124,0,0,0
2020-10-12 17:30,282,147,135,0,0,0
2020-10-12 17:45,276,139,137,0,0,0
2020-10-12 18:00,269,122,147,0,0,0
2020-10-12 18:15,212,95,117,0,0,0
2020-10-12 18:30,200,94,106,0,0,0
2020-10-12 18:45,204,98,106,0,0,0
2020-10-12 19:00,179,85,94,0,0,0
2020-10-12 19:15,182,80,102,0,0,0
2020-10-12 19:30,144,64,80,0,0,0
2020-10-12 19:45,127,58,69,0,0,0
2020-10-12 20:00,134,57,77,0,0,0
2020-10-12 20:15,134,48,86,0,0,0
2020-10-12 20:30,92,40,52,0,0,0
2020-10-12 20:45,73,29,44,0,0,0
2020-10-12 21:00,65,25,40,0,0,0
2020-10-12 21:15,77,23,54,0,0,0
2020-10-12 21:30,77,21,56,0,0,0
2020-10-12 21:45,68,24,44,0,0,0
2020-10-12 22:00,69,29,40,0,0,0
2020-10-12 22:15,73,12,61,0,0,0
2020-10-12 22:30,73,29,44,0,0,0
2020-10-12 22:45,67,20,47,0,0,0
2020-10-12 23:00,44,13,31,0,0,0
2020-10-12 23:15,48,11,37,0,0,0
2020-10-12 23:30,33,14,19,0,0,0
2020-10-12 23:45,42,9,33,0,0,0
2020-10-13 00:00,23,5,18,0,0,0
2020-10-13 00:15,27,11,16,0,0,0
2020-10-13 00:30,38,10,28,0,0,0
2020-10-13 00:45,19,2,17,0,0,0
2020-10-13 01:00,15,5,10,0,0,0
2020-10-13 01:15,11,6,5,0,0,0
2020-10-13 01:30,10,1,9,0,0,0
2020-10-13 01:45,14,2,12,0,0,0
2020-10-13 02:00,6,2,4,0,0,0
2020-10-13 02:15,6,2,4,0,0,0
2020-10-13 02:30,10,3,7,0,0,0
2020-10-13 02:45,10,3,7,0,0,0
2020-10-13 03:00,11,2,9,0,0,0
2020-10-13 03:15,7,1,6,0,0,0
2020-10-13 03:30,3,3,0,0,0,0
2020-10-13 03:45,1,0,1,0,0,0
2020-10-13 04:00,4,3,1,0,0,0
2020-10-13 04:15,3,2,1,0,0,0
2020-10-13 04:30,5,4,1,0,0,0
2020-10-13 04:45,7,4,3,0,0,0
2020-10-13 05:00,9,5,4,0,0,0
2020-10-13 05:15,10,6,4,0,0,0
2020-10-13 05:30,21,10,11,0,0,0
2020-10-13 05:45,21,19,2,0,0,0
2020-10-13 06:00,33,19,14,0,0,0
2020-10-13 06:15,33,22,11,0,0,0
2020-10-13 06:30,41,26,15,0,0,0
2020-10-13 06:45,78,42,36,0,0,0
2020-10-13 07:00,86,60,26,0,0,0
2020-10-13 07:15,102,65,37,0,0,0
2020-10-13 07:30,129,76,53,0,0,0
2020-10-13 07:45,196,131,65,0,0,0
2020-10-13 08:00,145,84,61,0,0,0
2020-10-13 08:15,171,114,57,0,0,0
2020-10-13 08:30,182,122,60,0,0,0
2020-10-13 08:45,195,123,72,0,0,0
2020-10-13 09:00,160,92,68,0,0,0
2020-10-13 09:15,125,79,46,0,0,0
2020-10-13 09:30,131,72,59,0,0,0
2020-10-13 09:45,154,90,64,0,0,0
2020-10-13 10:00,113,68,45,0,0,0
2020-10-13 10:15,96,59,37,0,0,0
2020-10-13 10:30,126,74,52,0,0,0
2020-10-13 10:45,128,76,52,0,0,0
2020-10-13 11:00,117,70,47,0,0,0
2020-10-13 11:15,127,69,58,0,0,0
2020-10-13 11:30,124,76,48,0,0,0
2020-10-13 11:45,162,96,66,0,0,0
2020-10-13 12:00,169,82,87,0,0,0
2020-10-13 12:15,149,73,76,0,0,0
2020-10-13 12:30,161,78,83,0,0,0
2020-10-13 12:45,186,110,76,0,0,0
2020-10-13 13:00,169,94,75,0,0,0
2020-10-13 13:15,154,94,60,0,0,0
2020-10-13 13:30,206,92,114,0,0,0
2020-10-13 13:45,185,96,89,0,0,0
2020-10-13 14:00,162,88,74,0,0,0
2020-10-13 14:15,204,129,75,0,0,0
2020-10-13 14:30,195,115,80,0,0,0
2020-10-13 14:45,230,124,106,0,0,0
2020-10-13 15:00,195,92,103,0,0,0
2020-10-13 15:15,212,110,102,0,0,0
2020-10-13 15:30,219,132,87,0,0,0
2020-10-13 15:45,226,127,99,0,0,0
2020-10-13 16:00,238,111,127,0,0,0
2020-10-13 16:15,244,131,113,0,0,0
2020-10-13 16:30,223,107,116,0,0,0
2020-10-13 16:45,260,119,141,0,0,0
2020-10-13 17:00,262,121,141,0,0,0
2020-10-13 17:15,277,136,141,0,0,0
2020-10-13 17:30,262,116,146,0,0,0
2020-10-13 17:45,266,140,126,0,0,0
2020-10-13 18:00,255,123,132,0,0,0
2020-10-13 18:15,234,111,123,0,0,0
2020-10-13 18:30,251,96,155,0,0,0
2020-10-13 18:45,206,100,106,0,0,0
2020-10-13 19:00,194,93,101,0,0,0
2020-10-13 19:15,197,107,90,0,0,0
2020-10-13 19:30,151,70,81,0,0,0
2020-10-13 19:45,161,66,95,0,0,0
2020-10-13 20:00,129,50,79,0,0,0
2020-10-13 20:15,113,57,56,0,0,0
2020-10-13 20:30,89,37,52,0,0,0
2020-10-13 20:45,80,23,57,0,0,0
2020-10-13 21:00,119,39,80,0,0,0
2020-10-13 21:15,83,23,60,0,0,0
2020-10-13 21:30,81,21,60,0,0,0
2020-10-13 21:45,71,19,52,0,0,0
2020-10-13 22:00,80,30,50,0,0,0
2020-10-13 22:15,94,20,74,0,0,0
2020-10-13 22:30,75,22,53,0,0,0
2020-10-13 22:45,65,19,46,0,0,0
2020-10-13 23:00,52,13,39,0,0,0
2020-10-13 23:15,55,14,41,0,0,0
2020-10-13 23:30,29,7,22,0,0,0
2020-10-13 23:45,20,12,8,0,0,0
2020-10-14 00:00,40,12,28,0,0,0
2020-10-14 00:15,33,6,27,0,0,0
2020-10-14 00:30,24,12,12,0,0,0
2020-10-14 00:45,24,8,16,0,0,0
2020-10-14 01:00,22,10,12,0,0,0
2020-10-14 01:15,23,7,16,0,0,0
2020-10-14 01:30,12,5,7,0,0,0
2020-10-14 01:45,8,1,7,0,0,0
2020-10-14 02:00,7,4,3,0,0,0
2020-10-14 02:15,12,3,9,0,0,0
2020-10-14 02:30,3,1,2,0,0,0
2020-10-14 02:45,4,0,4,0,0,0
2020-10-14 03:00,5,1,4,0,0,0
2020-10-14 03:15,8,4,4,0,0,0
2020-10-14 03:30,7,2,5,0,0,0
2020-10-14 03:45,5,1,4,0,0,0
2020-10-14 04:00,3,1,2,0,0,0
2020-10-14 04:15,0,0,0,0,0,0
2020-10-14 04:30,3,2,1,0,0,0
2020-10-14 04:45,7,4,3,0,0,0
2020-10-14 05:00,8,8,0,0,0,0
2020-10-14 05:15,10,9,1,0,0,0
2020-10-14 05:30,22,9,13,0,0,0
2020-10-14 05:45,21,17,4,0,0,0
2020-10-14 06:00,33,24,9,0,0,0
2020-10-14 06:15,37,26,11,0,0,0
2020-10-14 06:30,59,41,18,0,0,0
2020-10-14 06:45,81,54,27,0,0,0
2020-10-14 07:00,80,60,20,0,0,0
2020-10-14 07:15,88,63,25,0,0,0
2020-10-14 07:30,130,79,51,0,0,0
2020-10-14 07:45,195,129,66,0,0,0
2020-10-14 08:00,194,113,81,0,0,0
2020-10-14 08:15,180,105,75,0,0,0
2020-10-14 08:30,169,107,62,0,0,0
2020-10-14 08:45,204,109,95,0,0,0
2020-10-14 09:00,128,80,48,0,0,0
2020-10-14 09:15,129,87,42,0,0,0
2020-10-14 09:30,129,85,44,0,0,0
2020-10-14 09:45,159,102,57,0,0,0
2020-10-14 10:00,112,57,55,0,0,0
2020-10-14 10:15,128,75,53,0,0,0
2020-10-14 10:30,112,62,50,0,0,0
2020-10-14 10:45,119,75,44,0,0,0
2020-10-14 11:00,91,49,42,0,0,0
2020-10-14 11:15,103,54,49,0,0,0
2020-10-14 11:30,131,76,55,0,0,0
2020-10-14 11:45,174,103,71,0,0,0
2020-10-14 12:00,197,110,87,0,0,0
2020-10-14 12:15,168,86,82,0,0,0
2020-10-14 12:30,153,91,62,0,0,0
2020-10-14 12:45,183,106,77,0,0,0
2020-10-14 13:00,175,100,75,0,0,0
2020-10-14 13:15,179,86,93,0,0,0
2020-10-14 13:30,185,87,98,0,0,0
2020-10-14 13:45,208,82,126,0,0,0
2020-10-14 14:00,161,78,83,0,0,0
2020-10-14 14:15,174,93,81,0,0,0
2020-10-14 14:30,167,85,82,0,0,0
2020-10-14 14:45,204,112,92,0,0,0
2020-10-14 15:00,140,67,73,0,0,0
2020-10-14 15:15,156,94,62,0,0,0
2020-10-14 15:30,159,79,80,0,0,0
2020-10-14 15:45,212,102,110,0,0,0
2020-10-14 16:00,191,97,94,0,0,0
2020-10-14 16:15,254,135,119,0,0,0
2020-10-14 16:30,202,95,107,0,0,0
2020-10-14 16:45,222,116,106,0,0,0
2020-10-14 17:00,263,110,153,0,0,0
2020-10-14 17:15,240,118,122,0,0,0
2020-10-14 17:30,227,99,128,0,0,0
2020-10-14 17:45,268,126,142,0,0,0
2020-10-14 18:00,224,112,112,0,0,0
2020-10-14 18:15,206,80,126,0,0,0
2020-10-14 18:30,201,103,98,0,0,0
2020-10-14 18:45,225,102,123,0,0,0
2020-10-14 19:00,204,95,109,0,0,0
2020-10-14 19:15,214,109,105,0,0,0
2020-10-14 19:30,156,77,79,0,0,0
2020-10-14 19:45,153,92,61,0,0,0
2020-10-14 20:00,142,70,72,0,0,0
2020-10-14 20:15,118,61,57,0,0,0
2020-10-14 20:30,116,58,58,0,0,0
2020-10-14 20:45,97,36,61,0,0,0
2020-10-14 21:00,94,38,56,0,0,0
2020-10-14 21:15,85,36,49,0,0,0
2020-10-14 21:30,98,44,54,0,0,0
2020-10-14 21:45,83,29,54,0,0,0
2020-10-14 22:00,73,27,46,0,0,0
2020-10-14 22:15,80,33,47,0,0,0
2020-10-14 22:30,76,27,49,0,0,0
2020-10-14 22:45,69,24,45,0,0,0
2020-10-14 23:00,57,16,41,0,0,0
2020-10-14 23:15,77,36,41,0,0,0
2020-10-14 23:30,70,20,50,0,0,0
2020-10-14 23:45,50,18,32,0,0,0
2020-10-15 00:00,58,24,34,0,0,0
2020-10-15 00:15,36,12,24,0,0,0
2020-10-15 00:30,29,6,23,0,0,0
2020-10-15 00:45,31,13,18,0,0,0
2020-10-15 01:00,22,6,16,0,0,0
2020-10-15 01:15,44,5,39,0,0,0
2020-10-15 01:30,26,8,18,0,0,0
2020-10-15 01:45,22,7,15,0,0,0
2020-10-15 02:00,21,3,18,0,0,0
2020-10-15 02:15,30,4,26,0,0,0
2020-10-15 02:30,20,9,11,0,0,0
2020-10-15 02:45,13,6,7,0,0,0
2020-10-15 03:00,9,1,8,0,0,0
2020-10-15 03:15,8,4,4,0,0,0
2020-10-15 03:30,10,3,7,0,0,0
2020-10-15 03:45,7,0,7,0,0,0
2020-10-15 04:00,9,2,7,0,0,0
2020-10-15 04:15,5,3,2,0,0,0
2020-10-15 04:30,9,6,3,0,0,0
2020-10-15 04:45,6,2,4,0,0,0
2020-10-15 05:00,7,4,3,0,0,0
2020-10-15 05:15,13,9,4,0,0,0
2020-10-15 05:30,21,11,10,0,0,0
2020-10-15 05:45,28,23,5,0,0,0
2020-10-15 06:00,27,17,10,0,0,0
2020-10-15 06:15,35,23,12,0,0,0
2020-10-15 06:30,41,28,13,0,0,0
2020-10-15 06:45,65,42,23,0,0,0
2020-10-15 07:00,61,40,21,0,0,0
2020-10-15 07:15,99,56,43,0,0,0
2020-10-15 07:30,136,92,44,0,0,0
2020-10-15 07:45,179,113,66,0,0,0
2020-10-15 08:00,166,108,58,0,0,0
2020-10-15 08:15,138,77,61,0,0,0
2020-10-15 08:30,185,110,75,0,0,0
2020-10-15 08:45,199,105,94,0,0,0
2020-10-15 09:00,128,75,53,0,0,0
2020-10-15 09:15,117,67,50,0,0,0
2020-10-15 09:30,122,73,49,0,0,0
2020-10-15 09:45,141,77,64,0,0,0
2020-10-15 10:00,115,63,52,0,0,0
2020-10-15 10:15,99,62,37,0,0,0
2020-10-15 10:30,114,59,55,0,0,0
2020-10-15 10:45,104,71,33,0,0,0
2020-10-15 11:00,104,62,42,0,0,0
2020-10-15 11:15,105,61,44,0,0,0
2020-10-15 11:30,121,61,60,0,0,0
2020-10-15 11:45,140,80,60,0,0,0
2020-10-15 12:00,159,86,73,0,0,0
2020-10-15 12:15,150,79,71,0,0,0
2020-10-15 12:30,161,82,79,0,0,0
2020-10-15 12:45,167,83,84,0,0,0
2020-10-15 13:00,159,87,72,0,0,0
2020-10-15 13:15,146,70,76,0,0,0
2020-10-15 13:30,172,101,71,0,0,0
2020-10-15 13:45,186,100,86,0,0,0
2020-10-15 14:00,151,77,74,0,0,0
2020-10-15 14:15,175,111,64,0,0,0
2020-10-15 14:30,167,88,79,0,0,0
2020-10-15 14:45,163,81,82,0,0,0
2020-10-15 15:00,177,92,85,0,0,0
2020-10-15 15:15,156,86,70,0,0,0
2020-10-15 15:30,178,98,80,0,0,0
2020-10-15 15:45,213,106,107,0,0,0
2020-10-15 16:00,186,104,82,0,0,0
2020-10-15 16:15,213,103,110,0,0,0
2020-10-15 16:30,214,100,114,0,0,0
2020-10-15 16:45,221,101,120,0,0,0
2020-10-15 17:00,231,113,118,0,0,0
2020-10-15 17:15,244,119,125,0,0,0
2020-10-15 17:30,246,126,120,0,0,0
2020-10-15 17:45,233,115,118,0,0,0
2020-10-15 18:00,230,107,123,0,0,0
2020-10-15 18:15,239,108,131,0,0,0
2020-10-15 18:30,197,92,105,0,0,0
2020-10-15 18:45,228,109,119,0,0,0
2020-10-15 19:00,181,86,95,0,0,0
2020-10-15 19:15,192,102,90,0,0,0
2020-10-15 19:30,158,75,83,0,0,0
2020-10-15 19:45,162,74,88,0,0,0
2020-10-15 20:00,124,59,65,0,0,0
2020-10-15 20:15,120,38,82,0,0,0
2020-10-15 20:30,103,39,64,0,0,0
2020-10-15 20:45,108,49,59,0,0,0
2020-10-15 21:00,102,46,56,0,0,0
2020-10-15 21:15,67,23,44,0,0,0
2020-10-15 21:30,72,25,47,0,0,0
2020-10-15 21:45,58,14,44,0,0,0
2020-10-15 22:00,71,28,43,0,0,0
2020-10-15 22:15,76,14,62,0,0,0
2020-10-15 22:30,74,18,56,0,0,0
2020-10-15 22:45,61,17,44,0,0,0
2020-10-15 23:00,60,18,42,0,0,0
2020-10-15 23:15,68,14,54,0,0,0
2020-10-15 23:30,48,15,33,0,0,0
2020-10-15 23:45,33,10,23,0,0,0
2020-10-16 00:00,43,13,30,0,0,0
2020-10-16 00:15,31,9,22,0,0,0
2020-10-16 00:30,22,12,10,0,0,0
2020-10-16 00:45,30,9,21,0,0,0
2020-10-16 01:00,28,13,15,0,0,0
2020-10-16 01:15,13,9,4,0,0,0
2020-10-16 01:30,18,5,13,0,0,0
2020-10-16 01:45,23,6,17,0,0,0
2020-10-16 02:00,11,1,10,0,0,0
2020-10-16 02:15,14,2,12,0,0,0
2020-10-16 02:30,7,6,1,0,0,0
2020-10-16 02:45,9,1,8,0,0,0
2020-10-16 03:00,4,4,0,0,0,0
2020-10-16 03:15,9,0,9,0,0,0
2020-10-16 03:30,3,2,1,0,0,0
2020-10-16 03:45,6,4,2,0,0,0
2020-10-16 04:00,5,2,3,0,0,0
2020-10-16 04:15,1,1,0,0,0,0
2020-10-16 04:30,4,3,1,0,0,0
2020-10-16 04:45,8,3,5,0,0,0
2020-10-16 05:00,8,6,2,0,0,0
2020-10-16 05:15,9,5,4,0,0,0
2020-10-16 05:30,22,13,9,0,0,0
2020-10-16 05:45,21,16,5,0,0,0
2020-10-16 06:00,32,18,14,0,0,0
2020-10-16 06:15,37,26,11,0,0,0
2020-10-16 06:30,43,29,14,0,0,0
2020-10-16 06:45,58,30,28,0,0,0
2020-10-16 07:00,71,46,25,0,0,0
2020-10-16 07:15,97,57,40,0,0,0
2020-10-16 07:30,109,64,45,0,0,0
2020-10-16 07:45,168,100,68,0,0,0
2020-10-16 08:00,134,89,45,0,0,0
2020-10-16 08:15,151,102,49,0,0,0
2020-10-16 08:30,134,73,61,0,0,0
2020-10-16 08:45,164,98,66,0,0,0
2020-10-16 09:00,139,83,56,0,0,0
2020-10-16 09:15,125,84,41,0,0,0
2020-10-16 09:30,97,48,49,0,0,0
2020-10-16 09:45,128,78,50,0,0,0
2020-10-16 10:00,119,65,54,0,0,0
2020-10-16 10:15,97,58,39,0,0,0
2020-10-16 10:30,111,68,43,0,0,0
2020-10-16 10:45,115,57,58,0,0,0
2020-10-16 11:00,98,51,47,0,0,0
2020-10-16 11:15,115,62,53,0,0,0
2020-10-16 11:30,135,76,59,0,0,0
2020-10-16 11:45,173,105,68,0,0,0
2020-10-16 12:00,132,64,68,0,0,0
2020-10-16 12:15,146,76,70,0,0,0
2020-10-16 12:30,153,78,75,0,0,0
2020-10-16 12:45,189,98,91,0,0,0
2020-10-16 13:00,180,95,85,0,0,0
2020-10-16 13:15,154,89,65,0,0,0
2020-10-16 13:30,171,86,85,0,0,0
2020-10-16 13:45,187,101,86,0,0,0
2020-10-16 14:00,194,99,95,0,0,0
2020-10-16 14:15,186,102,84,0,0,0
2020-10-16 14:30,151,86,65,0,0,0
2020-10-16 14:45,201,102,99,0,0,0
2020-10-16 15:00,174,88,86,0,0,0
2020-10-16 15:15,180,88,92,0,0,0
2020-10-16 15:30,212,104,108,0,0,0
2020-10-16 15:45,228,146,82,0,0,0
2020-10-16 16:00,215,113,102,0,0,0
2020-10-16 16:15,164,82,82,0,0,0
2020-10-16 16:30,213,106,107,0,0,0
2020-10-16 16:45,198,108,90,0,0,0
2020-10-16 17:00,198,96,102,0,0,0
2020-10-16 17:15,213,107,106,0,0,0
2020-10-16 17:30,177,92,85,0,0,0
2020-10-16 17:45,200,87,113,0,0,0
2020-10-16 18:00,187,88,99,0,0,0
2020-10-16 18:15,189,98,91,0,0,0
2020-10-16 18:30,159,68,91,0,0,0
2020-10-16 18:45,227,112,115,0,0,0
2020-10-16 19:00,189,95,94,0,0,0
2020-10-16 19:15,160,85,75,0,0,0
2020-10-16 19:30,143,77,66,0,0,0
2020-10-16 19:45,161,79,82,0,0,0
2020-10-16 20:00,122,59,63,0,0,0
2020-10-16 20:15,131,72,59,0,0,0
2020-10-16 20:30,123,49,74,0,0,0
2020-10-16 20:45,93,28,65,0,0,0
2020-10-16 21:00,107,45,62,0,0,0
2020-10-16 21:15,71,33,38,0,0,0
2020-10-16 21:30,54,16,38,0,0,0
2020-10-16 21:45,54,17,37,0,0,0
2020-10-16 22:00,49,22,27,0,0,0
2020-10-16 22:15,43,15,28,0,0,0
2020-10-16 22:30,58,24,34,0,0,0
2020-10-16 22:45,48,11,37,0,0,0
2020-10-16 23:00,52,16,36,0,0,0
2020-10-16 23:15,63,33,30,0,0,0
2020-10-16 23:30,49,24,25,0,0,0
2020-10-16 23:45,30,7,23,0,0,0
2020-10-17 00:00,54,17,37,0,0,0
2020-10-17 00:15,53,20,33,0,0,0
2020-10-17 00:30,47,7,40,0,0,0
2020-10-17 00:45,51,14,37,0,0,0
2020-10-17 01:00,61,25,36,0,0,0
2020-10-17 01:15,39,17,22,0,0,0
2020-10-17 01:30,44,16,28,0,0,0
2020-10-17 01:45,34,6,28,0,0,0
2020-10-17 02:00,27,13,14,0,0,0
2020-10-17 02:15,30,9,21,0,0,0
2020-10-17 02:30,18,6,12,0,0,0
2020-10-17 02:45,30,11,19,0,0,0
2020-10-17 03:00,20,8,12,0,0,0
2020-10-17 03:15,16,4,12,0,0,0
2020-10-17 03:30,8,2,6,0,0,0
2020-10-17 03:45,16,4,12,0,0,0
2020-10-17 04:00,10,3,7,0,0,0
2020-10-17 04:15,13,3,10,0,0,0
2020-10-17 04:30,10,4,6,0,0,0
2020-10-17 04:45,9,1,8,0,0,0
2020-10-17 05:00,3,1,2,0,0,0
2020-10-17 05:15,8,2,6,0,0,0
2020-10-17 05:30,20,8,12,0,0,0
2020-10-17 05:45,11,8,3,0,0,0
2020-10-17 06:00,14,7,7,0,0,0
2020-10-17 06:15,8,5,3,0,0,0
2020-10-17 06:30,11,4,7,0,0,0
2020-10-17 06:45,12,10,2,0,0,0
2020-10-17 07:00,11,7,4,0,0,0
2020-10-17 07:15,8,6,2,0,0,0
2020-10-17 07:30,19,14,5,0,0,0
2020-10-17 07:45,26,22,4,0,0,0
2020-10-17 08:00,30,24,6,0,0,0
2020-10-17 08:15,28,13,15,0,0,0
2020-10-17 08:30,34,19,15,0,0,0
2020-10-17 08:45,72,43,29,0,0,0
2020-10-17 09:00,44,29,15,0,0,0
2020-10-17 09:15,74,51,23,0,0,0
2020-10-17 09:30,61,44,17,0,0,0
2020-10-17 09:45,121,98,23,0,0,0
2020-10-17 10:00,92,71,21,0,0,0
2020-10-17 10:15,99,71,28,0,0,0
2020-10-17 10:30,102,70,32,0,0,0
2020-10-17 10:45,137,103,34,0,0,0
2020-10-17 11:00,75,59,16,0,0,0
2020-10-17 11:15,130,76,54,0,0,0
2020-10-17 11:30,142,91,51,0,0,0
2020-10-17 11:45,123,88,35,0,0,0
2020-10-17 12:00,110,64,46,0,0,0
2020-10-17 12:15,116,59,57,0,0,0
2020-10-17 12:30,152,79,73,0,0,0
2020-10-17 12:45,172,114,58,0,0,0
2020-10-17 13:00,146,87,59,0,0,0
2020-10-17 13:15,138,66,72,0,0,0
2020-10-17 13:30,146,77,69,0,0,0
2020-10-17 13:45,146,70,76,0,0,0
2020-10-17 14:00,121,69,52,0,0,0
2020-10-17 14:15,132,64,68,0,0,0
2020-10-17 14:30,147,68,79,0,0,0
2020-10-17 14:45,149,88,61,0,0,0
2020-10-17 15:00,166,77,89,0,0,0
2020-10-17 15:15,155,77,78,0,0,0
2020-10-17 15:30,140,81,59,0,0,0
2020-10-17 15:45,138,75,63,0,0,0
2020-10-17 16:00,138,65,73,0,0,0
2020-10-17 16:15,123,45,78,0,0,0
2020-10-17 16:30,130,62,68,0,0,0
2020-10-17 16:45,130,70,60,0,0,0
2020-10-17 17:00,129,56,73,0,0,0
2020-10-17 17:15,133,63,70,0,0,0
2020-10-17 17:30,168,70,98,0,0,0
2020-10-17 17:45,170,80,90,0,0,0
2020-10-17 18:00,161,75,86,0,0,0
2020-10-17 18:15,125,68,57,0,0,0
2020-10-17 18:30,139,61,78,0,0,0
2020-10-17 18:45,116,53,63,0,0,0
2020-10-17 19:00,135,63,72,0,0,0
2020-10-17 19:15,115,59,56,0,0,0
2020-10-17 19:30,90,38,52,0,0,0
2020-10-17 19:45,120,70,50,0,0,0
2020-10-17 20:00,113,39,74,0,0,0
2020-10-17 20:15,90,39,51,0,0,0
2020-10-17 20:30,94,53,41,0,0,0
2020-10-17 20:45,78,33,45,0,0,0
2020-10-17 21:00,75,25,50,0,0,0
2020-10-17 21:15,75,26,49,0,0,0
2020-10-17 21:30,56,20,36,0,0,0
2020-10-17 21:45,59,22,37,0,0,0
2020-10-17 22:00,69,21,48,0,0,0
2020-10-17 22:15,58,15,43,0,0,0
2020-10-17 22:30,43,13,30,0,0,0
2020-10-17 22:45,56,25,31,0,0,0
2020-10-17 23:00,37,13,24,0,0,0
2020-10-17 23:15,51,22,29,0,0,0
2020-10-17 23:30,38,12,26,0,0,0
2020-10-17 23:45,61,12,49,0,0,0
2020-10-18 00:00,52,10,42,0,0,0
2020-10-18 00:15,50,19,31,0,0,0
2020-10-18 00:30,53,27,26,0,0,0
2020-10-18 00:45,38,15,23,0,0,0
2020-10-18 01:00,40,13,27,0,0,0
2020-10-18 01:15,42,17,25,0,0,0
2020-10-18 01:30,33,6,27,0,0,0
2020-10-18 01:45,17,7,10,0,0,0
2020-10-18 02:00,35,10,25,0,0,0
2020-10-18 02:15,33,9,24,0,0,0
2020-10-18 02:30,30,10,20,0,0,0
2020-10-18 02:45,38,8,30,0,0,0
2020-10-18 03:00,20,4,16,0,0,0
2020-10-18 03:15,16,9,7,0,0,0
2020-10-18 03:30,15,4,11,0,0,0
2020-10-18 03:45,16,4,12,0,0,0
2020-10-18 04:00,13,2,11,0,0,0
2020-10-18 04:15,10,2,8,0,0,0
2020-10-18 04:30,3,0,3,0,0,0
2020-10-18 04:45,5,1,4,0,0,0
2020-10-18 05:00,5,3,2,0,0,0
2020-10-18 05:15,6,2,4,0,0,0
2020-10-18 05:30,17,9,8,0,0,0
2020-10-18 05:45,12,5,7,0,0,0
2020-10-18 06:00,3,3,0,0,0,0
2020-10-18 06:15,6,3,3,0,0,0
2020-10-18 06:30,7,5,2,0,0,0
2020-10-18 06:45,4,1,3,0,0,0
2020-10-18 07:00,4,1,3,0,0,0
2020-10-18 07:15,8,5,3,0,0,0
2020-10-18 07:30,8,2,6,0,0,0
2020-10-18 07:45,11,9,2,0,0,0
2020-10-18 08:00,16,13,3,0,0,0
2020-10-18 08:15,11,6,5,0,0,0
2020-10-18 08:30,12,8,4,0,0,0
2020-10-18 08:45,36,23,13,0,0,0
2020-10-18 09:00,29,22,7,0,0,0
2020-10-18 09:15,38,21,17,0,0,0
2020-10-18 09:30,36,22,14,0,0,0
2020-10-18 09:45,67,49,18,0,0,0
2020-10-18 10:00,40,25,15,0,0,0
2020-10-18 10:15,35,28,7,0,0,0
2020-10-18 10:30,45,29,16,0,0,0
2020-10-18 10:45,65,46,19,0,0,0
2020-10-18 11:00,58,38,20,0,0,0
2020-10-18 11:15,53,28,25,0,0,0
2020-10-18 11:30,56,33,23,0,0,0
2020-10-18 11:45,56,27,29,0,0,0
2020-10-18 12:00,71,45,26,0,0,0
2020-10-18 12:15,72,35,37,0,0,0
2020-10-18 12:30,80,35,45,0,0,0
2020-10-18 12:45,69,39,30,0,0,0
2020-10-18 13:00,52,38,14,0,0,0
2020-10-18 13:15,87,42,45,0,0,0
2020-10-18 13:30,85,47,38,0,0,0
2020-10-18 13:45,98,60,38,0,0,0
2020-10-18 14:00,80,40,40,0,0,0
2020-10-18 14:15,85,48,37,0,0,0
2020-10-18 14:30,90,51,39,0,0,0
2020-10-18 14:45,127,74,53,0,0,0
2020-10-18 15:00,88,51,37,0,0,0
2020-10-18 15:15,104,59,45,0,0,0
2020-10-18 15:30,93,49,44,0,0,0
2020-10-18 15:45,130,72,58,0,0,0
2020-10-18 16:00,117,58,59,0,0,0
2020-10-18 16:15,100,60,40,0,0,0
2020-10-18 16:30,100,50,50,0,0,0
2020-10-18 16:45,109,51,58,0,0,0
2020-10-18 17:00,109,48,61,0,0,0
2020-10-18 17:15,96,44,52,0,0,0
2020-10-18 17:30,82,33,49,0,0,0
2020-10-18 17:45,167,79,88,0,0,0
2020-10-18 18:00,105,49,56,0,0,0
2020-10-18 18:15,107,51,56,0,0,0
2020-10-18 18:30,87,41,46,0,0,0
2020-10-18 18:45,111,51,60,0,0,0
2020-10-18 19:00,95,34,61,0,0,0
2020-10-18 19:15,78,39,39,0,0,0
2020-10-18 19:30,70,30,40,0,0,0
2020-10-18 19:45,66,28,38,0,0,0
2020-10-18 20:00,63,27,36,0,0,0
2020-10-18 20:15,71,24,47,0,0,0
2020-10-18 20:30,63,24,39,0,0,0
2020-10-18 20:45,64,19,45,0,0,0
2020-10-18 21:00,39,20,19,0,0,0
2020-10-18 21:15,51,11,40,0,0,0
2020-10-18 21:30,52,17,35,0,0,0
2020-10-18 21:45,56,19,37,0,0,0
2020-10-18 22:00,45,8,37,0,0,0
2020-10-18 22:15,29,12,17,0,0,0
2020-10-18 22:30,36,13,23,0,0,0
2020-10-18 22:45,40,22,18,0,0,0
2020-10-18 23:00,34,15,19,0,0,0
2020-10-18 23:15,19,7,12,0,0,0
2020-10-18 23:30,22,8,14,0,0,0
2020-10-18 23:45,23,3,20,0,0,0
2020-10-19 00:00,27,8,19,0,0,0
2020-10-19 00:15,16,5,11,0,0,0
2020-10-19 00:30,11,4,7,0,0,0
2020-10-19 00:45,12,5,7,0,0,0
2020-10-19 01:00,9,4,5,0,0,0
2020-10-19 01:15,9,2,7,0,0,0
2020-10-19 01:30,3,1,2,0,0,0
2020-10-19 01:45,10,3,7,0,0,0
2020-10-19 02:00,5,4,1,0,0,0
2020-10-19 02:15,4,3,1,0,0,0
2020-10-19 02:30,4,1,3,0,0,0
2020-10-19 02:45,3,3,0,0,0,0
2020-10-19 03:00,2,0,2,0,0,0
2020-10-19 03:15,4,3,1,0,0,0
2020-10-19 03:30,1,1,0,0,0,0
2020-10-19 03:45,1,0,1,0,0,0
2020-10-19 04:00,3,2,1,0,0,0
2020-10-19 04:15,3,0,3,0,0,0
2020-10-19 04:30,4,3,1,0,0,0
2020-10-19 04:45,10,6,4,0,0,0
2020-10-19 05:00,4,4,0,0,0,0
2020-10-19 05:15,10,7,3,0,0,0
2020-10-19 05:30,19,13,6,0,0,0
2020-10-19 05:45,25,22,3,0,0,0
2020-10-19 06:00,26,18,8,0,0,0
2020-10-19 06:15,41,25,16,0,0,0
2020-10-19 06:30,47,34,13,0,0,0
2020-10-19 06:45,86,54,32,0,0,0
2020-10-19 07:00,81,57,24,0,0,0
2020-10-19 07:15,115,69,46,0,0,0
2020-10-19 07:30,153,104,49,0,0,0
2020-10-19 07:45,180,103,77,0,0,0
2020-10-19 08:00,142,75,67,0,0,0
2020-10-19 08:15,159,102,57,0,0,0
2020-10-19 08:30,166,90,76,0,0,0
2020-10-19 08:45,176,106,70,0,0,0
2020-10-19 09:00,113,66,47,0,0,0
2020-10-19 09:15,144,83,61,0,0,0
2020-10-19 09:30,119,67,52,0,0,0
2020-10-19 09:45,157,96,61,0,0,0
2020-10-19 10:00,102,55,47,0,0,0
2020-10-19 10:15,101,51,50,0,0,0
2020-10-19 10:30,114,61,53,0,0,0
2020-10-19 10:45,118,64,54,0,0,0
2020-10-19 11:00,93,49,44,0,0,0
2020-10-19 11:15,60,21,39,0,0,0
2020-10-19 11:30,77,0,77,0,0,0
2020-10-19 11:45,143,89,54,0,0,0
2020-10-19 12:00,140,61,79,0,0,0
2020-10-19 12:15,176,81,95,0,0,0
2020-10-19 12:30,172,87,85,0,0,0
2020-10-19 12:45,210,125,85,0,0,0
2020-10-19 13:00,171,87,84,0,0,0
2020-10-19 13:15,188,97,91,0,0,0
2020-10-19 13:30,188,84,104,0,0,0
2020-10-19 13:45,192,100,92,0,0,0
2020-10-19 14:00,180,97,83,0,0,0
2020-10-19 14:15,188,100,88,0,0,0
2020-10-19 14:30,197,96,101,0,0,0
2020-10-19 14:45,178,93,85,0,0,0
2020-10-19 15:00,179,89,90,0,0,0
2020-10-19 15:15,210,99,111,0,0,0
2020-10-19 15:30,155,69,86,0,0,0
2020-10-19 15:45,254,119,135,0,0,0
2020-10-19 16:00,251,139,112,0,0,0
2020-10-19 16:15,263,136,127,0,0,0
2020-10-19 16:30,242,122,120,0,0,0
2020-10-19 16:45,258,117,141,0,0,0
2020-10-19 17:00,252,110,142,0,0,0
2020-10-19 17:15,271,121,150,0,0,0
2020-10-19 17:30,242,119,123,0,0,0
2020-10-19 17:45,223,113,110,0,0,0
2020-10-19 18:00,255,121,134,0,0,0
2020-10-19 18:15,187,93,94,0,0,0
2020-10-19 18:30,206,90,116,0,0,0
2020-10-19 18:45,180,80,100,0,0,0
2020-10-19 19:00,181,83,98,0,0,0
2020-10-19 19:15,189,91,98,0,0,0
2020-10-19 19:30,126,57,69,0,0,0
2020-10-19 19:45,157,67,90,0,0,0
2020-10-19 20:00,119,50,69,0,0,0
2020-10-19 20:15,106,47,59,0,0,0
2020-10-19 20:30,90,40,50,0,0,0
2020-10-19 20:45,73,41,32,0,0,0
2020-10-19 21:00,62,24,38,0,0,0
2020-10-19 21:15,71,25,46,0,0,0
2020-10-19 21:30,68,26,42,0,0,0
2020-10-19 21:45,59,29,30,0,0,0
2020-10-19 22:00,74,18,56,0,0,0
2020-10-19 22:15,64,18,46,0,0,0
2020-10-19 22:30,71,23,48,0,0,0
2020-10-19 22:45,37,9,28,0,0,0
2020-10-19 23:00,37,14,23,0,0,0
2020-10-19 23:15,46,13,33,0,0,0
2020-10-19 23:30,27,4,23,0,0,0
2020-10-19 23:45,18,6,12,0,0,0
2020-10-20 00:00,29,5,24,0,0,0
2020-10-20 00:15,33,14,19,0,0,0
2020-10-20 00:30,20,1,19,0,0,0
2020-10-20 00:45,16,7,9,0,0,0
2020-10-20 01:00,13,5,8,0,0,0
2020-10-20 01:15,13,1,12,0,0,0
2020-10-20 01:30,12,7,5,0,0,0
2020-10-20 01:45,11,3,8,0,0,0
2020-10-20 02:00,9,4,5,0,0,0
2020-10-20 02:15,4,0,4,0,0,0
2020-10-20 02:30,3,2,1,0,0,0
2020-10-20 02:45,8,1,7,0,0,0
2020-10-20 03:00,0,0,0,0,0,0
2020-10-20 03:15,6,1,5,0,0,0
2020-10-20 03:30,0,0,0,0,0,0
2020-10-20 03:45,2,2,0,0,0,0
2020-10-20 04:00,4,1,3,0,0,0
2020-10-20 04:15,2,1,1,0,0,0
2020-10-20 04:30,5,3,2,0,0,0
2020-10-20 04:45,12,7,5,0,0,0
2020-10-20 05:00,5,5,0,0,0,0
2020-10-20 05:15,7,5,2,0,0,0
2020-10-20 05:30,24,20,4,0,0,0
2020-10-20 05:45,22,15,7,0,0,0
2020-10-20 06:00,26,20,6,0,0,0
2020-10-20 06:15,42,28,14,0,0,0
2020-10-20 06:30,41,29,12,0,0,0
2020-10-20 06:45,66,51,15,0,0,0
2020-10-20 07:00,84,51,33,0,0,0
2020-10-20 07:15,112,74,38,0,0,0
2020-10-20 07:30,148,84,64,0,0,0
2020-10-20 07:45,230,139,91,0,0,0
2020-10-20 08:00,162,90,72,0,0,0
2020-10-20 08:15,171,101,70,0,0,0
2020-10-20 08:30,185,113,72,0,0,0
2020-10-20 08:45,212,133,79,0,0,0
2020-10-20 09:00,129,81,48,0,0,0
2020-10-20 09:15,130,83,47,0,0,0
2020-10-20 09:30,108,69,39,0,0,0
2020-10-20 09:45,169,106,63,0,0,0
2020-10-20 10:00,105,68,37,0,0,0
2020-10-20 10:15,104,63,41,0,0,0
2020-10-20 10:30,125,73,52,0,0,0
2020-10-20 10:45,128,75,53,0,0,0
2020-10-20 11:00,106,62,44,0,0,0
2020-10-20 11:15,124,64,60,0,0,0
2020-10-20 11:30,119,68,51,0,0,0
2020-10-20 11:45,169,95,74,0,0,0
2020-10-20 12:00,179,98,81,0,0,0
2020-10-20 12:15,173,88,85,0,0,0
2020-10-20 12:30,177,88,89,0,0,0
2020-10-20 12:45,162,95,67,0,0,0
2020-10-20 13:00,170,78,92,0,0,0
2020-10-20 13:15,161,85,76,0,0,0
2020-10-20 13:30,174,98,76,0,0,0
2020-10-20 13:45,192,116,76,0,0,0
2020-10-20 14:00,182,107,75,0,0,0
2020-10-20 14:15,188,100,88,0,0,0
2020-10-20 14:30,168,97,71,0,0,0
2020-10-20 14:45,169,69,100,0,0,0
2020-10-20 15:00,173,79,94,0,0,0
2020-10-20 15:15,197,92,105,0,0,0
2020-10-20 15:30,201,98,103,0,0,0
2020-10-20 15:45,204,99,105,0,0,0
2020-10-20 16:00,227,119,108,0,0,0
2020-10-20 16:15,186,77,109,0,0,0
2020-10-20 16:30,183,93,90,0,0,0
2020-10-20 16:45,243,123,120,0,0,0
2020-10-20 17:00,246,82,164,0,0,0
2020-10-20 17:15,213,108,105,0,0,0
2020-10-20 17:30,277,113,164,0,0,0
2020-10-20 17:45,260,132,128,0,0,0
2020-10-20 18:00,222,90,132,0,0,0
2020-10-20 18:15,242,119,123,0,0,0
2020-10-20 18:30,190,84,106,0,0,0
2020-10-20 18:45,196,101,95,0,0,0
2020-10-20 19:00,151,75,76,0,0,0
2020-10-20 19:15,138,66,72,0,0,0
2020-10-20 19:30,119,55,64,0,0,0
2020-10-20 19:45,131,57,74,0,0,0
2020-10-20 20:00,102,57,45,0,0,0
2020-10-20 20:15,89,34,55,0,0,0
2020-10-20 20:30,92,28,64,0,0,0
2020-10-20 20:45,66,29,37,0,0,0
2020-10-20 21:00,73,26,47,0,0,0
2020-10-20 21:15,66,27,39,0,0,0
2020-10-20 21:30,61,20,41,0,0,0
2020-10-20 21:45,45,5,40,0,0,0
2020-10-20 22:00,90,30,60,0,0,0
2020-10-20 22:15,70,15,55,0,0,0
2020-10-20 22:30,55,16,39,0,0,0
2020-10-20 22:45,50,12,38,0,0,0
2020-10-20 23:00,52,18,34,0,0,0
2020-10-20 23:15,45,15,30,0,0,0
2020-10-20 23:30,42,15,27,0,0,0
2020-10-20 23:45,29,10,19,0,0,0
2020-10-21 00:00,27,6,21,0,0,0
2020-10-21 00:15,27,8,19,0,0,0
2020-10-21 00:30,11,3,8,0,0,0
2020-10-21 00:45,16,5,11,0,0,0
2020-10-21 01:00,14,7,7,0,0,0
2020-10-21 01:15,13,6,7,0,0,0
2020-10-21 01:30,12,4,8,0,0,0
2020-10-21 01:45,12,8,4,0,0,0
2020-10-21 02:00,12,5,7,0,0,0
2020-10-21 02:15,5,3,2,0,0,0
2020-10-21 02:30,9,5,4,0,0,0
2020-10-21 02:45,3,2,1,0,0,0
2020-10-21 03:00,5,3,2,0,0,0
2020-10-21 03:15,6,0,6,0,0,0
2020-10-21 03:30,3,1,2,0,0,0
2020-10-21 03:45,2,2,0,0,0,0
2020-10-21 04:00,6,0,6,0,0,0
2020-10-21 04:15,4,1,3,0,0,0
2020-10-21 04:30,6,6,0,0,0,0
2020-10-21 04:45,10,6,4,0,0,0
2020-10-21 05:00,5,4,1,0,0,0
2020-10-21 05:15,9,7,2,0,0,0
2020-10-21 05:30,24,17,7,0,0,0
2020-10-21 05:45,19,17,2,0,0,0
2020-10-21 06:00,20,16,4,0,0,0
2020-10-21 06:15,21,16,5,0,0,0
2020-10-21 06:30,40,29,11,0,0,0
2020-10-21 06:45,68,48,20,0,0,0
2020-10-21 07:00,87,55,32,0,0,0
2020-10-21 07:15,103,61,42,0,0,0
2020-10-21 07:30,116,70,46,0,0,0
2020-10-21 07:45,193,112,81,0,0,0
2020-10-21 08:00,149,89,60,0,0,0
2020-10-21 08:15,172,106,66,0,0,0
2020-10-21 08:30,141,86,55,0,0,0
2020-10-21 08:45,191,121,70,0,0,0
2020-10-21 09:00,145,84,61,0,0,0
2020-10-21 09:15,110,57,53,0,0,0
2020-10-21 09:30,128,76,52,0,0,0
2020-10-21 09:45,150,90,60,0,0,0
2020-10-21 10:00,73,40,33,0,0,0
2020-10-21 10:15,73,44,29,0,0,0
2020-10-21 10:30,68,46,22,0,0,0
2020-10-21 10:45,83,52,31,0,0,0
2020-10-21 11:00,62,37,25,0,0,0
2020-10-21 11:15,86,57,29,0,0,0
2020-10-21 11:30,92,48,44,0,0,0
2020-10-21 11:45,113,63,50,0,0,0
2020-10-21 12:00,140,68,72,0,0,0
2020-10-21 12:15,144,66,78,0,0,0
2020-10-21 12:30,139,68,71,0,0,0
2020-10-21 12:45,126,73,53,0,0,0
2020-10-21 13:00,134,75,59,0,0,0
2020-10-21 13:15,151,81,70,0,0,0
2020-10-21 13:30,149,65,84,0,0,0
2020-10-21 13:45,185,96,89,0,0,0
2020-10-21 14:00,143,79,64,0,0,0
2020-10-21 14:15,198,118,80,0,0,0
2020-10-21 14:30,146,84,62,0,0,0
2020-10-21 14:45,184,94,90,0,0,0
2020-10-21 15:00,95,53,42,0,0,0
2020-10-21 15:15,143,70,73,0,0,0
2020-10-21 15:30,185,91,94,0,0,0
2020-10-21 15:45,203,101,102,0,0,0
2020-10-21 16:00,247,119,128,0,0,0
2020-10-21 16:15,213,104,109,0,0,0
2020-10-21 16:30,241,126,115,0,0,0
2020-10-21 16:45,249,134,115,0,0,0
2020-10-21 17:00,221,110,111,0,0,0
2020-10-21 17:15,236,126,110,0,0,0
2020-10-21 17:30,223,109,114,0,0,0
2020-10-21 17:45,286,151,135,0,0,0
2020-10-21 18:00,248,105,143,0,0,0
2020-10-21 18:15,227,107,120,0,0,0
2020-10-21 18:30,214,100,114,0,0,0
2020-10-21 18:45,234,119,115,0,0,0
2020-10-21 19:00,205,101,104,0,0,0
2020-10-21 19:15,173,85,88,0,0,0
2020-10-21 19:30,176,76,100,0,0,0
2020-10-21 19:45,199,105,94,0,0,0
2020-10-21 20:00,163,67,96,0,0,0
2020-10-21 20:15,115,53,62,0,0,0
2020-10-21 20:30,117,53,64,0,0,0
2020-10-21 20:45,109,45,64,0,0,0
2020-10-21 21:00,92,25,67,0,0,0
2020-10-21 21:15,90,29,61,0,0,0
2020-10-21 21:30,72,33,39,0,0,0
2020-10-21 21:45,67,25,42,0,0,0
2020-10-21 22:00,87,31,56,0,0,0
2020-10-21 22:15,81,20,61,0,0,0
2020-10-21 22:30,73,33,40,0,0,0
2020-10-21 22:45,95,42,53,0,0,0
2020-10-21 23:00,91,26,65,0,0,0
2020-10-21 23:15,50,18,32,0,0,0
2020-10-21 23:30,61,23,38,0,0,0
2020-10-21 23:45,83,20,63,0,0,0
2020-10-22 00:00,42,16,26,0,0,0
2020-10-22 00:15,63,19,44,0,0,0
2020-10-22 00:30,32,16,16,0,0,0
2020-10-22 00:45,37,7,30,0,0,0
2020-10-22 01:00,43,8,35,0,0,0
2020-10-22 01:15,42,7,35,0,0,0
2020-10-22 01:30,15,3,12,0,0,0
2020-10-22 01:45,25,2,23,0,0,0
2020-10-22 02:00,17,4,13,0,0,0
2020-10-22 02:15,16,4,12,0,0,0
2020-10-22 02:30,20,5,15,0,0,0
2020-10-22 02:45,17,4,13,0,0,0
2020-10-22 03:00,7,4,3,0,0,0
2020-10-22 03:15,9,0,9,0,0,0
2020-10-22 03:30,17,8,9,0,0,0
2020-10-22 03:45,9,4,5,0,0,0
2020-10-22 04:00,5,1,4,0,0,0
2020-10-22 04:15,6,2,4,0,0,0
2020-10-22 04:30,7,3,4,0,0,0
2020-10-22 04:45,12,6,6,0,0,0
2020-10-22 05:00,10,8,2,0,0,0
2020-10-22 05:15,5,4,1,0,0,0
2020-10-22 05:30,29,21,8,0,0,0
2020-10-22 05:45,30,22,8,0,0,0
2020-10-22 06:00,22,13,9,0,0,0
2020-10-22 06:15,34,22,12,0,0,0
2020-10-22 06:30,52,39,13,0,0,0
2020-10-22 06:45,76,54,22,0,0,0
2020-10-22 07:00,75,48,27,0,0,0
2020-10-22 07:15,127,74,53,0,0,0
2020-10-22 07:30,124,78,46,0,0,0
2020-10-22 07:45,181,110,71,0,0,0
2020-10-22 08:00,166,100,66,0,0,0
2020-10-22 08:15,154,82,72,0,0,0
2020-10-22 08:30,157,91,66,0,0,0
2020-10-22 08:45,205,139,66,0,0,0
2020-10-22 09:00,133,83,50,0,0,0
2020-10-22 09:15,144,91,53,0,0,0
2020-10-22 09:30,148,74,74,0,0,0
2020-10-22 09:45,163,99,64,0,0,0
2020-10-22 10:00,111,66,45,0,0,0
2020-10-22 10:15,126,70,56,0,0,0
2020-10-22 10:30,115,70,45,0,0,0
2020-10-22 10:45,144,72,72,0,0,0
2020-10-22 11:00,122,70,52,0,0,0
2020-10-22 11:15,126,83,43,0,0,0
2020-10-22 11:30,124,75,49,0,0,0
2020-10-22 11:45,191,109,82,0,0,0
2020-10-22 12:00,168,91,77,0,0,0
2020-10-22 12:15,175,107,68,0,0,0
2020-10-22 12:30,156,71,85,0,0,0
2020-10-22 12:45,178,87,91,0,0,0
2020-10-22 13:00,164,83,81,0,0,0
2020-10-22 13:15,172,80,92,0,0,0
2020-10-22 13:30,189,76,113,0,0,0
2020-10-22 13:45,195,99,96,0,0,0
2020-10-22 14:00,199,102,97,0,0,0
2020-10-22 14:15,170,85,85,0,0,0
2020-10-22 14:30,170,95,75,0,0,0
2020-10-22 14:45,203,103,100,0,0,0
2020-10-22 15:00,172,79,93,0,0,0
2020-10-22 15:15,176,70,106,0,0,0
2020-10-22 15:30,174,83,91,0,0,0
2020-10-22 15:45,205,102,103,0,0,0
2020-10-22 16:00,209,90,119,0,0,0
2020-10-22 16:15,210,101,109,0,0,0
2020-10-22 16:30,207,102,105,0,0,0
2020-10-22 16:45,240,113,127,0,0,0
2020-10-22 17:00,218,99,119,0,0,0
2020-10-22 17:15,232,108,124,0,0,0
2020-10-22 17:30,210,74,136,0,0,0
2020-10-22 17:45,200,68,132,0,0,0
2020-10-22 18:00,185,89,96,0,0,0
2020-10-22 18:15,192,79,113,0,0,0
2020-10-22 18:30,186,85,101,0,0,0
2020-10-22 18:45,175,80,95,0,0,0
2020-10-22 19:00,158,81,77,0,0,0
2020-10-22 19:15,139,70,69,0,0,0
2020-10-22 19:30,119,67,52,0,0,0
2020-10-22 19:45,142,71,71,0,0,0
2020-10-22 20:00,152,76,76,0,0,0
2020-10-22 20:15,125,52,73,0,0,0
2020-10-22 20:30,114,47,67,0,0,0
2020-10-22 20:45,94,29,65,0,0,0
2020-10-22 21:00,83,31,52,0,0,0
2020-10-22 21:15,87,34,53,0,0,0
2020-10-22 21:30,71,17,54,0,0,0
2020-10-22 21:45,70,28,42,0,0,0
2020-10-22 22:00,67,13,54,0,0,0
2020-10-22 22:15,64,23,41,0,0,0
2020-10-22 22:30,57,20,37,0,0,0
2020-10-22 22:45,63,14,49,0,0,0
2020-10-22 23:00,78,28,50,0,0,0
2020-10-22 23:15,52,16,36,0,0,0
2020-10-22 23:30,47,19,28,0,0,0
2020-10-22 23:45,53,18,35,0,0,0
2020-10-23 00:00,49,25,24,0,0,0
2020-10-23 00:15,34,15,19,0,0,0
2020-10-23 00:30,34,12,22,0,0,0
2020-10-23 00:45,23,6,17,0,0,0
2020-10-23 01:00,25,8,17,0,0,0
2020-10-23 01:15,12,3,9,0,0,0
2020-10-23 01:30,11,2,9,0,0,0
2020-10-23 01:45,20,5,15,0,0,0
2020-10-23 02:00,6,4,2,0,0,0
2020-10-23 02:15,7,2,5,0,0,0
2020-10-23 02:30,13,7,6,0,0,0
2020-10-23 02:45,8,5,3,0,0,0
2020-10-23 03:00,8,6,2,0,0,0
2020-10-23 03:15,5,3,2,0,0,0
2020-10-23 03:30,3,0,3,0,0,0
2020-10-23 03:45,1,0,1,0,0,0
2020-10-23 04:00,5,0,5,0,0,0
2020-10-23 04:15,5,2,3,0,0,0
2020-10-23 04:30,5,4,1,0,0,0
2020-10-23 04:45,10,6,4,0,0,0
2020-10-23 05:00,8,8,0,0,0,0
2020-10-23 05:15,10,8,2,0,0,0
2020-10-23 05:30,23,15,8,0,0,0
2020-10-23 05:45,25,20,5,0,0,0
2020-10-23 06:00,38,23,15,0,0,0
2020-10-23 06:15,33,23,10,0,0,0
2020-10-23 06:30,36,21,15,0,0,0
2020-10-23 06:45,68,44,24,0,0,0
2020-10-23 07:00,84,67,17,0,0,0
2020-10-23 07:15,92,57,35,0,0,0
2020-10-23 07:30,121,60,61,0,0,0
2020-10-23 07:45,191,116,75,0,0,0
2020-10-23 08:00,156,91,65,0,0,0
2020-10-23 08:15,148,84,64,0,0,0
2020-10-23 08:30,142,85,57,0,0,0
2020-10-23 08:45,166,97,69,0,0,0
2020-10-23 09:00,150,84,66,0,0,0
2020-10-23 09:15,132,84,48,0,0,0
2020-10-23 09:30,109,64,45,0,0,0
2020-10-23 09:45,160,104,56,0,0,0
2020-10-23 10:00,105,70,35,0,0,0
2020-10-23 10:15,100,58,42,0,0,0
2020-10-23 10:30,135,83,52,0,0,0
2020-10-23 10:45,130,77,53,0,0,0
2020-10-23 11:00,98,53,45,0,0,0
2020-10-23 11:15,126,59,67,0,0,0
2020-10-23 11:30,150,86,64,0,0,0
2020-10-23 11:45,163,103,60,0,0,0
2020-10-23 12:00,161,73,88,0,0,0
2020-10-23 12:15,139,75,64,0,0,0
2020-10-23 12:30,188,85,103,0,0,0
2020-10-23 12:45,128,74,54,0,0,0
2020-10-23 13:00,179,86,93,0,0,0
2020-10-23 13:15,163,78,85,0,0,0
2020-10-23 13:30,165,73,92,0,0,0
2020-10-23 13:45,168,94,74,0,0,0
2020-10-23 14:00,156,77,79,0,0,0
2020-10-23 14:15,156,99,57,0,0,0
2020-10-23 14:30,166,91,75,0,0,0
2020-10-23 14:45,170,79,91,0,0,0
2020-10-23 15:00,180,87,93,0,0,0
2020-10-23 15:15,195,112,83,0,0,0
2020-10-23 15:30,205,109,96,0,0,0
2020-10-23 15:45,185,103,82,0,0,0
2020-10-23 16:00,200,111,89,0,0,0
2020-10-23 16:15,214,117,97,0,0,0
2020-10-23 16:30,193,103,90,0,0,0
2020-10-23 16:45,199,113,86,0,0,0
2020-10-23 17:00,210,90,120,0,0,0
2020-10-23 17:15,205,107,98,0,0,0
2020-10-23 17:30,161,81,80,0,0,0
2020-10-23 17:45,214,117,97,0,0,0
2020-10-23 18:00,188,86,102,0,0,0
2020-10-23 18:15,156,81,75,0,0,0
2020-10-23 18:30,192,89,103,0,0,0
2020-10-23 18:45,206,113,93,0,0,0
2020-10-23 19:00,182,99,83,0,0,0
2020-10-23 19:15,164,88,76,0,0,0
2020-10-23 19:30,135,69,66,0,0,0
2020-10-23 19:45,160,92,68,0,0,0
2020-10-23 20:00,131,60,71,0,0,0
2020-10-23 20:15,128,64,64,0,0,0
2020-10-23 20:30,114,47,67,0,0,0
2020-10-23 20:45,105,54,51,0,0,0
2020-10-23 21:00,70,22,48,0,0,0
2020-10-23 21:15,78,31,47,0,0,0
2020-10-23 21:30,62,31,31,0,0,0
2020-10-23 21:45,56,26,30,0,0,0
2020-10-23 22:00,42,18,24,0,0,0
2020-10-23 22:15,67,26,41,0,0,0
2020-10-23 22:30,77,19,58,0,0,0
2020-10-23 22:45,62,17,45,0,0,0
2020-10-23 23:00,47,16,31,0,0,0
2020-10-23 23:15,59,22,37,0,0,0
2020-10-23 23:30,68,21,47,0,0,0
2020-10-23 23:45,48,8,40,0,0,0
2020-10-24 00:00,60,21,39,0,0,0
2020-10-24 00:15,38,10,28,0,0,0
2020-10-24 00:30,40,9,31,0,0,0
2020-10-24 00:45,58,16,42,0,0,0
2020-10-24 01:00,43,12,31,0,0,0
2020-10-24 01:15,35,9,26,0,0,0
2020-10-24 01:30,51,6,45,0,0,0
2020-10-24 01:45,19,7,12,0,0,0
2020-10-24 02:00,39,9,30,0,0,0
2020-10-24 02:15,36,4,32,0,0,0
2020-10-24 02:30,27,5,22,0,0,0
2020-10-24 02:45,30,3,27,0,0,0
2020-10-24 03:00,29,5,24,0,0,0
2020-10-24 03:15,27,6,21,0,0,0
2020-10-24 03:30,15,7,8,0,0,0
2020-10-24 03:45,14,3,11,0,0,0
2020-10-24 04:00,24,9,15,0,0,0
2020-10-24 04:15,13,3,10,0,0,0
2020-10-24 04:30,5,2,3,0,0,0
2020-10-24 04:45,10,4,6,0,0,0
2020-10-24 05:00,5,3,2,0,0,0
2020-10-24 05:15,15,10,5,0,0,0
2020-10-24 05:30,14,8,6,0,0,0
2020-10-24 05:45,15,9,6,0,0,0
2020-10-24 06:00,5,1,4,0,0,0
2020-10-24 06:15,10,6,4,0,0,0
2020-10-24 06:30,12,10,2,0,0,0
2020-10-24 06:45,16,8,8,0,0,0
2020-10-24 07:00,9,9,0,0,0,0
2020-10-24 07:15,22,16,6,0,0,0
2020-10-24 07:30,16,10,6,0,0,0
2020-10-24 07:45,33,24,9,0,0,0
2020-10-24 08:00,23,20,3,0,0,0
2020-10-24 08:15,43,23,20,0,0,0
2020-10-24 08:30,38,26,12,0,0,0
2020-10-24 08:45,67,41,26,0,0,0
2020-10-24 09:00,46,38,8,0,0,0
2020-10-24 09:15,72,51,21,0,0,0
2020-10-24 09:30,100,60,40,0,0,0
2020-10-24 09:45,135,92,43,0,0,0
2020-10-24 10:00,88,51,37,0,0,0
2020-10-24 10:15,102,77,25,0,0,0
2020-10-24 10:30,97,66,31,0,0,0
2020-10-24 10:45,130,93,37,0,0,0
2020-10-24 11:00,121,80,41,0,0,0
2020-10-24 11:15,122,73,49,0,0,0
2020-10-24 11:30,128,69,59,0,0,0
2020-10-24 11:45,120,74,46,0,0,0
2020-10-24 12:00,140,78,62,0,0,0
2020-10-24 12:15,144,87,57,0,0,0
2020-10-24 12:30,161,78,83,0,0,0
2020-10-24 12:45,141,83,58,0,0,0
2020-10-24 13:00,149,82,67,0,0,0
2020-10-24 13:15,153,76,77,0,0,0
2020-10-24 13:30,148,87,61,0,0,0
2020-10-24 13:45,145,78,67,0,0,0
2020-10-24 14:00,135,69,66,0,0,0
2020-10-24 14:15,145,81,64,0,0,0
2020-10-24 14:30,137,67,70,0,0,0
2020-10-24 14:45,166,86,80,0,0,0
2020-10-24 15:00,137,58,79,0,0,0
2020-10-24 15:15,157,72,85,0,0,0
2020-10-24 15:30,143,76,67,0,0,0
2020-10-24 15:45,146,76,70,0,0,0
2020-10-24 16:00,135,63,72,0,0,0
2020-10-24 16:15,140,76,64,0,0,0
2020-10-24 16:30,105,55,50,0,0,0
2020-10-24 16:45,132,75,57,0,0,0
2020-10-24 17:00,147,57,90,0,0,0
2020-10-24 17:15,144,69,75,0,0,0
2020-10-24 17:30,150,66,84,0,0,0
2020-10-24 17:45,170,73,97,0,0,0
2020-10-24 18:00,170,77,93,0,0,0
2020-10-24 18:15,184,95,89,0,0,0
2020-10-24 18:30,130,63,67,0,0,0
2020-10-24 18:45,133,58,75,0,0,0
2020-10-24 19:00,129,60,69,0,0,0
2020-10-24 19:15,124,47,77,0,0,0
2020-10-24 19:30,94,47,47,0,0,0
2020-10-24 19:45,131,63,68,0,0,0
2020-10-24 20:00,118,49,69,0,0,0
2020-10-24 20:15,77,33,44,0,0,0
2020-10-24 20:30,102,52,50,0,0,0
2020-10-24 20:45,98,46,52,0,0,0
2020-10-24 21:00,98,51,47,0,0,0
2020-10-24 21:15,53,21,32,0,0,0
2020-10-24 21:30,53,33,20,0,0,0
2020-10-24 21:45,55,22,33,0,0,0
2020-10-24 22:00,61,24,37,0,0,0
2020-10-24 22:15,69,27,42,0,0,0
2020-10-24 22:30,56,17,39,0,0,0
2020-10-24 22:45,40,17,23,0,0,0
2020-10-24 23:00,47,11,36,0,0,0
2020-10-24 23:15,48,21,27,0,0,0
2020-10-24 23:30,58,17,41,0,0,0
2020-10-24 23:45,45,19,26,0,0,0
2020-10-25 00:00,48,21,27,0,0,0
2020-10-25 00:15,37,13,24,0,0,0
2020-10-25 00:30,45,16,29,0,0,0
2020-10-25 00:45,49,18,31,0,0,0
2020-10-25 01:00,55,17,38,0,0,0
2020-10-25 01:15,46,11,35,0,0,0
2020-10-25 01:30,46,17,29,0,0,0
2020-10-25 01:45,42,14,28,0,0,0
2020-10-25 02:00,68,25,43,0,0,0
2020-10-25 02:15,71,17,54,0,0,0
2020-10-25 02:30,53,21,32,0,0,0
2020-10-25 02:45,58,18,40,0,0,0
2020-10-25 03:00,10,2,8,0,0,0
2020-10-25 03:15,9,4,5,0,0,0
2020-10-25 03:30,6,1,5,0,0,0
2020-10-25 03:45,9,4,5,0,0,0
2020-10-25 04:00,3,1,2,0,0,0
2020-10-25 04:15,8,4,4,0,0,0
2020-10-25 04:30,6,2,4,0,0,0
2020-10-25 04:45,5,2,3,0,0,0
2020-10-25 05:00,10,5,5,0,0,0
2020-10-25 05:15,6,2,4,0,0,0
2020-10-25 05:30,11,5,6,0,0,0
2020-10-25 05:45,4,1,3,0,0,0
2020-10-25 06:00,6,4,2,0,0,0
2020-10-25 06:15,1,1,0,0,0,0
2020-10-25 06:30,7,5,2,0,0,0
2020-10-25 06:45,4,4,0,0,0,0
2020-10-25 07:00,7,5,2,0,0,0
2020-10-25 07:15,15,5,10,0,0,0
2020-10-25 07:30,9,6,3,0,0,0
2020-10-25 07:45,16,13,3,0,0,0
2020-10-25 08:00,10,8,2,0,0,0
2020-10-25 08:15,12,9,3,0,0,0
2020-10-25 08:30,20,13,7,0,0,0
2020-10-25 08:45,33,17,16,0,0,0
2020-10-25 09:00,33,23,10,0,0,0
2020-10-25 09:15,28,20,8,0,0,0
2020-10-25 09:30,35,23,12,0,0,0
2020-10-25 09:45,63,47,16,0,0,0
2020-10-25 10:00,46,25,21,0,0,0
2020-10-25 10:15,44,31,13,0,0,0
2020-10-25 10:30,40,26,14,0,0,0
2020-10-25 10:45,54,35,19,0,0,0
2020-10-25 11:00,44,18,26,0,0,0
2020-10-25 11:15,39,25,14,0,0,0
2020-10-25 11:30,40,25,15,0,0,0
2020-10-25 11:45,60,43,17,0,0,0
2020-10-25 12:00,39,24,15,0,0,0
2020-10-25 12:15,45,19,26,0,0,0
2020-10-25 12:30,57,24,33,0,0,0
2020-10-25 12:45,64,26,38,0,0,0
2020-10-25 13:00,71,31,40,0,0,0
2020-10-25 13:15,54,28,26,0,0,0
2020-10-25 13:30,34,22,12,0,0,0
2020-10-25 13:45,61,32,29,0,0,0
2020-10-25 14:00,59,29,30,0,0,0
2020-10-25 14:15,65,17,48,0,0,0
2020-10-25 14:30,51,18,33,0,0,0
2020-10-25 14:45,70,46,24,0,0,0
2020-10-25 15:00,53,33,20,0,0,0
2020-10-25 15:15,67,36,31,0,0,0
2020-10-25 15:30,51,31,20,0,0,0
2020-10-25 15:45,64,37,27,0,0,0
2020-10-25 16:00,76,39,37,0,0,0
2020-10-25 16:15,67,39,28,0,0,0
2020-10-25 16:30,77,39,38,0,0,0
2020-10-25 16:45,93,40,53,0,0,0
2020-10-25 17:00,70,34,36,0,0,0
2020-10-25 17:15,94,47,47,0,0,0
2020-10-25 17:30,122,63,59,0,0,0
2020-10-25 17:45,115,59,56,0,0,0
2020-10-25 18:00,78,38,40,0,0,0
2020-10-25 18:15,76,31,45,0,0,0
2020-10-25 18:30,74,24,50,0,0,0
2020-10-25 18:45,93,49,44,0,0,0
2020-10-25 19:00,65,24,41,0,0,0
2020-10-25 19:15,64,30,34,0,0,0
2020-10-25 19:30,49,22,27,0,0,0
2020-10-25 19:45,59,22,37,0,0,0
2020-10-25 20:00,52,24,28,0,0,0
2020-10-25 20:15,59,21,38,0,0,0
2020-10-25 20:30,53,24,29,0,0,0
2020-10-25 20:45,40,26,14,0,0,0
2020-10-25 21:00,39,15,24,0,0,0
2020-10-25 21:15,46,21,25,0,0,0
2020-10-25 21:30,39,15,24,0,0,0
2020-10-25 21:45,30,8,22,0,0,0
2020-10-25 22:00,49,19,30,0,0,0
2020-10-25 22:15,39,15,24,0,0,0
2020-10-25 22:30,22,9,13,0,0,0
2020-10-25 22:45,35,16,19,0,0,0
2020-10-25 23:00,33,14,19,0,0,0
2020-10-25 23:15,23,15,8,0,0,0
2020-10-25 23:30,18,9,9,0,0,0
2020-10-25 23:45,23,8,15,0,0,0
2020-10-26 00:00,15,5,10,0,0,0
2020-10-26 00:15,28,5,23,0,0,0
2020-10-26 00:30,10,1,9,0,0,0
2020-10-26 00:45,8,4,4,0,0,0
2020-10-26 01:00,10,3,7,0,0,0
2020-10-26 01:15,7,4,3,0,0,0
2020-10-26 01:30,5,3,2,0,0,0
2020-10-26 01:45,5,3,2,0,0,0
2020-10-26 02:00,1,0,1,0,0,0
2020-10-26 02:15,7,3,4,0,0,0
2020-10-26 02:30,8,2,6,0,0,0
2020-10-26 02:45,5,3,2,0,0,0
2020-10-26 03:00,1,1,0,0,0,0
2020-10-26 03:15,2,0,2,0,0,0
2020-10-26 03:30,0,0,0,0,0,0
2020-10-26 03:45,4,1,3,0,0,0
2020-10-26 04:00,0,0,0,0,0,0
2020-10-26 04:15,1,0,1,0,0,0
2020-10-26 04:30,1,0,1,0,0,0
2020-10-26 04:45,2,0,2,0,0,0
2020-10-26 05:00,12,7,5,0,0,0
2020-10-26 05:15,13,10,3,0,0,0
2020-10-26 05:30,22,13,9,0,0,0
2020-10-26 05:45,25,17,8,0,0,0
2020-10-26 06:00,34,24,10,0,0,0
2020-10-26 06:15,48,34,14,0,0,0
2020-10-26 06:30,65,45,20,0,0,0
2020-10-26 06:45,95,62,33,0,0,0
2020-10-26 07:00,126,80,46,0,0,0
2020-10-26 07:15,230,159,71,0,0,0
2020-10-26 07:30,341,262,79,0,0,0
2020-10-26 07:45,291,169,122,0,0,0
2020-10-26 08:00,213,134,79,0,0,0
2020-10-26 08:15,178,110,68,0,0,0
2020-10-26 08:30,170,95,75,0,0,0
2020-10-26 08:45,217,127,90,0,0,0
2020-10-26 09:00,159,78,81,0,0,0
2020-10-26 09:15,143,87,56,0,0,0
2020-10-26 09:30,137,77,60,0,0,0
2020-10-26 09:45,180,98,82,0,0,0
2020-10-26 10:00,118,68,50,0,0,0
2020-10-26 10:15,112,70,42,0,0,0
2020-10-26 10:30,119,58,61,0,0,0
2020-10-26 10:45,131,71,60,0,0,0
2020-10-26 11:00,108,61,47,0,0,0
2020-10-26 11:15,111,62,49,0,0,0
2020-10-26 11:30,148,78,70,0,0,0
2020-10-26 11:45,177,99,78,0,0,0
2020-10-26 12:00,155,57,98,0,0,0
2020-10-26 12:15,172,85,87,0,0,0
2020-10-26 12:30,222,110,112,0,0,0
2020-10-26 12:45,217,115,102,0,0,0
2020-10-26 13:00,209,102,107,0,0,0
2020-10-26 13:15,221,103,118,0,0,0
2020-10-26 13:30,199,104,95,0,0,0
2020-10-26 13:45,215,106,109,0,0,0
2020-10-26 14:00,195,93,102,0,0,0
2020-10-26 14:15,195,96,99,0,0,0
2020-10-26 14:30,154,90,64,0,0,0
2020-10-26 14:45,227,105,122,0,0,0
2020-10-26 15:00,211,103,108,0,0,0
2020-10-26 15:15,187,87,100,0,0,0
2020-10-26 15:30,265,96,169,0,0,0
2020-10-26 15:45,288,124,164,0,0,0
2020-10-26 16:00,271,120,151,0,0,0
2020-10-26 16:15,296,129,167,0,0,0
2020-10-26 16:30,295,129,166,0,0,0
2020-10-26 16:45,232,120,112,0,0,0
2020-10-26 17:00,259,128,131,0,0,0
2020-10-26 17:15,284,113,171,0,0,0
2020-10-26 17:30,246,125,121,0,0,0
2020-10-26 17:45,265,149,116,0,0,0
2020-10-26 18:00,232,103,129,0,0,0
2020-10-26 18:15,212,84,128,0,0,0
2020-10-26 18:30,171,72,99,0,0,0
2020-10-26 18:45,188,80,108,0,0,0
2020-10-26 19:00,172,85,87,0,0,0
2020-10-26 19:15,146,82,64,0,0,0
2020-10-26 19:30,123,43,80,0,0,0
2020-10-26 19:45,154,74,80,0,0,0
2020-10-26 20:00,111,43,68,0,0,0
2020-10-26 20:15,94,38,56,0,0,0
2020-10-26 20:30,82,33,49,0,0,0
2020-10-26 20:45,64,35,29,0,0,0
2020-10-26 21:00,77,29,48,0,0,0
2020-10-26 21:15,85,31,54,0,0,0
2020-10-26 21:30,55,21,34,0,0,0
2020-10-26 21:45,81,28,53,0,0,0
2020-10-26 22:00,72,21,51,0,0,0
2020-10-26 22:15,55,17,38,0,0,0
2020-10-26 22:30,61,15,46,0,0,0
2020-10-26 22:45,42,14,28,0,0,0
2020-10-26 23:00,47,9,38,0,0,0
2020-10-26 23:15,45,11,34,0,0,0
2020-10-26 23:30,30,11,19,0,0,0
2020-10-26 23:45,31,10,21,0,0,0
2020-10-27 00:00,29,7,22,0,0,0
2020-10-27 00:15,34,6,28,0,0,0
2020-10-27 00:30,26,3,23,0,0,0
2020-10-27 00:45,22,11,11,0,0,0
2020-10-27 01:00,12,3,9,0,0,0
2020-10-27 01:15,18,6,12,0,0,0
2020-10-27 01:30,11,1,10,0,0,0
2020-10-27 01:45,9,2,7,0,0,0
2020-10-27 02:00,9,5,4,0,0,0
2020-10-27 02:15,6,1,5,0,0,0
2020-10-27 02:30,2,1,1,0,0,0
2020-10-27 02:45,2,1,1,0,0,0
2020-10-27 03:00,3,1,2,0,0,0
2020-10-27 03:15,7,5,2,0,0,0
2020-10-27 03:30,3,0,3,0,0,0
2020-10-27 03:45,1,0,1,0,0,0
2020-10-27 04:00,3,2,1,0,0,0
2020-10-27 04:15,2,1,1,0,0,0
2020-10-27 04:30,8,7,1,0,0,0
2020-10-27 04:45,13,8,5,0,0,0
2020-10-27 05:00,9,9,0,0,0,0
2020-10-27 05:15,11,7,4,0,0,0
2020-10-27 05:30,26,15,11,0,0,0
2020-10-27 05:45,26,22,4,0,0,0
2020-10-27 06:00,28,16,12,0,0,0
2020-10-27 06:15,58,37,21,0,0,0
2020-10-27 06:30,61,36,25,0,0,0
2020-10-27 06:45,90,64,26,0,0,0
2020-10-27 07:00,107,70,37,0,0,0
2020-10-27 07:15,195,133,62,0,0,0
2020-10-27 07:30,359,289,70,0,0,0
2020-10-27 07:45,289,173,116,0,0,0
2020-10-27 08:00,192,119,73,0,0,0
2020-10-27 08:15,183,116,67,0,0,0
2020-10-27 08:30,162,99,63,0,0,0
2020-10-27 08:45,216,135,81,0,0,0
2020-10-27 09:00,149,87,62,0,0,0
2020-10-27 09:15,140,80,60,0,0,0
2020-10-27 09:30,150,80,70,0,0,0
2020-10-27 09:45,152,84,68,0,0,0
2020-10-27 10:00,123,72,51,0,0,0
2020-10-27 10:15,122,57,65,0,0,0
2020-10-27 10:30,121,66,55,0,0,0
2020-10-27 10:45,135,74,61,0,0,0
2020-10-27 11:00,118,61,57,0,0,0
2020-10-27 11:15,119,58,61,0,0,0
2020-10-27 11:30,161,87,74,0,0,0
2020-10-27 11:45,160,93,67,0,0,0
2020-10-27 12:00,160,89,71,0,0,0
2020-10-27 12:15,196,108,88,0,0,0
2020-10-27 12:30,204,84,120,0,0,0
2020-10-27 12:45,250,156,94,0,0,0
2020-10-27 13:00,279,105,174,0,0,0
2020-10-27 13:15,238,103,135,0,0,0
2020-10-27 13:30,198,95,103,0,0,0
2020-10-27 13:45,218,90,128,0,0,0
2020-10-27 14:00,250,126,124,0,0,0
2020-10-27 14:15,191,111,80,0,0,0
2020-10-27 14:30,191,78,113,0,0,0
2020-10-27 14:45,190,94,96,0,0,0
2020-10-27 15:00,221,98,123,0,0,0
2020-10-27 15:15,195,94,101,0,0,0
2020-10-27 15:30,203,96,107,0,0,0
2020-10-27 15:45,234,126,108,0,0,0
2020-10-27 16:00,223,110,113,0,0,0
2020-10-27 16:15,250,116,134,0,0,0
2020-10-27 16:30,197,94,103,0,0,0
2020-10-27 16:45,270,125,145,0,0,0
2020-10-27 17:00,258,112,146,0,0,0
2020-10-27 17:15,287,130,157,0,0,0
2020-10-27 17:30,273,116,157,0,0,0
2020-10-27 17:45,285,127,158,0,0,0
2020-10-27 18:00,242,106,136,0,0,0
2020-10-27 18:15,217,97,120,0,0,0
2020-10-27 18:30,202,98,104,0,0,0
2020-10-27 18:45,214,118,96,0,0,0
2020-10-27 19:00,171,80,91,0,0,0
2020-10-27 19:15,173,73,100,0,0,0
2020-10-27 19:30,138,77,61,0,0,0
2020-10-27 19:45,135,67,68,0,0,0
2020-10-27 20:00,115,38,77,0,0,0
2020-10-27 20:15,107,62,45,0,0,0
2020-10-27 20:30,88,41,47,0,0,0
2020-10-27 20:45,65,26,39,0,0,0
2020-10-27 21:00,91,24,67,0,0,0
2020-10-27 21:15,69,27,42,0,0,0
2020-10-27 21:30,70,30,40,0,0,0
2020-10-27 21:45,58,20,38,0,0,0
2020-10-27 22:00,57,15,42,0,0,0
2020-10-27 22:15,61,23,38,0,0,0
2020-10-27 22:30,73,19,54,0,0,0
2020-10-27 22:45,71,25,46,0,0,0
2020-10-27 23:00,73,15,58,0,0,0
2020-10-27 23:15,53,18,35,0,0,0
2020-10-27 23:30,47,16,31,0,0,0
2020-10-27 23:45,35,8,27,0,0,0
2020-10-28 00:00,26,7,19,0,0,0
2020-10-28 00:15,27,13,14,0,0,0
2020-10-28 00:30,36,16,20,0,0,0
2020-10-28 00:45,31,4,27,0,0,0
2020-10-28 01:00,18,8,10,0,0,0
2020-10-28 01:15,13,4,9,0,0,0
2020-10-28 01:30,19,8,11,0,0,0
2020-10-28 01:45,14,3,11,0,0,0
2020-10-28 02:00,12,2,10,0,0,0
2020-10-28 02:15,10,4,6,0,0,0
2020-10-28 02:30,6,1,5,0,0,0
2020-10-28 02:45,4,1,3,0,0,0
2020-10-28 03:00,5,0,5,0,0,0
2020-10-28 03:15,10,5,5,0,0,0
2020-10-28 03:30,6,2,4,0,0,0
2020-10-28 03:45,8,3,5,0,0,0
2020-10-28 04:00,4,2,2,0,0,0
2020-10-28 04:15,1,0,1,0,0,0
2020-10-28 04:30,5,4,1,0,0,0
2020-10-28 04:45,7,3,4,0,0,0
2020-10-28 05:00,4,3,1,0,0,0
2020-10-28 05:15,12,9,3,0,0,0
2020-10-28 05:30,16,11,5,0,0,0
2020-10-28 05:45,23,19,4,0,0,0
2020-10-28 06:00,35,22,13,0,0,0
2020-10-28 06:15,45,34,11,0,0,0
2020-10-28 06:30,65,37,28,0,0,0
2020-10-28 06:45,103,70,33,0,0,0
2020-10-28 07:00,119,88,31,0,0,0
2020-10-28 07:15,201,147,54,0,0,0
2020-10-28 07:30,327,255,72,0,0,0
2020-10-28 07:45,316,196,120,0,0,0
2020-10-28 08:00,212,106,106,0,0,0
2020-10-28 08:15,189,116,73,0,0,0
2020-10-28 08:30,169,86,83,0,0,0
2020-10-28 08:45,181,108,73,0,0,0
2020-10-28 09:00,160,91,69,0,0,0
2020-10-28 09:15,158,90,68,0,0,0
2020-10-28 09:30,139,79,60,0,0,0
2020-10-28 09:45,178,104,74,0,0,0
2020-10-28 10:00,115,65,50,0,0,0
2020-10-28 10:15,107,66,41,0,0,0
2020-10-28 10:30,107,56,51,0,0,0
2020-10-28 10:45,153,94,59,0,0,0
2020-10-28 11:00,118,66,52,0,0,0
2020-10-28 11:15,165,92,73,0,0,0
2020-10-28 11:30,169,93,76,0,0,0
2020-10-28 11:45,194,112,82,0,0,0
2020-10-28 12:00,212,113,99,0,0,0
2020-10-28 12:15,178,96,82,0,0,0
2020-10-28 12:30,155,83,72,0,0,0
2020-10-28 12:45,214,133,81,0,0,0
2020-10-28 13:00,222,114,108,0,0,0
2020-10-28 13:15,246,123,123,0,0,0
2020-10-28 13:30,233,98,135,0,0,0
2020-10-28 13:45,270,135,135,0,0,0
2020-10-28 14:00,211,97,114,0,0,0
2020-10-28 14:15,191,107,84,0,0,0
2020-10-28 14:30,193,92,101,0,0,0
2020-10-28 14:45,234,110,124,0,0,0
2020-10-28 15:00,200,97,103,0,0,0
2020-10-28 15:15,193,106,87,0,0,0
2020-10-28 15:30,241,95,146,0,0,0
2020-10-28 15:45,305,145,160,0,0,0
2020-10-28 16:00,250,108,142,0,0,0
2020-10-28 16:15,254,112,142,0,0,0
2020-10-28 16:30,239,111,128,0,0,0
2020-10-28 16:45,258,136,122,0,0,0
2020-10-28 17:00,281,116,165,0,0,0
2020-10-28 17:15,250,127,123,0,0,0
2020-10-28 17:30,248,100,148,0,0,0
2020-10-28 17:45,243,115,128,0,0,0
2020-10-28 18:00,231,112,119,0,0,0
2020-10-28 18:15,207,100,107,0,0,0
2020-10-28 18:30,188,80,108,0,0,0
2020-10-28 18:45,169,88,81,0,0,0
2020-10-28 19:00,135,62,73,0,0,0
2020-10-28 19:15,157,71,86,0,0,0
2020-10-28 19:30,122,55,67,0,0,0
2020-10-28 19:45,139,65,74,0,0,0
2020-10-28 20:00,123,46,77,0,0,0
2020-10-28 20:15,103,56,47,0,0,0
2020-10-28 20:30,81,39,42,0,0,0
2020-10-28 20:45,72,24,48,0,0,0
2020-10-28 21:00,78,39,39,0,0,0
2020-10-28 21:15,44,14,30,0,0,0
2020-10-28 21:30,57,22,35,0,0,0
2020-10-28 21:45,55,24,31,0,0,0
2020-10-28 22:00,53,20,33,0,0,0
2020-10-28 22:15,50,16,34,0,0,0
2020-10-28 22:30,35,6,29,0,0,0
2020-10-28 22:45,56,28,28,0,0,0
2020-10-28 23:00,100,21,79,0,0,0
2020-10-28 23:15,70,12,58,0,0,0
2020-10-28 23:30,51,13,38,0,0,0
2020-10-28 23:45,32,14,18,0,0,0
2020-10-29 00:00,42,11,31,0,0,0
2020-10-29 00:15,26,11,15,0,0,0
2020-10-29 00:30,23,9,14,0,0,0
2020-10-29 00:45,26,10,16,0,0,0
2020-10-29 01:00,21,10,11,0,0,0
2020-10-29 01:15,19,6,13,0,0,0
2020-10-29 01:30,17,7,10,0,0,0
2020-10-29 01:45,23,8,15,0,0,0
2020-10-29 02:00,12,3,9,0,0,0
2020-10-29 02:15,5,3,2,0,0,0
2020-10-29 02:30,9,3,6,0,0,0
2020-10-29 02:45,7,4,3,0,0,0
2020-10-29 03:00,4,3,1,0,0,0
2020-10-29 03:15,6,4,2,0,0,0
2020-10-29 03:30,7,2,5,0,0,0
2020-10-29 03:45,3,2,1,0,0,0
2020-10-29 04:00,6,3,3,0,0,0
2020-10-29 04:15,5,5,0,0,0,0
2020-10-29 04:30,8,7,1,0,0,0
2020-10-29 04:45,7,2,5,0,0,0
2020-10-29 05:00,8,6,2,0,0,0
2020-10-29 05:15,12,7,5,0,0,0
2020-10-29 05:30,20,13,7,0,0,0
2020-10-29 05:45,22,18,4,0,0,0
2020-10-29 06:00,38,27,11,0,0,0
2020-10-29 06:15,46,34,12,0,0,0
2020-10-29 06:30,40,24,16,0,0,0
2020-10-29 06:45,89,58,31,0,0,0
2020-10-29 07:00,104,73,31,0,0,0
2020-10-29 07:15,170,124,46,0,0,0
2020-10-29 07:30,311,227,84,0,0,0
2020-10-29 07:45,271,180,91,0,0,0
2020-10-29 08:00,200,121,79,0,0,0
2020-10-29 08:15,163,93,70,0,0,0
2020-10-29 08:30,159,103,56,0,0,0
2020-10-29 08:45,193,124,69,0,0,0
2020-10-29 09:00,132,85,47,0,0,0
2020-10-29 09:15,160,96,64,0,0,0
2020-10-29 09:30,164,91,73,0,0,0
2020-10-29 09:45,168,92,76,0,0,0
2020-10-29 10:00,123,66,57,0,0,0
2020-10-29 10:15,104,62,42,0,0,0
2020-10-29 10:30,132,79,53,0,0,0
2020-10-29 10:45,106,66,40,0,0,0
2020-10-29 11:00,108,64,44,0,0,0
2020-10-29 11:15,139,67,72,0,0,0
2020-10-29 11:30,144,79,65,0,0,0
2020-10-29 11:45,163,95,68,0,0,0
2020-10-29 12:00,176,86,90,0,0,0
2020-10-29 12:15,191,98,93,0,0,0
2020-10-29 12:30,156,90,66,0,0,0
2020-10-29 12:45,200,112,88,0,0,0
2020-10-29 13:00,215,101,114,0,0,0
2020-10-29 13:15,200,92,108,0,0,0
2020-10-29 13:30,196,89,107,0,0,0
2020-10-29 13:45,215,125,90,0,0,0
2020-10-29 14:00,240,122,118,0,0,0
2020-10-29 14:15,210,111,99,0,0,0
2020-10-29 14:30,184,82,102,0,0,0
2020-10-29 14:45,233,121,112,0,0,0
2020-10-29 15:00,193,87,106,0,0,0
2020-10-29 15:15,214,94,120,0,0,0
2020-10-29 15:30,265,96,169,0,0,0
2020-10-29 15:45,243,97,146,0,0,0
2020-10-29 16:00,254,128,126,0,0,0
2020-10-29 16:15,248,100,148,0,0,0
2020-10-29 16:30,218,93,125,0,0,0
2020-10-29 16:45,222,106,116,0,0,0
2020-10-29 17:00,198,79,119,0,0,0
2020-10-29 17:15,211,108,103,0,0,0
2020-10-29 17:30,192,73,119,0,0,0
2020-10-29 17:45,214,94,120,0,0,0
2020-10-29 18:00,174,83,91,0,0,0
2020-10-29 18:15,172,72,100,0,0,0
2020-10-29 18:30,148,60,88,0,0,0
2020-10-29 18:45,157,80,77,0,0,0
2020-10-29 19:00,151,65,86,0,0,0
2020-10-29 19:15,123,58,65,0,0,0
2020-10-29 19:30,109,54,55,0,0,0
2020-10-29 19:45,137,62,75,0,0,0
2020-10-29 20:00,102,37,65,0,0,0
2020-10-29 20:15,74,32,42,0,0,0
2020-10-29 20:30,66,24,42,0,0,0
2020-10-29 20:45,51,18,33,0,0,0
2020-10-29 21:00,57,27,30,0,0,0
2020-10-29 21:15,44,16,28,0,0,0
2020-10-29 21:30,54,25,29,0,0,0
2020-10-29 21:45,36,14,22,0,0,0
2020-10-29 22:00,41,15,26,0,0,0
2020-10-29 22:15,59,15,44,0,0,0
2020-10-29 22:30,39,13,26,0,0,0
2020-10-29 22:45,36,11,25,0,0,0
2020-10-29 23:00,63,15,48,0,0,0
2020-10-29 23:15,24,9,15,0,0,0
2020-10-29 23:30,25,3,22,0,0,0
2020-10-29 23:45,32,13,19,0,0,0
2020-10-30 00:00,26,7,19,0,0,0
2020-10-30 00:15,32,11,21,0,0,0
2020-10-30 00:30,11,2,9,0,0,0
2020-10-30 00:45,19,9,10,0,0,0
2020-10-30 01:00,13,7,6,0,0,0
2020-10-30 01:15,13,7,6,0,0,0
2020-10-30 01:30,15,7,8,0,0,0
2020-10-30 01:45,10,3,7,0,0,0
2020-10-30 02:00,3,1,2,0,0,0
2020-10-30 02:15,13,6,7,0,0,0
2020-10-30 02:30,10,0,10,0,0,0
2020-10-30 02:45,8,1,7,0,0,0
2020-10-30 03:00,11,3,8,0,0,0
2020-10-30 03:15,3,1,2,0,0,0
2020-10-30 03:30,2,2,0,0,0,0
2020-10-30 03:45,2,1,1,0,0,0
2020-10-30 04:00,5,1,4,0,0,0
2020-10-30 04:15,6,2,4,0,0,0
2020-10-30 04:30,9,6,3,0,0,0
2020-10-30 04:45,4,2,2,0,0,0
2020-10-30 05:00,6,3,3,0,0,0
2020-10-30 05:15,21,12,9,0,0,0
2020-10-30 05:30,9,9,0,0,0,0
2020-10-30 05:45,16,13,3,0,0,0
2020-10-30 06:00,26,18,8,0,0,0
2020-10-30 06:15,34,27,7,0,0,0
2020-10-30 06:30,42,26,16,0,0,0
2020-10-30 06:45,50,34,16,0,0,0
2020-10-30 07:00,55,45,10,0,0,0
2020-10-30 07:15,99,80,19,0,0,0
2020-10-30 07:30,204,167,37,0,0,0
2020-10-30 07:45,206,141,65,0,0,0
2020-10-30 08:00,168,79,89,0,0,0
2020-10-30 08:15,148,100,48,0,0,0
2020-10-30 08:30,149,81,68,0,0,0
2020-10-30 08:45,132,91,41,0,0,0
2020-10-30 09:00,115,57,58,0,0,0
2020-10-30 09:15,120,83,37,0,0,0
2020-10-30 09:30,125,75,50,0,0,0
2020-10-30 09:45,144,85,59,0,0,0
2020-10-30 10:00,111,46,65,0,0,0
2020-10-30 10:15,122,69,53,0,0,0
2020-10-30 10:30,94,56,38,0,0,0
2020-10-30 10:45,117,72,45,0,0,0
2020-10-30 11:00,125,74,51,0,0,0
2020-10-30 11:15,104,65,39,0,0,0
2020-10-30 11:30,108,64,44,0,0,0
2020-10-30 11:45,124,66,58,0,0,0
2020-10-30 12:00,119,58,61,0,0,0
2020-10-30 12:15,124,67,57,0,0,0
2020-10-30 12:30,150,72,78,0,0,0
2020-10-30 12:45,189,99,90,0,0,0
2020-10-30 13:00,192,111,81,0,0,0
2020-10-30 13:15,215,90,125,0,0,0
2020-10-30 13:30,222,92,130,0,0,0
2020-10-30 13:45,180,89,91,0,0,0
2020-10-30 14:00,175,92,83,0,0,0
2020-10-30 14:15,188,81,107,0,0,0
2020-10-30 14:30,174,85,89,0,0,0
2020-10-30 14:45,208,107,101,0,0,0
2020-10-30 15:00,172,74,98,0,0,0
2020-10-30 15:15,187,115,72,0,0,0
2020-10-30 15:30,175,101,74,0,0,0
2020-10-30 15:45,175,84,91,0,0,0
2020-10-30 16:00,170,81,89,0,0,0
2020-10-30 16:15,177,95,82,0,0,0
2020-10-30 16:30,206,97,109,0,0,0
2020-10-30 16:45,187,92,95,0,0,0
2020-10-30 17:00,167,80,87,0,0,0
2020-10-30 17:15,211,105,106,0,0,0
2020-10-30 17:30,164,70,94,0,0,0
2020-10-30 17:45,174,87,87,0,0,0
2020-10-30 18:00,176,79,97,0,0,0
2020-10-30 18:15,166,79,87,0,0,0
2020-10-30 18:30,126,57,69,0,0,0
2020-10-30 18:45,173,84,89,0,0,0
2020-10-30 19:00,141,52,89,0,0,0
2020-10-30 19:15,130,58,72,0,0,0
2020-10-30 19:30,97,42,55,0,0,0
2020-10-30 19:45,112,54,58,0,0,0
2020-10-30 20:00,133,66,67,0,0,0
2020-10-30 20:15,93,43,50,0,0,0
2020-10-30 20:30,87,37,50,0,0,0
2020-10-30 20:45,58,27,31,0,0,0
2020-10-30 21:00,70,20,50,0,0,0
2020-10-30 21:15,59,21,38,0,0,0
2020-10-30 21:30,40,12,28,0,0,0
2020-10-30 21:45,59,18,41,0,0,0
2020-10-30 22:00,44,9,35,0,0,0
2020-10-30 22:15,49,17,32,0,0,0
2020-10-30 22:30,40,11,29,0,0,0
2020-10-30 22:45,46,13,33,0,0,0
2020-10-30 23:00,62,19,43,0,0,0
2020-10-30 23:15,65,16,49,0,0,0
2020-10-30 23:30,68,12,56,0,0,0
2020-10-30 23:45,50,11,39,0,0,0
2020-10-31 00:00,31,7,24,0,0,0
2020-10-31 00:15,45,10,35,0,0,0
2020-10-31 00:30,25,16,9,0,0,0
2020-10-31 00:45,35,8,27,0,0,0
2020-10-31 01:00,30,8,22,0,0,0
2020-10-31 01:15,38,12,26,0,0,0
2020-10-31 01:30,21,10,11,0,0,0
2020-10-31 01:45,28,10,18,0,0,0
2020-10-31 02:00,25,6,19,0,0,0
2020-10-31 02:15,25,11,14,0,0,0
2020-10-31 02:30,25,11,14,0,0,0
2020-10-31 02:45,23,7,16,0,0,0
2020-10-31 03:00,17,5,12,0,0,0
2020-10-31 03:15,8,5,3,0,0,0
2020-10-31 03:30,17,6,11,0,0,0
2020-10-31 03:45,15,4,11,0,0,0
2020-10-31 04:00,10,2,8,0,0,0
2020-10-31 04:15,10,6,4,0,0,0
2020-10-31 04:30,2,1,1,0,0,0
2020-10-31 04:45,4,1,3,0,0,0
2020-10-31 05:00,3,3,0,0,0,0
2020-10-31 05:15,10,3,7,0,0,0
2020-10-31 05:30,13,8,5,0,0,0
2020-10-31 05:45,15,11,4,0,0,0
2020-10-31 06:00,11,2,9,0,0,0
2020-10-31 06:15,7,4,3,0,0,0
2020-10-31 06:30,7,2,5,0,0,0
2020-10-31 06:45,8,5,3,0,0,0
2020-10-31 07:00,16,9,7,0,0,0
2020-10-31 07:15,13,9,4,0,0,0
2020-10-31 07:30,25,16,9,0,0,0
2020-10-31 07:45,32,19,13,0,0,0
2020-10-31 08:00,33,28,5,0,0,0
2020-10-31 08:15,32,18,14,0,0,0
2020-10-31 08:30,54,34,20,0,0,0
2020-10-31 08:45,70,45,25,0,0,0
2020-10-31 09:00,54,35,19,0,0,0
2020-10-31 09:15,86,58,28,0,0,0
2020-10-31 09:30,96,59,37,0,0,0
2020-10-31 09:45,137,101,36,0,0,0
2020-10-31 10:00,109,83,26,0,0,0
2020-10-31 10:15,97,69,28,0,0,0
2020-10-31 10:30,116,78,38,0,0,0
2020-10-31 10:45,138,94,44,0,0,0
2020-10-31 11:00,106,62,44,0,0,0
2020-10-31 11:15,115,59,56,0,0,0
2020-10-31 11:30,145,88,57,0,0,0
2020-10-31 11:45,141,100,41,0,0,0
2020-10-31 12:00,139,74,65,0,0,0
2020-10-31 12:15,167,104,63,0,0,0
2020-10-31 12:30,168,78,90,0,0,0
2020-10-31 12:45,182,101,81,0,0,0
2020-10-31 13:00,151,89,62,0,0,0
2020-10-31 13:15,158,73,85,0,0,0
2020-10-31 13:30,168,73,95,0,0,0
2020-10-31 13:45,155,82,73,0,0,0
2020-10-31 14:00,194,95,99,0,0,0
2020-10-31 14:15,153,81,72,0,0,0
2020-10-31 14:30,194,73,121,0,0,0
2020-10-31 14:45,184,92,92,0,0,0
2020-10-31 15:00,186,90,96,0,0,0
2020-10-31 15:15,178,96,82,0,0,0
2020-10-31 15:30,152,68,84,0,0,0
2020-10-31 15:45,181,85,96,0,0,0
2020-10-31 16:00,166,100,66,0,0,0
2020-10-31 16:15,160,74,86,0,0,0
2020-10-31 16:30,159,74,85,0,0,0
2020-10-31 16:45,157,86,71,0,0,0
2020-10-31 17:00,165,64,101,0,0,0
2020-10-31 17:15,150,59,91,0,0,0
2020-10-31 17:30,118,42,76,0,0,0
2020-10-31 17:45,212,78,134,0,0,0
2020-10-31 18:00,145,45,100,0,0,0
2020-10-31 18:15,138,63,75,0,0,0
2020-10-31 18:30,121,50,71,0,0,0
2020-10-31 18:45,117,61,56,0,0,0
2020-10-31 19:00,125,62,63,0,0,0
2020-10-31 19:15,106,52,54,0,0,0
2020-10-31 19:30,135,63,72,0,0,0
2020-10-31 19:45,101,44,57,0,0,0
2020-10-31 20:00,112,46,66,0,0,0
2020-10-31 20:15,112,51,61,0,0,0
2020-10-31 20:30,60,30,30,0,0,0
2020-10-31 20:45,44,19,25,0,0,0
2020-10-31 21:00,63,19,44,0,0,0
2020-10-31 21:15,51,25,26,0,0,0
2020-10-31 21:30,46,18,28,0,0,0
2020-10-31 21:45,31,20,11,0,0,0
2020-10-31 22:00,62,16,46,0,0,0
2020-10-31 22:15,53,8,45,0,0,0
2020-10-31 22:30,58,15,43,0,0,0
2020-10-31 22:45,49,20,29,0,0,0
2020-10-31 23:00,53,10,43,0,0,0
2020-10-31 23:15,61,9,52,0,0,0
2020-10-31 23:30,56,24,32,0,0,0
2020-10-31 23:45,44,12,32,0,0,0
