Datetime,100035541 (Neutor),101035541 (Neutor stadteinwÃ¤rts),102035541 (Neutor stadtauswÃ¤rts),100035541-status,101035541-status,102035541-status
2020-07-01 00:00,27,7,20,0,0,0
2020-07-01 00:15,36,15,21,0,0,0
2020-07-01 00:30,31,8,23,0,0,0
2020-07-01 00:45,23,9,14,0,0,0
2020-07-01 01:00,16,8,8,0,0,0
2020-07-01 01:15,18,6,12,0,0,0
2020-07-01 01:30,15,3,12,0,0,0
2020-07-01 01:45,12,8,4,0,0,0
2020-07-01 02:00,7,1,6,0,0,0
2020-07-01 02:15,3,1,2,0,0,0
2020-07-01 02:30,13,3,10,0,0,0
2020-07-01 02:45,3,0,3,0,0,0
2020-07-01 03:00,5,3,2,0,0,0
2020-07-01 03:15,2,2,0,0,0,0
2020-07-01 03:30,5,3,2,0,0,0
2020-07-01 03:45,6,3,3,0,0,0
2020-07-01 04:00,2,1,1,0,0,0
2020-07-01 04:15,6,3,3,0,0,0
2020-07-01 04:30,9,4,5,0,0,0
2020-07-01 04:45,6,3,3,0,0,0
2020-07-01 05:00,5,2,3,0,0,0
2020-07-01 05:15,6,3,3,0,0,0
2020-07-01 05:30,24,20,4,0,0,0
2020-07-01 05:45,22,17,5,0,0,0
2020-07-01 06:00,24,18,6,0,0,0
2020-07-01 06:15,36,22,14,0,0,0
2020-07-01 06:30,43,26,17,0,0,0
2020-07-01 06:45,63,41,22,0,0,0
2020-07-01 07:00,72,40,32,0,0,0
2020-07-01 07:15,84,49,35,0,0,0
2020-07-01 07:30,110,67,43,0,0,0
2020-07-01 07:45,115,73,42,0,0,0
2020-07-01 08:00,54,11,43,0,0,0
2020-07-01 08:15,46,0,46,0,0,0
2020-07-01 08:30,48,1,47,0,0,0
2020-07-01 08:45,47,0,47,0,0,0
2020-07-01 09:00,30,1,29,0,0,0
2020-07-01 09:15,34,0,34,0,0,0
2020-07-01 09:30,45,0,45,0,0,0
2020-07-01 09:45,44,0,44,0,0,0
2020-07-01 10:00,43,0,43,0,0,0
2020-07-01 10:15,26,0,26,0,0,0
2020-07-01 10:30,37,0,37,0,0,0
2020-07-01 10:45,29,0,29,0,0,0
2020-07-01 11:00,32,0,32,0,0,0
2020-07-01 11:15,35,0,35,0,0,0
2020-07-01 11:30,44,0,44,0,0,0
2020-07-01 11:45,46,1,45,0,0,0
2020-07-01 12:00,62,2,60,0,0,0
2020-07-01 12:15,48,1,47,0,0,0
2020-07-01 12:30,48,0,48,0,0,0
2020-07-01 12:45,36,0,36,0,0,0
2020-07-01 13:00,55,0,55,0,0,0
2020-07-01 13:15,46,0,46,0,0,0
2020-07-01 13:30,65,2,63,0,0,0
2020-07-01 13:45,59,0,59,0,0,0
2020-07-01 14:00,54,0,54,0,0,0
2020-07-01 14:15,60,0,60,0,0,0
2020-07-01 14:30,47,0,47,0,0,0
2020-07-01 14:45,36,0,36,0,0,0
2020-07-01 15:00,41,0,41,0,0,0
2020-07-01 15:15,56,1,55,0,0,0
2020-07-01 15:30,31,0,31,0,0,0
2020-07-01 15:45,48,0,48,0,0,0
2020-07-01 16:00,57,0,57,0,0,0
2020-07-01 16:15,39,1,38,0,0,0
2020-07-01 16:30,52,1,51,0,0,0
2020-07-01 16:45,70,1,69,0,0,0
2020-07-01 17:00,58,0,58,0,0,0
2020-07-01 17:15,76,0,76,0,0,0
2020-07-01 17:30,81,1,80,0,0,0
2020-07-01 17:45,77,2,75,0,0,0
2020-07-01 18:00,93,0,93,0,0,0
2020-07-01 18:15,72,0,72,0,0,0
2020-07-01 18:30,69,3,66,0,0,0
2020-07-01 18:45,68,5,63,0,0,0
2020-07-01 19:00,84,2,82,0,0,0
2020-07-01 19:15,64,0,64,0,0,0
2020-07-01 19:30,84,1,83,0,0,0
2020-07-01 19:45,64,0,64,0,0,0
2020-07-01 20:00,60,0,60,0,0,0
2020-07-01 20:15,70,0,70,0,0,0
2020-07-01 20:30,38,0,38,0,0,0
2020-07-01 20:45,22,0,22,0,0,0
2020-07-01 21:00,43,2,41,0,0,0
2020-07-01 21:15,49,0,49,0,0,0
2020-07-01 21:30,54,0,54,0,0,0
2020-07-01 21:45,65,0,65,0,0,0
2020-07-01 22:00,43,0,43,0,0,0
2020-07-01 22:15,36,0,36,0,0,0
2020-07-01 22:30,47,0,47,0,0,0
2020-07-01 22:45,36,0,36,0,0,0
2020-07-01 23:00,51,0,51,0,0,0
2020-07-01 23:15,40,0,40,0,0,0
2020-07-01 23:30,23,0,23,0,0,0
2020-07-01 23:45,33,0,33,0,0,0
2020-07-02 00:00,34,1,33,0,0,0
2020-07-02 00:15,18,0,18,0,0,0
2020-07-02 00:30,27,0,27,0,0,0
2020-07-02 00:45,18,0,18,0,0,0
2020-07-02 01:00,17,0,17,0,0,0
2020-07-02 01:15,16,0,16,0,0,0
2020-07-02 01:30,14,0,14,0,0,0
2020-07-02 01:45,19,0,19,0,0,0
2020-07-02 02:00,15,1,14,0,0,0
2020-07-02 02:15,3,0,3,0,0,0
2020-07-02 02:30,14,1,13,0,0,0
2020-07-02 02:45,22,0,22,0,0,0
2020-07-02 03:00,7,0,7,0,0,0
2020-07-02 03:15,3,0,3,0,0,0
2020-07-02 03:30,2,0,2,0,0,0
2020-07-02 03:45,9,0,9,0,0,0
2020-07-02 04:00,1,0,1,0,0,0
2020-07-02 04:15,1,0,1,0,0,0
2020-07-02 04:30,0,0,0,0,0,0
2020-07-02 04:45,3,0,3,0,0,0
2020-07-02 05:00,5,0,5,0,0,0
2020-07-02 05:15,7,0,7,0,0,0
2020-07-02 05:30,6,0,6,0,0,0
2020-07-02 05:45,4,0,4,0,0,0
2020-07-02 06:00,5,0,5,0,0,0
2020-07-02 06:15,12,0,12,0,0,0
2020-07-02 06:30,21,0,21,0,0,0
2020-07-02 06:45,25,0,25,0,0,0
2020-07-02 07:00,37,0,37,0,0,0
2020-07-02 07:15,45,1,44,0,0,0
2020-07-02 07:30,63,0,63,0,0,0
2020-07-02 07:45,74,2,72,0,0,0
2020-07-02 08:00,74,0,74,0,0,0
2020-07-02 08:15,79,0,79,0,0,0
2020-07-02 08:30,80,0,80,0,0,0
2020-07-02 08:45,75,1,74,0,0,0
2020-07-02 09:00,68,0,68,0,0,0
2020-07-02 09:15,56,0,56,0,0,0
2020-07-02 09:30,69,0,69,0,0,0
2020-07-02 09:45,60,0,60,0,0,0
2020-07-02 10:00,57,0,57,0,0,0
2020-07-02 10:15,38,0,38,0,0,0
2020-07-02 10:30,51,0,51,0,0,0
2020-07-02 10:45,59,0,59,0,0,0
2020-07-02 11:00,59,0,59,0,0,0
2020-07-02 11:15,65,0,65,0,0,0
2020-07-02 11:30,68,0,68,0,0,0
2020-07-02 11:45,68,0,68,0,0,0
2020-07-02 12:00,57,0,57,0,0,0
2020-07-02 12:15,65,0,65,0,0,0
2020-07-02 12:30,66,0,66,0,0,0
2020-07-02 12:45,70,0,70,0,0,0
2020-07-02 13:00,80,1,79,0,0,0
2020-07-02 13:15,81,0,81,0,0,0
2020-07-02 13:30,94,0,94,0,0,0
2020-07-02 13:45,92,2,90,0,0,0
2020-07-02 14:00,78,0,78,0,0,0
2020-07-02 14:15,100,0,100,0,0,0
2020-07-02 14:30,80,0,80,0,0,0
2020-07-02 14:45,167,83,84,0,0,0
2020-07-02 15:00,171,91,80,0,0,0
2020-07-02 15:15,197,109,88,0,0,0
2020-07-02 15:30,211,124,87,0,0,0
2020-07-02 15:45,224,131,93,0,0,0
2020-07-02 16:00,227,136,91,0,0,0
2020-07-02 16:15,207,89,118,0,0,0
2020-07-02 16:30,205,102,103,0,0,0
2020-07-02 16:45,195,96,99,0,0,0
2020-07-02 17:00,214,98,116,0,0,0
2020-07-02 17:15,231,115,116,0,0,0
2020-07-02 17:30,217,100,117,0,0,0
2020-07-02 17:45,267,152,115,0,0,0
2020-07-02 18:00,231,115,116,0,0,0
2020-07-02 18:15,228,92,136,0,0,0
2020-07-02 18:30,147,51,96,0,0,0
2020-07-02 18:45,189,102,87,0,0,0
2020-07-02 19:00,198,94,104,0,0,0
2020-07-02 19:15,208,92,116,0,0,0
2020-07-02 19:30,203,110,93,0,0,0
2020-07-02 19:45,170,76,94,0,0,0
2020-07-02 20:00,166,78,88,0,0,0
2020-07-02 20:15,132,65,67,0,0,0
2020-07-02 20:30,121,48,73,0,0,0
2020-07-02 20:45,74,44,30,0,0,0
2020-07-02 21:00,87,33,54,0,0,0
2020-07-02 21:15,79,31,48,0,0,0
2020-07-02 21:30,105,40,65,0,0,0
2020-07-02 21:45,73,26,47,0,0,0
2020-07-02 22:00,70,34,36,0,0,0
2020-07-02 22:15,70,27,43,0,0,0
2020-07-02 22:30,96,41,55,0,0,0
2020-07-02 22:45,69,27,42,0,0,0
2020-07-02 23:00,74,26,48,0,0,0
2020-07-02 23:15,69,22,47,0,0,0
2020-07-02 23:30,55,23,32,0,0,0
2020-07-02 23:45,47,16,31,0,0,0
2020-07-03 00:00,62,23,39,0,0,0
2020-07-03 00:15,51,21,30,0,0,0
2020-07-03 00:30,32,7,25,0,0,0
2020-07-03 00:45,23,8,15,0,0,0
2020-07-03 01:00,16,4,12,0,0,0
2020-07-03 01:15,19,5,14,0,0,0
2020-07-03 01:30,15,7,8,0,0,0
2020-07-03 01:45,14,5,9,0,0,0
2020-07-03 02:00,12,6,6,0,0,0
2020-07-03 02:15,6,1,5,0,0,0
2020-07-03 02:30,10,4,6,0,0,0
2020-07-03 02:45,14,4,10,0,0,0
2020-07-03 03:00,13,6,7,0,0,0
2020-07-03 03:15,6,3,3,0,0,0
2020-07-03 03:30,6,3,3,0,0,0
2020-07-03 03:45,3,3,0,0,0,0
2020-07-03 04:00,5,2,3,0,0,0
2020-07-03 04:15,11,2,9,0,0,0
2020-07-03 04:30,8,6,2,0,0,0
2020-07-03 04:45,5,1,4,0,0,0
2020-07-03 05:00,7,4,3,0,0,0
2020-07-03 05:15,12,9,3,0,0,0
2020-07-03 05:30,16,12,4,0,0,0
2020-07-03 05:45,29,18,11,0,0,0
2020-07-03 06:00,20,17,3,0,0,0
2020-07-03 06:15,39,30,9,0,0,0
2020-07-03 06:30,48,32,16,0,0,0
2020-07-03 06:45,66,46,20,0,0,0
2020-07-03 07:00,69,42,27,0,0,0
2020-07-03 07:15,77,54,23,0,0,0
2020-07-03 07:30,107,73,34,0,0,0
2020-07-03 07:45,169,80,89,0,0,0
2020-07-03 08:00,136,67,69,0,0,0
2020-07-03 08:15,162,91,71,0,0,0
2020-07-03 08:30,142,74,68,0,0,0
2020-07-03 08:45,171,108,63,0,0,0
2020-07-03 09:00,147,88,59,0,0,0
2020-07-03 09:15,125,82,43,0,0,0
2020-07-03 09:30,130,87,43,0,0,0
2020-07-03 09:45,144,99,45,0,0,0
2020-07-03 10:00,121,74,47,0,0,0
2020-07-03 10:15,107,65,42,0,0,0
2020-07-03 10:30,116,62,54,0,0,0
2020-07-03 10:45,126,90,36,0,0,0
2020-07-03 11:00,137,78,59,0,0,0
2020-07-03 11:15,145,93,52,0,0,0
2020-07-03 11:30,147,79,68,0,0,0
2020-07-03 11:45,132,79,53,0,0,0
2020-07-03 12:00,174,90,84,0,0,0
2020-07-03 12:15,154,85,69,0,0,0
2020-07-03 12:30,184,93,91,0,0,0
2020-07-03 12:45,198,116,82,0,0,0
2020-07-03 13:00,192,97,95,0,0,0
2020-07-03 13:15,164,78,86,0,0,0
2020-07-03 13:30,160,75,85,0,0,0
2020-07-03 13:45,182,112,70,0,0,0
2020-07-03 14:00,172,74,98,0,0,0
2020-07-03 14:15,189,97,92,0,0,0
2020-07-03 14:30,166,79,87,0,0,0
2020-07-03 14:45,227,124,103,0,0,0
2020-07-03 15:00,197,113,84,0,0,0
2020-07-03 15:15,195,107,88,0,0,0
2020-07-03 15:30,183,103,80,0,0,0
2020-07-03 15:45,203,123,80,0,0,0
2020-07-03 16:00,210,125,85,0,0,0
2020-07-03 16:15,181,106,75,0,0,0
2020-07-03 16:30,193,96,97,0,0,0
2020-07-03 16:45,207,104,103,0,0,0
2020-07-03 17:00,160,84,76,0,0,0
2020-07-03 17:15,207,115,92,0,0,0
2020-07-03 17:30,185,100,85,0,0,0
2020-07-03 17:45,211,121,90,0,0,0
2020-07-03 18:00,217,108,109,0,0,0
2020-07-03 18:15,191,76,115,0,0,0
2020-07-03 18:30,169,94,75,0,0,0
2020-07-03 18:45,232,151,81,0,0,0
2020-07-03 19:00,216,115,101,0,0,0
2020-07-03 19:15,222,140,82,0,0,0
2020-07-03 19:30,196,100,96,0,0,0
2020-07-03 19:45,173,107,66,0,0,0
2020-07-03 20:00,166,85,81,0,0,0
2020-07-03 20:15,146,72,74,0,0,0
2020-07-03 20:30,131,71,60,0,0,0
2020-07-03 20:45,135,62,73,0,0,0
2020-07-03 21:00,84,42,42,0,0,0
2020-07-03 21:15,129,70,59,0,0,0
2020-07-03 21:30,87,42,45,0,0,0
2020-07-03 21:45,86,41,45,0,0,0
2020-07-03 22:00,83,45,38,0,0,0
2020-07-03 22:15,103,44,59,0,0,0
2020-07-03 22:30,100,39,61,0,0,0
2020-07-03 22:45,72,21,51,0,0,0
2020-07-03 23:00,81,23,58,0,0,0
2020-07-03 23:15,85,35,50,0,0,0
2020-07-03 23:30,70,35,35,0,0,0
2020-07-03 23:45,77,34,43,0,0,0
2020-07-04 00:00,90,15,75,0,0,0
2020-07-04 00:15,111,43,68,0,0,0
2020-07-04 00:30,86,17,69,0,0,0
2020-07-04 00:45,104,33,71,0,0,0
2020-07-04 01:00,61,19,42,0,0,0
2020-07-04 01:15,78,29,49,0,0,0
2020-07-04 01:30,65,26,39,0,0,0
2020-07-04 01:45,57,16,41,0,0,0
2020-07-04 02:00,37,3,34,0,0,0
2020-07-04 02:15,42,8,34,0,0,0
2020-07-04 02:30,61,31,30,0,0,0
2020-07-04 02:45,40,11,29,0,0,0
2020-07-04 03:00,34,10,24,0,0,0
2020-07-04 03:15,52,16,36,0,0,0
2020-07-04 03:30,41,1,40,0,0,0
2020-07-04 03:45,39,10,29,0,0,0
2020-07-04 04:00,22,4,18,0,0,0
2020-07-04 04:15,21,5,16,0,0,0
2020-07-04 04:30,15,7,8,0,0,0
2020-07-04 04:45,15,8,7,0,0,0
2020-07-04 05:00,13,5,8,0,0,0
2020-07-04 05:15,13,3,10,0,0,0
2020-07-04 05:30,16,10,6,0,0,0
2020-07-04 05:45,16,10,6,0,0,0
2020-07-04 06:00,6,0,6,0,0,0
2020-07-04 06:15,11,6,5,0,0,0
2020-07-04 06:30,16,14,2,0,0,0
2020-07-04 06:45,21,16,5,0,0,0
2020-07-04 07:00,24,9,15,0,0,0
2020-07-04 07:15,17,11,6,0,0,0
2020-07-04 07:30,21,14,7,0,0,0
2020-07-04 07:45,24,14,10,0,0,0
2020-07-04 08:00,35,23,12,0,0,0
2020-07-04 08:15,37,23,14,0,0,0
2020-07-04 08:30,44,28,16,0,0,0
2020-07-04 08:45,64,40,24,0,0,0
2020-07-04 09:00,50,40,10,0,0,0
2020-07-04 09:15,77,48,29,0,0,0
2020-07-04 09:30,100,67,33,0,0,0
2020-07-04 09:45,126,88,38,0,0,0
2020-07-04 10:00,95,57,38,0,0,0
2020-07-04 10:15,86,66,20,0,0,0
2020-07-04 10:30,124,67,57,0,0,0
2020-07-04 10:45,110,74,36,0,0,0
2020-07-04 11:00,104,68,36,0,0,0
2020-07-04 11:15,112,72,40,0,0,0
2020-07-04 11:30,124,63,61,0,0,0
2020-07-04 11:45,165,113,52,0,0,0
2020-07-04 12:00,146,82,64,0,0,0
2020-07-04 12:15,148,98,50,0,0,0
2020-07-04 12:30,142,98,44,0,0,0
2020-07-04 12:45,151,86,65,0,0,0
2020-07-04 13:00,149,86,63,0,0,0
2020-07-04 13:15,137,71,66,0,0,0
2020-07-04 13:30,183,91,92,0,0,0
2020-07-04 13:45,141,70,71,0,0,0
2020-07-04 14:00,125,70,55,0,0,0
2020-07-04 14:15,122,60,62,0,0,0
2020-07-04 14:30,141,56,85,0,0,0
2020-07-04 14:45,174,93,81,0,0,0
2020-07-04 15:00,135,57,78,0,0,0
2020-07-04 15:15,135,76,59,0,0,0
2020-07-04 15:30,120,55,65,0,0,0
2020-07-04 15:45,123,68,55,0,0,0
2020-07-04 16:00,104,46,58,0,0,0
2020-07-04 16:15,139,69,70,0,0,0
2020-07-04 16:30,147,73,74,0,0,0
2020-07-04 16:45,141,81,60,0,0,0
2020-07-04 17:00,120,66,54,0,0,0
2020-07-04 17:15,111,59,52,0,0,0
2020-07-04 17:30,119,52,67,0,0,0
2020-07-04 17:45,125,65,60,0,0,0
2020-07-04 18:00,138,67,71,0,0,0
2020-07-04 18:15,126,70,56,0,0,0
2020-07-04 18:30,123,64,59,0,0,0
2020-07-04 18:45,165,97,68,0,0,0
2020-07-04 19:00,124,67,57,0,0,0
2020-07-04 19:15,143,79,64,0,0,0
2020-07-04 19:30,135,73,62,0,0,0
2020-07-04 19:45,146,83,63,0,0,0
2020-07-04 20:00,113,60,53,0,0,0
2020-07-04 20:15,94,42,52,0,0,0
2020-07-04 20:30,102,35,67,0,0,0
2020-07-04 20:45,97,53,44,0,0,0
2020-07-04 21:00,63,36,27,0,0,0
2020-07-04 21:15,61,27,34,0,0,0
2020-07-04 21:30,44,28,16,0,0,0
2020-07-04 21:45,63,27,36,0,0,0
2020-07-04 22:00,67,24,43,0,0,0
2020-07-04 22:15,50,20,30,0,0,0
2020-07-04 22:30,64,21,43,0,0,0
2020-07-04 22:45,47,15,32,0,0,0
2020-07-04 23:00,64,29,35,0,0,0
2020-07-04 23:15,76,36,40,0,0,0
2020-07-04 23:30,58,26,32,0,0,0
2020-07-04 23:45,69,33,36,0,0,0
2020-07-05 00:00,78,30,48,0,0,0
2020-07-05 00:15,64,24,40,0,0,0
2020-07-05 00:30,62,21,41,0,0,0
2020-07-05 00:45,48,19,29,0,0,0
2020-07-05 01:00,72,24,48,0,0,0
2020-07-05 01:15,51,22,29,0,0,0
2020-07-05 01:30,30,8,22,0,0,0
2020-07-05 01:45,52,21,31,0,0,0
2020-07-05 02:00,43,12,31,0,0,0
2020-07-05 02:15,30,9,21,0,0,0
2020-07-05 02:30,32,12,20,0,0,0
2020-07-05 02:45,25,5,20,0,0,0
2020-07-05 03:00,23,6,17,0,0,0
2020-07-05 03:15,23,11,12,0,0,0
2020-07-05 03:30,31,14,17,0,0,0
2020-07-05 03:45,26,11,15,0,0,0
2020-07-05 04:00,8,4,4,0,0,0
2020-07-05 04:15,9,1,8,0,0,0
2020-07-05 04:30,10,3,7,0,0,0
2020-07-05 04:45,8,3,5,0,0,0
2020-07-05 05:00,8,5,3,0,0,0
2020-07-05 05:15,9,2,7,0,0,0
2020-07-05 05:30,7,3,4,0,0,0
2020-07-05 05:45,15,6,9,0,0,0
2020-07-05 06:00,9,7,2,0,0,0
2020-07-05 06:15,3,3,0,0,0,0
2020-07-05 06:30,5,1,4,0,0,0
2020-07-05 06:45,9,6,3,0,0,0
2020-07-05 07:00,8,6,2,0,0,0
2020-07-05 07:15,8,2,6,0,0,0
2020-07-05 07:30,16,6,10,0,0,0
2020-07-05 07:45,11,6,5,0,0,0
2020-07-05 08:00,10,3,7,0,0,0
2020-07-05 08:15,8,5,3,0,0,0
2020-07-05 08:30,14,6,8,0,0,0
2020-07-05 08:45,18,15,3,0,0,0
2020-07-05 09:00,23,14,9,0,0,0
2020-07-05 09:15,21,11,10,0,0,0
2020-07-05 09:30,42,23,19,0,0,0
2020-07-05 09:45,58,41,17,0,0,0
2020-07-05 10:00,59,33,26,0,0,0
2020-07-05 10:15,55,36,19,0,0,0
2020-07-05 10:30,52,35,17,0,0,0
2020-07-05 10:45,70,49,21,0,0,0
2020-07-05 11:00,49,36,13,0,0,0
2020-07-05 11:15,60,30,30,0,0,0
2020-07-05 11:30,79,45,34,0,0,0
2020-07-05 11:45,68,36,32,0,0,0
2020-07-05 12:00,97,56,41,0,0,0
2020-07-05 12:15,73,39,34,0,0,0
2020-07-05 12:30,79,43,36,0,0,0
2020-07-05 12:45,72,45,27,0,0,0
2020-07-05 13:00,83,47,36,0,0,0
2020-07-05 13:15,60,30,30,0,0,0
2020-07-05 13:30,75,47,28,0,0,0
2020-07-05 13:45,83,53,30,0,0,0
2020-07-05 14:00,63,35,28,0,0,0
2020-07-05 14:15,75,35,40,0,0,0
2020-07-05 14:30,71,28,43,0,0,0
2020-07-05 14:45,86,63,23,0,0,0
2020-07-05 15:00,62,34,28,0,0,0
2020-07-05 15:15,50,27,23,0,0,0
2020-07-05 15:30,84,46,38,0,0,0
2020-07-05 15:45,77,46,31,0,0,0
2020-07-05 16:00,92,51,41,0,0,0
2020-07-05 16:15,67,37,30,0,0,0
2020-07-05 16:30,94,46,48,0,0,0
2020-07-05 16:45,80,48,32,0,0,0
2020-07-05 17:00,88,35,53,0,0,0
2020-07-05 17:15,75,43,32,0,0,0
2020-07-05 17:30,89,48,41,0,0,0
2020-07-05 17:45,97,52,45,0,0,0
2020-07-05 18:00,88,36,52,0,0,0
2020-07-05 18:15,126,64,62,0,0,0
2020-07-05 18:30,102,54,48,0,0,0
2020-07-05 18:45,108,68,40,0,0,0
2020-07-05 19:00,91,52,39,0,0,0
2020-07-05 19:15,88,42,46,0,0,0
2020-07-05 19:30,93,55,38,0,0,0
2020-07-05 19:45,107,58,49,0,0,0
2020-07-05 20:00,78,38,40,0,0,0
2020-07-05 20:15,68,33,35,0,0,0
2020-07-05 20:30,64,27,37,0,0,0
2020-07-05 20:45,67,32,35,0,0,0
2020-07-05 21:00,66,26,40,0,0,0
2020-07-05 21:15,55,23,32,0,0,0
2020-07-05 21:30,46,18,28,0,0,0
2020-07-05 21:45,63,26,37,0,0,0
2020-07-05 22:00,72,27,45,0,0,0
2020-07-05 22:15,45,15,30,0,0,0
2020-07-05 22:30,48,14,34,0,0,0
2020-07-05 22:45,52,20,32,0,0,0
2020-07-05 23:00,50,19,31,0,0,0
2020-07-05 23:15,30,22,8,0,0,0
2020-07-05 23:30,41,13,28,0,0,0
2020-07-05 23:45,35,9,26,0,0,0
2020-07-06 00:00,24,8,16,0,0,0
2020-07-06 00:15,29,12,17,0,0,0
2020-07-06 00:30,20,7,13,0,0,0
2020-07-06 00:45,23,9,14,0,0,0
2020-07-06 01:00,12,4,8,0,0,0
2020-07-06 01:15,12,4,8,0,0,0
2020-07-06 01:30,10,4,6,0,0,0
2020-07-06 01:45,5,3,2,0,0,0
2020-07-06 02:00,11,8,3,0,0,0
2020-07-06 02:15,7,2,5,0,0,0
2020-07-06 02:30,5,0,5,0,0,0
2020-07-06 02:45,6,2,4,0,0,0
2020-07-06 03:00,2,1,1,0,0,0
2020-07-06 03:15,4,4,0,0,0,0
2020-07-06 03:30,4,0,4,0,0,0
2020-07-06 03:45,3,2,1,0,0,0
2020-07-06 04:00,1,1,0,0,0,0
2020-07-06 04:15,2,0,2,0,0,0
2020-07-06 04:30,7,5,2,0,0,0
2020-07-06 04:45,9,7,2,0,0,0
2020-07-06 05:00,7,5,2,0,0,0
2020-07-06 05:15,10,9,1,0,0,0
2020-07-06 05:30,16,10,6,0,0,0
2020-07-06 05:45,28,22,6,0,0,0
2020-07-06 06:00,18,13,5,0,0,0
2020-07-06 06:15,43,26,17,0,0,0
2020-07-06 06:30,56,34,22,0,0,0
2020-07-06 06:45,87,55,32,0,0,0
2020-07-06 07:00,82,53,29,0,0,0
2020-07-06 07:15,101,62,39,0,0,0
2020-07-06 07:30,147,83,64,0,0,0
2020-07-06 07:45,142,79,63,0,0,0
2020-07-06 08:00,153,76,77,0,0,0
2020-07-06 08:15,128,80,48,0,0,0
2020-07-06 08:30,176,106,70,0,0,0
2020-07-06 08:45,172,114,58,0,0,0
2020-07-06 09:00,119,72,47,0,0,0
2020-07-06 09:15,111,69,42,0,0,0
2020-07-06 09:30,123,73,50,0,0,0
2020-07-06 09:45,175,105,70,0,0,0
2020-07-06 10:00,144,83,61,0,0,0
2020-07-06 10:15,112,66,46,0,0,0
2020-07-06 10:30,120,59,61,0,0,0
2020-07-06 10:45,128,72,56,0,0,0
2020-07-06 11:00,106,54,52,0,0,0
2020-07-06 11:15,110,53,57,0,0,0
2020-07-06 11:30,125,66,59,0,0,0
2020-07-06 11:45,126,74,52,0,0,0
2020-07-06 12:00,163,90,73,0,0,0
2020-07-06 12:15,156,89,67,0,0,0
2020-07-06 12:30,188,96,92,0,0,0
2020-07-06 12:45,174,87,87,0,0,0
2020-07-06 13:00,86,49,37,0,0,0
2020-07-06 13:15,113,51,62,0,0,0
2020-07-06 13:30,113,53,60,0,0,0
2020-07-06 13:45,151,83,68,0,0,0
2020-07-06 14:00,143,64,79,0,0,0
2020-07-06 14:15,134,70,64,0,0,0
2020-07-06 14:30,147,78,69,0,0,0
2020-07-06 14:45,146,84,62,0,0,0
2020-07-06 15:00,136,76,60,0,0,0
2020-07-06 15:15,154,81,73,0,0,0
2020-07-06 15:30,144,69,75,0,0,0
2020-07-06 15:45,149,79,70,0,0,0
2020-07-06 16:00,197,94,103,0,0,0
2020-07-06 16:15,206,101,105,0,0,0
2020-07-06 16:30,227,101,126,0,0,0
2020-07-06 16:45,184,91,93,0,0,0
2020-07-06 17:00,176,84,92,0,0,0
2020-07-06 17:15,161,68,93,0,0,0
2020-07-06 17:30,200,98,102,0,0,0
2020-07-06 17:45,170,86,84,0,0,0
2020-07-06 18:00,203,102,101,0,0,0
2020-07-06 18:15,184,108,76,0,0,0
2020-07-06 18:30,136,62,74,0,0,0
2020-07-06 18:45,182,105,77,0,0,0
2020-07-06 19:00,172,97,75,0,0,0
2020-07-06 19:15,174,107,67,0,0,0
2020-07-06 19:30,146,81,65,0,0,0
2020-07-06 19:45,109,59,50,0,0,0
2020-07-06 20:00,132,76,56,0,0,0
2020-07-06 20:15,127,67,60,0,0,0
2020-07-06 20:30,79,38,41,0,0,0
2020-07-06 20:45,77,35,42,0,0,0
2020-07-06 21:00,57,25,32,0,0,0
2020-07-06 21:15,74,43,31,0,0,0
2020-07-06 21:30,64,24,40,0,0,0
2020-07-06 21:45,75,32,43,0,0,0
2020-07-06 22:00,60,24,36,0,0,0
2020-07-06 22:15,64,18,46,0,0,0
2020-07-06 22:30,62,17,45,0,0,0
2020-07-06 22:45,58,30,28,0,0,0
2020-07-06 23:00,68,31,37,0,0,0
2020-07-06 23:15,44,14,30,0,0,0
2020-07-06 23:30,53,19,34,0,0,0
2020-07-06 23:45,33,10,23,0,0,0
2020-07-07 00:00,35,17,18,0,0,0
2020-07-07 00:15,28,6,22,0,0,0
2020-07-07 00:30,19,5,14,0,0,0
2020-07-07 00:45,17,9,8,0,0,0
2020-07-07 01:00,14,6,8,0,0,0
2020-07-07 01:15,7,3,4,0,0,0
2020-07-07 01:30,12,2,10,0,0,0
2020-07-07 01:45,6,3,3,0,0,0
2020-07-07 02:00,4,1,3,0,0,0
2020-07-07 02:15,4,2,2,0,0,0
2020-07-07 02:30,4,3,1,0,0,0
2020-07-07 02:45,5,2,3,0,0,0
2020-07-07 03:00,5,1,4,0,0,0
2020-07-07 03:15,5,1,4,0,0,0
2020-07-07 03:30,6,3,3,0,0,0
2020-07-07 03:45,4,1,3,0,0,0
2020-07-07 04:00,3,1,2,0,0,0
2020-07-07 04:15,9,4,5,0,0,0
2020-07-07 04:30,11,9,2,0,0,0
2020-07-07 04:45,13,7,6,0,0,0
2020-07-07 05:00,7,4,3,0,0,0
2020-07-07 05:15,6,6,0,0,0,0
2020-07-07 05:30,27,17,10,0,0,0
2020-07-07 05:45,35,26,9,0,0,0
2020-07-07 06:00,35,22,13,0,0,0
2020-07-07 06:15,45,29,16,0,0,0
2020-07-07 06:30,46,26,20,0,0,0
2020-07-07 06:45,80,50,30,0,0,0
2020-07-07 07:00,109,76,33,0,0,0
2020-07-07 07:15,107,67,40,0,0,0
2020-07-07 07:30,174,102,72,0,0,0
2020-07-07 07:45,187,111,76,0,0,0
2020-07-07 08:00,154,83,71,0,0,0
2020-07-07 08:15,159,91,68,0,0,0
2020-07-07 08:30,162,91,71,0,0,0
2020-07-07 08:45,197,137,60,0,0,0
2020-07-07 09:00,144,92,52,0,0,0
2020-07-07 09:15,123,77,46,0,0,0
2020-07-07 09:30,161,98,63,0,0,0
2020-07-07 09:45,166,101,65,0,0,0
2020-07-07 10:00,139,76,63,0,0,0
2020-07-07 10:15,130,73,57,0,0,0
2020-07-07 10:30,130,75,55,0,0,0
2020-07-07 10:45,123,68,55,0,0,0
2020-07-07 11:00,116,56,60,0,0,0
2020-07-07 11:15,120,70,50,0,0,0
2020-07-07 11:30,152,95,57,0,0,0
2020-07-07 11:45,167,101,66,0,0,0
2020-07-07 12:00,147,80,67,0,0,0
2020-07-07 12:15,130,71,59,0,0,0
2020-07-07 12:30,151,77,74,0,0,0
2020-07-07 12:45,183,101,82,0,0,0
2020-07-07 13:00,188,93,95,0,0,0
2020-07-07 13:15,163,97,66,0,0,0
2020-07-07 13:30,186,102,84,0,0,0
2020-07-07 13:45,224,126,98,0,0,0
2020-07-07 14:00,193,82,111,0,0,0
2020-07-07 14:15,178,97,81,0,0,0
2020-07-07 14:30,147,63,84,0,0,0
2020-07-07 14:45,156,85,71,0,0,0
2020-07-07 15:00,165,82,83,0,0,0
2020-07-07 15:15,176,101,75,0,0,0
2020-07-07 15:30,131,65,66,0,0,0
2020-07-07 15:45,218,134,84,0,0,0
2020-07-07 16:00,223,113,110,0,0,0
2020-07-07 16:15,192,94,98,0,0,0
2020-07-07 16:30,199,95,104,0,0,0
2020-07-07 16:45,248,132,116,0,0,0
2020-07-07 17:00,227,97,130,0,0,0
2020-07-07 17:15,250,124,126,0,0,0
2020-07-07 17:30,253,122,131,0,0,0
2020-07-07 17:45,244,128,116,0,0,0
2020-07-07 18:00,235,105,130,0,0,0
2020-07-07 18:15,195,101,94,0,0,0
2020-07-07 18:30,179,86,93,0,0,0
2020-07-07 18:45,224,116,108,0,0,0
2020-07-07 19:00,189,91,98,0,0,0
2020-07-07 19:15,176,102,74,0,0,0
2020-07-07 19:30,154,68,86,0,0,0
2020-07-07 19:45,172,102,70,0,0,0
2020-07-07 20:00,163,73,90,0,0,0
2020-07-07 20:15,144,66,78,0,0,0
2020-07-07 20:30,81,37,44,0,0,0
2020-07-07 20:45,116,49,67,0,0,0
2020-07-07 21:00,101,50,51,0,0,0
2020-07-07 21:15,105,46,59,0,0,0
2020-07-07 21:30,105,57,48,0,0,0
2020-07-07 21:45,94,41,53,0,0,0
2020-07-07 22:00,82,40,42,0,0,0
2020-07-07 22:15,84,29,55,0,0,0
2020-07-07 22:30,52,23,29,0,0,0
2020-07-07 22:45,72,27,45,0,0,0
2020-07-07 23:00,57,19,38,0,0,0
2020-07-07 23:15,65,17,48,0,0,0
2020-07-07 23:30,55,18,37,0,0,0
2020-07-07 23:45,38,22,16,0,0,0
2020-07-08 00:00,44,11,33,0,0,0
2020-07-08 00:15,22,9,13,0,0,0
2020-07-08 00:30,13,10,3,0,0,0
2020-07-08 00:45,24,7,17,0,0,0
2020-07-08 01:00,16,8,8,0,0,0
2020-07-08 01:15,15,4,11,0,0,0
2020-07-08 01:30,11,3,8,0,0,0
2020-07-08 01:45,22,7,15,0,0,0
2020-07-08 02:00,7,0,7,0,0,0
2020-07-08 02:15,12,6,6,0,0,0
2020-07-08 02:30,8,1,7,0,0,0
2020-07-08 02:45,9,3,6,0,0,0
2020-07-08 03:00,0,0,0,0,0,0
2020-07-08 03:15,10,2,8,0,0,0
2020-07-08 03:30,4,1,3,0,0,0
2020-07-08 03:45,8,3,5,0,0,0
2020-07-08 04:00,4,1,3,0,0,0
2020-07-08 04:15,7,5,2,0,0,0
2020-07-08 04:30,3,3,0,0,0,0
2020-07-08 04:45,9,5,4,0,0,0
2020-07-08 05:00,7,5,2,0,0,0
2020-07-08 05:15,8,7,1,0,0,0
2020-07-08 05:30,19,13,6,0,0,0
2020-07-08 05:45,36,29,7,0,0,0
2020-07-08 06:00,16,10,6,0,0,0
2020-07-08 06:15,47,22,25,0,0,0
2020-07-08 06:30,47,25,22,0,0,0
2020-07-08 06:45,75,55,20,0,0,0
2020-07-08 07:00,64,35,29,0,0,0
2020-07-08 07:15,76,43,33,0,0,0
2020-07-08 07:30,138,92,46,0,0,0
2020-07-08 07:45,152,91,61,0,0,0
2020-07-08 08:00,127,71,56,0,0,0
2020-07-08 08:15,163,85,78,0,0,0
2020-07-08 08:30,145,74,71,0,0,0
2020-07-08 08:45,182,126,56,0,0,0
2020-07-08 09:00,119,69,50,0,0,0
2020-07-08 09:15,101,60,41,0,0,0
2020-07-08 09:30,123,75,48,0,0,0
2020-07-08 09:45,145,95,50,0,0,0
2020-07-08 10:00,118,68,50,0,0,0
2020-07-08 10:15,93,61,32,0,0,0
2020-07-08 10:30,102,49,53,0,0,0
2020-07-08 10:45,130,72,58,0,0,0
2020-07-08 11:00,107,57,50,0,0,0
2020-07-08 11:15,128,76,52,0,0,0
2020-07-08 11:30,136,72,64,0,0,0
2020-07-08 11:45,135,72,63,0,0,0
2020-07-08 12:00,117,59,58,0,0,0
2020-07-08 12:15,130,67,63,0,0,0
2020-07-08 12:30,128,74,54,0,0,0
2020-07-08 12:45,128,72,56,0,0,0
2020-07-08 13:00,128,63,65,0,0,0
2020-07-08 13:15,147,75,72,0,0,0
2020-07-08 13:30,176,88,88,0,0,0
2020-07-08 13:45,203,112,91,0,0,0
2020-07-08 14:00,140,71,69,0,0,0
2020-07-08 14:15,141,76,65,0,0,0
2020-07-08 14:30,172,91,81,0,0,0
2020-07-08 14:45,172,86,86,0,0,0
2020-07-08 15:00,160,86,74,0,0,0
2020-07-08 15:15,157,94,63,0,0,0
2020-07-08 15:30,155,71,84,0,0,0
2020-07-08 15:45,149,77,72,0,0,0
2020-07-08 16:00,158,63,95,0,0,0
2020-07-08 16:15,169,81,88,0,0,0
2020-07-08 16:30,163,65,98,0,0,0
2020-07-08 16:45,186,88,98,0,0,0
2020-07-08 17:00,206,95,111,0,0,0
2020-07-08 17:15,175,81,94,0,0,0
2020-07-08 17:30,187,93,94,0,0,0
2020-07-08 17:45,250,110,140,0,0,0
2020-07-08 18:00,234,92,142,0,0,0
2020-07-08 18:15,167,77,90,0,0,0
2020-07-08 18:30,160,71,89,0,0,0
2020-07-08 18:45,179,89,90,0,0,0
2020-07-08 19:00,180,89,91,0,0,0
2020-07-08 19:15,185,90,95,0,0,0
2020-07-08 19:30,172,80,92,0,0,0
2020-07-08 19:45,163,71,92,0,0,0
2020-07-08 20:00,164,83,81,0,0,0
2020-07-08 20:15,113,51,62,0,0,0
2020-07-08 20:30,109,55,54,0,0,0
2020-07-08 20:45,111,54,57,0,0,0
2020-07-08 21:00,88,41,47,0,0,0
2020-07-08 21:15,80,25,55,0,0,0
2020-07-08 21:30,71,27,44,0,0,0
2020-07-08 21:45,88,33,55,0,0,0
2020-07-08 22:00,70,25,45,0,0,0
2020-07-08 22:15,92,39,53,0,0,0
2020-07-08 22:30,72,27,45,0,0,0
2020-07-08 22:45,52,18,34,0,0,0
2020-07-08 23:00,73,29,44,0,0,0
2020-07-08 23:15,63,24,39,0,0,0
2020-07-08 23:30,60,26,34,0,0,0
2020-07-08 23:45,64,24,40,0,0,0
2020-07-09 00:00,50,18,32,0,0,0
2020-07-09 00:15,34,16,18,0,0,0
2020-07-09 00:30,34,14,20,0,0,0
2020-07-09 00:45,19,8,11,0,0,0
2020-07-09 01:00,23,5,18,0,0,0
2020-07-09 01:15,26,9,17,0,0,0
2020-07-09 01:30,33,6,27,0,0,0
2020-07-09 01:45,18,10,8,0,0,0
2020-07-09 02:00,29,6,23,0,0,0
2020-07-09 02:15,23,4,19,0,0,0
2020-07-09 02:30,25,4,21,0,0,0
2020-07-09 02:45,25,2,23,0,0,0
2020-07-09 03:00,17,3,14,0,0,0
2020-07-09 03:15,13,5,8,0,0,0
2020-07-09 03:30,7,3,4,0,0,0
2020-07-09 03:45,3,1,2,0,0,0
2020-07-09 04:00,5,2,3,0,0,0
2020-07-09 04:15,7,6,1,0,0,0
2020-07-09 04:30,8,5,3,0,0,0
2020-07-09 04:45,9,7,2,0,0,0
2020-07-09 05:00,2,1,1,0,0,0
2020-07-09 05:15,10,6,4,0,0,0
2020-07-09 05:30,31,19,12,0,0,0
2020-07-09 05:45,27,18,9,0,0,0
2020-07-09 06:00,21,14,7,0,0,0
2020-07-09 06:15,39,22,17,0,0,0
2020-07-09 06:30,46,25,21,0,0,0
2020-07-09 06:45,56,36,20,0,0,0
2020-07-09 07:00,48,31,17,0,0,0
2020-07-09 07:15,61,36,25,0,0,0
2020-07-09 07:30,112,53,59,0,0,0
2020-07-09 07:45,138,78,60,0,0,0
2020-07-09 08:00,115,57,58,0,0,0
2020-07-09 08:15,114,58,56,0,0,0
2020-07-09 08:30,122,75,47,0,0,0
2020-07-09 08:45,155,113,42,0,0,0
2020-07-09 09:00,115,69,46,0,0,0
2020-07-09 09:15,114,75,39,0,0,0
2020-07-09 09:30,115,63,52,0,0,0
2020-07-09 09:45,115,76,39,0,0,0
2020-07-09 10:00,87,43,44,0,0,0
2020-07-09 10:15,113,57,56,0,0,0
2020-07-09 10:30,110,66,44,0,0,0
2020-07-09 10:45,116,62,54,0,0,0
2020-07-09 11:00,86,60,26,0,0,0
2020-07-09 11:15,106,61,45,0,0,0
2020-07-09 11:30,101,55,46,0,0,0
2020-07-09 11:45,104,62,42,0,0,0
2020-07-09 12:00,129,62,67,0,0,0
2020-07-09 12:15,111,59,52,0,0,0
2020-07-09 12:30,132,62,70,0,0,0
2020-07-09 12:45,148,76,72,0,0,0
2020-07-09 13:00,113,58,55,0,0,0
2020-07-09 13:15,126,74,52,0,0,0
2020-07-09 13:30,143,71,72,0,0,0
2020-07-09 13:45,159,83,76,0,0,0
2020-07-09 14:00,143,76,67,0,0,0
2020-07-09 14:15,161,84,77,0,0,0
2020-07-09 14:30,124,63,61,0,0,0
2020-07-09 14:45,119,73,46,0,0,0
2020-07-09 15:00,124,64,60,0,0,0
2020-07-09 15:15,148,86,62,0,0,0
2020-07-09 15:30,120,61,59,0,0,0
2020-07-09 15:45,162,68,94,0,0,0
2020-07-09 16:00,171,77,94,0,0,0
2020-07-09 16:15,151,75,76,0,0,0
2020-07-09 16:30,151,79,72,0,0,0
2020-07-09 16:45,152,78,74,0,0,0
2020-07-09 17:00,178,76,102,0,0,0
2020-07-09 17:15,163,74,89,0,0,0
2020-07-09 17:30,197,82,115,0,0,0
2020-07-09 17:45,219,101,118,0,0,0
2020-07-09 18:00,200,78,122,0,0,0
2020-07-09 18:15,162,75,87,0,0,0
2020-07-09 18:30,150,75,75,0,0,0
2020-07-09 18:45,165,78,87,0,0,0
2020-07-09 19:00,157,74,83,0,0,0
2020-07-09 19:15,145,82,63,0,0,0
2020-07-09 19:30,138,67,71,0,0,0
2020-07-09 19:45,142,65,77,0,0,0
2020-07-09 20:00,99,52,47,0,0,0
2020-07-09 20:15,118,58,60,0,0,0
2020-07-09 20:30,84,44,40,0,0,0
2020-07-09 20:45,76,43,33,0,0,0
2020-07-09 21:00,76,32,44,0,0,0
2020-07-09 21:15,72,26,46,0,0,0
2020-07-09 21:30,48,12,36,0,0,0
2020-07-09 21:45,51,27,24,0,0,0
2020-07-09 22:00,57,22,35,0,0,0
2020-07-09 22:15,72,29,43,0,0,0
2020-07-09 22:30,68,25,43,0,0,0
2020-07-09 22:45,54,19,35,0,0,0
2020-07-09 23:00,59,18,41,0,0,0
2020-07-09 23:15,53,22,31,0,0,0
2020-07-09 23:30,44,10,34,0,0,0
2020-07-09 23:45,60,17,43,0,0,0
2020-07-10 00:00,18,14,4,0,0,0
2020-07-10 00:15,21,8,13,0,0,0
2020-07-10 00:30,38,15,23,0,0,0
2020-07-10 00:45,13,4,9,0,0,0
2020-07-10 01:00,25,11,14,0,0,0
2020-07-10 01:15,24,5,19,0,0,0
2020-07-10 01:30,20,3,17,0,0,0
2020-07-10 01:45,16,3,13,0,0,0
2020-07-10 02:00,10,3,7,0,0,0
2020-07-10 02:15,16,7,9,0,0,0
2020-07-10 02:30,5,4,1,0,0,0
2020-07-10 02:45,11,5,6,0,0,0
2020-07-10 03:00,8,3,5,0,0,0
2020-07-10 03:15,1,0,1,0,0,0
2020-07-10 03:30,7,6,1,0,0,0
2020-07-10 03:45,5,2,3,0,0,0
2020-07-10 04:00,6,1,5,0,0,0
2020-07-10 04:15,4,3,1,0,0,0
2020-07-10 04:30,9,4,5,0,0,0
2020-07-10 04:45,13,4,9,0,0,0
2020-07-10 05:00,3,1,2,0,0,0
2020-07-10 05:15,10,7,3,0,0,0
2020-07-10 05:30,17,9,8,0,0,0
2020-07-10 05:45,28,22,6,0,0,0
2020-07-10 06:00,25,15,10,0,0,0
2020-07-10 06:15,50,28,22,0,0,0
2020-07-10 06:30,49,34,15,0,0,0
2020-07-10 06:45,64,40,24,0,0,0
2020-07-10 07:00,89,54,35,0,0,0
2020-07-10 07:15,73,44,29,0,0,0
2020-07-10 07:30,130,60,70,0,0,0
2020-07-10 07:45,135,76,59,0,0,0
2020-07-10 08:00,121,67,54,0,0,0
2020-07-10 08:15,126,86,40,0,0,0
2020-07-10 08:30,138,66,72,0,0,0
2020-07-10 08:45,153,108,45,0,0,0
2020-07-10 09:00,125,77,48,0,0,0
2020-07-10 09:15,122,73,49,0,0,0
2020-07-10 09:30,147,88,59,0,0,0
2020-07-10 09:45,172,107,65,0,0,0
2020-07-10 10:00,116,68,48,0,0,0
2020-07-10 10:15,108,79,29,0,0,0
2020-07-10 10:30,95,53,42,0,0,0
2020-07-10 10:45,131,86,45,0,0,0
2020-07-10 11:00,97,56,41,0,0,0
2020-07-10 11:15,105,62,43,0,0,0
2020-07-10 11:30,114,61,53,0,0,0
2020-07-10 11:45,141,68,73,0,0,0
2020-07-10 12:00,120,71,49,0,0,0
2020-07-10 12:15,131,76,55,0,0,0
2020-07-10 12:30,184,101,83,0,0,0
2020-07-10 12:45,211,119,92,0,0,0
2020-07-10 13:00,159,77,82,0,0,0
2020-07-10 13:15,142,84,58,0,0,0
2020-07-10 13:30,139,74,65,0,0,0
2020-07-10 13:45,181,113,68,0,0,0
2020-07-10 14:00,158,89,69,0,0,0
2020-07-10 14:15,153,75,78,0,0,0
2020-07-10 14:30,136,71,65,0,0,0
2020-07-10 14:45,161,91,70,0,0,0
2020-07-10 15:00,139,74,65,0,0,0
2020-07-10 15:15,175,99,76,0,0,0
2020-07-10 15:30,162,82,80,0,0,0
2020-07-10 15:45,191,107,84,0,0,0
2020-07-10 16:00,167,102,65,0,0,0
2020-07-10 16:15,164,79,85,0,0,0
2020-07-10 16:30,148,84,64,0,0,0
2020-07-10 16:45,172,89,83,0,0,0
2020-07-10 17:00,181,76,105,0,0,0
2020-07-10 17:15,183,91,92,0,0,0
2020-07-10 17:30,164,85,79,0,0,0
2020-07-10 17:45,208,93,115,0,0,0
2020-07-10 18:00,192,92,100,0,0,0
2020-07-10 18:15,168,81,87,0,0,0
2020-07-10 18:30,149,67,82,0,0,0
2020-07-10 18:45,180,98,82,0,0,0
2020-07-10 19:00,145,81,64,0,0,0
2020-07-10 19:15,183,108,75,0,0,0
2020-07-10 19:30,130,82,48,0,0,0
2020-07-10 19:45,135,79,56,0,0,0
2020-07-10 20:00,112,59,53,0,0,0
2020-07-10 20:15,115,64,51,0,0,0
2020-07-10 20:30,92,48,44,0,0,0
2020-07-10 20:45,102,59,43,0,0,0
2020-07-10 21:00,94,49,45,0,0,0
2020-07-10 21:15,64,38,26,0,0,0
2020-07-10 21:30,77,38,39,0,0,0
2020-07-10 21:45,65,28,37,0,0,0
2020-07-10 22:00,85,42,43,0,0,0
2020-07-10 22:15,69,36,33,0,0,0
2020-07-10 22:30,63,26,37,0,0,0
2020-07-10 22:45,64,20,44,0,0,0
2020-07-10 23:00,72,20,52,0,0,0
2020-07-10 23:15,69,17,52,0,0,0
2020-07-10 23:30,58,19,39,0,0,0
2020-07-10 23:45,75,29,46,0,0,0
2020-07-11 00:00,59,11,48,0,0,0
2020-07-11 00:15,65,26,39,0,0,0
2020-07-11 00:30,60,18,42,0,0,0
2020-07-11 00:45,63,21,42,0,0,0
2020-07-11 01:00,74,25,49,0,0,0
2020-07-11 01:15,70,30,40,0,0,0
2020-07-11 01:30,49,13,36,0,0,0
2020-07-11 01:45,48,19,29,0,0,0
2020-07-11 02:00,36,7,29,0,0,0
2020-07-11 02:15,39,12,27,0,0,0
2020-07-11 02:30,30,5,25,0,0,0
2020-07-11 02:45,25,5,20,0,0,0
2020-07-11 03:00,26,7,19,0,0,0
2020-07-11 03:15,22,5,17,0,0,0
2020-07-11 03:30,28,7,21,0,0,0
2020-07-11 03:45,25,4,21,0,0,0
2020-07-11 04:00,7,3,4,0,0,0
2020-07-11 04:15,31,3,28,0,0,0
2020-07-11 04:30,22,12,10,0,0,0
2020-07-11 04:45,10,4,6,0,0,0
2020-07-11 05:00,10,6,4,0,0,0
2020-07-11 05:15,9,3,6,0,0,0
2020-07-11 05:30,14,7,7,0,0,0
2020-07-11 05:45,20,10,10,0,0,0
2020-07-11 06:00,8,6,2,0,0,0
2020-07-11 06:15,12,9,3,0,0,0
2020-07-11 06:30,12,5,7,0,0,0
2020-07-11 06:45,15,10,5,0,0,0
2020-07-11 07:00,20,12,8,0,0,0
2020-07-11 07:15,22,19,3,0,0,0
2020-07-11 07:30,35,27,8,0,0,0
2020-07-11 07:45,54,37,17,0,0,0
2020-07-11 08:00,37,27,10,0,0,0
2020-07-11 08:15,59,35,24,0,0,0
2020-07-11 08:30,49,31,18,0,0,0
2020-07-11 08:45,56,34,22,0,0,0
2020-07-11 09:00,64,46,18,0,0,0
2020-07-11 09:15,78,53,25,0,0,0
2020-07-11 09:30,81,44,37,0,0,0
2020-07-11 09:45,104,69,35,0,0,0
2020-07-11 10:00,95,65,30,0,0,0
2020-07-11 10:15,132,79,53,0,0,0
2020-07-11 10:30,104,66,38,0,0,0
2020-07-11 10:45,140,84,56,0,0,0
2020-07-11 11:00,124,77,47,0,0,0
2020-07-11 11:15,133,73,60,0,0,0
2020-07-11 11:30,152,83,69,0,0,0
2020-07-11 11:45,177,96,81,0,0,0
2020-07-11 12:00,128,71,57,0,0,0
2020-07-11 12:15,171,116,55,0,0,0
2020-07-11 12:30,169,108,61,0,0,0
2020-07-11 12:45,185,115,70,0,0,0
2020-07-11 13:00,154,78,76,0,0,0
2020-07-11 13:15,165,84,81,0,0,0
2020-07-11 13:30,148,85,63,0,0,0
2020-07-11 13:45,163,89,74,0,0,0
2020-07-11 14:00,143,73,70,0,0,0
2020-07-11 14:15,139,73,66,0,0,0
2020-07-11 14:30,169,70,99,0,0,0
2020-07-11 14:45,186,84,102,0,0,0
2020-07-11 15:00,148,77,71,0,0,0
2020-07-11 15:15,156,77,79,0,0,0
2020-07-11 15:30,141,81,60,0,0,0
2020-07-11 15:45,189,91,98,0,0,0
2020-07-11 16:00,141,80,61,0,0,0
2020-07-11 16:15,139,73,66,0,0,0
2020-07-11 16:30,155,75,80,0,0,0
2020-07-11 16:45,125,52,73,0,0,0
2020-07-11 17:00,149,84,65,0,0,0
2020-07-11 17:15,131,64,67,0,0,0
2020-07-11 17:30,116,55,61,0,0,0
2020-07-11 17:45,185,88,97,0,0,0
2020-07-11 18:00,176,68,108,0,0,0
2020-07-11 18:15,150,88,62,0,0,0
2020-07-11 18:30,101,45,56,0,0,0
2020-07-11 18:45,143,99,44,0,0,0
2020-07-11 19:00,139,73,66,0,0,0
2020-07-11 19:15,158,86,72,0,0,0
2020-07-11 19:30,138,75,63,0,0,0
2020-07-11 19:45,134,64,70,0,0,0
2020-07-11 20:00,135,88,47,0,0,0
2020-07-11 20:15,147,78,69,0,0,0
2020-07-11 20:30,107,53,54,0,0,0
2020-07-11 20:45,102,55,47,0,0,0
2020-07-11 21:00,76,45,31,0,0,0
2020-07-11 21:15,76,34,42,0,0,0
2020-07-11 21:30,75,34,41,0,0,0
2020-07-11 21:45,66,24,42,0,0,0
2020-07-11 22:00,59,17,42,0,0,0
2020-07-11 22:15,66,27,39,0,0,0
2020-07-11 22:30,65,24,41,0,0,0
2020-07-11 22:45,92,35,57,0,0,0
2020-07-11 23:00,83,21,62,0,0,0
2020-07-11 23:15,71,26,45,0,0,0
2020-07-11 23:30,94,36,58,0,0,0
2020-07-11 23:45,75,28,47,0,0,0
2020-07-12 00:00,95,30,65,0,0,0
2020-07-12 00:15,71,31,40,0,0,0
2020-07-12 00:30,72,28,44,0,0,0
2020-07-12 00:45,67,33,34,0,0,0
2020-07-12 01:00,52,18,34,0,0,0
2020-07-12 01:15,72,21,51,0,0,0
2020-07-12 01:30,63,18,45,0,0,0
2020-07-12 01:45,48,10,38,0,0,0
2020-07-12 02:00,49,11,38,0,0,0
2020-07-12 02:15,36,8,28,0,0,0
2020-07-12 02:30,47,8,39,0,0,0
2020-07-12 02:45,32,6,26,0,0,0
2020-07-12 03:00,25,8,17,0,0,0
2020-07-12 03:15,27,7,20,0,0,0
2020-07-12 03:30,22,8,14,0,0,0
2020-07-12 03:45,17,2,15,0,0,0
2020-07-12 04:00,21,11,10,0,0,0
2020-07-12 04:15,9,2,7,0,0,0
2020-07-12 04:30,18,7,11,0,0,0
2020-07-12 04:45,5,1,4,0,0,0
2020-07-12 05:00,10,4,6,0,0,0
2020-07-12 05:15,5,3,2,0,0,0
2020-07-12 05:30,14,7,7,0,0,0
2020-07-12 05:45,9,3,6,0,0,0
2020-07-12 06:00,10,6,4,0,0,0
2020-07-12 06:15,11,5,6,0,0,0
2020-07-12 06:30,5,1,4,0,0,0
2020-07-12 06:45,8,4,4,0,0,0
2020-07-12 07:00,11,4,7,0,0,0
2020-07-12 07:15,6,3,3,0,0,0
2020-07-12 07:30,15,8,7,0,0,0
2020-07-12 07:45,11,7,4,0,0,0
2020-07-12 08:00,13,4,9,0,0,0
2020-07-12 08:15,19,9,10,0,0,0
2020-07-12 08:30,16,9,7,0,0,0
2020-07-12 08:45,25,12,13,0,0,0
2020-07-12 09:00,25,13,12,0,0,0
2020-07-12 09:15,37,20,17,0,0,0
2020-07-12 09:30,46,23,23,0,0,0
2020-07-12 09:45,59,33,26,0,0,0
2020-07-12 10:00,53,25,28,0,0,0
2020-07-12 10:15,50,35,15,0,0,0
2020-07-12 10:30,59,38,21,0,0,0
2020-07-12 10:45,80,41,39,0,0,0
2020-07-12 11:00,56,34,22,0,0,0
2020-07-12 11:15,61,34,27,0,0,0
2020-07-12 11:30,101,65,36,0,0,0
2020-07-12 11:45,95,47,48,0,0,0
2020-07-12 12:00,123,52,71,0,0,0
2020-07-12 12:15,96,65,31,0,0,0
2020-07-12 12:30,89,55,34,0,0,0
2020-07-12 12:45,115,71,44,0,0,0
2020-07-12 13:00,126,65,61,0,0,0
2020-07-12 13:15,100,57,43,0,0,0
2020-07-12 13:30,138,76,62,0,0,0
2020-07-12 13:45,129,76,53,0,0,0
2020-07-12 14:00,115,55,60,0,0,0
2020-07-12 14:15,136,73,63,0,0,0
2020-07-12 14:30,115,67,48,0,0,0
2020-07-12 14:45,173,111,62,0,0,0
2020-07-12 15:00,146,81,65,0,0,0
2020-07-12 15:15,131,68,63,0,0,0
2020-07-12 15:30,122,76,46,0,0,0
2020-07-12 15:45,147,82,65,0,0,0
2020-07-12 16:00,162,85,77,0,0,0
2020-07-12 16:15,146,82,64,0,0,0
2020-07-12 16:30,137,77,60,0,0,0
2020-07-12 16:45,143,56,87,0,0,0
2020-07-12 17:00,98,50,48,0,0,0
2020-07-12 17:15,133,66,67,0,0,0
2020-07-12 17:30,123,55,68,0,0,0
2020-07-12 17:45,148,69,79,0,0,0
2020-07-12 18:00,154,57,97,0,0,0
2020-07-12 18:15,139,73,66,0,0,0
2020-07-12 18:30,134,57,77,0,0,0
2020-07-12 18:45,151,76,75,0,0,0
2020-07-12 19:00,117,40,77,0,0,0
2020-07-12 19:15,98,45,53,0,0,0
2020-07-12 19:30,107,64,43,0,0,0
2020-07-12 19:45,128,67,61,0,0,0
2020-07-12 20:00,116,62,54,0,0,0
2020-07-12 20:15,79,40,39,0,0,0
2020-07-12 20:30,96,35,61,0,0,0
2020-07-12 20:45,97,40,57,0,0,0
2020-07-12 21:00,111,40,71,0,0,0
2020-07-12 21:15,69,29,40,0,0,0
2020-07-12 21:30,64,19,45,0,0,0
2020-07-12 21:45,67,28,39,0,0,0
2020-07-12 22:00,88,25,63,0,0,0
2020-07-12 22:15,63,22,41,0,0,0
2020-07-12 22:30,64,19,45,0,0,0
2020-07-12 22:45,54,17,37,0,0,0
2020-07-12 23:00,46,14,32,0,0,0
2020-07-12 23:15,39,16,23,0,0,0
2020-07-12 23:30,43,12,31,0,0,0
2020-07-12 23:45,27,7,20,0,0,0
2020-07-13 00:00,31,9,22,0,0,0
2020-07-13 00:15,20,7,13,0,0,0
2020-07-13 00:30,17,5,12,0,0,0
2020-07-13 00:45,10,5,5,0,0,0
2020-07-13 01:00,14,8,6,0,0,0
2020-07-13 01:15,11,1,10,0,0,0
2020-07-13 01:30,6,2,4,0,0,0
2020-07-13 01:45,6,1,5,0,0,0
2020-07-13 02:00,5,1,4,0,0,0
2020-07-13 02:15,3,2,1,0,0,0
2020-07-13 02:30,4,1,3,0,0,0
2020-07-13 02:45,2,0,2,0,0,0
2020-07-13 03:00,8,0,8,0,0,0
2020-07-13 03:15,3,3,0,0,0,0
2020-07-13 03:30,4,2,2,0,0,0
2020-07-13 03:45,4,3,1,0,0,0
2020-07-13 04:00,2,1,1,0,0,0
2020-07-13 04:15,4,2,2,0,0,0
2020-07-13 04:30,7,3,4,0,0,0
2020-07-13 04:45,10,5,5,0,0,0
2020-07-13 05:00,8,3,5,0,0,0
2020-07-13 05:15,13,10,3,0,0,0
2020-07-13 05:30,13,7,6,0,0,0
2020-07-13 05:45,28,22,6,0,0,0
2020-07-13 06:00,26,17,9,0,0,0
2020-07-13 06:15,54,25,29,0,0,0
2020-07-13 06:30,62,39,23,0,0,0
2020-07-13 06:45,84,59,25,0,0,0
2020-07-13 07:00,103,67,36,0,0,0
2020-07-13 07:15,111,71,40,0,0,0
2020-07-13 07:30,158,93,65,0,0,0
2020-07-13 07:45,161,88,73,0,0,0
2020-07-13 08:00,146,82,64,0,0,0
2020-07-13 08:15,150,90,60,0,0,0
2020-07-13 08:30,160,98,62,0,0,0
2020-07-13 08:45,210,140,70,0,0,0
2020-07-13 09:00,123,78,45,0,0,0
2020-07-13 09:15,129,79,50,0,0,0
2020-07-13 09:30,134,62,72,0,0,0
2020-07-13 09:45,187,103,84,0,0,0
2020-07-13 10:00,117,67,50,0,0,0
2020-07-13 10:15,132,76,56,0,0,0
2020-07-13 10:30,122,54,68,0,0,0
2020-07-13 10:45,128,73,55,0,0,0
2020-07-13 11:00,136,76,60,0,0,0
2020-07-13 11:15,150,77,73,0,0,0
2020-07-13 11:30,147,83,64,0,0,0
2020-07-13 11:45,162,89,73,0,0,0
2020-07-13 12:00,162,83,79,0,0,0
2020-07-13 12:15,171,95,76,0,0,0
2020-07-13 12:30,169,86,83,0,0,0
2020-07-13 12:45,186,90,96,0,0,0
2020-07-13 13:00,189,77,112,0,0,0
2020-07-13 13:15,186,85,101,0,0,0
2020-07-13 13:30,191,101,90,0,0,0
2020-07-13 13:45,245,111,134,0,0,0
2020-07-13 14:00,194,99,95,0,0,0
2020-07-13 14:15,195,103,92,0,0,0
2020-07-13 14:30,175,86,89,0,0,0
2020-07-13 14:45,209,121,88,0,0,0
2020-07-13 15:00,174,77,97,0,0,0
2020-07-13 15:15,205,105,100,0,0,0
2020-07-13 15:30,182,99,83,0,0,0
2020-07-13 15:45,240,126,114,0,0,0
2020-07-13 16:00,204,87,117,0,0,0
2020-07-13 16:15,257,134,123,0,0,0
2020-07-13 16:30,207,89,118,0,0,0
2020-07-13 16:45,250,124,126,0,0,0
2020-07-13 17:00,250,131,119,0,0,0
2020-07-13 17:15,230,107,123,0,0,0
2020-07-13 17:30,225,105,120,0,0,0
2020-07-13 17:45,240,117,123,0,0,0
2020-07-13 18:00,234,109,125,0,0,0
2020-07-13 18:15,232,98,134,0,0,0
2020-07-13 18:30,206,95,111,0,0,0
2020-07-13 18:45,227,106,121,0,0,0
2020-07-13 19:00,191,113,78,0,0,0
2020-07-13 19:15,167,88,79,0,0,0
2020-07-13 19:30,162,87,75,0,0,0
2020-07-13 19:45,174,87,87,0,0,0
2020-07-13 20:00,140,64,76,0,0,0
2020-07-13 20:15,145,69,76,0,0,0
2020-07-13 20:30,126,76,50,0,0,0
2020-07-13 20:45,112,47,65,0,0,0
2020-07-13 21:00,115,59,56,0,0,0
2020-07-13 21:15,102,43,59,0,0,0
2020-07-13 21:30,95,38,57,0,0,0
2020-07-13 21:45,108,44,64,0,0,0
2020-07-13 22:00,100,21,79,0,0,0
2020-07-13 22:15,69,19,50,0,0,0
2020-07-13 22:30,70,24,46,0,0,0
2020-07-13 22:45,72,25,47,0,0,0
2020-07-13 23:00,69,31,38,0,0,0
2020-07-13 23:15,42,20,22,0,0,0
2020-07-13 23:30,59,11,48,0,0,0
2020-07-13 23:45,52,23,29,0,0,0
2020-07-14 00:00,35,7,28,0,0,0
2020-07-14 00:15,20,5,15,0,0,0
2020-07-14 00:30,32,14,18,0,0,0
2020-07-14 00:45,19,3,16,0,0,0
2020-07-14 01:00,18,5,13,0,0,0
2020-07-14 01:15,21,8,13,0,0,0
2020-07-14 01:30,22,1,21,0,0,0
2020-07-14 01:45,8,3,5,0,0,0
2020-07-14 02:00,16,10,6,0,0,0
2020-07-14 02:15,13,2,11,0,0,0
2020-07-14 02:30,7,1,6,0,0,0
2020-07-14 02:45,11,5,6,0,0,0
2020-07-14 03:00,3,1,2,0,0,0
2020-07-14 03:15,4,1,3,0,0,0
2020-07-14 03:30,1,0,1,0,0,0
2020-07-14 03:45,4,2,2,0,0,0
2020-07-14 04:00,2,0,2,0,0,0
2020-07-14 04:15,6,3,3,0,0,0
2020-07-14 04:30,7,4,3,0,0,0
2020-07-14 04:45,15,6,9,0,0,0
2020-07-14 05:00,7,5,2,0,0,0
2020-07-14 05:15,9,7,2,0,0,0
2020-07-14 05:30,16,12,4,0,0,0
2020-07-14 05:45,30,24,6,0,0,0
2020-07-14 06:00,24,16,8,0,0,0
2020-07-14 06:15,42,27,15,0,0,0
2020-07-14 06:30,68,40,28,0,0,0
2020-07-14 06:45,73,49,24,0,0,0
2020-07-14 07:00,94,53,41,0,0,0
2020-07-14 07:15,122,76,46,0,0,0
2020-07-14 07:30,181,97,84,0,0,0
2020-07-14 07:45,167,100,67,0,0,0
2020-07-14 08:00,138,69,69,0,0,0
2020-07-14 08:15,125,70,55,0,0,0
2020-07-14 08:30,159,85,74,0,0,0
2020-07-14 08:45,206,150,56,0,0,0
2020-07-14 09:00,163,105,58,0,0,0
2020-07-14 09:15,158,110,48,0,0,0
2020-07-14 09:30,170,117,53,0,0,0
2020-07-14 09:45,144,84,60,0,0,0
2020-07-14 10:00,127,62,65,0,0,0
2020-07-14 10:15,131,71,60,0,0,0
2020-07-14 10:30,104,54,50,0,0,0
2020-07-14 10:45,150,80,70,0,0,0
2020-07-14 11:00,124,71,53,0,0,0
2020-07-14 11:15,141,77,64,0,0,0
2020-07-14 11:30,120,81,39,0,0,0
2020-07-14 11:45,184,95,89,0,0,0
2020-07-14 12:00,160,85,75,0,0,0
2020-07-14 12:15,144,64,80,0,0,0
2020-07-14 12:30,158,73,85,0,0,0
2020-07-14 12:45,189,95,94,0,0,0
2020-07-14 13:00,152,84,68,0,0,0
2020-07-14 13:15,128,57,71,0,0,0
2020-07-14 13:30,165,92,73,0,0,0
2020-07-14 13:45,207,118,89,0,0,0
2020-07-14 14:00,190,102,88,0,0,0
2020-07-14 14:15,185,108,77,0,0,0
2020-07-14 14:30,166,83,83,0,0,0
2020-07-14 14:45,166,90,76,0,0,0
2020-07-14 15:00,163,73,90,0,0,0
2020-07-14 15:15,131,61,70,0,0,0
2020-07-14 15:30,164,87,77,0,0,0
2020-07-14 15:45,177,76,101,0,0,0
2020-07-14 16:00,190,67,123,0,0,0
2020-07-14 16:15,159,78,81,0,0,0
2020-07-14 16:30,155,69,86,0,0,0
2020-07-14 16:45,174,56,118,0,0,0
2020-07-14 17:00,148,54,94,0,0,0
2020-07-14 17:15,134,60,74,0,0,0
2020-07-14 17:30,178,74,104,0,0,0
2020-07-14 17:45,193,80,113,0,0,0
2020-07-14 18:00,185,78,107,0,0,0
2020-07-14 18:15,172,78,94,0,0,0
2020-07-14 18:30,152,75,77,0,0,0
2020-07-14 18:45,159,82,77,0,0,0
2020-07-14 19:00,170,84,86,0,0,0
2020-07-14 19:15,154,82,72,0,0,0
2020-07-14 19:30,114,48,66,0,0,0
2020-07-14 19:45,104,53,51,0,0,0
2020-07-14 20:00,95,35,60,0,0,0
2020-07-14 20:15,83,40,43,0,0,0
2020-07-14 20:30,85,43,42,0,0,0
2020-07-14 20:45,88,43,45,0,0,0
2020-07-14 21:00,82,54,28,0,0,0
2020-07-14 21:15,67,26,41,0,0,0
2020-07-14 21:30,61,30,31,0,0,0
2020-07-14 21:45,58,28,30,0,0,0
2020-07-14 22:00,52,16,36,0,0,0
2020-07-14 22:15,58,16,42,0,0,0
2020-07-14 22:30,48,21,27,0,0,0
2020-07-14 22:45,37,12,25,0,0,0
2020-07-14 23:00,47,20,27,0,0,0
2020-07-14 23:15,39,11,28,0,0,0
2020-07-14 23:30,39,16,23,0,0,0
2020-07-14 23:45,37,13,24,0,0,0
2020-07-15 00:00,38,11,27,0,0,0
2020-07-15 00:15,25,5,20,0,0,0
2020-07-15 00:30,11,5,6,0,0,0
2020-07-15 00:45,27,7,20,0,0,0
2020-07-15 01:00,20,8,12,0,0,0
2020-07-15 01:15,12,3,9,0,0,0
2020-07-15 01:30,17,4,13,0,0,0
2020-07-15 01:45,4,1,3,0,0,0
2020-07-15 02:00,13,5,8,0,0,0
2020-07-15 02:15,6,4,2,0,0,0
2020-07-15 02:30,8,4,4,0,0,0
2020-07-15 02:45,2,1,1,0,0,0
2020-07-15 03:00,2,0,2,0,0,0
2020-07-15 03:15,2,1,1,0,0,0
2020-07-15 03:30,1,1,0,0,0,0
2020-07-15 03:45,6,4,2,0,0,0
2020-07-15 04:00,1,0,1,0,0,0
2020-07-15 04:15,6,4,2,0,0,0
2020-07-15 04:30,6,3,3,0,0,0
2020-07-15 04:45,9,4,5,0,0,0
2020-07-15 05:00,7,4,3,0,0,0
2020-07-15 05:15,8,7,1,0,0,0
2020-07-15 05:30,18,16,2,0,0,0
2020-07-15 05:45,24,21,3,0,0,0
2020-07-15 06:00,28,19,9,0,0,0
2020-07-15 06:15,38,23,15,0,0,0
2020-07-15 06:30,41,27,14,0,0,0
2020-07-15 06:45,76,56,20,0,0,0
2020-07-15 07:00,85,58,27,0,0,0
2020-07-15 07:15,97,58,39,0,0,0
2020-07-15 07:30,167,102,65,0,0,0
2020-07-15 07:45,183,99,84,0,0,0
2020-07-15 08:00,151,85,66,0,0,0
2020-07-15 08:15,153,95,58,0,0,0
2020-07-15 08:30,160,83,77,0,0,0
2020-07-15 08:45,206,140,66,0,0,0
2020-07-15 09:00,159,115,44,0,0,0
2020-07-15 09:15,124,78,46,0,0,0
2020-07-15 09:30,137,81,56,0,0,0
2020-07-15 09:45,166,94,72,0,0,0
2020-07-15 10:00,135,65,70,0,0,0
2020-07-15 10:15,147,80,67,0,0,0
2020-07-15 10:30,125,84,41,0,0,0
2020-07-15 10:45,169,93,76,0,0,0
2020-07-15 11:00,130,79,51,0,0,0
2020-07-15 11:15,184,120,64,0,0,0
2020-07-15 11:30,177,108,69,0,0,0
2020-07-15 11:45,206,114,92,0,0,0
2020-07-15 12:00,198,103,95,0,0,0
2020-07-15 12:15,174,87,87,0,0,0
2020-07-15 12:30,166,87,79,0,0,0
2020-07-15 12:45,191,105,86,0,0,0
2020-07-15 13:00,180,79,101,0,0,0
2020-07-15 13:15,198,87,111,0,0,0
2020-07-15 13:30,175,74,101,0,0,0
2020-07-15 13:45,236,116,120,0,0,0
2020-07-15 14:00,226,124,102,0,0,0
2020-07-15 14:15,168,102,66,0,0,0
2020-07-15 14:30,212,107,105,0,0,0
2020-07-15 14:45,178,94,84,0,0,0
2020-07-15 15:00,165,76,89,0,0,0
2020-07-15 15:15,162,72,90,0,0,0
2020-07-15 15:30,201,91,110,0,0,0
2020-07-15 15:45,239,109,130,0,0,0
2020-07-15 16:00,188,80,108,0,0,0
2020-07-15 16:15,257,103,154,0,0,0
2020-07-15 16:30,211,91,120,0,0,0
2020-07-15 16:45,219,108,111,0,0,0
2020-07-15 17:00,214,106,108,0,0,0
2020-07-15 17:15,258,112,146,0,0,0
2020-07-15 17:30,243,112,131,0,0,0
2020-07-15 17:45,235,118,117,0,0,0
2020-07-15 18:00,223,97,126,0,0,0
2020-07-15 18:15,192,79,113,0,0,0
2020-07-15 18:30,213,94,119,0,0,0
2020-07-15 18:45,260,126,134,0,0,0
2020-07-15 19:00,189,85,104,0,0,0
2020-07-15 19:15,139,66,73,0,0,0
2020-07-15 19:30,144,61,83,0,0,0
2020-07-15 19:45,181,83,98,0,0,0
2020-07-15 20:00,163,93,70,0,0,0
2020-07-15 20:15,166,83,83,0,0,0
2020-07-15 20:30,110,59,51,0,0,0
2020-07-15 20:45,123,61,62,0,0,0
2020-07-15 21:00,100,38,62,0,0,0
2020-07-15 21:15,87,35,52,0,0,0
2020-07-15 21:30,104,45,59,0,0,0
2020-07-15 21:45,94,41,53,0,0,0
2020-07-15 22:00,87,23,64,0,0,0
2020-07-15 22:15,83,30,53,0,0,0
2020-07-15 22:30,83,38,45,0,0,0
2020-07-15 22:45,87,30,57,0,0,0
2020-07-15 23:00,82,22,60,0,0,0
2020-07-15 23:15,70,24,46,0,0,0
2020-07-15 23:30,52,22,30,0,0,0
2020-07-15 23:45,81,36,45,0,0,0
2020-07-16 00:00,51,23,28,0,0,0
2020-07-16 00:15,53,15,38,0,0,0
2020-07-16 00:30,55,29,26,0,0,0
2020-07-16 00:45,53,19,34,0,0,0
2020-07-16 01:00,57,30,27,0,0,0
2020-07-16 01:15,30,15,15,0,0,0
2020-07-16 01:30,19,2,17,0,0,0
2020-07-16 01:45,48,9,39,0,0,0
2020-07-16 02:00,27,6,21,0,0,0
2020-07-16 02:15,20,4,16,0,0,0
2020-07-16 02:30,41,9,32,0,0,0
2020-07-16 02:45,32,1,31,0,0,0
2020-07-16 03:00,12,4,8,0,0,0
2020-07-16 03:15,8,0,8,0,0,0
2020-07-16 03:30,8,0,8,0,0,0
2020-07-16 03:45,16,4,12,0,0,0
2020-07-16 04:00,14,5,9,0,0,0
2020-07-16 04:15,13,5,8,0,0,0
2020-07-16 04:30,5,1,4,0,0,0
2020-07-16 04:45,12,2,10,0,0,0
2020-07-16 05:00,3,1,2,0,0,0
2020-07-16 05:15,11,6,5,0,0,0
2020-07-16 05:30,19,12,7,0,0,0
2020-07-16 05:45,22,19,3,0,0,0
2020-07-16 06:00,20,15,5,0,0,0
2020-07-16 06:15,39,23,16,0,0,0
2020-07-16 06:30,59,35,24,0,0,0
2020-07-16 06:45,69,43,26,0,0,0
2020-07-16 07:00,95,51,44,0,0,0
2020-07-16 07:15,80,50,30,0,0,0
2020-07-16 07:30,169,93,76,0,0,0
2020-07-16 07:45,160,88,72,0,0,0
2020-07-16 08:00,124,68,56,0,0,0
2020-07-16 08:15,155,93,62,0,0,0
2020-07-16 08:30,133,78,55,0,0,0
2020-07-16 08:45,185,131,54,0,0,0
2020-07-16 09:00,141,98,43,0,0,0
2020-07-16 09:15,134,73,61,0,0,0
2020-07-16 09:30,141,75,66,0,0,0
2020-07-16 09:45,123,82,41,0,0,0
2020-07-16 10:00,116,67,49,0,0,0
2020-07-16 10:15,124,71,53,0,0,0
2020-07-16 10:30,137,69,68,0,0,0
2020-07-16 10:45,155,95,60,0,0,0
2020-07-16 11:00,108,63,45,0,0,0
2020-07-16 11:15,137,83,54,0,0,0
2020-07-16 11:30,152,87,65,0,0,0
2020-07-16 11:45,167,82,85,0,0,0
2020-07-16 12:00,173,91,82,0,0,0
2020-07-16 12:15,162,91,71,0,0,0
2020-07-16 12:30,141,74,67,0,0,0
2020-07-16 12:45,156,85,71,0,0,0
2020-07-16 13:00,165,97,68,0,0,0
2020-07-16 13:15,145,81,64,0,0,0
2020-07-16 13:30,180,96,84,0,0,0
2020-07-16 13:45,239,151,88,0,0,0
2020-07-16 14:00,195,108,87,0,0,0
2020-07-16 14:15,187,98,89,0,0,0
2020-07-16 14:30,184,86,98,0,0,0
2020-07-16 14:45,171,83,88,0,0,0
2020-07-16 15:00,169,83,86,0,0,0
2020-07-16 15:15,182,94,88,0,0,0
2020-07-16 15:30,211,91,120,0,0,0
2020-07-16 15:45,212,113,99,0,0,0
2020-07-16 16:00,237,105,132,0,0,0
2020-07-16 16:15,176,74,102,0,0,0
2020-07-16 16:30,204,86,118,0,0,0
2020-07-16 16:45,192,95,97,0,0,0
2020-07-16 17:00,222,97,125,0,0,0
2020-07-16 17:15,253,114,139,0,0,0
2020-07-16 17:30,233,104,129,0,0,0
2020-07-16 17:45,272,115,157,0,0,0
2020-07-16 18:00,238,109,129,0,0,0
2020-07-16 18:15,193,91,102,0,0,0
2020-07-16 18:30,159,71,88,0,0,0
2020-07-16 18:45,178,94,84,0,0,0
2020-07-16 19:00,197,94,103,0,0,0
2020-07-16 19:15,219,115,104,0,0,0
2020-07-16 19:30,174,77,97,0,0,0
2020-07-16 19:45,170,95,75,0,0,0
2020-07-16 20:00,141,68,73,0,0,0
2020-07-16 20:15,108,61,47,0,0,0
2020-07-16 20:30,107,64,43,0,0,0
2020-07-16 20:45,109,58,51,0,0,0
2020-07-16 21:00,100,40,60,0,0,0
2020-07-16 21:15,64,25,39,0,0,0
2020-07-16 21:30,98,37,61,0,0,0
2020-07-16 21:45,90,32,58,0,0,0
2020-07-16 22:00,97,33,64,0,0,0
2020-07-16 22:15,83,28,55,0,0,0
2020-07-16 22:30,93,34,59,0,0,0
2020-07-16 22:45,82,26,56,0,0,0
2020-07-16 23:00,53,12,41,0,0,0
2020-07-16 23:15,63,17,46,0,0,0
2020-07-16 23:30,34,12,22,0,0,0
2020-07-16 23:45,51,18,33,0,0,0
2020-07-17 00:00,43,25,18,0,0,0
2020-07-17 00:15,34,7,27,0,0,0
2020-07-17 00:30,31,12,19,0,0,0
2020-07-17 00:45,47,15,32,0,0,0
2020-07-17 01:00,31,16,15,0,0,0
2020-07-17 01:15,27,5,22,0,0,0
2020-07-17 01:30,17,3,14,0,0,0
2020-07-17 01:45,15,5,10,0,0,0
2020-07-17 02:00,21,6,15,0,0,0
2020-07-17 02:15,7,2,5,0,0,0
2020-07-17 02:30,17,6,11,0,0,0
2020-07-17 02:45,9,3,6,0,0,0
2020-07-17 03:00,9,1,8,0,0,0
2020-07-17 03:15,12,3,9,0,0,0
2020-07-17 03:30,4,0,4,0,0,0
2020-07-17 03:45,3,1,2,0,0,0
2020-07-17 04:00,9,4,5,0,0,0
2020-07-17 04:15,4,3,1,0,0,0
2020-07-17 04:30,5,3,2,0,0,0
2020-07-17 04:45,16,9,7,0,0,0
2020-07-17 05:00,10,5,5,0,0,0
2020-07-17 05:15,13,6,7,0,0,0
2020-07-17 05:30,15,11,4,0,0,0
2020-07-17 05:45,30,20,10,0,0,0
2020-07-17 06:00,24,18,6,0,0,0
2020-07-17 06:15,52,29,23,0,0,0
2020-07-17 06:30,50,22,28,0,0,0
2020-07-17 06:45,72,46,26,0,0,0
2020-07-17 07:00,72,45,27,0,0,0
2020-07-17 07:15,97,75,22,0,0,0
2020-07-17 07:30,153,87,66,0,0,0
2020-07-17 07:45,197,128,69,0,0,0
2020-07-17 08:00,141,78,63,0,0,0
2020-07-17 08:15,136,75,61,0,0,0
2020-07-17 08:30,134,77,57,0,0,0
2020-07-17 08:45,192,134,58,0,0,0
2020-07-17 09:00,129,77,52,0,0,0
2020-07-17 09:15,138,73,65,0,0,0
2020-07-17 09:30,140,82,58,0,0,0
2020-07-17 09:45,161,96,65,0,0,0
2020-07-17 10:00,127,68,59,0,0,0
2020-07-17 10:15,136,69,67,0,0,0
2020-07-17 10:30,134,75,59,0,0,0
2020-07-17 10:45,163,86,77,0,0,0
2020-07-17 11:00,139,76,63,0,0,0
2020-07-17 11:15,140,71,69,0,0,0
2020-07-17 11:30,146,79,67,0,0,0
2020-07-17 11:45,155,100,55,0,0,0
2020-07-17 12:00,193,103,90,0,0,0
2020-07-17 12:15,187,102,85,0,0,0
2020-07-17 12:30,182,102,80,0,0,0
2020-07-17 12:45,165,81,84,0,0,0
2020-07-17 13:00,147,76,71,0,0,0
2020-07-17 13:15,191,84,107,0,0,0
2020-07-17 13:30,165,82,83,0,0,0
2020-07-17 13:45,224,126,98,0,0,0
2020-07-17 14:00,221,96,125,0,0,0
2020-07-17 14:15,178,93,85,0,0,0
2020-07-17 14:30,176,87,89,0,0,0
2020-07-17 14:45,214,113,101,0,0,0
2020-07-17 15:00,155,68,87,0,0,0
2020-07-17 15:15,175,86,89,0,0,0
2020-07-17 15:30,174,92,82,0,0,0
2020-07-17 15:45,201,108,93,0,0,0
2020-07-17 16:00,194,94,100,0,0,0
2020-07-17 16:15,196,93,103,0,0,0
2020-07-17 16:30,216,110,106,0,0,0
2020-07-17 16:45,201,103,98,0,0,0
2020-07-17 17:00,221,100,121,0,0,0
2020-07-17 17:15,182,102,80,0,0,0
2020-07-17 17:30,186,89,97,0,0,0
2020-07-17 17:45,197,103,94,0,0,0
2020-07-17 18:00,183,89,94,0,0,0
2020-07-17 18:15,205,90,115,0,0,0
2020-07-17 18:30,196,89,107,0,0,0
2020-07-17 18:45,209,108,101,0,0,0
2020-07-17 19:00,198,110,88,0,0,0
2020-07-17 19:15,161,96,65,0,0,0
2020-07-17 19:30,163,96,67,0,0,0
2020-07-17 19:45,147,76,71,0,0,0
2020-07-17 20:00,156,76,80,0,0,0
2020-07-17 20:15,155,81,74,0,0,0
2020-07-17 20:30,87,51,36,0,0,0
2020-07-17 20:45,104,57,47,0,0,0
2020-07-17 21:00,113,51,62,0,0,0
2020-07-17 21:15,96,36,60,0,0,0
2020-07-17 21:30,87,38,49,0,0,0
2020-07-17 21:45,72,37,35,0,0,0
2020-07-17 22:00,100,44,56,0,0,0
2020-07-17 22:15,104,36,68,0,0,0
2020-07-17 22:30,96,33,63,0,0,0
2020-07-17 22:45,75,26,49,0,0,0
2020-07-17 23:00,71,23,48,0,0,0
2020-07-17 23:15,71,19,52,0,0,0
2020-07-17 23:30,84,16,68,0,0,0
2020-07-17 23:45,114,38,76,0,0,0
2020-07-18 00:00,78,18,60,0,0,0
2020-07-18 00:15,82,43,39,0,0,0
2020-07-18 00:30,64,16,48,0,0,0
2020-07-18 00:45,72,28,44,0,0,0
2020-07-18 01:00,50,22,28,0,0,0
2020-07-18 01:15,64,19,45,0,0,0
2020-07-18 01:30,58,28,30,0,0,0
2020-07-18 01:45,63,14,49,0,0,0
2020-07-18 02:00,61,16,45,0,0,0
2020-07-18 02:15,57,9,48,0,0,0
2020-07-18 02:30,37,6,31,0,0,0
2020-07-18 02:45,59,8,51,0,0,0
2020-07-18 03:00,28,4,24,0,0,0
2020-07-18 03:15,24,6,18,0,0,0
2020-07-18 03:30,16,4,12,0,0,0
2020-07-18 03:45,25,4,21,0,0,0
2020-07-18 04:00,13,4,9,0,0,0
2020-07-18 04:15,10,8,2,0,0,0
2020-07-18 04:30,10,2,8,0,0,0
2020-07-18 04:45,13,5,8,0,0,0
2020-07-18 05:00,14,7,7,0,0,0
2020-07-18 05:15,7,4,3,0,0,0
2020-07-18 05:30,10,6,4,0,0,0
2020-07-18 05:45,15,10,5,0,0,0
2020-07-18 06:00,7,3,4,0,0,0
2020-07-18 06:15,8,5,3,0,0,0
2020-07-18 06:30,15,7,8,0,0,0
2020-07-18 06:45,20,13,7,0,0,0
2020-07-18 07:00,20,12,8,0,0,0
2020-07-18 07:15,42,30,12,0,0,0
2020-07-18 07:30,58,38,20,0,0,0
2020-07-18 07:45,41,29,12,0,0,0
2020-07-18 08:00,29,19,10,0,0,0
2020-07-18 08:15,45,29,16,0,0,0
2020-07-18 08:30,50,28,22,0,0,0
2020-07-18 08:45,72,51,21,0,0,0
2020-07-18 09:00,60,40,20,0,0,0
2020-07-18 09:15,68,51,17,0,0,0
2020-07-18 09:30,84,48,36,0,0,0
2020-07-18 09:45,105,68,37,0,0,0
2020-07-18 10:00,114,65,49,0,0,0
2020-07-18 10:15,131,72,59,0,0,0
2020-07-18 10:30,134,73,61,0,0,0
2020-07-18 10:45,130,72,58,0,0,0
2020-07-18 11:00,184,114,70,0,0,0
2020-07-18 11:15,159,100,59,0,0,0
2020-07-18 11:30,150,73,77,0,0,0
2020-07-18 11:45,143,88,55,0,0,0
2020-07-18 12:00,134,83,51,0,0,0
2020-07-18 12:15,156,85,71,0,0,0
2020-07-18 12:30,163,94,69,0,0,0
2020-07-18 12:45,195,102,93,0,0,0
2020-07-18 13:00,193,89,104,0,0,0
2020-07-18 13:15,153,77,76,0,0,0
2020-07-18 13:30,184,92,92,0,0,0
2020-07-18 13:45,181,94,87,0,0,0
2020-07-18 14:00,171,88,83,0,0,0
2020-07-18 14:15,232,106,126,0,0,0
2020-07-18 14:30,165,88,77,0,0,0
2020-07-18 14:45,165,73,92,0,0,0
2020-07-18 15:00,161,82,79,0,0,0
2020-07-18 15:15,138,63,75,0,0,0
2020-07-18 15:30,150,78,72,0,0,0
2020-07-18 15:45,177,96,81,0,0,0
2020-07-18 16:00,145,80,65,0,0,0
2020-07-18 16:15,131,70,61,0,0,0
2020-07-18 16:30,145,70,75,0,0,0
2020-07-18 16:45,157,69,88,0,0,0
2020-07-18 17:00,145,71,74,0,0,0
2020-07-18 17:15,151,64,87,0,0,0
2020-07-18 17:30,132,79,53,0,0,0
2020-07-18 17:45,185,79,106,0,0,0
2020-07-18 18:00,143,75,68,0,0,0
2020-07-18 18:15,129,76,53,0,0,0
2020-07-18 18:30,165,96,69,0,0,0
2020-07-18 18:45,156,95,61,0,0,0
2020-07-18 19:00,160,84,76,0,0,0
2020-07-18 19:15,152,92,60,0,0,0
2020-07-18 19:30,113,71,42,0,0,0
2020-07-18 19:45,129,70,59,0,0,0
2020-07-18 20:00,128,59,69,0,0,0
2020-07-18 20:15,115,51,64,0,0,0
2020-07-18 20:30,105,56,49,0,0,0
2020-07-18 20:45,97,41,56,0,0,0
2020-07-18 21:00,84,45,39,0,0,0
2020-07-18 21:15,92,36,56,0,0,0
2020-07-18 21:30,89,26,63,0,0,0
2020-07-18 21:45,90,50,40,0,0,0
2020-07-18 22:00,79,23,56,0,0,0
2020-07-18 22:15,75,37,38,0,0,0
2020-07-18 22:30,64,14,50,0,0,0
2020-07-18 22:45,98,19,79,0,0,0
2020-07-18 23:00,75,15,60,0,0,0
2020-07-18 23:15,60,21,39,0,0,0
2020-07-18 23:30,82,25,57,0,0,0
2020-07-18 23:45,82,27,55,0,0,0
2020-07-19 00:00,73,18,55,0,0,0
2020-07-19 00:15,63,24,39,0,0,0
2020-07-19 00:30,61,18,43,0,0,0
2020-07-19 00:45,64,20,44,0,0,0
2020-07-19 01:00,44,12,32,0,0,0
2020-07-19 01:15,48,10,38,0,0,0
2020-07-19 01:30,54,11,43,0,0,0
2020-07-19 01:45,54,11,43,0,0,0
2020-07-19 02:00,61,18,43,0,0,0
2020-07-19 02:15,42,8,34,0,0,0
2020-07-19 02:30,50,11,39,0,0,0
2020-07-19 02:45,27,10,17,0,0,0
2020-07-19 03:00,48,14,34,0,0,0
2020-07-19 03:15,31,4,27,0,0,0
2020-07-19 03:30,31,12,19,0,0,0
2020-07-19 03:45,25,6,19,0,0,0
2020-07-19 04:00,17,3,14,0,0,0
2020-07-19 04:15,27,1,26,0,0,0
2020-07-19 04:30,10,4,6,0,0,0
2020-07-19 04:45,12,3,9,0,0,0
2020-07-19 05:00,13,7,6,0,0,0
2020-07-19 05:15,10,5,5,0,0,0
2020-07-19 05:30,14,6,8,0,0,0
2020-07-19 05:45,11,4,7,0,0,0
2020-07-19 06:00,6,3,3,0,0,0
2020-07-19 06:15,12,5,7,0,0,0
2020-07-19 06:30,4,1,3,0,0,0
2020-07-19 06:45,5,5,0,0,0,0
2020-07-19 07:00,6,4,2,0,0,0
2020-07-19 07:15,5,3,2,0,0,0
2020-07-19 07:30,23,8,15,0,0,0
2020-07-19 07:45,11,10,1,0,0,0
2020-07-19 08:00,19,14,5,0,0,0
2020-07-19 08:15,19,8,11,0,0,0
2020-07-19 08:30,21,11,10,0,0,0
2020-07-19 08:45,43,28,15,0,0,0
2020-07-19 09:00,28,11,17,0,0,0
2020-07-19 09:15,22,10,12,0,0,0
2020-07-19 09:30,60,25,35,0,0,0
2020-07-19 09:45,62,30,32,0,0,0
2020-07-19 10:00,80,34,46,0,0,0
2020-07-19 10:15,69,49,20,0,0,0
2020-07-19 10:30,53,16,37,0,0,0
2020-07-19 10:45,80,36,44,0,0,0
2020-07-19 11:00,86,39,47,0,0,0
2020-07-19 11:15,93,45,48,0,0,0
2020-07-19 11:30,92,42,50,0,0,0
2020-07-19 11:45,109,43,66,0,0,0
2020-07-19 12:00,96,56,40,0,0,0
2020-07-19 12:15,91,48,43,0,0,0
2020-07-19 12:30,84,39,45,0,0,0
2020-07-19 12:45,103,65,38,0,0,0
2020-07-19 13:00,80,41,39,0,0,0
2020-07-19 13:15,105,64,41,0,0,0
2020-07-19 13:30,119,56,63,0,0,0
2020-07-19 13:45,107,60,47,0,0,0
2020-07-19 14:00,106,52,54,0,0,0
2020-07-19 14:15,125,56,69,0,0,0
2020-07-19 14:30,118,72,46,0,0,0
2020-07-19 14:45,142,80,62,0,0,0
2020-07-19 15:00,113,62,51,0,0,0
2020-07-19 15:15,113,67,46,0,0,0
2020-07-19 15:30,114,64,50,0,0,0
2020-07-19 15:45,131,83,48,0,0,0
2020-07-19 16:00,106,48,58,0,0,0
2020-07-19 16:15,106,59,47,0,0,0
2020-07-19 16:30,129,71,58,0,0,0
2020-07-19 16:45,145,58,87,0,0,0
2020-07-19 17:00,125,56,69,0,0,0
2020-07-19 17:15,118,60,58,0,0,0
2020-07-19 17:30,108,50,58,0,0,0
2020-07-19 17:45,119,54,65,0,0,0
2020-07-19 18:00,121,58,63,0,0,0
2020-07-19 18:15,146,67,79,0,0,0
2020-07-19 18:30,132,68,64,0,0,0
2020-07-19 18:45,132,67,65,0,0,0
2020-07-19 19:00,100,45,55,0,0,0
2020-07-19 19:15,108,55,53,0,0,0
2020-07-19 19:30,90,43,47,0,0,0
2020-07-19 19:45,109,54,55,0,0,0
2020-07-19 20:00,113,47,66,0,0,0
2020-07-19 20:15,106,38,68,0,0,0
2020-07-19 20:30,108,43,65,0,0,0
2020-07-19 20:45,95,27,68,0,0,0
2020-07-19 21:00,85,30,55,0,0,0
2020-07-19 21:15,65,30,35,0,0,0
2020-07-19 21:30,80,32,48,0,0,0
2020-07-19 21:45,66,18,48,0,0,0
2020-07-19 22:00,68,10,58,0,0,0
2020-07-19 22:15,77,18,59,0,0,0
2020-07-19 22:30,55,14,41,0,0,0
2020-07-19 22:45,41,10,31,0,0,0
2020-07-19 23:00,42,17,25,0,0,0
2020-07-19 23:15,28,7,21,0,0,0
2020-07-19 23:30,27,3,24,0,0,0
2020-07-19 23:45,40,12,28,0,0,0
2020-07-20 00:00,17,6,11,0,0,0
2020-07-20 00:15,21,10,11,0,0,0
2020-07-20 00:30,20,3,17,0,0,0
2020-07-20 00:45,15,5,10,0,0,0
2020-07-20 01:00,6,4,2,0,0,0
2020-07-20 01:15,8,2,6,0,0,0
2020-07-20 01:30,10,3,7,0,0,0
2020-07-20 01:45,3,2,1,0,0,0
2020-07-20 02:00,4,1,3,0,0,0
2020-07-20 02:15,8,5,3,0,0,0
2020-07-20 02:30,2,0,2,0,0,0
2020-07-20 02:45,5,0,5,0,0,0
2020-07-20 03:00,5,3,2,0,0,0
2020-07-20 03:15,6,0,6,0,0,0
2020-07-20 03:30,0,0,0,0,0,0
2020-07-20 03:45,3,2,1,0,0,0
2020-07-20 04:00,1,0,1,0,0,0
2020-07-20 04:15,0,0,0,0,0,0
2020-07-20 04:30,6,4,2,0,0,0
2020-07-20 04:45,11,4,7,0,0,0
2020-07-20 05:00,6,5,1,0,0,0
2020-07-20 05:15,21,13,8,0,0,0
2020-07-20 05:30,21,15,6,0,0,0
2020-07-20 05:45,18,16,2,0,0,0
2020-07-20 06:00,25,18,7,0,0,0
2020-07-20 06:15,53,35,18,0,0,0
2020-07-20 06:30,48,26,22,0,0,0
2020-07-20 06:45,75,44,31,0,0,0
2020-07-20 07:00,89,51,38,0,0,0
2020-07-20 07:15,103,61,42,0,0,0
2020-07-20 07:30,162,94,68,0,0,0
2020-07-20 07:45,149,95,54,0,0,0
2020-07-20 08:00,139,79,60,0,0,0
2020-07-20 08:15,147,78,69,0,0,0
2020-07-20 08:30,143,78,65,0,0,0
2020-07-20 08:45,167,106,61,0,0,0
2020-07-20 09:00,122,75,47,0,0,0
2020-07-20 09:15,142,82,60,0,0,0
2020-07-20 09:30,119,69,50,0,0,0
2020-07-20 09:45,153,107,46,0,0,0
2020-07-20 10:00,120,71,49,0,0,0
2020-07-20 10:15,107,58,49,0,0,0
2020-07-20 10:30,155,62,93,0,0,0
2020-07-20 10:45,157,99,58,0,0,0
2020-07-20 11:00,162,101,61,0,0,0
2020-07-20 11:15,162,100,62,0,0,0
2020-07-20 11:30,135,69,66,0,0,0
2020-07-20 11:45,150,82,68,0,0,0
2020-07-20 12:00,149,84,65,0,0,0
2020-07-20 12:15,153,78,75,0,0,0
2020-07-20 12:30,152,80,72,0,0,0
2020-07-20 12:45,153,88,65,0,0,0
2020-07-20 13:00,177,89,88,0,0,0
2020-07-20 13:15,166,75,91,0,0,0
2020-07-20 13:30,175,77,98,0,0,0
2020-07-20 13:45,202,117,85,0,0,0
2020-07-20 14:00,150,80,70,0,0,0
2020-07-20 14:15,139,62,77,0,0,0
2020-07-20 14:30,151,77,74,0,0,0
2020-07-20 14:45,163,79,84,0,0,0
2020-07-20 15:00,159,87,72,0,0,0
2020-07-20 15:15,172,89,83,0,0,0
2020-07-20 15:30,191,86,105,0,0,0
2020-07-20 15:45,201,103,98,0,0,0
2020-07-20 16:00,192,85,107,0,0,0
2020-07-20 16:15,214,102,112,0,0,0
2020-07-20 16:30,197,90,107,0,0,0
2020-07-20 16:45,243,114,129,0,0,0
2020-07-20 17:00,211,77,134,0,0,0
2020-07-20 17:15,215,112,103,0,0,0
2020-07-20 17:30,236,97,139,0,0,0
2020-07-20 17:45,239,113,126,0,0,0
2020-07-20 18:00,220,100,120,0,0,0
2020-07-20 18:15,222,117,105,0,0,0
2020-07-20 18:30,211,85,126,0,0,0
2020-07-20 18:45,178,83,95,0,0,0
2020-07-20 19:00,196,100,96,0,0,0
2020-07-20 19:15,168,68,100,0,0,0
2020-07-20 19:30,173,86,87,0,0,0
2020-07-20 19:45,152,71,81,0,0,0
2020-07-20 20:00,136,48,88,0,0,0
2020-07-20 20:15,105,53,52,0,0,0
2020-07-20 20:30,97,51,46,0,0,0
2020-07-20 20:45,130,53,77,0,0,0
2020-07-20 21:00,90,32,58,0,0,0
2020-07-20 21:15,81,35,46,0,0,0
2020-07-20 21:30,107,44,63,0,0,0
2020-07-20 21:45,102,38,64,0,0,0
2020-07-20 22:00,84,33,51,0,0,0
2020-07-20 22:15,58,15,43,0,0,0
2020-07-20 22:30,84,23,61,0,0,0
2020-07-20 22:45,59,16,43,0,0,0
2020-07-20 23:00,58,24,34,0,0,0
2020-07-20 23:15,44,19,25,0,0,0
2020-07-20 23:30,43,16,27,0,0,0
2020-07-20 23:45,35,12,23,0,0,0
2020-07-21 00:00,53,19,34,0,0,0
2020-07-21 00:15,23,10,13,0,0,0
2020-07-21 00:30,21,6,15,0,0,0
2020-07-21 00:45,16,3,13,0,0,0
2020-07-21 01:00,16,3,13,0,0,0
2020-07-21 01:15,18,6,12,0,0,0
2020-07-21 01:30,17,4,13,0,0,0
2020-07-21 01:45,16,5,11,0,0,0
2020-07-21 02:00,10,1,9,0,0,0
2020-07-21 02:15,5,1,4,0,0,0
2020-07-21 02:30,13,5,8,0,0,0
2020-07-21 02:45,4,0,4,0,0,0
2020-07-21 03:00,9,4,5,0,0,0
2020-07-21 03:15,3,0,3,0,0,0
2020-07-21 03:30,4,2,2,0,0,0
2020-07-21 03:45,3,1,2,0,0,0
2020-07-21 04:00,7,2,5,0,0,0
2020-07-21 04:15,3,0,3,0,0,0
2020-07-21 04:30,3,3,0,0,0,0
2020-07-21 04:45,4,3,1,0,0,0
2020-07-21 05:00,11,7,4,0,0,0
2020-07-21 05:15,16,11,5,0,0,0
2020-07-21 05:30,16,14,2,0,0,0
2020-07-21 05:45,23,17,6,0,0,0
2020-07-21 06:00,23,21,2,0,0,0
2020-07-21 06:15,36,29,7,0,0,0
2020-07-21 06:30,53,34,19,0,0,0
2020-07-21 06:45,82,57,25,0,0,0
2020-07-21 07:00,100,63,37,0,0,0
2020-07-21 07:15,107,64,43,0,0,0
2020-07-21 07:30,136,86,50,0,0,0
2020-07-21 07:45,201,133,68,0,0,0
2020-07-21 08:00,149,94,55,0,0,0
2020-07-21 08:15,156,92,64,0,0,0
2020-07-21 08:30,144,90,54,0,0,0
2020-07-21 08:45,218,136,82,0,0,0
2020-07-21 09:00,175,105,70,0,0,0
2020-07-21 09:15,149,111,38,0,0,0
2020-07-21 09:30,138,87,51,0,0,0
2020-07-21 09:45,142,83,59,0,0,0
2020-07-21 10:00,138,73,65,0,0,0
2020-07-21 10:15,120,60,60,0,0,0
2020-07-21 10:30,139,78,61,0,0,0
2020-07-21 10:45,151,102,49,0,0,0
2020-07-21 11:00,160,95,65,0,0,0
2020-07-21 11:15,161,93,68,0,0,0
2020-07-21 11:30,140,87,53,0,0,0
2020-07-21 11:45,162,93,69,0,0,0
2020-07-21 12:00,141,65,76,0,0,0
2020-07-21 12:15,158,83,75,0,0,0
2020-07-21 12:30,134,72,62,0,0,0
2020-07-21 12:45,175,103,72,0,0,0
2020-07-21 13:00,198,103,95,0,0,0
2020-07-21 13:15,170,80,90,0,0,0
2020-07-21 13:30,172,84,88,0,0,0
2020-07-21 13:45,181,108,73,0,0,0
2020-07-21 14:00,187,89,98,0,0,0
2020-07-21 14:15,201,105,96,0,0,0
2020-07-21 14:30,200,98,102,0,0,0
2020-07-21 14:45,201,104,97,0,0,0
2020-07-21 15:00,188,83,105,0,0,0
2020-07-21 15:15,160,81,79,0,0,0
2020-07-21 15:30,170,82,88,0,0,0
2020-07-21 15:45,227,120,107,0,0,0
2020-07-21 16:00,218,111,107,0,0,0
2020-07-21 16:15,216,98,118,0,0,0
2020-07-21 16:30,202,87,115,0,0,0
2020-07-21 16:45,272,123,149,0,0,0
2020-07-21 17:00,212,101,111,0,0,0
2020-07-21 17:15,285,127,158,0,0,0
2020-07-21 17:30,222,101,121,0,0,0
2020-07-21 17:45,257,128,129,0,0,0
2020-07-21 18:00,240,104,136,0,0,0
2020-07-21 18:15,248,118,130,0,0,0
2020-07-21 18:30,210,93,117,0,0,0
2020-07-21 18:45,233,135,98,0,0,0
2020-07-21 19:00,206,104,102,0,0,0
2020-07-21 19:15,217,111,106,0,0,0
2020-07-21 19:30,165,67,98,0,0,0
2020-07-21 19:45,177,84,93,0,0,0
2020-07-21 20:00,159,82,77,0,0,0
2020-07-21 20:15,133,57,76,0,0,0
2020-07-21 20:30,142,64,78,0,0,0
2020-07-21 20:45,119,55,64,0,0,0
2020-07-21 21:00,100,52,48,0,0,0
2020-07-21 21:15,123,45,78,0,0,0
2020-07-21 21:30,89,32,57,0,0,0
2020-07-21 21:45,104,43,61,0,0,0
2020-07-21 22:00,99,40,59,0,0,0
2020-07-21 22:15,93,32,61,0,0,0
2020-07-21 22:30,104,32,72,0,0,0
2020-07-21 22:45,76,40,36,0,0,0
2020-07-21 23:00,72,18,54,0,0,0
2020-07-21 23:15,90,19,71,0,0,0
2020-07-21 23:30,63,27,36,0,0,0
2020-07-21 23:45,56,20,36,0,0,0
2020-07-22 00:00,67,24,43,0,0,0
2020-07-22 00:15,43,6,37,0,0,0
2020-07-22 00:30,49,11,38,0,0,0
2020-07-22 00:45,17,4,13,0,0,0
2020-07-22 01:00,14,5,9,0,0,0
2020-07-22 01:15,12,3,9,0,0,0
2020-07-22 01:30,19,7,12,0,0,0
2020-07-22 01:45,18,5,13,0,0,0
2020-07-22 02:00,17,1,16,0,0,0
2020-07-22 02:15,22,6,16,0,0,0
2020-07-22 02:30,5,0,5,0,0,0
2020-07-22 02:45,18,2,16,0,0,0
2020-07-22 03:00,4,1,3,0,0,0
2020-07-22 03:15,6,0,6,0,0,0
2020-07-22 03:30,7,4,3,0,0,0
2020-07-22 03:45,3,2,1,0,0,0
2020-07-22 04:00,4,2,2,0,0,0
2020-07-22 04:15,6,4,2,0,0,0
2020-07-22 04:30,9,4,5,0,0,0
2020-07-22 04:45,5,3,2,0,0,0
2020-07-22 05:00,6,1,5,0,0,0
2020-07-22 05:15,18,17,1,0,0,0
2020-07-22 05:30,22,13,9,0,0,0
2020-07-22 05:45,25,19,6,0,0,0
2020-07-22 06:00,31,20,11,0,0,0
2020-07-22 06:15,51,38,13,0,0,0
2020-07-22 06:30,54,35,19,0,0,0
2020-07-22 06:45,77,49,28,0,0,0
2020-07-22 07:00,92,62,30,0,0,0
2020-07-22 07:15,124,63,61,0,0,0
2020-07-22 07:30,186,114,72,0,0,0
2020-07-22 07:45,146,89,57,0,0,0
2020-07-22 08:00,145,85,60,0,0,0
2020-07-22 08:15,162,90,72,0,0,0
2020-07-22 08:30,200,105,95,0,0,0
2020-07-22 08:45,185,123,62,0,0,0
2020-07-22 09:00,163,113,50,0,0,0
2020-07-22 09:15,153,111,42,0,0,0
2020-07-22 09:30,166,109,57,0,0,0
2020-07-22 09:45,164,117,47,0,0,0
2020-07-22 10:00,123,79,44,0,0,0
2020-07-22 10:15,137,78,59,0,0,0
2020-07-22 10:30,131,71,60,0,0,0
2020-07-22 10:45,147,84,63,0,0,0
2020-07-22 11:00,131,63,68,0,0,0
2020-07-22 11:15,153,85,68,0,0,0
2020-07-22 11:30,173,101,72,0,0,0
2020-07-22 11:45,191,126,65,0,0,0
2020-07-22 12:00,151,82,69,0,0,0
2020-07-22 12:15,192,105,87,0,0,0
2020-07-22 12:30,181,77,104,0,0,0
2020-07-22 12:45,231,114,117,0,0,0
2020-07-22 13:00,190,99,91,0,0,0
2020-07-22 13:15,225,95,130,0,0,0
2020-07-22 13:30,170,73,97,0,0,0
2020-07-22 13:45,206,105,101,0,0,0
2020-07-22 14:00,193,86,107,0,0,0
2020-07-22 14:15,205,95,110,0,0,0
2020-07-22 14:30,203,99,104,0,0,0
2020-07-22 14:45,214,92,122,0,0,0
2020-07-22 15:00,181,71,110,0,0,0
2020-07-22 15:15,190,94,96,0,0,0
2020-07-22 15:30,163,80,83,0,0,0
2020-07-22 15:45,215,103,112,0,0,0
2020-07-22 16:00,200,94,106,0,0,0
2020-07-22 16:15,242,110,132,0,0,0
2020-07-22 16:30,252,118,134,0,0,0
2020-07-22 16:45,194,88,106,0,0,0
2020-07-22 17:00,236,113,123,0,0,0
2020-07-22 17:15,247,101,146,0,0,0
2020-07-22 17:30,236,109,127,0,0,0
2020-07-22 17:45,256,136,120,0,0,0
2020-07-22 18:00,235,104,131,0,0,0
2020-07-22 18:15,235,100,135,0,0,0
2020-07-22 18:30,202,100,102,0,0,0
2020-07-22 18:45,222,119,103,0,0,0
2020-07-22 19:00,207,115,92,0,0,0
2020-07-22 19:15,217,108,109,0,0,0
2020-07-22 19:30,148,68,80,0,0,0
2020-07-22 19:45,173,82,91,0,0,0
2020-07-22 20:00,150,80,70,0,0,0
2020-07-22 20:15,151,81,70,0,0,0
2020-07-22 20:30,138,77,61,0,0,0
2020-07-22 20:45,126,53,73,0,0,0
2020-07-22 21:00,128,65,63,0,0,0
2020-07-22 21:15,84,34,50,0,0,0
2020-07-22 21:30,132,49,83,0,0,0
2020-07-22 21:45,97,45,52,0,0,0
2020-07-22 22:00,117,42,75,0,0,0
2020-07-22 22:15,116,43,73,0,0,0
2020-07-22 22:30,79,16,63,0,0,0
2020-07-22 22:45,88,18,70,0,0,0
2020-07-22 23:00,92,45,47,0,0,0
2020-07-22 23:15,81,27,54,0,0,0
2020-07-22 23:30,90,40,50,0,0,0
2020-07-22 23:45,79,35,44,0,0,0
2020-07-23 00:00,59,23,36,0,0,0
2020-07-23 00:15,53,21,32,0,0,0
2020-07-23 00:30,77,7,70,0,0,0
2020-07-23 00:45,29,5,24,0,0,0
2020-07-23 01:00,19,5,14,0,0,0
2020-07-23 01:15,39,14,25,0,0,0
2020-07-23 01:30,32,4,28,0,0,0
2020-07-23 01:45,31,12,19,0,0,0
2020-07-23 02:00,16,3,13,0,0,0
2020-07-23 02:15,8,2,6,0,0,0
2020-07-23 02:30,23,4,19,0,0,0
2020-07-23 02:45,22,6,16,0,0,0
2020-07-23 03:00,19,8,11,0,0,0
2020-07-23 03:15,31,1,30,0,0,0
2020-07-23 03:30,12,5,7,0,0,0
2020-07-23 03:45,13,5,8,0,0,0
2020-07-23 04:00,5,1,4,0,0,0
2020-07-23 04:15,10,3,7,0,0,0
2020-07-23 04:30,7,4,3,0,0,0
2020-07-23 04:45,7,3,4,0,0,0
2020-07-23 05:00,7,4,3,0,0,0
2020-07-23 05:15,13,7,6,0,0,0
2020-07-23 05:30,29,15,14,0,0,0
2020-07-23 05:45,24,18,6,0,0,0
2020-07-23 06:00,39,30,9,0,0,0
2020-07-23 06:15,57,37,20,0,0,0
2020-07-23 06:30,55,32,23,0,0,0
2020-07-23 06:45,71,37,34,0,0,0
2020-07-23 07:00,106,76,30,0,0,0
2020-07-23 07:15,111,71,40,0,0,0
2020-07-23 07:30,200,121,79,0,0,0
2020-07-23 07:45,180,120,60,0,0,0
2020-07-23 08:00,169,105,64,0,0,0
2020-07-23 08:15,141,79,62,0,0,0
2020-07-23 08:30,170,84,86,0,0,0
2020-07-23 08:45,191,136,55,0,0,0
2020-07-23 09:00,150,95,55,0,0,0
2020-07-23 09:15,128,73,55,0,0,0
2020-07-23 09:30,147,78,69,0,0,0
2020-07-23 09:45,169,107,62,0,0,0
2020-07-23 10:00,126,67,59,0,0,0
2020-07-23 10:15,128,61,67,0,0,0
2020-07-23 10:30,137,65,72,0,0,0
2020-07-23 10:45,172,74,98,0,0,0
2020-07-23 11:00,196,110,86,0,0,0
2020-07-23 11:15,150,85,65,0,0,0
2020-07-23 11:30,174,102,72,0,0,0
2020-07-23 11:45,159,99,60,0,0,0
2020-07-23 12:00,178,93,85,0,0,0
2020-07-23 12:15,182,97,85,0,0,0
2020-07-23 12:30,161,93,68,0,0,0
2020-07-23 12:45,174,96,78,0,0,0
2020-07-23 13:00,189,81,108,0,0,0
2020-07-23 13:15,168,89,79,0,0,0
2020-07-23 13:30,191,99,92,0,0,0
2020-07-23 13:45,182,110,72,0,0,0
2020-07-23 14:00,185,105,80,0,0,0
2020-07-23 14:15,190,110,80,0,0,0
2020-07-23 14:30,221,116,105,0,0,0
2020-07-23 14:45,172,77,95,0,0,0
2020-07-23 15:00,180,88,92,0,0,0
2020-07-23 15:15,170,85,85,0,0,0
2020-07-23 15:30,218,115,103,0,0,0
2020-07-23 15:45,216,105,111,0,0,0
2020-07-23 16:00,250,120,130,0,0,0
2020-07-23 16:15,231,108,123,0,0,0
2020-07-23 16:30,251,116,135,0,0,0
2020-07-23 16:45,246,122,124,0,0,0
2020-07-23 17:00,246,125,121,0,0,0
2020-07-23 17:15,263,111,152,0,0,0
2020-07-23 17:30,242,108,134,0,0,0
2020-07-23 17:45,282,152,130,0,0,0
2020-07-23 18:00,242,110,132,0,0,0
2020-07-23 18:15,242,113,129,0,0,0
2020-07-23 18:30,251,123,128,0,0,0
2020-07-23 18:45,246,122,124,0,0,0
2020-07-23 19:00,211,93,118,0,0,0
2020-07-23 19:15,203,102,101,0,0,0
2020-07-23 19:30,192,88,104,0,0,0
2020-07-23 19:45,188,100,88,0,0,0
2020-07-23 20:00,187,96,91,0,0,0
2020-07-23 20:15,172,103,69,0,0,0
2020-07-23 20:30,124,66,58,0,0,0
2020-07-23 20:45,116,48,68,0,0,0
2020-07-23 21:00,95,30,65,0,0,0
2020-07-23 21:15,98,44,54,0,0,0
2020-07-23 21:30,86,27,59,0,0,0
2020-07-23 21:45,101,43,58,0,0,0
2020-07-23 22:00,83,25,58,0,0,0
2020-07-23 22:15,86,21,65,0,0,0
2020-07-23 22:30,77,14,63,0,0,0
2020-07-23 22:45,89,31,58,0,0,0
2020-07-23 23:00,101,23,78,0,0,0
2020-07-23 23:15,61,20,41,0,0,0
2020-07-23 23:30,67,23,44,0,0,0
2020-07-23 23:45,71,22,49,0,0,0
2020-07-24 00:00,61,11,50,0,0,0
2020-07-24 00:15,45,9,36,0,0,0
2020-07-24 00:30,46,21,25,0,0,0
2020-07-24 00:45,34,2,32,0,0,0
2020-07-24 01:00,32,8,24,0,0,0
2020-07-24 01:15,34,15,19,0,0,0
2020-07-24 01:30,19,2,17,0,0,0
2020-07-24 01:45,27,7,20,0,0,0
2020-07-24 02:00,24,9,15,0,0,0
2020-07-24 02:15,28,6,22,0,0,0
2020-07-24 02:30,12,2,10,0,0,0
2020-07-24 02:45,10,3,7,0,0,0
2020-07-24 03:00,13,1,12,0,0,0
2020-07-24 03:15,8,2,6,0,0,0
2020-07-24 03:30,5,1,4,0,0,0
2020-07-24 03:45,7,2,5,0,0,0
2020-07-24 04:00,3,1,2,0,0,0
2020-07-24 04:15,6,2,4,0,0,0
2020-07-24 04:30,8,5,3,0,0,0
2020-07-24 04:45,8,3,5,0,0,0
2020-07-24 05:00,5,3,2,0,0,0
2020-07-24 05:15,15,12,3,0,0,0
2020-07-24 05:30,12,9,3,0,0,0
2020-07-24 05:45,39,25,14,0,0,0
2020-07-24 06:00,34,24,10,0,0,0
2020-07-24 06:15,38,22,16,0,0,0
2020-07-24 06:30,38,22,16,0,0,0
2020-07-24 06:45,59,34,25,0,0,0
2020-07-24 07:00,95,60,35,0,0,0
2020-07-24 07:15,109,64,45,0,0,0
2020-07-24 07:30,121,72,49,0,0,0
2020-07-24 07:45,160,101,59,0,0,0
2020-07-24 08:00,116,65,51,0,0,0
2020-07-24 08:15,129,82,47,0,0,0
2020-07-24 08:30,145,79,66,0,0,0
2020-07-24 08:45,168,114,54,0,0,0
2020-07-24 09:00,120,85,35,0,0,0
2020-07-24 09:15,125,88,37,0,0,0
2020-07-24 09:30,151,80,71,0,0,0
2020-07-24 09:45,160,96,64,0,0,0
2020-07-24 10:00,149,97,52,0,0,0
2020-07-24 10:15,143,86,57,0,0,0
2020-07-24 10:30,142,72,70,0,0,0
2020-07-24 10:45,157,71,86,0,0,0
2020-07-24 11:00,149,79,70,0,0,0
2020-07-24 11:15,136,72,64,0,0,0
2020-07-24 11:30,135,72,63,0,0,0
2020-07-24 11:45,183,78,105,0,0,0
2020-07-24 12:00,149,67,82,0,0,0
2020-07-24 12:15,155,80,75,0,0,0
2020-07-24 12:30,174,93,81,0,0,0
2020-07-24 12:45,185,92,93,0,0,0
2020-07-24 13:00,153,78,75,0,0,0
2020-07-24 13:15,154,64,90,0,0,0
2020-07-24 13:30,149,82,67,0,0,0
2020-07-24 13:45,217,107,110,0,0,0
2020-07-24 14:00,180,97,83,0,0,0
2020-07-24 14:15,174,92,82,0,0,0
2020-07-24 14:30,161,78,83,0,0,0
2020-07-24 14:45,187,99,88,0,0,0
2020-07-24 15:00,176,92,84,0,0,0
2020-07-24 15:15,211,92,119,0,0,0
2020-07-24 15:30,173,79,94,0,0,0
2020-07-24 15:45,174,80,94,0,0,0
2020-07-24 16:00,174,88,86,0,0,0
2020-07-24 16:15,184,80,104,0,0,0
2020-07-24 16:30,155,73,82,0,0,0
2020-07-24 16:45,194,83,111,0,0,0
2020-07-24 17:00,173,90,83,0,0,0
2020-07-24 17:15,195,84,111,0,0,0
2020-07-24 17:30,190,102,88,0,0,0
2020-07-24 17:45,187,82,105,0,0,0
2020-07-24 18:00,188,100,88,0,0,0
2020-07-24 18:15,147,70,77,0,0,0
2020-07-24 18:30,113,38,75,0,0,0
2020-07-24 18:45,150,86,64,0,0,0
2020-07-24 19:00,171,79,92,0,0,0
2020-07-24 19:15,172,88,84,0,0,0
2020-07-24 19:30,128,76,52,0,0,0
2020-07-24 19:45,132,69,63,0,0,0
2020-07-24 20:00,147,77,70,0,0,0
2020-07-24 20:15,125,78,47,0,0,0
2020-07-24 20:30,119,60,59,0,0,0
2020-07-24 20:45,100,47,53,0,0,0
2020-07-24 21:00,80,40,40,0,0,0
2020-07-24 21:15,78,49,29,0,0,0
2020-07-24 21:30,96,55,41,0,0,0
2020-07-24 21:45,70,33,37,0,0,0
2020-07-24 22:00,88,39,49,0,0,0
2020-07-24 22:15,71,24,47,0,0,0
2020-07-24 22:30,78,25,53,0,0,0
2020-07-24 22:45,70,29,41,0,0,0
2020-07-24 23:00,93,17,76,0,0,0
2020-07-24 23:15,65,27,38,0,0,0
2020-07-24 23:30,80,25,55,0,0,0
2020-07-24 23:45,76,32,44,0,0,0
2020-07-25 00:00,97,20,77,0,0,0
2020-07-25 00:15,57,19,38,0,0,0
2020-07-25 00:30,61,14,47,0,0,0
2020-07-25 00:45,53,20,33,0,0,0
2020-07-25 01:00,76,22,54,0,0,0
2020-07-25 01:15,53,19,34,0,0,0
2020-07-25 01:30,41,9,32,0,0,0
2020-07-25 01:45,51,15,36,0,0,0
2020-07-25 02:00,42,9,33,0,0,0
2020-07-25 02:15,35,5,30,0,0,0
2020-07-25 02:30,32,13,19,0,0,0
2020-07-25 02:45,38,10,28,0,0,0
2020-07-25 03:00,43,10,33,0,0,0
2020-07-25 03:15,27,6,21,0,0,0
2020-07-25 03:30,26,18,8,0,0,0
2020-07-25 03:45,11,2,9,0,0,0
2020-07-25 04:00,28,3,25,0,0,0
2020-07-25 04:15,18,4,14,0,0,0
2020-07-25 04:30,18,4,14,0,0,0
2020-07-25 04:45,12,1,11,0,0,0
2020-07-25 05:00,20,5,15,0,0,0
2020-07-25 05:15,14,7,7,0,0,0
2020-07-25 05:30,15,6,9,0,0,0
2020-07-25 05:45,14,7,7,0,0,0
2020-07-25 06:00,13,7,6,0,0,0
2020-07-25 06:15,11,6,5,0,0,0
2020-07-25 06:30,16,10,6,0,0,0
2020-07-25 06:45,12,9,3,0,0,0
2020-07-25 07:00,22,11,11,0,0,0
2020-07-25 07:15,20,14,6,0,0,0
2020-07-25 07:30,34,30,4,0,0,0
2020-07-25 07:45,40,28,12,0,0,0
2020-07-25 08:00,28,15,13,0,0,0
2020-07-25 08:15,42,23,19,0,0,0
2020-07-25 08:30,48,33,15,0,0,0
2020-07-25 08:45,54,44,10,0,0,0
2020-07-25 09:00,52,31,21,0,0,0
2020-07-25 09:15,69,48,21,0,0,0
2020-07-25 09:30,83,64,19,0,0,0
2020-07-25 09:45,97,61,36,0,0,0
2020-07-25 10:00,88,62,26,0,0,0
2020-07-25 10:15,139,75,64,0,0,0
2020-07-25 10:30,114,57,57,0,0,0
2020-07-25 10:45,170,104,66,0,0,0
2020-07-25 11:00,111,52,59,0,0,0
2020-07-25 11:15,137,82,55,0,0,0
2020-07-25 11:30,163,93,70,0,0,0
2020-07-25 11:45,165,93,72,0,0,0
2020-07-25 12:00,153,91,62,0,0,0
2020-07-25 12:15,123,66,57,0,0,0
2020-07-25 12:30,134,59,75,0,0,0
2020-07-25 12:45,137,79,58,0,0,0
2020-07-25 13:00,121,63,58,0,0,0
2020-07-25 13:15,127,60,67,0,0,0
2020-07-25 13:30,128,66,62,0,0,0
2020-07-25 13:45,140,67,73,0,0,0
2020-07-25 14:00,165,102,63,0,0,0
2020-07-25 14:15,154,95,59,0,0,0
2020-07-25 14:30,159,86,73,0,0,0
2020-07-25 14:45,116,60,56,0,0,0
2020-07-25 15:00,144,50,94,0,0,0
2020-07-25 15:15,105,41,64,0,0,0
2020-07-25 15:30,133,74,59,0,0,0
2020-07-25 15:45,129,62,67,0,0,0
2020-07-25 16:00,73,40,33,0,0,0
2020-07-25 16:15,130,56,74,0,0,0
2020-07-25 16:30,139,57,82,0,0,0
2020-07-25 16:45,95,37,58,0,0,0
2020-07-25 17:00,95,38,57,0,0,0
2020-07-25 17:15,97,43,54,0,0,0
2020-07-25 17:30,106,45,61,0,0,0
2020-07-25 17:45,133,59,74,0,0,0
2020-07-25 18:00,127,52,75,0,0,0
2020-07-25 18:15,120,55,65,0,0,0
2020-07-25 18:30,107,44,63,0,0,0
2020-07-25 18:45,140,76,64,0,0,0
2020-07-25 19:00,106,50,56,0,0,0
2020-07-25 19:15,140,68,72,0,0,0
2020-07-25 19:30,124,51,73,0,0,0
2020-07-25 19:45,106,49,57,0,0,0
2020-07-25 20:00,93,36,57,0,0,0
2020-07-25 20:15,116,55,61,0,0,0
2020-07-25 20:30,85,35,50,0,0,0
2020-07-25 20:45,78,33,45,0,0,0
2020-07-25 21:00,86,42,44,0,0,0
2020-07-25 21:15,53,27,26,0,0,0
2020-07-25 21:30,65,30,35,0,0,0
2020-07-25 21:45,62,27,35,0,0,0
2020-07-25 22:00,62,15,47,0,0,0
2020-07-25 22:15,68,27,41,0,0,0
2020-07-25 22:30,78,31,47,0,0,0
2020-07-25 22:45,59,25,34,0,0,0
2020-07-25 23:00,54,12,42,0,0,0
2020-07-25 23:15,56,22,34,0,0,0
2020-07-25 23:30,83,35,48,0,0,0
2020-07-25 23:45,74,24,50,0,0,0
2020-07-26 00:00,73,15,58,0,0,0
2020-07-26 00:15,61,22,39,0,0,0
2020-07-26 00:30,43,7,36,0,0,0
2020-07-26 00:45,55,16,39,0,0,0
2020-07-26 01:00,54,6,48,0,0,0
2020-07-26 01:15,25,10,15,0,0,0
2020-07-26 01:30,40,20,20,0,0,0
2020-07-26 01:45,47,10,37,0,0,0
2020-07-26 02:00,55,19,36,0,0,0
2020-07-26 02:15,43,10,33,0,0,0
2020-07-26 02:30,24,6,18,0,0,0
2020-07-26 02:45,30,2,28,0,0,0
2020-07-26 03:00,35,11,24,0,0,0
2020-07-26 03:15,24,3,21,0,0,0
2020-07-26 03:30,24,2,22,0,0,0
2020-07-26 03:45,10,3,7,0,0,0
2020-07-26 04:00,13,3,10,0,0,0
2020-07-26 04:15,9,2,7,0,0,0
2020-07-26 04:30,0,0,0,0,0,0
2020-07-26 04:45,3,3,0,0,0,0
2020-07-26 05:00,12,1,11,0,0,0
2020-07-26 05:15,4,0,4,0,0,0
2020-07-26 05:30,19,12,7,0,0,0
2020-07-26 05:45,9,0,9,0,0,0
2020-07-26 06:00,14,3,11,0,0,0
2020-07-26 06:15,9,4,5,0,0,0
2020-07-26 06:30,11,3,8,0,0,0
2020-07-26 06:45,5,1,4,0,0,0
2020-07-26 07:00,4,0,4,0,0,0
2020-07-26 07:15,10,4,6,0,0,0
2020-07-26 07:30,11,4,7,0,0,0
2020-07-26 07:45,7,5,2,0,0,0
2020-07-26 08:00,13,4,9,0,0,0
2020-07-26 08:15,12,9,3,0,0,0
2020-07-26 08:30,11,6,5,0,0,0
2020-07-26 08:45,19,10,9,0,0,0
2020-07-26 09:00,29,17,12,0,0,0
2020-07-26 09:15,24,17,7,0,0,0
2020-07-26 09:30,35,22,13,0,0,0
2020-07-26 09:45,46,41,5,0,0,0
2020-07-26 10:00,53,35,18,0,0,0
2020-07-26 10:15,35,17,18,0,0,0
2020-07-26 10:30,51,35,16,0,0,0
2020-07-26 10:45,83,45,38,0,0,0
2020-07-26 11:00,57,24,33,0,0,0
2020-07-26 11:15,47,30,17,0,0,0
2020-07-26 11:30,51,30,21,0,0,0
2020-07-26 11:45,56,39,17,0,0,0
2020-07-26 12:00,63,38,25,0,0,0
2020-07-26 12:15,62,28,34,0,0,0
2020-07-26 12:30,77,43,34,0,0,0
2020-07-26 12:45,89,48,41,0,0,0
2020-07-26 13:00,72,43,29,0,0,0
2020-07-26 13:15,73,41,32,0,0,0
2020-07-26 13:30,70,40,30,0,0,0
2020-07-26 13:45,92,60,32,0,0,0
2020-07-26 14:00,111,71,40,0,0,0
2020-07-26 14:15,92,58,34,0,0,0
2020-07-26 14:30,104,56,48,0,0,0
2020-07-26 14:45,156,101,55,0,0,0
2020-07-26 15:00,104,40,64,0,0,0
2020-07-26 15:15,148,59,89,0,0,0
2020-07-26 15:30,102,60,42,0,0,0
2020-07-26 15:45,97,44,53,0,0,0
2020-07-26 16:00,110,53,57,0,0,0
2020-07-26 16:15,123,59,64,0,0,0
2020-07-26 16:30,109,49,60,0,0,0
2020-07-26 16:45,127,65,62,0,0,0
2020-07-26 17:00,103,56,47,0,0,0
2020-07-26 17:15,87,39,48,0,0,0
2020-07-26 17:30,108,54,54,0,0,0
2020-07-26 17:45,128,74,54,0,0,0
2020-07-26 18:00,101,52,49,0,0,0
2020-07-26 18:15,108,47,61,0,0,0
2020-07-26 18:30,111,45,66,0,0,0
2020-07-26 18:45,114,65,49,0,0,0
2020-07-26 19:00,96,40,56,0,0,0
2020-07-26 19:15,112,42,70,0,0,0
2020-07-26 19:30,107,56,51,0,0,0
2020-07-26 19:45,135,57,78,0,0,0
2020-07-26 20:00,74,30,44,0,0,0
2020-07-26 20:15,95,44,51,0,0,0
2020-07-26 20:30,101,35,66,0,0,0
2020-07-26 20:45,78,31,47,0,0,0
2020-07-26 21:00,104,52,52,0,0,0
2020-07-26 21:15,80,29,51,0,0,0
2020-07-26 21:30,87,35,52,0,0,0
2020-07-26 21:45,56,19,37,0,0,0
2020-07-26 22:00,73,21,52,0,0,0
2020-07-26 22:15,45,11,34,0,0,0
2020-07-26 22:30,49,13,36,0,0,0
2020-07-26 22:45,57,12,45,0,0,0
2020-07-26 23:00,49,9,40,0,0,0
2020-07-26 23:15,49,13,36,0,0,0
2020-07-26 23:30,17,5,12,0,0,0
2020-07-26 23:45,36,15,21,0,0,0
2020-07-27 00:00,23,4,19,0,0,0
2020-07-27 00:15,16,5,11,0,0,0
2020-07-27 00:30,48,3,45,0,0,0
2020-07-27 00:45,13,5,8,0,0,0
2020-07-27 01:00,15,3,12,0,0,0
2020-07-27 01:15,10,5,5,0,0,0
2020-07-27 01:30,11,5,6,0,0,0
2020-07-27 01:45,6,1,5,0,0,0
2020-07-27 02:00,8,4,4,0,0,0
2020-07-27 02:15,5,0,5,0,0,0
2020-07-27 02:30,7,3,4,0,0,0
2020-07-27 02:45,0,0,0,0,0,0
2020-07-27 03:00,1,0,1,0,0,0
2020-07-27 03:15,3,3,0,0,0,0
2020-07-27 03:30,4,2,2,0,0,0
2020-07-27 03:45,2,1,1,0,0,0
2020-07-27 04:00,1,0,1,0,0,0
2020-07-27 04:15,5,3,2,0,0,0
2020-07-27 04:30,7,7,0,0,0,0
2020-07-27 04:45,8,7,1,0,0,0
2020-07-27 05:00,18,9,9,0,0,0
2020-07-27 05:15,18,10,8,0,0,0
2020-07-27 05:30,18,13,5,0,0,0
2020-07-27 05:45,27,22,5,0,0,0
2020-07-27 06:00,27,20,7,0,0,0
2020-07-27 06:15,51,34,17,0,0,0
2020-07-27 06:30,69,42,27,0,0,0
2020-07-27 06:45,83,51,32,0,0,0
2020-07-27 07:00,94,62,32,0,0,0
2020-07-27 07:15,98,60,38,0,0,0
2020-07-27 07:30,182,112,70,0,0,0
2020-07-27 07:45,180,121,59,0,0,0
2020-07-27 08:00,121,80,41,0,0,0
2020-07-27 08:15,128,79,49,0,0,0
2020-07-27 08:30,161,93,68,0,0,0
2020-07-27 08:45,190,126,64,0,0,0
2020-07-27 09:00,152,82,70,0,0,0
2020-07-27 09:15,117,68,49,0,0,0
2020-07-27 09:30,141,77,64,0,0,0
2020-07-27 09:45,130,81,49,0,0,0
2020-07-27 10:00,128,74,54,0,0,0
2020-07-27 10:15,105,54,51,0,0,0
2020-07-27 10:30,136,66,70,0,0,0
2020-07-27 10:45,119,59,60,0,0,0
2020-07-27 11:00,119,73,46,0,0,0
2020-07-27 11:15,138,71,67,0,0,0
2020-07-27 11:30,153,77,76,0,0,0
2020-07-27 11:45,128,71,57,0,0,0
2020-07-27 12:00,117,57,60,0,0,0
2020-07-27 12:15,137,65,72,0,0,0
2020-07-27 12:30,133,57,76,0,0,0
2020-07-27 12:45,144,65,79,0,0,0
2020-07-27 13:00,132,62,70,0,0,0
2020-07-27 13:15,132,60,72,0,0,0
2020-07-27 13:30,134,50,84,0,0,0
2020-07-27 13:45,150,84,66,0,0,0
2020-07-27 14:00,160,72,88,0,0,0
2020-07-27 14:15,170,79,91,0,0,0
2020-07-27 14:30,134,66,68,0,0,0
2020-07-27 14:45,139,61,78,0,0,0
2020-07-27 15:00,122,55,67,0,0,0
2020-07-27 15:15,140,57,83,0,0,0
2020-07-27 15:30,154,73,81,0,0,0
2020-07-27 15:45,171,86,85,0,0,0
2020-07-27 16:00,210,89,121,0,0,0
2020-07-27 16:15,202,92,110,0,0,0
2020-07-27 16:30,192,86,106,0,0,0
2020-07-27 16:45,193,87,106,0,0,0
2020-07-27 17:00,213,85,128,0,0,0
2020-07-27 17:15,198,98,100,0,0,0
2020-07-27 17:30,212,102,110,0,0,0
2020-07-27 17:45,209,102,107,0,0,0
2020-07-27 18:00,202,95,107,0,0,0
2020-07-27 18:15,150,75,75,0,0,0
2020-07-27 18:30,166,88,78,0,0,0
2020-07-27 18:45,164,81,83,0,0,0
2020-07-27 19:00,140,72,68,0,0,0
2020-07-27 19:15,176,77,99,0,0,0
2020-07-27 19:30,117,53,64,0,0,0
2020-07-27 19:45,153,75,78,0,0,0
2020-07-27 20:00,147,78,69,0,0,0
2020-07-27 20:15,128,73,55,0,0,0
2020-07-27 20:30,86,42,44,0,0,0
2020-07-27 20:45,114,42,72,0,0,0
2020-07-27 21:00,86,52,34,0,0,0
2020-07-27 21:15,91,39,52,0,0,0
2020-07-27 21:30,85,44,41,0,0,0
2020-07-27 21:45,65,26,39,0,0,0
2020-07-27 22:00,74,29,45,0,0,0
2020-07-27 22:15,70,25,45,0,0,0
2020-07-27 22:30,50,19,31,0,0,0
2020-07-27 22:45,68,25,43,0,0,0
2020-07-27 23:00,33,11,22,0,0,0
2020-07-27 23:15,31,13,18,0,0,0
2020-07-27 23:30,88,5,83,0,0,0
2020-07-27 23:45,70,12,58,0,0,0
2020-07-28 00:00,36,15,21,0,0,0
2020-07-28 00:15,38,4,34,0,0,0
2020-07-28 00:30,29,11,18,0,0,0
2020-07-28 00:45,24,2,22,0,0,0
2020-07-28 01:00,22,8,14,0,0,0
2020-07-28 01:15,20,8,12,0,0,0
2020-07-28 01:30,10,1,9,0,0,0
2020-07-28 01:45,17,1,16,0,0,0
2020-07-28 02:00,14,6,8,0,0,0
2020-07-28 02:15,7,6,1,0,0,0
2020-07-28 02:30,3,1,2,0,0,0
2020-07-28 02:45,4,2,2,0,0,0
2020-07-28 03:00,3,2,1,0,0,0
2020-07-28 03:15,4,1,3,0,0,0
2020-07-28 03:30,3,1,2,0,0,0
2020-07-28 03:45,3,1,2,0,0,0
2020-07-28 04:00,9,1,8,0,0,0
2020-07-28 04:15,8,6,2,0,0,0
2020-07-28 04:30,7,4,3,0,0,0
2020-07-28 04:45,7,3,4,0,0,0
2020-07-28 05:00,8,4,4,0,0,0
2020-07-28 05:15,17,11,6,0,0,0
2020-07-28 05:30,16,12,4,0,0,0
2020-07-28 05:45,23,19,4,0,0,0
2020-07-28 06:00,39,29,10,0,0,0
2020-07-28 06:15,48,30,18,0,0,0
2020-07-28 06:30,76,44,32,0,0,0
2020-07-28 06:45,77,56,21,0,0,0
2020-07-28 07:00,82,57,25,0,0,0
2020-07-28 07:15,105,64,41,0,0,0
2020-07-28 07:30,182,106,76,0,0,0
2020-07-28 07:45,198,127,71,0,0,0
2020-07-28 08:00,138,77,61,0,0,0
2020-07-28 08:15,143,98,45,0,0,0
2020-07-28 08:30,172,107,65,0,0,0
2020-07-28 08:45,163,103,60,0,0,0
2020-07-28 09:00,143,92,51,0,0,0
2020-07-28 09:15,137,84,53,0,0,0
2020-07-28 09:30,137,81,56,0,0,0
2020-07-28 09:45,143,79,64,0,0,0
2020-07-28 10:00,91,46,45,0,0,0
2020-07-28 10:15,121,56,65,0,0,0
2020-07-28 10:30,104,54,50,0,0,0
2020-07-28 10:45,121,75,46,0,0,0
2020-07-28 11:00,118,67,51,0,0,0
2020-07-28 11:15,140,80,60,0,0,0
2020-07-28 11:30,143,67,76,0,0,0
2020-07-28 11:45,132,74,58,0,0,0
2020-07-28 12:00,140,66,74,0,0,0
2020-07-28 12:15,144,75,69,0,0,0
2020-07-28 12:30,149,67,82,0,0,0
2020-07-28 12:45,158,95,63,0,0,0
2020-07-28 13:00,164,92,72,0,0,0
2020-07-28 13:15,140,66,74,0,0,0
2020-07-28 13:30,156,79,77,0,0,0
2020-07-28 13:45,156,89,67,0,0,0
2020-07-28 14:00,187,93,94,0,0,0
2020-07-28 14:15,170,89,81,0,0,0
2020-07-28 14:30,150,77,73,0,0,0
2020-07-28 14:45,144,74,70,0,0,0
2020-07-28 15:00,174,74,100,0,0,0
2020-07-28 15:15,165,86,79,0,0,0
2020-07-28 15:30,155,70,85,0,0,0
2020-07-28 15:45,196,103,93,0,0,0
2020-07-28 16:00,241,97,144,0,0,0
2020-07-28 16:15,214,90,124,0,0,0
2020-07-28 16:30,217,98,119,0,0,0
2020-07-28 16:45,233,107,126,0,0,0
2020-07-28 17:00,229,95,134,0,0,0
2020-07-28 17:15,231,109,122,0,0,0
2020-07-28 17:30,229,101,128,0,0,0
2020-07-28 17:45,280,133,147,0,0,0
2020-07-28 18:00,218,93,125,0,0,0
2020-07-28 18:15,183,79,104,0,0,0
2020-07-28 18:30,184,90,94,0,0,0
2020-07-28 18:45,200,97,103,0,0,0
2020-07-28 19:00,193,89,104,0,0,0
2020-07-28 19:15,185,87,98,0,0,0
2020-07-28 19:30,164,73,91,0,0,0
2020-07-28 19:45,171,95,76,0,0,0
2020-07-28 20:00,156,67,89,0,0,0
2020-07-28 20:15,129,73,56,0,0,0
2020-07-28 20:30,128,54,74,0,0,0
2020-07-28 20:45,97,38,59,0,0,0
2020-07-28 21:00,95,45,50,0,0,0
2020-07-28 21:15,86,29,57,0,0,0
2020-07-28 21:30,87,31,56,0,0,0
2020-07-28 21:45,85,23,62,0,0,0
2020-07-28 22:00,55,22,33,0,0,0
2020-07-28 22:15,68,17,51,0,0,0
2020-07-28 22:30,70,23,47,0,0,0
2020-07-28 22:45,60,23,37,0,0,0
2020-07-28 23:00,65,28,37,0,0,0
2020-07-28 23:15,57,11,46,0,0,0
2020-07-28 23:30,62,25,37,0,0,0
2020-07-28 23:45,39,16,23,0,0,0
2020-07-29 00:00,56,16,40,0,0,0
2020-07-29 00:15,35,13,22,0,0,0
2020-07-29 00:30,37,15,22,0,0,0
2020-07-29 00:45,23,8,15,0,0,0
2020-07-29 01:00,25,7,18,0,0,0
2020-07-29 01:15,14,6,8,0,0,0
2020-07-29 01:30,15,5,10,0,0,0
2020-07-29 01:45,19,8,11,0,0,0
2020-07-29 02:00,12,9,3,0,0,0
2020-07-29 02:15,7,3,4,0,0,0
2020-07-29 02:30,10,3,7,0,0,0
2020-07-29 02:45,12,6,6,0,0,0
2020-07-29 03:00,4,1,3,0,0,0
2020-07-29 03:15,1,0,1,0,0,0
2020-07-29 03:30,6,3,3,0,0,0
2020-07-29 03:45,5,2,3,0,0,0
2020-07-29 04:00,3,2,1,0,0,0
2020-07-29 04:15,6,5,1,0,0,0
2020-07-29 04:30,14,9,5,0,0,0
2020-07-29 04:45,10,4,6,0,0,0
2020-07-29 05:00,4,1,3,0,0,0
2020-07-29 05:15,17,11,6,0,0,0
2020-07-29 05:30,13,10,3,0,0,0
2020-07-29 05:45,25,18,7,0,0,0
2020-07-29 06:00,30,22,8,0,0,0
2020-07-29 06:15,53,38,15,0,0,0
2020-07-29 06:30,54,40,14,0,0,0
2020-07-29 06:45,81,55,26,0,0,0
2020-07-29 07:00,83,58,25,0,0,0
2020-07-29 07:15,106,71,35,0,0,0
2020-07-29 07:30,183,112,71,0,0,0
2020-07-29 07:45,189,114,75,0,0,0
2020-07-29 08:00,146,84,62,0,0,0
2020-07-29 08:15,164,104,60,0,0,0
2020-07-29 08:30,178,101,77,0,0,0
2020-07-29 08:45,178,110,68,0,0,0
2020-07-29 09:00,145,91,54,0,0,0
2020-07-29 09:15,165,102,63,0,0,0
2020-07-29 09:30,147,76,71,0,0,0
2020-07-29 09:45,175,102,73,0,0,0
2020-07-29 10:00,134,86,48,0,0,0
2020-07-29 10:15,136,76,60,0,0,0
2020-07-29 10:30,147,75,72,0,0,0
2020-07-29 10:45,161,112,49,0,0,0
2020-07-29 11:00,171,114,57,0,0,0
2020-07-29 11:15,194,109,85,0,0,0
2020-07-29 11:30,174,89,85,0,0,0
2020-07-29 11:45,150,81,69,0,0,0
2020-07-29 12:00,183,100,83,0,0,0
2020-07-29 12:15,181,101,80,0,0,0
2020-07-29 12:30,148,76,72,0,0,0
2020-07-29 12:45,193,104,89,0,0,0
2020-07-29 13:00,156,72,84,0,0,0
2020-07-29 13:15,229,100,129,0,0,0
2020-07-29 13:30,163,80,83,0,0,0
2020-07-29 13:45,230,116,114,0,0,0
2020-07-29 14:00,170,80,90,0,0,0
2020-07-29 14:15,192,91,101,0,0,0
2020-07-29 14:30,178,71,107,0,0,0
2020-07-29 14:45,159,77,82,0,0,0
2020-07-29 15:00,146,64,82,0,0,0
2020-07-29 15:15,166,74,92,0,0,0
2020-07-29 15:30,178,98,80,0,0,0
2020-07-29 15:45,228,111,117,0,0,0
2020-07-29 16:00,210,78,132,0,0,0
2020-07-29 16:15,215,98,117,0,0,0
2020-07-29 16:30,227,108,119,0,0,0
2020-07-29 16:45,226,107,119,0,0,0
2020-07-29 17:00,205,90,115,0,0,0
2020-07-29 17:15,235,105,130,0,0,0
2020-07-29 17:30,245,123,122,0,0,0
2020-07-29 17:45,278,119,159,0,0,0
2020-07-29 18:00,230,115,115,0,0,0
2020-07-29 18:15,216,95,121,0,0,0
2020-07-29 18:30,176,75,101,0,0,0
2020-07-29 18:45,209,120,89,0,0,0
2020-07-29 19:00,184,94,90,0,0,0
2020-07-29 19:15,169,81,88,0,0,0
2020-07-29 19:30,149,75,74,0,0,0
2020-07-29 19:45,170,77,93,0,0,0
2020-07-29 20:00,167,81,86,0,0,0
2020-07-29 20:15,138,75,63,0,0,0
2020-07-29 20:30,113,47,66,0,0,0
2020-07-29 20:45,109,48,61,0,0,0
2020-07-29 21:00,105,49,56,0,0,0
2020-07-29 21:15,100,60,40,0,0,0
2020-07-29 21:30,79,33,46,0,0,0
2020-07-29 21:45,108,40,68,0,0,0
2020-07-29 22:00,92,31,61,0,0,0
2020-07-29 22:15,75,36,39,0,0,0
2020-07-29 22:30,69,21,48,0,0,0
2020-07-29 22:45,71,22,49,0,0,0
2020-07-29 23:00,79,25,54,0,0,0
2020-07-29 23:15,69,20,49,0,0,0
2020-07-29 23:30,40,16,24,0,0,0
2020-07-29 23:45,52,18,34,0,0,0
2020-07-30 00:00,44,9,35,0,0,0
2020-07-30 00:15,47,28,19,0,0,0
2020-07-30 00:30,54,29,25,0,0,0
2020-07-30 00:45,36,21,15,0,0,0
2020-07-30 01:00,40,9,31,0,0,0
2020-07-30 01:15,25,6,19,0,0,0
2020-07-30 01:30,31,9,22,0,0,0
2020-07-30 01:45,31,6,25,0,0,0
2020-07-30 02:00,25,4,21,0,0,0
2020-07-30 02:15,24,4,20,0,0,0
2020-07-30 02:30,20,5,15,0,0,0
2020-07-30 02:45,6,2,4,0,0,0
2020-07-30 03:00,8,2,6,0,0,0
2020-07-30 03:15,24,4,20,0,0,0
2020-07-30 03:30,14,4,10,0,0,0
2020-07-30 03:45,6,2,4,0,0,0
2020-07-30 04:00,10,5,5,0,0,0
2020-07-30 04:15,8,6,2,0,0,0
2020-07-30 04:30,10,7,3,0,0,0
2020-07-30 04:45,6,2,4,0,0,0
2020-07-30 05:00,6,4,2,0,0,0
2020-07-30 05:15,22,12,10,0,0,0
2020-07-30 05:30,14,10,4,0,0,0
2020-07-30 05:45,23,21,2,0,0,0
2020-07-30 06:00,31,21,10,0,0,0
2020-07-30 06:15,47,24,23,0,0,0
2020-07-30 06:30,61,43,18,0,0,0
2020-07-30 06:45,67,46,21,0,0,0
2020-07-30 07:00,100,69,31,0,0,0
2020-07-30 07:15,110,65,45,0,0,0
2020-07-30 07:30,175,118,57,0,0,0
2020-07-30 07:45,180,116,64,0,0,0
2020-07-30 08:00,129,74,55,0,0,0
2020-07-30 08:15,146,88,58,0,0,0
2020-07-30 08:30,157,92,65,0,0,0
2020-07-30 08:45,197,134,63,0,0,0
2020-07-30 09:00,150,96,54,0,0,0
2020-07-30 09:15,143,93,50,0,0,0
2020-07-30 09:30,158,92,66,0,0,0
2020-07-30 09:45,131,82,49,0,0,0
2020-07-30 10:00,110,69,41,0,0,0
2020-07-30 10:15,115,65,50,0,0,0
2020-07-30 10:30,89,41,48,0,0,0
2020-07-30 10:45,148,81,67,0,0,0
2020-07-30 11:00,104,47,57,0,0,0
2020-07-30 11:15,109,54,55,0,0,0
2020-07-30 11:30,135,77,58,0,0,0
2020-07-30 11:45,159,87,72,0,0,0
2020-07-30 12:00,137,66,71,0,0,0
2020-07-30 12:15,166,83,83,0,0,0
2020-07-30 12:30,190,84,106,0,0,0
2020-07-30 12:45,198,108,90,0,0,0
2020-07-30 13:00,151,85,66,0,0,0
2020-07-30 13:15,194,67,127,0,0,0
2020-07-30 13:30,160,77,83,0,0,0
2020-07-30 13:45,181,101,80,0,0,0
2020-07-30 14:00,178,117,61,0,0,0
2020-07-30 14:15,205,110,95,0,0,0
2020-07-30 14:30,175,83,92,0,0,0
2020-07-30 14:45,177,87,90,0,0,0
2020-07-30 15:00,152,74,78,0,0,0
2020-07-30 15:15,162,78,84,0,0,0
2020-07-30 15:30,197,103,94,0,0,0
2020-07-30 15:45,200,111,89,0,0,0
2020-07-30 16:00,220,113,107,0,0,0
2020-07-30 16:15,223,96,127,0,0,0
2020-07-30 16:30,221,108,113,0,0,0
2020-07-30 16:45,250,113,137,0,0,0
2020-07-30 17:00,235,110,125,0,0,0
2020-07-30 17:15,239,98,141,0,0,0
2020-07-30 17:30,279,125,154,0,0,0
2020-07-30 17:45,253,125,128,0,0,0
2020-07-30 18:00,227,110,117,0,0,0
2020-07-30 18:15,216,108,108,0,0,0
2020-07-30 18:30,219,101,118,0,0,0
2020-07-30 18:45,216,113,103,0,0,0
2020-07-30 19:00,212,105,107,0,0,0
2020-07-30 19:15,173,93,80,0,0,0
2020-07-30 19:30,171,84,87,0,0,0
2020-07-30 19:45,180,81,99,0,0,0
2020-07-30 20:00,180,67,113,0,0,0
2020-07-30 20:15,138,59,79,0,0,0
2020-07-30 20:30,127,57,70,0,0,0
2020-07-30 20:45,111,52,59,0,0,0
2020-07-30 21:00,124,53,71,0,0,0
2020-07-30 21:15,121,51,70,0,0,0
2020-07-30 21:30,121,48,73,0,0,0
2020-07-30 21:45,107,36,71,0,0,0
2020-07-30 22:00,72,17,55,0,0,0
2020-07-30 22:15,103,29,74,0,0,0
2020-07-30 22:30,94,27,67,0,0,0
2020-07-30 22:45,60,19,41,0,0,0
2020-07-30 23:00,62,21,41,0,0,0
2020-07-30 23:15,52,22,30,0,0,0
2020-07-30 23:30,72,21,51,0,0,0
2020-07-30 23:45,57,29,28,0,0,0
2020-07-31 00:00,42,9,33,0,0,0
2020-07-31 00:15,64,15,49,0,0,0
2020-07-31 00:30,31,8,23,0,0,0
2020-07-31 00:45,24,6,18,0,0,0
2020-07-31 01:00,23,8,15,0,0,0
2020-07-31 01:15,31,13,18,0,0,0
2020-07-31 01:30,17,4,13,0,0,0
2020-07-31 01:45,10,3,7,0,0,0
2020-07-31 02:00,13,5,8,0,0,0
2020-07-31 02:15,9,5,4,0,0,0
2020-07-31 02:30,10,7,3,0,0,0
2020-07-31 02:45,6,2,4,0,0,0
2020-07-31 03:00,10,3,7,0,0,0
2020-07-31 03:15,12,0,12,0,0,0
2020-07-31 03:30,5,2,3,0,0,0
2020-07-31 03:45,5,0,5,0,0,0
2020-07-31 04:00,1,0,1,0,0,0
2020-07-31 04:15,4,2,2,0,0,0
2020-07-31 04:30,14,9,5,0,0,0
2020-07-31 04:45,16,7,9,0,0,0
2020-07-31 05:00,6,1,5,0,0,0
2020-07-31 05:15,13,6,7,0,0,0
2020-07-31 05:30,32,20,12,0,0,0
2020-07-31 05:45,22,17,5,0,0,0
2020-07-31 06:00,26,14,12,0,0,0
2020-07-31 06:15,56,34,22,0,0,0
2020-07-31 06:30,51,28,23,0,0,0
2020-07-31 06:45,65,42,23,0,0,0
2020-07-31 07:00,81,51,30,0,0,0
2020-07-31 07:15,90,63,27,0,0,0
2020-07-31 07:30,157,94,63,0,0,0
2020-07-31 07:45,133,74,59,0,0,0
2020-07-31 08:00,131,74,57,0,0,0
2020-07-31 08:15,140,93,47,0,0,0
2020-07-31 08:30,149,89,60,0,0,0
2020-07-31 08:45,183,121,62,0,0,0
2020-07-31 09:00,136,88,48,0,0,0
2020-07-31 09:15,208,130,78,0,0,0
2020-07-31 09:30,177,117,60,0,0,0
2020-07-31 09:45,186,113,73,0,0,0
2020-07-31 10:00,151,66,85,0,0,0
2020-07-31 10:15,117,64,53,0,0,0
2020-07-31 10:30,138,79,59,0,0,0
2020-07-31 10:45,140,77,63,0,0,0
2020-07-31 11:00,131,77,54,0,0,0
2020-07-31 11:15,145,84,61,0,0,0
2020-07-31 11:30,164,85,79,0,0,0
2020-07-31 11:45,171,98,73,0,0,0
2020-07-31 12:00,171,95,76,0,0,0
2020-07-31 12:15,217,96,121,0,0,0
2020-07-31 12:30,174,90,84,0,0,0
2020-07-31 12:45,162,86,76,0,0,0
2020-07-31 13:00,191,82,109,0,0,0
2020-07-31 13:15,188,85,103,0,0,0
2020-07-31 13:30,167,85,82,0,0,0
2020-07-31 13:45,182,102,80,0,0,0
2020-07-31 14:00,248,139,109,0,0,0
2020-07-31 14:15,207,111,96,0,0,0
2020-07-31 14:30,209,99,110,0,0,0
2020-07-31 14:45,201,106,95,0,0,0
2020-07-31 15:00,198,92,106,0,0,0
2020-07-31 15:15,174,108,66,0,0,0
2020-07-31 15:30,190,104,86,0,0,0
2020-07-31 15:45,177,103,74,0,0,0
2020-07-31 16:00,182,83,99,0,0,0
2020-07-31 16:15,174,83,91,0,0,0
2020-07-31 16:30,170,65,105,0,0,0
2020-07-31 16:45,196,110,86,0,0,0
2020-07-31 17:00,216,87,129,0,0,0
2020-07-31 17:15,216,113,103,0,0,0
2020-07-31 17:30,222,128,94,0,0,0
2020-07-31 17:45,205,112,93,0,0,0
2020-07-31 18:00,198,99,99,0,0,0
2020-07-31 18:15,191,87,104,0,0,0
2020-07-31 18:30,204,101,103,0,0,0
2020-07-31 18:45,216,129,87,0,0,0
2020-07-31 19:00,211,95,116,0,0,0
2020-07-31 19:15,177,96,81,0,0,0
2020-07-31 19:30,137,74,63,0,0,0
2020-07-31 19:45,165,88,77,0,0,0
2020-07-31 20:00,130,66,64,0,0,0
2020-07-31 20:15,169,89,80,0,0,0
2020-07-31 20:30,149,76,73,0,0,0
2020-07-31 20:45,134,64,70,0,0,0
2020-07-31 21:00,114,48,66,0,0,0
2020-07-31 21:15,120,49,71,0,0,0
2020-07-31 21:30,95,38,57,0,0,0
2020-07-31 21:45,121,45,76,0,0,0
2020-07-31 22:00,85,38,47,0,0,0
2020-07-31 22:15,113,31,82,0,0,0
2020-07-31 22:30,102,28,74,0,0,0
2020-07-31 22:45,90,21,69,0,0,0
2020-07-31 23:00,82,31,51,0,0,0
2020-07-31 23:15,118,37,81,0,0,0
2020-07-31 23:30,91,28,63,0,0,0
2020-07-31 23:45,74,28,46,0,0,0
