Datetime,100035541 (Neutor),101035541 (Neutor stadteinwÃ¤rts),102035541 (Neutor stadtauswÃ¤rts),100035541-status,101035541-status,102035541-status
2020-01-01 00:00,7,6,1,0,0,0
2020-01-01 00:15,20,14,6,0,0,0
2020-01-01 00:30,43,20,23,0,0,0
2020-01-01 00:45,40,7,33,0,0,0
2020-01-01 01:00,32,13,19,0,0,0
2020-01-01 01:15,37,14,23,0,0,0
2020-01-01 01:30,44,16,28,0,0,0
2020-01-01 01:45,64,35,29,0,0,0
2020-01-01 02:00,62,33,29,0,0,0
2020-01-01 02:15,60,19,41,0,0,0
2020-01-01 02:30,67,34,33,0,0,0
2020-01-01 02:45,69,30,39,0,0,0
2020-01-01 03:00,45,12,33,0,0,0
2020-01-01 03:15,55,26,29,0,0,0
2020-01-01 03:30,66,11,55,0,0,0
2020-01-01 03:45,67,26,41,0,0,0
2020-01-01 04:00,62,20,42,0,0,0
2020-01-01 04:15,52,17,35,0,0,0
2020-01-01 04:30,47,24,23,0,0,0
2020-01-01 04:45,29,9,20,0,0,0
2020-01-01 05:00,32,5,27,0,0,0
2020-01-01 05:15,29,9,20,0,0,0
2020-01-01 05:30,16,3,13,0,0,0
2020-01-01 05:45,17,4,13,0,0,0
2020-01-01 06:00,10,3,7,0,0,0
2020-01-01 06:15,10,4,6,0,0,0
2020-01-01 06:30,14,4,10,0,0,0
2020-01-01 06:45,17,1,16,0,0,0
2020-01-01 07:00,13,3,10,0,0,0
2020-01-01 07:15,13,3,10,0,0,0
2020-01-01 07:30,4,2,2,0,0,0
2020-01-01 07:45,6,3,3,0,0,0
2020-01-01 08:00,5,0,5,0,0,0
2020-01-01 08:15,5,0,5,0,0,0
2020-01-01 08:30,13,6,7,0,0,0
2020-01-01 08:45,8,5,3,0,0,0
2020-01-01 09:00,6,3,3,0,0,0
2020-01-01 09:15,10,9,1,0,0,0
2020-01-01 09:30,13,5,8,0,0,0
2020-01-01 09:45,6,5,1,0,0,0
2020-01-01 10:00,4,3,1,0,0,0
2020-01-01 10:15,11,9,2,0,0,0
2020-01-01 10:30,9,3,6,0,0,0
2020-01-01 10:45,10,7,3,0,0,0
2020-01-01 11:00,21,14,7,0,0,0
2020-01-01 11:15,15,12,3,0,0,0
2020-01-01 11:30,25,21,4,0,0,0
2020-01-01 11:45,13,11,2,0,0,0
2020-01-01 12:00,18,11,7,0,0,0
2020-01-01 12:15,20,12,8,0,0,0
2020-01-01 12:30,27,18,9,0,0,0
2020-01-01 12:45,30,16,14,0,0,0
2020-01-01 13:00,22,15,7,0,0,0
2020-01-01 13:15,28,17,11,0,0,0
2020-01-01 13:30,35,18,17,0,0,0
2020-01-01 13:45,36,19,17,0,0,0
2020-01-01 14:00,51,22,29,0,0,0
2020-01-01 14:15,33,16,17,0,0,0
2020-01-01 14:30,32,17,15,0,0,0
2020-01-01 14:45,33,16,17,0,0,0
2020-01-01 15:00,35,20,15,0,0,0
2020-01-01 15:15,41,29,12,0,0,0
2020-01-01 15:30,37,20,17,0,0,0
2020-01-01 15:45,42,30,12,0,0,0
2020-01-01 16:00,34,18,16,0,0,0
2020-01-01 16:15,33,18,15,0,0,0
2020-01-01 16:30,42,20,22,0,0,0
2020-01-01 16:45,47,22,25,0,0,0
2020-01-01 17:00,34,12,22,0,0,0
2020-01-01 17:15,47,17,30,0,0,0
2020-01-01 17:30,19,7,12,0,0,0
2020-01-01 17:45,21,6,15,0,0,0
2020-01-01 18:00,29,15,14,0,0,0
2020-01-01 18:15,30,10,20,0,0,0
2020-01-01 18:30,38,15,23,0,0,0
2020-01-01 18:45,29,6,23,0,0,0
2020-01-01 19:00,28,9,19,0,0,0
2020-01-01 19:15,23,7,16,0,0,0
2020-01-01 19:30,22,9,13,0,0,0
2020-01-01 19:45,28,17,11,0,0,0
2020-01-01 20:00,30,10,20,0,0,0
2020-01-01 20:15,20,13,7,0,0,0
2020-01-01 20:30,9,3,6,0,0,0
2020-01-01 20:45,18,6,12,0,0,0
2020-01-01 21:00,10,4,6,0,0,0
2020-01-01 21:15,17,2,15,0,0,0
2020-01-01 21:30,9,6,3,0,0,0
2020-01-01 21:45,15,6,9,0,0,0
2020-01-01 22:00,11,4,7,0,0,0
2020-01-01 22:15,12,3,9,0,0,0
2020-01-01 22:30,17,6,11,0,0,0
2020-01-01 22:45,7,3,4,0,0,0
2020-01-01 23:00,9,3,6,0,0,0
2020-01-01 23:15,6,6,0,0,0,0
2020-01-01 23:30,13,2,11,0,0,0
2020-01-01 23:45,2,1,1,0,0,0
2020-01-02 00:00,6,4,2,0,0,0
2020-01-02 00:15,3,2,1,0,0,0
2020-01-02 00:30,6,3,3,0,0,0
2020-01-02 00:45,2,1,1,0,0,0
2020-01-02 01:00,3,2,1,0,0,0
2020-01-02 01:15,3,0,3,0,0,0
2020-01-02 01:30,3,1,2,0,0,0
2020-01-02 01:45,2,0,2,0,0,0
2020-01-02 02:00,0,0,0,0,0,0
2020-01-02 02:15,1,0,1,0,0,0
2020-01-02 02:30,0,0,0,0,0,0
2020-01-02 02:45,3,0,3,0,0,0
2020-01-02 03:00,0,0,0,0,0,0
2020-01-02 03:15,3,3,0,0,0,0
2020-01-02 03:30,3,1,2,0,0,0
2020-01-02 03:45,2,2,0,0,0,0
2020-01-02 04:00,0,0,0,0,0,0
2020-01-02 04:15,1,1,0,0,0,0
2020-01-02 04:30,2,1,1,0,0,0
2020-01-02 04:45,1,1,0,0,0,0
2020-01-02 05:00,1,0,1,0,0,0
2020-01-02 05:15,7,7,0,0,0,0
2020-01-02 05:30,10,9,1,0,0,0
2020-01-02 05:45,10,5,5,0,0,0
2020-01-02 06:00,12,7,5,0,0,0
2020-01-02 06:15,15,8,7,0,0,0
2020-01-02 06:30,39,29,10,0,0,0
2020-01-02 06:45,22,14,8,0,0,0
2020-01-02 07:00,38,29,9,0,0,0
2020-01-02 07:15,55,34,21,0,0,0
2020-01-02 07:30,67,42,25,0,0,0
2020-01-02 07:45,82,57,25,0,0,0
2020-01-02 08:00,71,44,27,0,0,0
2020-01-02 08:15,56,41,15,0,0,0
2020-01-02 08:30,71,43,28,0,0,0
2020-01-02 08:45,79,50,29,0,0,0
2020-01-02 09:00,64,38,26,0,0,0
2020-01-02 09:15,58,44,14,0,0,0
2020-01-02 09:30,49,38,11,0,0,0
2020-01-02 09:45,79,53,26,0,0,0
2020-01-02 10:00,49,33,16,0,0,0
2020-01-02 10:15,47,36,11,0,0,0
2020-01-02 10:30,51,37,14,0,0,0
2020-01-02 10:45,53,33,20,0,0,0
2020-01-02 11:00,64,34,30,0,0,0
2020-01-02 11:15,54,31,23,0,0,0
2020-01-02 11:30,64,30,34,0,0,0
2020-01-02 11:45,66,46,20,0,0,0
2020-01-02 12:00,68,33,35,0,0,0
2020-01-02 12:15,62,34,28,0,0,0
2020-01-02 12:30,84,44,40,0,0,0
2020-01-02 12:45,100,47,53,0,0,0
2020-01-02 13:00,80,48,32,0,0,0
2020-01-02 13:15,89,46,43,0,0,0
2020-01-02 13:30,78,51,27,0,0,0
2020-01-02 13:45,108,60,48,0,0,0
2020-01-02 14:00,89,48,41,0,0,0
2020-01-02 14:15,93,52,41,0,0,0
2020-01-02 14:30,111,55,56,0,0,0
2020-01-02 14:45,113,59,54,0,0,0
2020-01-02 15:00,86,42,44,0,0,0
2020-01-02 15:15,106,56,50,0,0,0
2020-01-02 15:30,101,58,43,0,0,0
2020-01-02 15:45,110,66,44,0,0,0
2020-01-02 16:00,131,76,55,0,0,0
2020-01-02 16:15,126,58,68,0,0,0
2020-01-02 16:30,108,39,69,0,0,0
2020-01-02 16:45,135,59,76,0,0,0
2020-01-02 17:00,106,49,57,0,0,0
2020-01-02 17:15,115,44,71,0,0,0
2020-01-02 17:30,119,47,72,0,0,0
2020-01-02 17:45,121,47,74,0,0,0
2020-01-02 18:00,103,37,66,0,0,0
2020-01-02 18:15,125,42,83,0,0,0
2020-01-02 18:30,93,37,56,0,0,0
2020-01-02 18:45,101,43,58,0,0,0
2020-01-02 19:00,109,36,73,0,0,0
2020-01-02 19:15,79,27,52,0,0,0
2020-01-02 19:30,76,22,54,0,0,0
2020-01-02 19:45,79,40,39,0,0,0
2020-01-02 20:00,49,18,31,0,0,0
2020-01-02 20:15,64,27,37,0,0,0
2020-01-02 20:30,46,20,26,0,0,0
2020-01-02 20:45,33,12,21,0,0,0
2020-01-02 21:00,36,17,19,0,0,0
2020-01-02 21:15,22,13,9,0,0,0
2020-01-02 21:30,27,12,15,0,0,0
2020-01-02 21:45,28,13,15,0,0,0
2020-01-02 22:00,23,10,13,0,0,0
2020-01-02 22:15,40,14,26,0,0,0
2020-01-02 22:30,30,10,20,0,0,0
2020-01-02 22:45,30,11,19,0,0,0
2020-01-02 23:00,29,11,18,0,0,0
2020-01-02 23:15,16,9,7,0,0,0
2020-01-02 23:30,17,4,13,0,0,0
2020-01-02 23:45,27,9,18,0,0,0
2020-01-03 00:00,12,3,9,0,0,0
2020-01-03 00:15,18,8,10,0,0,0
2020-01-03 00:30,16,8,8,0,0,0
2020-01-03 00:45,7,3,4,0,0,0
2020-01-03 01:00,6,3,3,0,0,0
2020-01-03 01:15,15,4,11,0,0,0
2020-01-03 01:30,12,6,6,0,0,0
2020-01-03 01:45,12,1,11,0,0,0
2020-01-03 02:00,6,3,3,0,0,0
2020-01-03 02:15,12,9,3,0,0,0
2020-01-03 02:30,2,0,2,0,0,0
2020-01-03 02:45,6,2,4,0,0,0
2020-01-03 03:00,1,0,1,0,0,0
2020-01-03 03:15,2,0,2,0,0,0
2020-01-03 03:30,1,0,1,0,0,0
2020-01-03 03:45,3,2,1,0,0,0
2020-01-03 04:00,4,2,2,0,0,0
2020-01-03 04:15,1,1,0,0,0,0
2020-01-03 04:30,2,1,1,0,0,0
2020-01-03 04:45,2,1,1,0,0,0
2020-01-03 05:00,1,1,0,0,0,0
2020-01-03 05:15,6,5,1,0,0,0
2020-01-03 05:30,14,10,4,0,0,0
2020-01-03 05:45,11,5,6,0,0,0
2020-01-03 06:00,15,11,4,0,0,0
2020-01-03 06:15,19,12,7,0,0,0
2020-01-03 06:30,32,17,15,0,0,0
2020-01-03 06:45,42,26,16,0,0,0
2020-01-03 07:00,36,23,13,0,0,0
2020-01-03 07:15,57,40,17,0,0,0
2020-01-03 07:30,68,42,26,0,0,0
2020-01-03 07:45,79,49,30,0,0,0
2020-01-03 08:00,78,59,19,0,0,0
2020-01-03 08:15,85,61,24,0,0,0
2020-01-03 08:30,55,40,15,0,0,0
2020-01-03 08:45,115,71,44,0,0,0
2020-01-03 09:00,84,52,32,0,0,0
2020-01-03 09:15,67,49,18,0,0,0
2020-01-03 09:30,75,56,19,0,0,0
2020-01-03 09:45,89,66,23,0,0,0
2020-01-03 10:00,82,49,33,0,0,0
2020-01-03 10:15,67,40,27,0,0,0
2020-01-03 10:30,67,42,25,0,0,0
2020-01-03 10:45,88,55,33,0,0,0
2020-01-03 11:00,66,45,21,0,0,0
2020-01-03 11:15,66,36,30,0,0,0
2020-01-03 11:30,89,60,29,0,0,0
2020-01-03 11:45,81,51,30,0,0,0
2020-01-03 12:00,78,56,22,0,0,0
2020-01-03 12:15,91,50,41,0,0,0
2020-01-03 12:30,74,44,30,0,0,0
2020-01-03 12:45,88,55,33,0,0,0
2020-01-03 13:00,101,48,53,0,0,0
2020-01-03 13:15,86,43,43,0,0,0
2020-01-03 13:30,67,31,36,0,0,0
2020-01-03 13:45,88,51,37,0,0,0
2020-01-03 14:00,81,45,36,0,0,0
2020-01-03 14:15,81,47,34,0,0,0
2020-01-03 14:30,90,40,50,0,0,0
2020-01-03 14:45,88,37,51,0,0,0
2020-01-03 15:00,101,50,51,0,0,0
2020-01-03 15:15,86,35,51,0,0,0
2020-01-03 15:30,78,37,41,0,0,0
2020-01-03 15:45,83,45,38,0,0,0
2020-01-03 16:00,67,23,44,0,0,0
2020-01-03 16:15,81,27,54,0,0,0
2020-01-03 16:30,74,29,45,0,0,0
2020-01-03 16:45,88,36,52,0,0,0
2020-01-03 17:00,82,29,53,0,0,0
2020-01-03 17:15,76,30,46,0,0,0
2020-01-03 17:30,92,32,60,0,0,0
2020-01-03 17:45,77,33,44,0,0,0
2020-01-03 18:00,68,25,43,0,0,0
2020-01-03 18:15,76,29,47,0,0,0
2020-01-03 18:30,54,24,30,0,0,0
2020-01-03 18:45,86,43,43,0,0,0
2020-01-03 19:00,105,40,65,0,0,0
2020-01-03 19:15,69,44,25,0,0,0
2020-01-03 19:30,66,32,34,0,0,0
2020-01-03 19:45,57,26,31,0,0,0
2020-01-03 20:00,60,32,28,0,0,0
2020-01-03 20:15,59,22,37,0,0,0
2020-01-03 20:30,65,18,47,0,0,0
2020-01-03 20:45,37,16,21,0,0,0
2020-01-03 21:00,53,25,28,0,0,0
2020-01-03 21:15,30,10,20,0,0,0
2020-01-03 21:30,41,14,27,0,0,0
2020-01-03 21:45,36,18,18,0,0,0
2020-01-03 22:00,22,12,10,0,0,0
2020-01-03 22:15,22,9,13,0,0,0
2020-01-03 22:30,26,8,18,0,0,0
2020-01-03 22:45,24,4,20,0,0,0
2020-01-03 23:00,44,12,32,0,0,0
2020-01-03 23:15,44,22,22,0,0,0
2020-01-03 23:30,38,20,18,0,0,0
2020-01-03 23:45,30,11,19,0,0,0
2020-01-04 00:00,34,12,22,0,0,0
2020-01-04 00:15,34,15,19,0,0,0
2020-01-04 00:30,17,7,10,0,0,0
2020-01-04 00:45,22,10,12,0,0,0
2020-01-04 01:00,40,13,27,0,0,0
2020-01-04 01:15,22,7,15,0,0,0
2020-01-04 01:30,12,5,7,0,0,0
2020-01-04 01:45,10,1,9,0,0,0
2020-01-04 02:00,24,13,11,0,0,0
2020-01-04 02:15,7,0,7,0,0,0
2020-01-04 02:30,13,0,13,0,0,0
2020-01-04 02:45,9,0,9,0,0,0
2020-01-04 03:00,13,1,12,0,0,0
2020-01-04 03:15,10,5,5,0,0,0
2020-01-04 03:30,4,0,4,0,0,0
2020-01-04 03:45,9,4,5,0,0,0
2020-01-04 04:00,5,1,4,0,0,0
2020-01-04 04:15,11,5,6,0,0,0
2020-01-04 04:30,8,3,5,0,0,0
2020-01-04 04:45,4,1,3,0,0,0
2020-01-04 05:00,4,3,1,0,0,0
2020-01-04 05:15,8,2,6,0,0,0
2020-01-04 05:30,11,7,4,0,0,0
2020-01-04 05:45,8,6,2,0,0,0
2020-01-04 06:00,8,4,4,0,0,0
2020-01-04 06:15,9,6,3,0,0,0
2020-01-04 06:30,5,4,1,0,0,0
2020-01-04 06:45,5,1,4,0,0,0
2020-01-04 07:00,7,5,2,0,0,0
2020-01-04 07:15,10,8,2,0,0,0
2020-01-04 07:30,7,6,1,0,0,0
2020-01-04 07:45,25,21,4,0,0,0
2020-01-04 08:00,11,7,4,0,0,0
2020-01-04 08:15,17,11,6,0,0,0
2020-01-04 08:30,36,33,3,0,0,0
2020-01-04 08:45,36,30,6,0,0,0
2020-01-04 09:00,30,22,8,0,0,0
2020-01-04 09:15,40,27,13,0,0,0
2020-01-04 09:30,45,40,5,0,0,0
2020-01-04 09:45,98,84,14,0,0,0
2020-01-04 10:00,105,83,22,0,0,0
2020-01-04 10:15,71,51,20,0,0,0
2020-01-04 10:30,62,39,23,0,0,0
2020-01-04 10:45,93,68,25,0,0,0
2020-01-04 11:00,87,57,30,0,0,0
2020-01-04 11:15,58,37,21,0,0,0
2020-01-04 11:30,90,58,32,0,0,0
2020-01-04 11:45,112,68,44,0,0,0
2020-01-04 12:00,93,58,35,0,0,0
2020-01-04 12:15,108,62,46,0,0,0
2020-01-04 12:30,114,54,60,0,0,0
2020-01-04 12:45,90,59,31,0,0,0
2020-01-04 13:00,90,49,41,0,0,0
2020-01-04 13:15,97,47,50,0,0,0
2020-01-04 13:30,94,52,42,0,0,0
2020-01-04 13:45,105,55,50,0,0,0
2020-01-04 14:00,103,59,44,0,0,0
2020-01-04 14:15,85,45,40,0,0,0
2020-01-04 14:30,83,38,45,0,0,0
2020-01-04 14:45,95,52,43,0,0,0
2020-01-04 15:00,74,29,45,0,0,0
2020-01-04 15:15,71,28,43,0,0,0
2020-01-04 15:30,58,32,26,0,0,0
2020-01-04 15:45,85,45,40,0,0,0
2020-01-04 16:00,72,29,43,0,0,0
2020-01-04 16:15,84,34,50,0,0,0
2020-01-04 16:30,77,41,36,0,0,0
2020-01-04 16:45,59,24,35,0,0,0
2020-01-04 17:00,69,26,43,0,0,0
2020-01-04 17:15,79,31,48,0,0,0
2020-01-04 17:30,76,31,45,0,0,0
2020-01-04 17:45,82,34,48,0,0,0
2020-01-04 18:00,122,30,92,0,0,0
2020-01-04 18:15,78,34,44,0,0,0
2020-01-04 18:30,84,40,44,0,0,0
2020-01-04 18:45,77,34,43,0,0,0
2020-01-04 19:00,72,38,34,0,0,0
2020-01-04 19:15,57,31,26,0,0,0
2020-01-04 19:30,57,28,29,0,0,0
2020-01-04 19:45,72,42,30,0,0,0
2020-01-04 20:00,56,36,20,0,0,0
2020-01-04 20:15,68,43,25,0,0,0
2020-01-04 20:30,66,24,42,0,0,0
2020-01-04 20:45,48,25,23,0,0,0
2020-01-04 21:00,39,18,21,0,0,0
2020-01-04 21:15,35,21,14,0,0,0
2020-01-04 21:30,30,18,12,0,0,0
2020-01-04 21:45,36,16,20,0,0,0
2020-01-04 22:00,37,11,26,0,0,0
2020-01-04 22:15,35,12,23,0,0,0
2020-01-04 22:30,37,14,23,0,0,0
2020-01-04 22:45,32,10,22,0,0,0
2020-01-04 23:00,51,19,32,0,0,0
2020-01-04 23:15,47,19,28,0,0,0
2020-01-04 23:30,33,17,16,0,0,0
2020-01-04 23:45,31,10,21,0,0,0
2020-01-05 00:00,43,24,19,0,0,0
2020-01-05 00:15,28,7,21,0,0,0
2020-01-05 00:30,33,6,27,0,0,0
2020-01-05 00:45,27,8,19,0,0,0
2020-01-05 01:00,42,15,27,0,0,0
2020-01-05 01:15,38,13,25,0,0,0
2020-01-05 01:30,29,11,18,0,0,0
2020-01-05 01:45,29,8,21,0,0,0
2020-01-05 02:00,17,4,13,0,0,0
2020-01-05 02:15,23,6,17,0,0,0
2020-01-05 02:30,26,6,20,0,0,0
2020-01-05 02:45,22,1,21,0,0,0
2020-01-05 03:00,15,5,10,0,0,0
2020-01-05 03:15,15,3,12,0,0,0
2020-01-05 03:30,11,3,8,0,0,0
2020-01-05 03:45,10,3,7,0,0,0
2020-01-05 04:00,17,5,12,0,0,0
2020-01-05 04:15,10,1,9,0,0,0
2020-01-05 04:30,4,0,4,0,0,0
2020-01-05 04:45,3,1,2,0,0,0
2020-01-05 05:00,4,1,3,0,0,0
2020-01-05 05:15,3,1,2,0,0,0
2020-01-05 05:30,9,6,3,0,0,0
2020-01-05 05:45,2,0,2,0,0,0
2020-01-05 06:00,6,1,5,0,0,0
2020-01-05 06:15,10,4,6,0,0,0
2020-01-05 06:30,6,3,3,0,0,0
2020-01-05 06:45,8,4,4,0,0,0
2020-01-05 07:00,6,4,2,0,0,0
2020-01-05 07:15,7,2,5,0,0,0
2020-01-05 07:30,4,1,3,0,0,0
2020-01-05 07:45,11,5,6,0,0,0
2020-01-05 08:00,6,3,3,0,0,0
2020-01-05 08:15,4,3,1,0,0,0
2020-01-05 08:30,10,4,6,0,0,0
2020-01-05 08:45,16,13,3,0,0,0
2020-01-05 09:00,14,8,6,0,0,0
2020-01-05 09:15,20,15,5,0,0,0
2020-01-05 09:30,33,22,11,0,0,0
2020-01-05 09:45,85,75,10,0,0,0
2020-01-05 10:00,59,49,10,0,0,0
2020-01-05 10:15,59,36,23,0,0,0
2020-01-05 10:30,45,27,18,0,0,0
2020-01-05 10:45,54,42,12,0,0,0
2020-01-05 11:00,50,34,16,0,0,0
2020-01-05 11:15,35,15,20,0,0,0
2020-01-05 11:30,41,30,11,0,0,0
2020-01-05 11:45,62,38,24,0,0,0
2020-01-05 12:00,51,35,16,0,0,0
2020-01-05 12:15,58,29,29,0,0,0
2020-01-05 12:30,54,33,21,0,0,0
2020-01-05 12:45,77,50,27,0,0,0
2020-01-05 13:00,72,37,35,0,0,0
2020-01-05 13:15,71,37,34,0,0,0
2020-01-05 13:30,65,38,27,0,0,0
2020-01-05 13:45,83,42,41,0,0,0
2020-01-05 14:00,56,32,24,0,0,0
2020-01-05 14:15,79,36,43,0,0,0
2020-01-05 14:30,50,29,21,0,0,0
2020-01-05 14:45,101,52,49,0,0,0
2020-01-05 15:00,61,21,40,0,0,0
2020-01-05 15:15,77,37,40,0,0,0
2020-01-05 15:30,108,49,59,0,0,0
2020-01-05 15:45,79,46,33,0,0,0
2020-01-05 16:00,86,32,54,0,0,0
2020-01-05 16:15,80,34,46,0,0,0
2020-01-05 16:30,78,34,44,0,0,0
2020-01-05 16:45,92,51,41,0,0,0
2020-01-05 17:00,73,32,41,0,0,0
2020-01-05 17:15,81,41,40,0,0,0
2020-01-05 17:30,91,41,50,0,0,0
2020-01-05 17:45,113,51,62,0,0,0
2020-01-05 18:00,138,39,99,0,0,0
2020-01-05 18:15,82,32,50,0,0,0
2020-01-05 18:30,76,40,36,0,0,0
2020-01-05 18:45,99,62,37,0,0,0
2020-01-05 19:00,76,27,49,0,0,0
2020-01-05 19:15,86,37,49,0,0,0
2020-01-05 19:30,80,26,54,0,0,0
2020-01-05 19:45,58,28,30,0,0,0
2020-01-05 20:00,75,32,43,0,0,0
2020-01-05 20:15,67,32,35,0,0,0
2020-01-05 20:30,51,24,27,0,0,0
2020-01-05 20:45,64,37,27,0,0,0
2020-01-05 21:00,49,16,33,0,0,0
2020-01-05 21:15,42,17,25,0,0,0
2020-01-05 21:30,51,25,26,0,0,0
2020-01-05 21:45,48,16,32,0,0,0
2020-01-05 22:00,62,19,43,0,0,0
2020-01-05 22:15,52,22,30,0,0,0
2020-01-05 22:30,28,13,15,0,0,0
2020-01-05 22:45,43,14,29,0,0,0
2020-01-05 23:00,35,17,18,0,0,0
2020-01-05 23:15,14,6,8,0,0,0
2020-01-05 23:30,19,9,10,0,0,0
2020-01-05 23:45,19,5,14,0,0,0
2020-01-06 00:00,18,4,14,0,0,0
2020-01-06 00:15,21,13,8,0,0,0
2020-01-06 00:30,14,5,9,0,0,0
2020-01-06 00:45,10,3,7,0,0,0
2020-01-06 01:00,10,2,8,0,0,0
2020-01-06 01:15,8,1,7,0,0,0
2020-01-06 01:30,14,5,9,0,0,0
2020-01-06 01:45,10,2,8,0,0,0
2020-01-06 02:00,8,1,7,0,0,0
2020-01-06 02:15,4,1,3,0,0,0
2020-01-06 02:30,4,1,3,0,0,0
2020-01-06 02:45,5,2,3,0,0,0
2020-01-06 03:00,1,0,1,0,0,0
2020-01-06 03:15,1,0,1,0,0,0
2020-01-06 03:30,2,1,1,0,0,0
2020-01-06 03:45,6,6,0,0,0,0
2020-01-06 04:00,2,1,1,0,0,0
2020-01-06 04:15,2,2,0,0,0,0
2020-01-06 04:30,1,0,1,0,0,0
2020-01-06 04:45,7,4,3,0,0,0
2020-01-06 05:00,6,4,2,0,0,0
2020-01-06 05:15,12,11,1,0,0,0
2020-01-06 05:30,16,13,3,0,0,0
2020-01-06 05:45,21,9,12,0,0,0
2020-01-06 06:00,20,12,8,0,0,0
2020-01-06 06:15,40,30,10,0,0,0
2020-01-06 06:30,51,30,21,0,0,0
2020-01-06 06:45,71,47,24,0,0,0
2020-01-06 07:00,81,51,30,0,0,0
2020-01-06 07:15,105,65,40,0,0,0
2020-01-06 07:30,158,93,65,0,0,0
2020-01-06 07:45,247,154,93,0,0,0
2020-01-06 08:00,240,136,104,0,0,0
2020-01-06 08:15,226,132,94,0,0,0
2020-01-06 08:30,172,101,71,0,0,0
2020-01-06 08:45,218,136,82,0,0,0
2020-01-06 09:00,177,110,67,0,0,0
2020-01-06 09:15,169,104,65,0,0,0
2020-01-06 09:30,144,78,66,0,0,0
2020-01-06 09:45,249,146,103,0,0,0
2020-01-06 10:00,202,105,97,0,0,0
2020-01-06 10:15,139,87,52,0,0,0
2020-01-06 10:30,141,87,54,0,0,0
2020-01-06 10:45,126,79,47,0,0,0
2020-01-06 11:00,143,78,65,0,0,0
2020-01-06 11:15,146,72,74,0,0,0
2020-01-06 11:30,152,96,56,0,0,0
2020-01-06 11:45,182,116,66,0,0,0
2020-01-06 12:00,174,75,99,0,0,0
2020-01-06 12:15,209,104,105,0,0,0
2020-01-06 12:30,158,93,65,0,0,0
2020-01-06 12:45,166,89,77,0,0,0
2020-01-06 13:00,190,100,90,0,0,0
2020-01-06 13:15,146,67,79,0,0,0
2020-01-06 13:30,167,86,81,0,0,0
2020-01-06 13:45,168,97,71,0,0,0
2020-01-06 14:00,187,108,79,0,0,0
2020-01-06 14:15,164,72,92,0,0,0
2020-01-06 14:30,151,71,80,0,0,0
2020-01-06 14:45,185,102,83,0,0,0
2020-01-06 15:00,195,95,100,0,0,0
2020-01-06 15:15,147,82,65,0,0,0
2020-01-06 15:30,189,83,106,0,0,0
2020-01-06 15:45,252,146,106,0,0,0
2020-01-06 16:00,236,139,97,0,0,0
2020-01-06 16:15,293,154,139,0,0,0
2020-01-06 16:30,267,125,142,0,0,0
2020-01-06 16:45,296,157,139,0,0,0
2020-01-06 17:00,266,117,149,0,0,0
2020-01-06 17:15,270,119,151,0,0,0
2020-01-06 17:30,249,117,132,0,0,0
2020-01-06 17:45,344,175,169,0,0,0
2020-01-06 18:00,275,128,147,0,0,0
2020-01-06 18:15,256,114,142,0,0,0
2020-01-06 18:30,211,99,112,0,0,0
2020-01-06 18:45,235,99,136,0,0,0
2020-01-06 19:00,188,79,109,0,0,0
2020-01-06 19:15,204,99,105,0,0,0
2020-01-06 19:30,148,76,72,0,0,0
2020-01-06 19:45,224,111,113,0,0,0
2020-01-06 20:00,163,54,109,0,0,0
2020-01-06 20:15,127,48,79,0,0,0
2020-01-06 20:30,95,41,54,0,0,0
2020-01-06 20:45,88,45,43,0,0,0
2020-01-06 21:00,94,34,60,0,0,0
2020-01-06 21:15,78,26,52,0,0,0
2020-01-06 21:30,68,27,41,0,0,0
2020-01-06 21:45,96,34,62,0,0,0
2020-01-06 22:00,114,41,73,0,0,0
2020-01-06 22:15,79,40,39,0,0,0
2020-01-06 22:30,52,18,34,0,0,0
2020-01-06 22:45,68,23,45,0,0,0
2020-01-06 23:00,52,19,33,0,0,0
2020-01-06 23:15,38,11,27,0,0,0
2020-01-06 23:30,30,18,12,0,0,0
2020-01-06 23:45,20,5,15,0,0,0
2020-01-07 00:00,28,10,18,0,0,0
2020-01-07 00:15,11,0,11,0,0,0
2020-01-07 00:30,25,8,17,0,0,0
2020-01-07 00:45,10,1,9,0,0,0
2020-01-07 01:00,12,3,9,0,0,0
2020-01-07 01:15,13,3,10,0,0,0
2020-01-07 01:30,7,1,6,0,0,0
2020-01-07 01:45,2,1,1,0,0,0
2020-01-07 02:00,8,2,6,0,0,0
2020-01-07 02:15,1,0,1,0,0,0
2020-01-07 02:30,3,1,2,0,0,0
2020-01-07 02:45,4,1,3,0,0,0
2020-01-07 03:00,1,0,1,0,0,0
2020-01-07 03:15,2,0,2,0,0,0
2020-01-07 03:30,2,0,2,0,0,0
2020-01-07 03:45,5,3,2,0,0,0
2020-01-07 04:00,2,1,1,0,0,0
2020-01-07 04:15,1,1,0,0,0,0
2020-01-07 04:30,5,2,3,0,0,0
2020-01-07 04:45,9,7,2,0,0,0
2020-01-07 05:00,9,8,1,0,0,0
2020-01-07 05:15,10,7,3,0,0,0
2020-01-07 05:30,17,10,7,0,0,0
2020-01-07 05:45,27,15,12,0,0,0
2020-01-07 06:00,27,23,4,0,0,0
2020-01-07 06:15,45,38,7,0,0,0
2020-01-07 06:30,70,37,33,0,0,0
2020-01-07 06:45,102,70,32,0,0,0
2020-01-07 07:00,110,77,33,0,0,0
2020-01-07 07:15,172,115,57,0,0,0
2020-01-07 07:30,285,204,81,0,0,0
2020-01-07 07:45,437,256,181,0,0,0
2020-01-07 08:00,572,279,293,0,0,0
2020-01-07 08:15,368,178,190,0,0,0
2020-01-07 08:30,215,133,82,0,0,0
2020-01-07 08:45,280,162,118,0,0,0
2020-01-07 09:00,268,158,110,0,0,0
2020-01-07 09:15,157,98,59,0,0,0
2020-01-07 09:30,170,113,57,0,0,0
2020-01-07 09:45,524,281,243,0,0,0
2020-01-07 10:00,589,370,219,0,0,0
2020-01-07 10:15,195,103,92,0,0,0
2020-01-07 10:30,138,76,62,0,0,0
2020-01-07 10:45,158,88,70,0,0,0
2020-01-07 11:00,157,94,63,0,0,0
2020-01-07 11:15,161,75,86,0,0,0
2020-01-07 11:30,178,94,84,0,0,0
2020-01-07 11:45,397,240,157,0,0,0
2020-01-07 12:00,464,269,195,0,0,0
2020-01-07 12:15,215,98,117,0,0,0
2020-01-07 12:30,181,80,101,0,0,0
2020-01-07 12:45,185,99,86,0,0,0
2020-01-07 13:00,208,80,128,0,0,0
2020-01-07 13:15,242,95,147,0,0,0
2020-01-07 13:30,212,116,96,0,0,0
2020-01-07 13:45,467,242,225,0,0,0
2020-01-07 14:00,441,210,231,0,0,0
2020-01-07 14:15,237,104,133,0,0,0
2020-01-07 14:30,198,100,98,0,0,0
2020-01-07 14:45,193,89,104,0,0,0
2020-01-07 15:00,195,76,119,0,0,0
2020-01-07 15:15,179,96,83,0,0,0
2020-01-07 15:30,225,127,98,0,0,0
2020-01-07 15:45,455,247,208,0,0,0
2020-01-07 16:00,471,241,230,0,0,0
2020-01-07 16:15,267,115,152,0,0,0
2020-01-07 16:30,268,119,149,0,0,0
2020-01-07 16:45,275,122,153,0,0,0
2020-01-07 17:00,262,135,127,0,0,0
2020-01-07 17:15,276,125,151,0,0,0
2020-01-07 17:30,285,152,133,0,0,0
2020-01-07 17:45,479,220,259,0,0,0
2020-01-07 18:00,444,191,253,0,0,0
2020-01-07 18:15,341,154,187,0,0,0
2020-01-07 18:30,286,141,145,0,0,0
2020-01-07 18:45,272,118,154,0,0,0
2020-01-07 19:00,221,117,104,0,0,0
2020-01-07 19:15,238,132,106,0,0,0
2020-01-07 19:30,210,123,87,0,0,0
2020-01-07 19:45,293,140,153,0,0,0
2020-01-07 20:00,226,116,110,0,0,0
2020-01-07 20:15,159,70,89,0,0,0
2020-01-07 20:30,115,48,67,0,0,0
2020-01-07 20:45,122,42,80,0,0,0
2020-01-07 21:00,111,47,64,0,0,0
2020-01-07 21:15,119,45,74,0,0,0
2020-01-07 21:30,96,46,50,0,0,0
2020-01-07 21:45,115,41,74,0,0,0
2020-01-07 22:00,110,40,70,0,0,0
2020-01-07 22:15,129,65,64,0,0,0
2020-01-07 22:30,74,27,47,0,0,0
2020-01-07 22:45,81,27,54,0,0,0
2020-01-07 23:00,55,13,42,0,0,0
2020-01-07 23:15,46,17,29,0,0,0
2020-01-07 23:30,57,22,35,0,0,0
2020-01-07 23:45,33,13,20,0,0,0
2020-01-08 00:00,53,13,40,0,0,0
2020-01-08 00:15,27,5,22,0,0,0
2020-01-08 00:30,14,2,12,0,0,0
2020-01-08 00:45,13,1,12,0,0,0
2020-01-08 01:00,9,2,7,0,0,0
2020-01-08 01:15,15,5,10,0,0,0
2020-01-08 01:30,13,5,8,0,0,0
2020-01-08 01:45,7,2,5,0,0,0
2020-01-08 02:00,6,1,5,0,0,0
2020-01-08 02:15,8,1,7,0,0,0
2020-01-08 02:30,4,2,2,0,0,0
2020-01-08 02:45,1,0,1,0,0,0
2020-01-08 03:00,5,0,5,0,0,0
2020-01-08 03:15,4,1,3,0,0,0
2020-01-08 03:30,4,3,1,0,0,0
2020-01-08 03:45,4,3,1,0,0,0
2020-01-08 04:00,3,2,1,0,0,0
2020-01-08 04:15,3,1,2,0,0,0
2020-01-08 04:30,5,3,2,0,0,0
2020-01-08 04:45,11,5,6,0,0,0
2020-01-08 05:00,6,4,2,0,0,0
2020-01-08 05:15,9,6,3,0,0,0
2020-01-08 05:30,12,10,2,0,0,0
2020-01-08 05:45,21,10,11,0,0,0
2020-01-08 06:00,23,18,5,0,0,0
2020-01-08 06:15,44,31,13,0,0,0
2020-01-08 06:30,62,40,22,0,0,0
2020-01-08 06:45,88,60,28,0,0,0
2020-01-08 07:00,84,53,31,0,0,0
2020-01-08 07:15,137,95,42,0,0,0
2020-01-08 07:30,125,58,67,0,0,0
2020-01-08 07:45,224,49,175,0,0,0
2020-01-08 08:00,522,260,262,0,0,0
2020-01-08 08:15,326,164,162,0,0,0
2020-01-08 08:30,193,117,76,0,0,0
2020-01-08 08:45,263,157,106,0,0,0
2020-01-08 09:00,219,117,102,0,0,0
2020-01-08 09:15,174,97,77,0,0,0
2020-01-08 09:30,179,99,80,0,0,0
2020-01-08 09:45,367,195,172,0,0,0
2020-01-08 10:00,494,250,244,0,0,0
2020-01-08 10:15,201,95,106,0,0,0
2020-01-08 10:30,140,77,63,0,0,0
2020-01-08 10:45,128,71,57,0,0,0
2020-01-08 11:00,137,80,57,0,0,0
2020-01-08 11:15,128,77,51,0,0,0
2020-01-08 11:30,173,119,54,0,0,0
2020-01-08 11:45,375,204,171,0,0,0
2020-01-08 12:00,354,187,167,0,0,0
2020-01-08 12:15,172,88,84,0,0,0
2020-01-08 12:30,185,78,107,0,0,0
2020-01-08 12:45,206,92,114,0,0,0
2020-01-08 13:00,199,101,98,0,0,0
2020-01-08 13:15,203,79,124,0,0,0
2020-01-08 13:30,180,101,79,0,0,0
2020-01-08 13:45,343,185,158,0,0,0
2020-01-08 14:00,384,200,184,0,0,0
2020-01-08 14:15,195,88,107,0,0,0
2020-01-08 14:30,184,82,102,0,0,0
2020-01-08 14:45,192,93,99,0,0,0
2020-01-08 15:00,183,79,104,0,0,0
2020-01-08 15:15,173,84,89,0,0,0
2020-01-08 15:30,245,117,128,0,0,0
2020-01-08 15:45,348,166,182,0,0,0
2020-01-08 16:00,379,195,184,0,0,0
2020-01-08 16:15,318,148,170,0,0,0
2020-01-08 16:30,249,106,143,0,0,0
2020-01-08 16:45,255,114,141,0,0,0
2020-01-08 17:00,250,116,134,0,0,0
2020-01-08 17:15,268,118,150,0,0,0
2020-01-08 17:30,303,153,150,0,0,0
2020-01-08 17:45,393,210,183,0,0,0
2020-01-08 18:00,370,172,198,0,0,0
2020-01-08 18:15,225,104,121,0,0,0
2020-01-08 18:30,197,88,109,0,0,0
2020-01-08 18:45,278,140,138,0,0,0
2020-01-08 19:00,213,119,94,0,0,0
2020-01-08 19:15,210,88,122,0,0,0
2020-01-08 19:30,202,108,94,0,0,0
2020-01-08 19:45,264,98,166,0,0,0
2020-01-08 20:00,224,92,132,0,0,0
2020-01-08 20:15,159,67,92,0,0,0
2020-01-08 20:30,130,61,69,0,0,0
2020-01-08 20:45,133,48,85,0,0,0
2020-01-08 21:00,75,27,48,0,0,0
2020-01-08 21:15,112,45,67,0,0,0
2020-01-08 21:30,103,49,54,0,0,0
2020-01-08 21:45,77,32,45,0,0,0
2020-01-08 22:00,133,65,68,0,0,0
2020-01-08 22:15,120,52,68,0,0,0
2020-01-08 22:30,93,35,58,0,0,0
2020-01-08 22:45,85,37,48,0,0,0
2020-01-08 23:00,68,36,32,0,0,0
2020-01-08 23:15,64,25,39,0,0,0
2020-01-08 23:30,60,25,35,0,0,0
2020-01-08 23:45,39,14,25,0,0,0
2020-01-09 00:00,47,15,32,0,0,0
2020-01-09 00:15,34,13,21,0,0,0
2020-01-09 00:30,31,10,21,0,0,0
2020-01-09 00:45,35,14,21,0,0,0
2020-01-09 01:00,30,5,25,0,0,0
2020-01-09 01:15,13,2,11,0,0,0
2020-01-09 01:30,15,4,11,0,0,0
2020-01-09 01:45,15,3,12,0,0,0
2020-01-09 02:00,9,3,6,0,0,0
2020-01-09 02:15,17,4,13,0,0,0
2020-01-09 02:30,17,0,17,0,0,0
2020-01-09 02:45,12,4,8,0,0,0
2020-01-09 03:00,9,1,8,0,0,0
2020-01-09 03:15,16,5,11,0,0,0
2020-01-09 03:30,3,0,3,0,0,0
2020-01-09 03:45,13,5,8,0,0,0
2020-01-09 04:00,6,0,6,0,0,0
2020-01-09 04:15,4,2,2,0,0,0
2020-01-09 04:30,5,4,1,0,0,0
2020-01-09 04:45,16,6,10,0,0,0
2020-01-09 05:00,11,7,4,0,0,0
2020-01-09 05:15,10,6,4,0,0,0
2020-01-09 05:30,22,16,6,0,0,0
2020-01-09 05:45,20,12,8,0,0,0
2020-01-09 06:00,25,19,6,0,0,0
2020-01-09 06:15,35,24,11,0,0,0
2020-01-09 06:30,48,28,20,0,0,0
2020-01-09 06:45,56,32,24,0,0,0
2020-01-09 07:00,88,55,33,0,0,0
2020-01-09 07:15,144,89,55,0,0,0
2020-01-09 07:30,267,182,85,0,0,0
2020-01-09 07:45,351,186,165,0,0,0
2020-01-09 08:00,463,225,238,0,0,0
2020-01-09 08:15,351,200,151,0,0,0
2020-01-09 08:30,200,132,68,0,0,0
2020-01-09 08:45,273,147,126,0,0,0
2020-01-09 09:00,221,113,108,0,0,0
2020-01-09 09:15,173,112,61,0,0,0
2020-01-09 09:30,189,100,89,0,0,0
2020-01-09 09:45,420,222,198,0,0,0
2020-01-09 10:00,505,305,200,0,0,0
2020-01-09 10:15,201,96,105,0,0,0
2020-01-09 10:30,131,72,59,0,0,0
2020-01-09 10:45,158,96,62,0,0,0
2020-01-09 11:00,135,75,60,0,0,0
2020-01-09 11:15,133,67,66,0,0,0
2020-01-09 11:30,161,105,56,0,0,0
2020-01-09 11:45,379,186,193,0,0,0
2020-01-09 12:00,436,180,256,0,0,0
2020-01-09 12:15,241,113,128,0,0,0
2020-01-09 12:30,197,106,91,0,0,0
2020-01-09 12:45,212,105,107,0,0,0
2020-01-09 13:00,187,96,91,0,0,0
2020-01-09 13:15,215,99,116,0,0,0
2020-01-09 13:30,241,127,114,0,0,0
2020-01-09 13:45,393,217,176,0,0,0
2020-01-09 14:00,432,218,214,0,0,0
2020-01-09 14:15,215,93,122,0,0,0
2020-01-09 14:30,194,97,97,0,0,0
2020-01-09 14:45,195,88,107,0,0,0
2020-01-09 15:00,216,100,116,0,0,0
2020-01-09 15:15,241,140,101,0,0,0
2020-01-09 15:30,203,110,93,0,0,0
2020-01-09 15:45,451,239,212,0,0,0
2020-01-09 16:00,412,224,188,0,0,0
2020-01-09 16:15,294,148,146,0,0,0
2020-01-09 16:30,258,117,141,0,0,0
2020-01-09 16:45,261,117,144,0,0,0
2020-01-09 17:00,235,125,110,0,0,0
2020-01-09 17:15,258,122,136,0,0,0
2020-01-09 17:30,277,143,134,0,0,0
2020-01-09 17:45,431,210,221,0,0,0
2020-01-09 18:00,359,153,206,0,0,0
2020-01-09 18:15,235,112,123,0,0,0
2020-01-09 18:30,229,123,106,0,0,0
2020-01-09 18:45,222,97,125,0,0,0
2020-01-09 19:00,190,80,110,0,0,0
2020-01-09 19:15,175,82,93,0,0,0
2020-01-09 19:30,188,77,111,0,0,0
2020-01-09 19:45,272,100,172,0,0,0
2020-01-09 20:00,220,76,144,0,0,0
2020-01-09 20:15,166,70,96,0,0,0
2020-01-09 20:30,77,24,53,0,0,0
2020-01-09 20:45,118,46,72,0,0,0
2020-01-09 21:00,91,29,62,0,0,0
2020-01-09 21:15,90,43,47,0,0,0
2020-01-09 21:30,100,39,61,0,0,0
2020-01-09 21:45,104,29,75,0,0,0
2020-01-09 22:00,99,28,71,0,0,0
2020-01-09 22:15,111,58,53,0,0,0
2020-01-09 22:30,70,21,49,0,0,0
2020-01-09 22:45,79,30,49,0,0,0
2020-01-09 23:00,72,20,52,0,0,0
2020-01-09 23:15,71,21,50,0,0,0
2020-01-09 23:30,50,14,36,0,0,0
2020-01-09 23:45,37,8,29,0,0,0
2020-01-10 00:00,34,7,27,0,0,0
2020-01-10 00:15,40,16,24,0,0,0
2020-01-10 00:30,29,4,25,0,0,0
2020-01-10 00:45,14,2,12,0,0,0
2020-01-10 01:00,22,6,16,0,0,0
2020-01-10 01:15,11,2,9,0,0,0
2020-01-10 01:30,13,4,9,0,0,0
2020-01-10 01:45,14,3,11,0,0,0
2020-01-10 02:00,11,3,8,0,0,0
2020-01-10 02:15,7,3,4,0,0,0
2020-01-10 02:30,6,2,4,0,0,0
2020-01-10 02:45,2,1,1,0,0,0
2020-01-10 03:00,7,0,7,0,0,0
2020-01-10 03:15,2,0,2,0,0,0
2020-01-10 03:30,3,1,2,0,0,0
2020-01-10 03:45,8,4,4,0,0,0
2020-01-10 04:00,0,0,0,0,0,0
2020-01-10 04:15,1,1,0,0,0,0
2020-01-10 04:30,7,6,1,0,0,0
2020-01-10 04:45,9,2,7,0,0,0
2020-01-10 05:00,3,3,0,0,0,0
2020-01-10 05:15,9,4,5,0,0,0
2020-01-10 05:30,18,15,3,0,0,0
2020-01-10 05:45,21,12,9,0,0,0
2020-01-10 06:00,20,9,11,0,0,0
2020-01-10 06:15,39,26,13,0,0,0
2020-01-10 06:30,39,23,16,0,0,0
2020-01-10 06:45,73,45,28,0,0,0
2020-01-10 07:00,112,72,40,0,0,0
2020-01-10 07:15,109,63,46,0,0,0
2020-01-10 07:30,247,192,55,0,0,0
2020-01-10 07:45,320,190,130,0,0,0
2020-01-10 08:00,349,176,173,0,0,0
2020-01-10 08:15,268,133,135,0,0,0
2020-01-10 08:30,198,126,72,0,0,0
2020-01-10 08:45,281,142,139,0,0,0
2020-01-10 09:00,237,121,116,0,0,0
2020-01-10 09:15,171,95,76,0,0,0
2020-01-10 09:30,177,100,77,0,0,0
2020-01-10 09:45,299,167,132,0,0,0
2020-01-10 10:00,378,222,156,0,0,0
2020-01-10 10:15,179,81,98,0,0,0
2020-01-10 10:30,146,82,64,0,0,0
2020-01-10 10:45,148,71,77,0,0,0
2020-01-10 11:00,163,83,80,0,0,0
2020-01-10 11:15,154,85,69,0,0,0
2020-01-10 11:30,162,83,79,0,0,0
2020-01-10 11:45,289,174,115,0,0,0
2020-01-10 12:00,284,132,152,0,0,0
2020-01-10 12:15,221,121,100,0,0,0
2020-01-10 12:30,197,107,90,0,0,0
2020-01-10 12:45,275,128,147,0,0,0
2020-01-10 13:00,184,89,95,0,0,0
2020-01-10 13:15,229,108,121,0,0,0
2020-01-10 13:30,218,128,90,0,0,0
2020-01-10 13:45,309,162,147,0,0,0
2020-01-10 14:00,260,116,144,0,0,0
2020-01-10 14:15,202,103,99,0,0,0
2020-01-10 14:30,208,122,86,0,0,0
2020-01-10 14:45,228,102,126,0,0,0
2020-01-10 15:00,200,101,99,0,0,0
2020-01-10 15:15,210,110,100,0,0,0
2020-01-10 15:30,198,99,99,0,0,0
2020-01-10 15:45,232,133,99,0,0,0
2020-01-10 16:00,244,116,128,0,0,0
2020-01-10 16:15,220,122,98,0,0,0
2020-01-10 16:30,214,113,101,0,0,0
2020-01-10 16:45,210,95,115,0,0,0
2020-01-10 17:00,242,117,125,0,0,0
2020-01-10 17:15,197,90,107,0,0,0
2020-01-10 17:30,219,99,120,0,0,0
2020-01-10 17:45,257,125,132,0,0,0
2020-01-10 18:00,204,96,108,0,0,0
2020-01-10 18:15,257,125,132,0,0,0
2020-01-10 18:30,204,111,93,0,0,0
2020-01-10 18:45,206,112,94,0,0,0
2020-01-10 19:00,212,108,104,0,0,0
2020-01-10 19:15,222,112,110,0,0,0
2020-01-10 19:30,191,100,91,0,0,0
2020-01-10 19:45,199,124,75,0,0,0
2020-01-10 20:00,207,86,121,0,0,0
2020-01-10 20:15,94,89,5,0,0,0
2020-01-10 20:30,141,71,70,0,0,0
2020-01-10 20:45,129,72,57,0,0,0
2020-01-10 21:00,115,45,70,0,0,0
2020-01-10 21:15,100,50,50,0,0,0
2020-01-10 21:30,89,36,53,0,0,0
2020-01-10 21:45,106,49,57,0,0,0
2020-01-10 22:00,95,33,62,0,0,0
2020-01-10 22:15,60,24,36,0,0,0
2020-01-10 22:30,77,28,49,0,0,0
2020-01-10 22:45,103,46,57,0,0,0
2020-01-10 23:00,54,24,30,0,0,0
2020-01-10 23:15,88,33,55,0,0,0
2020-01-10 23:30,99,39,60,0,0,0
2020-01-10 23:45,70,31,39,0,0,0
2020-01-11 00:00,102,20,82,0,0,0
2020-01-11 00:15,85,14,71,0,0,0
2020-01-11 00:30,70,24,46,0,0,0
2020-01-11 00:45,76,28,48,0,0,0
2020-01-11 01:00,58,13,45,0,0,0
2020-01-11 01:15,57,15,42,0,0,0
2020-01-11 01:30,51,19,32,0,0,0
2020-01-11 01:45,57,21,36,0,0,0
2020-01-11 02:00,41,12,29,0,0,0
2020-01-11 02:15,51,9,42,0,0,0
2020-01-11 02:30,33,5,28,0,0,0
2020-01-11 02:45,46,10,36,0,0,0
2020-01-11 03:00,35,6,29,0,0,0
2020-01-11 03:15,25,9,16,0,0,0
2020-01-11 03:30,24,9,15,0,0,0
2020-01-11 03:45,13,2,11,0,0,0
2020-01-11 04:00,15,5,10,0,0,0
2020-01-11 04:15,25,6,19,0,0,0
2020-01-11 04:30,14,4,10,0,0,0
2020-01-11 04:45,17,5,12,0,0,0
2020-01-11 05:00,5,2,3,0,0,0
2020-01-11 05:15,6,5,1,0,0,0
2020-01-11 05:30,10,2,8,0,0,0
2020-01-11 05:45,18,14,4,0,0,0
2020-01-11 06:00,8,3,5,0,0,0
2020-01-11 06:15,7,4,3,0,0,0
2020-01-11 06:30,8,5,3,0,0,0
2020-01-11 06:45,14,9,5,0,0,0
2020-01-11 07:00,15,12,3,0,0,0
2020-01-11 07:15,10,9,1,0,0,0
2020-01-11 07:30,16,12,4,0,0,0
2020-01-11 07:45,75,68,7,0,0,0
2020-01-11 08:00,55,46,9,0,0,0
2020-01-11 08:15,45,27,18,0,0,0
2020-01-11 08:30,59,38,21,0,0,0
2020-01-11 08:45,111,77,34,0,0,0
2020-01-11 09:00,67,43,24,0,0,0
2020-01-11 09:15,104,81,23,0,0,0
2020-01-11 09:30,113,85,28,0,0,0
2020-01-11 09:45,176,121,55,0,0,0
2020-01-11 10:00,126,88,38,0,0,0
2020-01-11 10:15,126,99,27,0,0,0
2020-01-11 10:30,114,75,39,0,0,0
2020-01-11 10:45,140,89,51,0,0,0
2020-01-11 11:00,134,89,45,0,0,0
2020-01-11 11:15,107,77,30,0,0,0
2020-01-11 11:30,117,77,40,0,0,0
2020-01-11 11:45,166,111,55,0,0,0
2020-01-11 12:00,152,94,58,0,0,0
2020-01-11 12:15,168,105,63,0,0,0
2020-01-11 12:30,152,87,65,0,0,0
2020-01-11 12:45,136,94,42,0,0,0
2020-01-11 13:00,188,109,79,0,0,0
2020-01-11 13:15,191,88,103,0,0,0
2020-01-11 13:30,177,91,86,0,0,0
2020-01-11 13:45,179,88,91,0,0,0
2020-01-11 14:00,187,75,112,0,0,0
2020-01-11 14:15,173,75,98,0,0,0
2020-01-11 14:30,139,64,75,0,0,0
2020-01-11 14:45,185,73,112,0,0,0
2020-01-11 15:00,154,67,87,0,0,0
2020-01-11 15:15,158,79,79,0,0,0
2020-01-11 15:30,151,75,76,0,0,0
2020-01-11 15:45,170,89,81,0,0,0
2020-01-11 16:00,170,68,102,0,0,0
2020-01-11 16:15,147,61,86,0,0,0
2020-01-11 16:30,131,41,90,0,0,0
2020-01-11 16:45,146,71,75,0,0,0
2020-01-11 17:00,155,57,98,0,0,0
2020-01-11 17:15,146,57,89,0,0,0
2020-01-11 17:30,138,47,91,0,0,0
2020-01-11 17:45,150,56,94,0,0,0
2020-01-11 18:00,167,67,100,0,0,0
2020-01-11 18:15,151,58,93,0,0,0
2020-01-11 18:30,123,46,77,0,0,0
2020-01-11 18:45,155,87,68,0,0,0
2020-01-11 19:00,168,76,92,0,0,0
2020-01-11 19:15,125,72,53,0,0,0
2020-01-11 19:30,138,65,73,0,0,0
2020-01-11 19:45,178,100,78,0,0,0
2020-01-11 20:00,149,67,82,0,0,0
2020-01-11 20:15,133,53,80,0,0,0
2020-01-11 20:30,107,45,62,0,0,0
2020-01-11 20:45,98,41,57,0,0,0
2020-01-11 21:00,97,40,57,0,0,0
2020-01-11 21:15,94,41,53,0,0,0
2020-01-11 21:30,80,42,38,0,0,0
2020-01-11 21:45,71,40,31,0,0,0
2020-01-11 22:00,83,24,59,0,0,0
2020-01-11 22:15,75,45,30,0,0,0
2020-01-11 22:30,65,26,39,0,0,0
2020-01-11 22:45,80,47,33,0,0,0
2020-01-11 23:00,67,27,40,0,0,0
2020-01-11 23:15,68,30,38,0,0,0
2020-01-11 23:30,64,40,24,0,0,0
2020-01-11 23:45,74,26,48,0,0,0
2020-01-12 00:00,72,31,41,0,0,0
2020-01-12 00:15,81,40,41,0,0,0
2020-01-12 00:30,81,41,40,0,0,0
2020-01-12 00:45,80,34,46,0,0,0
2020-01-12 01:00,60,29,31,0,0,0
2020-01-12 01:15,76,36,40,0,0,0
2020-01-12 01:30,64,24,40,0,0,0
2020-01-12 01:45,60,16,44,0,0,0
2020-01-12 02:00,45,16,29,0,0,0
2020-01-12 02:15,32,11,21,0,0,0
2020-01-12 02:30,44,17,27,0,0,0
2020-01-12 02:45,34,10,24,0,0,0
2020-01-12 03:00,30,12,18,0,0,0
2020-01-12 03:15,38,10,28,0,0,0
2020-01-12 03:30,29,10,19,0,0,0
2020-01-12 03:45,22,5,17,0,0,0
2020-01-12 04:00,35,14,21,0,0,0
2020-01-12 04:15,24,5,19,0,0,0
2020-01-12 04:30,6,2,4,0,0,0
2020-01-12 04:45,8,3,5,0,0,0
2020-01-12 05:00,15,2,13,0,0,0
2020-01-12 05:15,6,3,3,0,0,0
2020-01-12 05:30,11,3,8,0,0,0
2020-01-12 05:45,10,6,4,0,0,0
2020-01-12 06:00,5,1,4,0,0,0
2020-01-12 06:15,7,4,3,0,0,0
2020-01-12 06:30,20,7,13,0,0,0
2020-01-12 06:45,14,8,6,0,0,0
2020-01-12 07:00,5,4,1,0,0,0
2020-01-12 07:15,9,7,2,0,0,0
2020-01-12 07:30,12,7,5,0,0,0
2020-01-12 07:45,47,38,9,0,0,0
2020-01-12 08:00,26,20,6,0,0,0
2020-01-12 08:15,28,25,3,0,0,0
2020-01-12 08:30,49,29,20,0,0,0
2020-01-12 08:45,42,30,12,0,0,0
2020-01-12 09:00,31,16,15,0,0,0
2020-01-12 09:15,51,40,11,0,0,0
2020-01-12 09:30,48,33,15,0,0,0
2020-01-12 09:45,111,84,27,0,0,0
2020-01-12 10:00,66,47,19,0,0,0
2020-01-12 10:15,74,58,16,0,0,0
2020-01-12 10:30,75,47,28,0,0,0
2020-01-12 10:45,76,49,27,0,0,0
2020-01-12 11:00,71,45,26,0,0,0
2020-01-12 11:15,76,47,29,0,0,0
2020-01-12 11:30,51,31,20,0,0,0
2020-01-12 11:45,83,42,41,0,0,0
2020-01-12 12:00,80,42,38,0,0,0
2020-01-12 12:15,57,28,29,0,0,0
2020-01-12 12:30,69,32,37,0,0,0
2020-01-12 12:45,89,39,50,0,0,0
2020-01-12 13:00,61,37,24,0,0,0
2020-01-12 13:15,72,41,31,0,0,0
2020-01-12 13:30,65,33,32,0,0,0
2020-01-12 13:45,93,54,39,0,0,0
2020-01-12 14:00,61,32,29,0,0,0
2020-01-12 14:15,83,37,46,0,0,0
2020-01-12 14:30,93,46,47,0,0,0
2020-01-12 14:45,97,53,44,0,0,0
2020-01-12 15:00,86,44,42,0,0,0
2020-01-12 15:15,100,41,59,0,0,0
2020-01-12 15:30,79,35,44,0,0,0
2020-01-12 15:45,90,40,50,0,0,0
2020-01-12 16:00,94,47,47,0,0,0
2020-01-12 16:15,88,36,52,0,0,0
2020-01-12 16:30,132,55,77,0,0,0
2020-01-12 16:45,107,52,55,0,0,0
2020-01-12 17:00,102,45,57,0,0,0
2020-01-12 17:15,78,27,51,0,0,0
2020-01-12 17:30,104,47,57,0,0,0
2020-01-12 17:45,108,46,62,0,0,0
2020-01-12 18:00,111,49,62,0,0,0
2020-01-12 18:15,95,40,55,0,0,0
2020-01-12 18:30,109,35,74,0,0,0
2020-01-12 18:45,114,59,55,0,0,0
2020-01-12 19:00,73,34,39,0,0,0
2020-01-12 19:15,87,30,57,0,0,0
2020-01-12 19:30,81,23,58,0,0,0
2020-01-12 19:45,88,43,45,0,0,0
2020-01-12 20:00,73,22,51,0,0,0
2020-01-12 20:15,65,23,42,0,0,0
2020-01-12 20:30,61,18,43,0,0,0
2020-01-12 20:45,54,21,33,0,0,0
2020-01-12 21:00,48,14,34,0,0,0
2020-01-12 21:15,46,19,27,0,0,0
2020-01-12 21:30,62,20,42,0,0,0
2020-01-12 21:45,36,10,26,0,0,0
2020-01-12 22:00,54,17,37,0,0,0
2020-01-12 22:15,61,17,44,0,0,0
2020-01-12 22:30,32,8,24,0,0,0
2020-01-12 22:45,27,12,15,0,0,0
2020-01-12 23:00,45,16,29,0,0,0
2020-01-12 23:15,28,8,20,0,0,0
2020-01-12 23:30,21,8,13,0,0,0
2020-01-12 23:45,18,12,6,0,0,0
2020-01-13 00:00,20,4,16,0,0,0
2020-01-13 00:15,16,7,9,0,0,0
2020-01-13 00:30,13,4,9,0,0,0
2020-01-13 00:45,13,4,9,0,0,0
2020-01-13 01:00,10,3,7,0,0,0
2020-01-13 01:15,9,3,6,0,0,0
2020-01-13 01:30,5,2,3,0,0,0
2020-01-13 01:45,3,2,1,0,0,0
2020-01-13 02:00,5,1,4,0,0,0
2020-01-13 02:15,3,1,2,0,0,0
2020-01-13 02:30,3,0,3,0,0,0
2020-01-13 02:45,2,0,2,0,0,0
2020-01-13 03:00,1,0,1,0,0,0
2020-01-13 03:15,2,0,2,0,0,0
2020-01-13 03:30,2,0,2,0,0,0
2020-01-13 03:45,2,2,0,0,0,0
2020-01-13 04:00,0,0,0,0,0,0
2020-01-13 04:15,0,0,0,0,0,0
2020-01-13 04:30,2,1,1,0,0,0
2020-01-13 04:45,8,4,4,0,0,0
2020-01-13 05:00,8,6,2,0,0,0
2020-01-13 05:15,6,6,0,0,0,0
2020-01-13 05:30,10,7,3,0,0,0
2020-01-13 05:45,26,13,13,0,0,0
2020-01-13 06:00,40,31,9,0,0,0
2020-01-13 06:15,39,26,13,0,0,0
2020-01-13 06:30,66,41,25,0,0,0
2020-01-13 06:45,80,50,30,0,0,0
2020-01-13 07:00,79,50,29,0,0,0
2020-01-13 07:15,152,95,57,0,0,0
2020-01-13 07:30,259,197,62,0,0,0
2020-01-13 07:45,304,172,132,0,0,0
2020-01-13 08:00,518,282,236,0,0,0
2020-01-13 08:15,311,163,148,0,0,0
2020-01-13 08:30,209,128,81,0,0,0
2020-01-13 08:45,262,136,126,0,0,0
2020-01-13 09:00,201,104,97,0,0,0
2020-01-13 09:15,163,95,68,0,0,0
2020-01-13 09:30,184,105,79,0,0,0
2020-01-13 09:45,346,183,163,0,0,0
2020-01-13 10:00,587,376,211,0,0,0
2020-01-13 10:15,146,85,61,0,0,0
2020-01-13 10:30,115,54,61,0,0,0
2020-01-13 10:45,137,64,73,0,0,0
2020-01-13 11:00,166,89,77,0,0,0
2020-01-13 11:15,134,67,67,0,0,0
2020-01-13 11:30,160,85,75,0,0,0
2020-01-13 11:45,382,196,186,0,0,0
2020-01-13 12:00,399,183,216,0,0,0
2020-01-13 12:15,199,82,117,0,0,0
2020-01-13 12:30,187,94,93,0,0,0
2020-01-13 12:45,232,107,125,0,0,0
2020-01-13 13:00,238,110,128,0,0,0
2020-01-13 13:15,193,86,107,0,0,0
2020-01-13 13:30,203,97,106,0,0,0
2020-01-13 13:45,384,202,182,0,0,0
2020-01-13 14:00,429,183,246,0,0,0
2020-01-13 14:15,216,103,113,0,0,0
2020-01-13 14:30,182,78,104,0,0,0
2020-01-13 14:45,223,94,129,0,0,0
2020-01-13 15:00,238,106,132,0,0,0
2020-01-13 15:15,197,100,97,0,0,0
2020-01-13 15:30,214,120,94,0,0,0
2020-01-13 15:45,530,275,255,0,0,0
2020-01-13 16:00,496,260,236,0,0,0
2020-01-13 16:15,317,151,166,0,0,0
2020-01-13 16:30,283,136,147,0,0,0
2020-01-13 16:45,250,124,126,0,0,0
2020-01-13 17:00,280,145,135,0,0,0
2020-01-13 17:15,275,122,153,0,0,0
2020-01-13 17:30,328,159,169,0,0,0
2020-01-13 17:45,503,237,266,0,0,0
2020-01-13 18:00,381,171,210,0,0,0
2020-01-13 18:15,299,122,177,0,0,0
2020-01-13 18:30,272,139,133,0,0,0
2020-01-13 18:45,275,134,141,0,0,0
2020-01-13 19:00,268,126,142,0,0,0
2020-01-13 19:15,213,94,119,0,0,0
2020-01-13 19:30,185,71,114,0,0,0
2020-01-13 19:45,321,138,183,0,0,0
2020-01-13 20:00,201,88,113,0,0,0
2020-01-13 20:15,182,79,103,0,0,0
2020-01-13 20:30,127,53,74,0,0,0
2020-01-13 20:45,119,51,68,0,0,0
2020-01-13 21:00,94,46,48,0,0,0
2020-01-13 21:15,91,31,60,0,0,0
2020-01-13 21:30,101,35,66,0,0,0
2020-01-13 21:45,124,33,91,0,0,0
2020-01-13 22:00,119,45,74,0,0,0
2020-01-13 22:15,118,55,63,0,0,0
2020-01-13 22:30,74,17,57,0,0,0
2020-01-13 22:45,66,15,51,0,0,0
2020-01-13 23:00,43,13,30,0,0,0
2020-01-13 23:15,41,15,26,0,0,0
2020-01-13 23:30,42,17,25,0,0,0
2020-01-13 23:45,45,10,35,0,0,0
2020-01-14 00:00,30,7,23,0,0,0
2020-01-14 00:15,44,13,31,0,0,0
2020-01-14 00:30,14,4,10,0,0,0
2020-01-14 00:45,8,0,8,0,0,0
2020-01-14 01:00,12,3,9,0,0,0
2020-01-14 01:15,18,5,13,0,0,0
2020-01-14 01:30,4,0,4,0,0,0
2020-01-14 01:45,9,3,6,0,0,0
2020-01-14 02:00,1,0,1,0,0,0
2020-01-14 02:15,3,3,0,0,0,0
2020-01-14 02:30,3,2,1,0,0,0
2020-01-14 02:45,1,0,1,0,0,0
2020-01-14 03:00,1,0,1,0,0,0
2020-01-14 03:15,2,0,2,0,0,0
2020-01-14 03:30,3,0,3,0,0,0
2020-01-14 03:45,1,0,1,0,0,0
2020-01-14 04:00,2,1,1,0,0,0
2020-01-14 04:15,1,1,0,0,0,0
2020-01-14 04:30,3,3,0,0,0,0
2020-01-14 04:45,9,5,4,0,0,0
2020-01-14 05:00,11,6,5,0,0,0
2020-01-14 05:15,9,7,2,0,0,0
2020-01-14 05:30,18,13,5,0,0,0
2020-01-14 05:45,22,10,12,0,0,0
2020-01-14 06:00,20,13,7,0,0,0
2020-01-14 06:15,45,36,9,0,0,0
2020-01-14 06:30,46,28,18,0,0,0
2020-01-14 06:45,72,46,26,0,0,0
2020-01-14 07:00,78,53,25,0,0,0
2020-01-14 07:15,131,85,46,0,0,0
2020-01-14 07:30,215,149,66,0,0,0
2020-01-14 07:45,314,184,130,0,0,0
2020-01-14 08:00,512,271,241,0,0,0
2020-01-14 08:15,345,182,163,0,0,0
2020-01-14 08:30,199,117,82,0,0,0
2020-01-14 08:45,272,159,113,0,0,0
2020-01-14 09:00,244,150,94,0,0,0
2020-01-14 09:15,161,93,68,0,0,0
2020-01-14 09:30,168,96,72,0,0,0
2020-01-14 09:45,503,241,262,0,0,0
2020-01-14 10:00,574,331,243,0,0,0
2020-01-14 10:15,172,87,85,0,0,0
2020-01-14 10:30,116,59,57,0,0,0
2020-01-14 10:45,154,76,78,0,0,0
2020-01-14 11:00,164,84,80,0,0,0
2020-01-14 11:15,135,75,60,0,0,0
2020-01-14 11:30,176,106,70,0,0,0
2020-01-14 11:45,416,247,169,0,0,0
2020-01-14 12:00,444,195,249,0,0,0
2020-01-14 12:15,221,119,102,0,0,0
2020-01-14 12:30,160,87,73,0,0,0
2020-01-14 12:45,201,104,97,0,0,0
2020-01-14 13:00,185,78,107,0,0,0
2020-01-14 13:15,202,92,110,0,0,0
2020-01-14 13:30,192,84,108,0,0,0
2020-01-14 13:45,408,215,193,0,0,0
2020-01-14 14:00,427,201,226,0,0,0
2020-01-14 14:15,210,87,123,0,0,0
2020-01-14 14:30,161,75,86,0,0,0
2020-01-14 14:45,215,88,127,0,0,0
2020-01-14 15:00,179,86,93,0,0,0
2020-01-14 15:15,182,81,101,0,0,0
2020-01-14 15:30,213,102,111,0,0,0
2020-01-14 15:45,416,209,207,0,0,0
2020-01-14 16:00,460,238,222,0,0,0
2020-01-14 16:15,281,125,156,0,0,0
2020-01-14 16:30,247,121,126,0,0,0
2020-01-14 16:45,267,131,136,0,0,0
2020-01-14 17:00,240,129,111,0,0,0
2020-01-14 17:15,263,134,129,0,0,0
2020-01-14 17:30,334,177,157,0,0,0
2020-01-14 17:45,453,208,245,0,0,0
2020-01-14 18:00,434,185,249,0,0,0
2020-01-14 18:15,310,134,176,0,0,0
2020-01-14 18:30,292,154,138,0,0,0
2020-01-14 18:45,287,141,146,0,0,0
2020-01-14 19:00,261,127,134,0,0,0
2020-01-14 19:15,227,117,110,0,0,0
2020-01-14 19:30,231,108,123,0,0,0
2020-01-14 19:45,255,139,116,0,0,0
2020-01-14 20:00,233,118,115,0,0,0
2020-01-14 20:15,156,77,79,0,0,0
2020-01-14 20:30,120,48,72,0,0,0
2020-01-14 20:45,152,66,86,0,0,0
2020-01-14 21:00,107,49,58,0,0,0
2020-01-14 21:15,122,50,72,0,0,0
2020-01-14 21:30,93,41,52,0,0,0
2020-01-14 21:45,112,30,82,0,0,0
2020-01-14 22:00,157,53,104,0,0,0
2020-01-14 22:15,140,67,73,0,0,0
2020-01-14 22:30,106,40,66,0,0,0
2020-01-14 22:45,77,25,52,0,0,0
2020-01-14 23:00,67,22,45,0,0,0
2020-01-14 23:15,63,27,36,0,0,0
2020-01-14 23:30,43,14,29,0,0,0
2020-01-14 23:45,44,16,28,0,0,0
2020-01-15 00:00,34,8,26,0,0,0
2020-01-15 00:15,21,6,15,0,0,0
2020-01-15 00:30,22,6,16,0,0,0
2020-01-15 00:45,16,10,6,0,0,0
2020-01-15 01:00,15,3,12,0,0,0
2020-01-15 01:15,12,2,10,0,0,0
2020-01-15 01:30,8,0,8,0,0,0
2020-01-15 01:45,11,4,7,0,0,0
2020-01-15 02:00,5,1,4,0,0,0
2020-01-15 02:15,3,1,2,0,0,0
2020-01-15 02:30,3,2,1,0,0,0
2020-01-15 02:45,3,2,1,0,0,0
2020-01-15 03:00,3,0,3,0,0,0
2020-01-15 03:15,7,0,7,0,0,0
2020-01-15 03:30,4,1,3,0,0,0
2020-01-15 03:45,7,2,5,0,0,0
2020-01-15 04:00,2,1,1,0,0,0
2020-01-15 04:15,2,1,1,0,0,0
2020-01-15 04:30,5,4,1,0,0,0
2020-01-15 04:45,12,8,4,0,0,0
2020-01-15 05:00,7,5,2,0,0,0
2020-01-15 05:15,5,2,3,0,0,0
2020-01-15 05:30,11,10,1,0,0,0
2020-01-15 05:45,32,19,13,0,0,0
2020-01-15 06:00,24,19,5,0,0,0
2020-01-15 06:15,37,29,8,0,0,0
2020-01-15 06:30,59,38,21,0,0,0
2020-01-15 06:45,99,64,35,0,0,0
2020-01-15 07:00,96,61,35,0,0,0
2020-01-15 07:15,161,103,58,0,0,0
2020-01-15 07:30,273,196,77,0,0,0
2020-01-15 07:45,360,238,122,0,0,0
2020-01-15 08:00,543,299,244,0,0,0
2020-01-15 08:15,397,192,205,0,0,0
2020-01-15 08:30,219,135,84,0,0,0
2020-01-15 08:45,305,161,144,0,0,0
2020-01-15 09:00,236,137,99,0,0,0
2020-01-15 09:15,175,94,81,0,0,0
2020-01-15 09:30,218,129,89,0,0,0
2020-01-15 09:45,411,209,202,0,0,0
2020-01-15 10:00,481,279,202,0,0,0
2020-01-15 10:15,213,107,106,0,0,0
2020-01-15 10:30,158,96,62,0,0,0
2020-01-15 10:45,153,81,72,0,0,0
2020-01-15 11:00,181,85,96,0,0,0
2020-01-15 11:15,166,97,69,0,0,0
2020-01-15 11:30,196,108,88,0,0,0
2020-01-15 11:45,485,285,200,0,0,0
2020-01-15 12:00,367,185,182,0,0,0
2020-01-15 12:15,258,119,139,0,0,0
2020-01-15 12:30,219,115,104,0,0,0
2020-01-15 12:45,291,154,137,0,0,0
2020-01-15 13:00,251,131,120,0,0,0
2020-01-15 13:15,216,95,121,0,0,0
2020-01-15 13:30,271,147,124,0,0,0
2020-01-15 13:45,397,238,159,0,0,0
2020-01-15 14:00,435,218,217,0,0,0
2020-01-15 14:15,262,132,130,0,0,0
2020-01-15 14:30,199,105,94,0,0,0
2020-01-15 14:45,210,79,131,0,0,0
2020-01-15 15:00,193,81,112,0,0,0
2020-01-15 15:15,261,133,128,0,0,0
2020-01-15 15:30,271,136,135,0,0,0
2020-01-15 15:45,470,226,244,0,0,0
2020-01-15 16:00,480,214,266,0,0,0
2020-01-15 16:15,334,130,204,0,0,0
2020-01-15 16:30,250,110,140,0,0,0
2020-01-15 16:45,305,147,158,0,0,0
2020-01-15 17:00,260,124,136,0,0,0
2020-01-15 17:15,269,127,142,0,0,0
2020-01-15 17:30,282,144,138,0,0,0
2020-01-15 17:45,447,209,238,0,0,0
2020-01-15 18:00,365,160,205,0,0,0
2020-01-15 18:15,267,126,141,0,0,0
2020-01-15 18:30,234,112,122,0,0,0
2020-01-15 18:45,257,114,143,0,0,0
2020-01-15 19:00,237,111,126,0,0,0
2020-01-15 19:15,234,115,119,0,0,0
2020-01-15 19:30,224,109,115,0,0,0
2020-01-15 19:45,310,128,182,0,0,0
2020-01-15 20:00,277,136,141,0,0,0
2020-01-15 20:15,205,105,100,0,0,0
2020-01-15 20:30,130,53,77,0,0,0
2020-01-15 20:45,123,56,67,0,0,0
2020-01-15 21:00,103,41,62,0,0,0
2020-01-15 21:15,85,29,56,0,0,0
2020-01-15 21:30,100,36,64,0,0,0
2020-01-15 21:45,110,41,69,0,0,0
2020-01-15 22:00,123,43,80,0,0,0
2020-01-15 22:15,140,59,81,0,0,0
2020-01-15 22:30,132,36,96,0,0,0
2020-01-15 22:45,78,27,51,0,0,0
2020-01-15 23:00,86,29,57,0,0,0
2020-01-15 23:15,63,19,44,0,0,0
2020-01-15 23:30,66,23,43,0,0,0
2020-01-15 23:45,56,12,44,0,0,0
2020-01-16 00:00,28,8,20,0,0,0
2020-01-16 00:15,29,9,20,0,0,0
2020-01-16 00:30,36,13,23,0,0,0
2020-01-16 00:45,25,5,20,0,0,0
2020-01-16 01:00,21,6,15,0,0,0
2020-01-16 01:15,25,8,17,0,0,0
2020-01-16 01:30,21,4,17,0,0,0
2020-01-16 01:45,17,5,12,0,0,0
2020-01-16 02:00,23,3,20,0,0,0
2020-01-16 02:15,10,1,9,0,0,0
2020-01-16 02:30,8,1,7,0,0,0
2020-01-16 02:45,10,1,9,0,0,0
2020-01-16 03:00,5,2,3,0,0,0
2020-01-16 03:15,11,2,9,0,0,0
2020-01-16 03:30,4,0,4,0,0,0
2020-01-16 03:45,5,4,1,0,0,0
2020-01-16 04:00,4,0,4,0,0,0
2020-01-16 04:15,2,0,2,0,0,0
2020-01-16 04:30,8,3,5,0,0,0
2020-01-16 04:45,11,6,5,0,0,0
2020-01-16 05:00,12,6,6,0,0,0
2020-01-16 05:15,8,7,1,0,0,0
2020-01-16 05:30,16,13,3,0,0,0
2020-01-16 05:45,29,17,12,0,0,0
2020-01-16 06:00,22,16,6,0,0,0
2020-01-16 06:15,49,39,10,0,0,0
2020-01-16 06:30,57,42,15,0,0,0
2020-01-16 06:45,86,51,35,0,0,0
2020-01-16 07:00,101,65,36,0,0,0
2020-01-16 07:15,146,92,54,0,0,0
2020-01-16 07:30,292,226,66,0,0,0
2020-01-16 07:45,387,242,145,0,0,0
2020-01-16 08:00,543,272,271,0,0,0
2020-01-16 08:15,377,187,190,0,0,0
2020-01-16 08:30,227,151,76,0,0,0
2020-01-16 08:45,266,169,97,0,0,0
2020-01-16 09:00,229,138,91,0,0,0
2020-01-16 09:15,214,147,67,0,0,0
2020-01-16 09:30,233,130,103,0,0,0
2020-01-16 09:45,474,271,203,0,0,0
2020-01-16 10:00,573,353,220,0,0,0
2020-01-16 10:15,211,94,117,0,0,0
2020-01-16 10:30,120,65,55,0,0,0
2020-01-16 10:45,139,68,71,0,0,0
2020-01-16 11:00,195,108,87,0,0,0
2020-01-16 11:15,155,80,75,0,0,0
2020-01-16 11:30,173,99,74,0,0,0
2020-01-16 11:45,367,204,163,0,0,0
2020-01-16 12:00,437,173,264,0,0,0
2020-01-16 12:15,258,113,145,0,0,0
2020-01-16 12:30,171,82,89,0,0,0
2020-01-16 12:45,218,117,101,0,0,0
2020-01-16 13:00,209,101,108,0,0,0
2020-01-16 13:15,231,104,127,0,0,0
2020-01-16 13:30,240,113,127,0,0,0
2020-01-16 13:45,396,204,192,0,0,0
2020-01-16 14:00,434,210,224,0,0,0
2020-01-16 14:15,275,141,134,0,0,0
2020-01-16 14:30,180,93,87,0,0,0
2020-01-16 14:45,219,91,128,0,0,0
2020-01-16 15:00,217,102,115,0,0,0
2020-01-16 15:15,210,105,105,0,0,0
2020-01-16 15:30,274,137,137,0,0,0
2020-01-16 15:45,433,238,195,0,0,0
2020-01-16 16:00,456,232,224,0,0,0
2020-01-16 16:15,311,145,166,0,0,0
2020-01-16 16:30,303,148,155,0,0,0
2020-01-16 16:45,332,160,172,0,0,0
2020-01-16 17:00,293,147,146,0,0,0
2020-01-16 17:15,312,135,177,0,0,0
2020-01-16 17:30,315,164,151,0,0,0
2020-01-16 17:45,485,210,275,0,0,0
2020-01-16 18:00,408,158,250,0,0,0
2020-01-16 18:15,306,129,177,0,0,0
2020-01-16 18:30,259,141,118,0,0,0
2020-01-16 18:45,310,150,160,0,0,0
2020-01-16 19:00,239,116,123,0,0,0
2020-01-16 19:15,258,117,141,0,0,0
2020-01-16 19:30,219,100,119,0,0,0
2020-01-16 19:45,264,119,145,0,0,0
2020-01-16 20:00,280,132,148,0,0,0
2020-01-16 20:15,170,72,98,0,0,0
2020-01-16 20:30,136,59,77,0,0,0
2020-01-16 20:45,102,34,68,0,0,0
2020-01-16 21:00,111,49,62,0,0,0
2020-01-16 21:15,119,53,66,0,0,0
2020-01-16 21:30,88,33,55,0,0,0
2020-01-16 21:45,117,32,85,0,0,0
2020-01-16 22:00,122,45,77,0,0,0
2020-01-16 22:15,116,45,71,0,0,0
2020-01-16 22:30,118,22,96,0,0,0
2020-01-16 22:45,135,40,95,0,0,0
2020-01-16 23:00,93,25,68,0,0,0
2020-01-16 23:15,73,23,50,0,0,0
2020-01-16 23:30,57,21,36,0,0,0
2020-01-16 23:45,41,8,33,0,0,0
2020-01-17 00:00,50,25,25,0,0,0
2020-01-17 00:15,29,9,20,0,0,0
2020-01-17 00:30,26,8,18,0,0,0
2020-01-17 00:45,21,6,15,0,0,0
2020-01-17 01:00,14,5,9,0,0,0
2020-01-17 01:15,10,4,6,0,0,0
2020-01-17 01:30,17,2,15,0,0,0
2020-01-17 01:45,9,0,9,0,0,0
2020-01-17 02:00,5,1,4,0,0,0
2020-01-17 02:15,5,0,5,0,0,0
2020-01-17 02:30,7,3,4,0,0,0
2020-01-17 02:45,5,2,3,0,0,0
2020-01-17 03:00,2,2,0,0,0,0
2020-01-17 03:15,4,1,3,0,0,0
2020-01-17 03:30,4,2,2,0,0,0
2020-01-17 03:45,5,3,2,0,0,0
2020-01-17 04:00,1,0,1,0,0,0
2020-01-17 04:15,2,0,2,0,0,0
2020-01-17 04:30,5,4,1,0,0,0
2020-01-17 04:45,7,4,3,0,0,0
2020-01-17 05:00,9,3,6,0,0,0
2020-01-17 05:15,8,7,1,0,0,0
2020-01-17 05:30,13,11,2,0,0,0
2020-01-17 05:45,21,9,12,0,0,0
2020-01-17 06:00,22,12,10,0,0,0
2020-01-17 06:15,33,23,10,0,0,0
2020-01-17 06:30,47,28,19,0,0,0
2020-01-17 06:45,65,38,27,0,0,0
2020-01-17 07:00,98,60,38,0,0,0
2020-01-17 07:15,149,86,63,0,0,0
2020-01-17 07:30,267,184,83,0,0,0
2020-01-17 07:45,337,194,143,0,0,0
2020-01-17 08:00,346,189,157,0,0,0
2020-01-17 08:15,313,150,163,0,0,0
2020-01-17 08:30,199,120,79,0,0,0
2020-01-17 08:45,250,132,118,0,0,0
2020-01-17 09:00,225,120,105,0,0,0
2020-01-17 09:15,147,90,57,0,0,0
2020-01-17 09:30,167,94,73,0,0,0
2020-01-17 09:45,300,166,134,0,0,0
2020-01-17 10:00,391,216,175,0,0,0
2020-01-17 10:15,154,70,84,0,0,0
2020-01-17 10:30,137,74,63,0,0,0
2020-01-17 10:45,155,72,83,0,0,0
2020-01-17 11:00,164,88,76,0,0,0
2020-01-17 11:15,164,77,87,0,0,0
2020-01-17 11:30,187,93,94,0,0,0
2020-01-17 11:45,260,154,106,0,0,0
2020-01-17 12:00,293,137,156,0,0,0
2020-01-17 12:15,231,105,126,0,0,0
2020-01-17 12:30,205,120,85,0,0,0
2020-01-17 12:45,199,110,89,0,0,0
2020-01-17 13:00,243,126,117,0,0,0
2020-01-17 13:15,245,106,139,0,0,0
2020-01-17 13:30,228,118,110,0,0,0
2020-01-17 13:45,294,165,129,0,0,0
2020-01-17 14:00,332,175,157,0,0,0
2020-01-17 14:15,216,91,125,0,0,0
2020-01-17 14:30,216,102,114,0,0,0
2020-01-17 14:45,213,95,118,0,0,0
2020-01-17 15:00,203,82,121,0,0,0
2020-01-17 15:15,208,95,113,0,0,0
2020-01-17 15:30,162,92,70,0,0,0
2020-01-17 15:45,224,122,102,0,0,0
2020-01-17 16:00,249,128,121,0,0,0
2020-01-17 16:15,216,102,114,0,0,0
2020-01-17 16:30,185,81,104,0,0,0
2020-01-17 16:45,236,123,113,0,0,0
2020-01-17 17:00,179,92,87,0,0,0
2020-01-17 17:15,203,93,110,0,0,0
2020-01-17 17:30,191,77,114,0,0,0
2020-01-17 17:45,247,111,136,0,0,0
2020-01-17 18:00,244,118,126,0,0,0
2020-01-17 18:15,173,81,92,0,0,0
2020-01-17 18:30,175,67,108,0,0,0
2020-01-17 18:45,222,119,103,0,0,0
2020-01-17 19:00,166,86,80,0,0,0
2020-01-17 19:15,173,87,86,0,0,0
2020-01-17 19:30,139,66,73,0,0,0
2020-01-17 19:45,173,99,74,0,0,0
2020-01-17 20:00,173,80,93,0,0,0
2020-01-17 20:15,176,72,104,0,0,0
2020-01-17 20:30,144,69,75,0,0,0
2020-01-17 20:45,104,48,56,0,0,0
2020-01-17 21:00,110,51,59,0,0,0
2020-01-17 21:15,92,37,55,0,0,0
2020-01-17 21:30,109,39,70,0,0,0
2020-01-17 21:45,84,36,48,0,0,0
2020-01-17 22:00,92,51,41,0,0,0
2020-01-17 22:15,63,28,35,0,0,0
2020-01-17 22:30,98,28,70,0,0,0
2020-01-17 22:45,73,28,45,0,0,0
2020-01-17 23:00,74,33,41,0,0,0
2020-01-17 23:15,75,41,34,0,0,0
2020-01-17 23:30,68,26,42,0,0,0
2020-01-17 23:45,62,16,46,0,0,0
2020-01-18 00:00,59,23,36,0,0,0
2020-01-18 00:15,45,21,24,0,0,0
2020-01-18 00:30,50,19,31,0,0,0
2020-01-18 00:45,72,27,45,0,0,0
2020-01-18 01:00,56,30,26,0,0,0
2020-01-18 01:15,45,17,28,0,0,0
2020-01-18 01:30,44,16,28,0,0,0
2020-01-18 01:45,53,16,37,0,0,0
2020-01-18 02:00,42,18,24,0,0,0
2020-01-18 02:15,33,9,24,0,0,0
2020-01-18 02:30,45,20,25,0,0,0
2020-01-18 02:45,42,16,26,0,0,0
2020-01-18 03:00,40,14,26,0,0,0
2020-01-18 03:15,34,7,27,0,0,0
2020-01-18 03:30,25,6,19,0,0,0
2020-01-18 03:45,12,4,8,0,0,0
2020-01-18 04:00,18,2,16,0,0,0
2020-01-18 04:15,11,6,5,0,0,0
2020-01-18 04:30,13,5,8,0,0,0
2020-01-18 04:45,12,5,7,0,0,0
2020-01-18 05:00,3,1,2,0,0,0
2020-01-18 05:15,20,10,10,0,0,0
2020-01-18 05:30,14,7,7,0,0,0
2020-01-18 05:45,20,8,12,0,0,0
2020-01-18 06:00,12,4,8,0,0,0
2020-01-18 06:15,13,8,5,0,0,0
2020-01-18 06:30,10,7,3,0,0,0
2020-01-18 06:45,9,5,4,0,0,0
2020-01-18 07:00,5,3,2,0,0,0
2020-01-18 07:15,17,12,5,0,0,0
2020-01-18 07:30,25,24,1,0,0,0
2020-01-18 07:45,128,113,15,0,0,0
2020-01-18 08:00,66,53,13,0,0,0
2020-01-18 08:15,61,46,15,0,0,0
2020-01-18 08:30,70,47,23,0,0,0
2020-01-18 08:45,118,84,34,0,0,0
2020-01-18 09:00,94,73,21,0,0,0
2020-01-18 09:15,73,45,28,0,0,0
2020-01-18 09:30,99,70,29,0,0,0
2020-01-18 09:45,168,133,35,0,0,0
2020-01-18 10:00,129,101,28,0,0,0
2020-01-18 10:15,109,81,28,0,0,0
2020-01-18 10:30,102,73,29,0,0,0
2020-01-18 10:45,163,93,70,0,0,0
2020-01-18 11:00,104,63,41,0,0,0
2020-01-18 11:15,100,53,47,0,0,0
2020-01-18 11:30,116,74,42,0,0,0
2020-01-18 11:45,130,83,47,0,0,0
2020-01-18 12:00,117,71,46,0,0,0
2020-01-18 12:15,155,94,61,0,0,0
2020-01-18 12:30,160,103,57,0,0,0
2020-01-18 12:45,170,109,61,0,0,0
2020-01-18 13:00,120,61,59,0,0,0
2020-01-18 13:15,133,66,67,0,0,0
2020-01-18 13:30,142,70,72,0,0,0
2020-01-18 13:45,182,93,89,0,0,0
2020-01-18 14:00,156,71,85,0,0,0
2020-01-18 14:15,157,86,71,0,0,0
2020-01-18 14:30,108,44,64,0,0,0
2020-01-18 14:45,178,86,92,0,0,0
2020-01-18 15:00,134,54,80,0,0,0
2020-01-18 15:15,155,59,96,0,0,0
2020-01-18 15:30,129,62,67,0,0,0
2020-01-18 15:45,122,69,53,0,0,0
2020-01-18 16:00,125,62,63,0,0,0
2020-01-18 16:15,123,41,82,0,0,0
2020-01-18 16:30,130,51,79,0,0,0
2020-01-18 16:45,100,39,61,0,0,0
2020-01-18 17:00,101,43,58,0,0,0
2020-01-18 17:15,123,59,64,0,0,0
2020-01-18 17:30,98,40,58,0,0,0
2020-01-18 17:45,151,47,104,0,0,0
2020-01-18 18:00,153,47,106,0,0,0
2020-01-18 18:15,164,74,90,0,0,0
2020-01-18 18:30,115,57,58,0,0,0
2020-01-18 18:45,150,89,61,0,0,0
2020-01-18 19:00,140,64,76,0,0,0
2020-01-18 19:15,116,59,57,0,0,0
2020-01-18 19:30,132,67,65,0,0,0
2020-01-18 19:45,121,59,62,0,0,0
2020-01-18 20:00,119,57,62,0,0,0
2020-01-18 20:15,113,58,55,0,0,0
2020-01-18 20:30,95,49,46,0,0,0
2020-01-18 20:45,95,50,45,0,0,0
2020-01-18 21:00,73,30,43,0,0,0
2020-01-18 21:15,65,25,40,0,0,0
2020-01-18 21:30,69,26,43,0,0,0
2020-01-18 21:45,40,22,18,0,0,0
2020-01-18 22:00,48,16,32,0,0,0
2020-01-18 22:15,55,27,28,0,0,0
2020-01-18 22:30,64,25,39,0,0,0
2020-01-18 22:45,63,22,41,0,0,0
2020-01-18 23:00,74,20,54,0,0,0
2020-01-18 23:15,77,33,44,0,0,0
2020-01-18 23:30,51,19,32,0,0,0
2020-01-18 23:45,78,37,41,0,0,0
2020-01-19 00:00,67,33,34,0,0,0
2020-01-19 00:15,58,28,30,0,0,0
2020-01-19 00:30,57,10,47,0,0,0
2020-01-19 00:45,59,16,43,0,0,0
2020-01-19 01:00,50,28,22,0,0,0
2020-01-19 01:15,42,17,25,0,0,0
2020-01-19 01:30,48,16,32,0,0,0
2020-01-19 01:45,35,20,15,0,0,0
2020-01-19 02:00,44,24,20,0,0,0
2020-01-19 02:15,32,7,25,0,0,0
2020-01-19 02:30,38,9,29,0,0,0
2020-01-19 02:45,35,3,32,0,0,0
2020-01-19 03:00,40,6,34,0,0,0
2020-01-19 03:15,38,8,30,0,0,0
2020-01-19 03:30,25,6,19,0,0,0
2020-01-19 03:45,15,6,9,0,0,0
2020-01-19 04:00,19,4,15,0,0,0
2020-01-19 04:15,17,6,11,0,0,0
2020-01-19 04:30,11,1,10,0,0,0
2020-01-19 04:45,2,1,1,0,0,0
2020-01-19 05:00,6,1,5,0,0,0
2020-01-19 05:15,11,3,8,0,0,0
2020-01-19 05:30,16,9,7,0,0,0
2020-01-19 05:45,5,2,3,0,0,0
2020-01-19 06:00,9,3,6,0,0,0
2020-01-19 06:15,9,3,6,0,0,0
2020-01-19 06:30,6,4,2,0,0,0
2020-01-19 06:45,8,4,4,0,0,0
2020-01-19 07:00,7,4,3,0,0,0
2020-01-19 07:15,6,5,1,0,0,0
2020-01-19 07:30,8,5,3,0,0,0
2020-01-19 07:45,66,59,7,0,0,0
2020-01-19 08:00,44,40,4,0,0,0
2020-01-19 08:15,30,19,11,0,0,0
2020-01-19 08:30,29,22,7,0,0,0
2020-01-19 08:45,41,28,13,0,0,0
2020-01-19 09:00,61,38,23,0,0,0
2020-01-19 09:15,91,72,19,0,0,0
2020-01-19 09:30,60,51,9,0,0,0
2020-01-19 09:45,126,105,21,0,0,0
2020-01-19 10:00,80,66,14,0,0,0
2020-01-19 10:15,61,47,14,0,0,0
2020-01-19 10:30,66,45,21,0,0,0
2020-01-19 10:45,81,53,28,0,0,0
2020-01-19 11:00,64,39,25,0,0,0
2020-01-19 11:15,82,44,38,0,0,0
2020-01-19 11:30,83,35,48,0,0,0
2020-01-19 11:45,109,41,68,0,0,0
2020-01-19 12:00,83,35,48,0,0,0
2020-01-19 12:15,125,49,76,0,0,0
2020-01-19 12:30,110,40,70,0,0,0
2020-01-19 12:45,106,51,55,0,0,0
2020-01-19 13:00,127,68,59,0,0,0
2020-01-19 13:15,149,86,63,0,0,0
2020-01-19 13:30,145,73,72,0,0,0
2020-01-19 13:45,147,81,66,0,0,0
2020-01-19 14:00,130,66,64,0,0,0
2020-01-19 14:15,134,65,69,0,0,0
2020-01-19 14:30,125,60,65,0,0,0
2020-01-19 14:45,173,95,78,0,0,0
2020-01-19 15:00,117,68,49,0,0,0
2020-01-19 15:15,78,41,37,0,0,0
2020-01-19 15:30,100,44,56,0,0,0
2020-01-19 15:45,150,71,79,0,0,0
2020-01-19 16:00,117,57,60,0,0,0
2020-01-19 16:15,90,46,44,0,0,0
2020-01-19 16:30,104,58,46,0,0,0
2020-01-19 16:45,127,61,66,0,0,0
2020-01-19 17:00,107,41,66,0,0,0
2020-01-19 17:15,129,49,80,0,0,0
2020-01-19 17:30,114,58,56,0,0,0
2020-01-19 17:45,140,91,49,0,0,0
2020-01-19 18:00,125,55,70,0,0,0
2020-01-19 18:15,96,33,63,0,0,0
2020-01-19 18:30,76,40,36,0,0,0
2020-01-19 18:45,109,63,46,0,0,0
2020-01-19 19:00,82,41,41,0,0,0
2020-01-19 19:15,75,40,35,0,0,0
2020-01-19 19:30,123,58,65,0,0,0
2020-01-19 19:45,91,40,51,0,0,0
2020-01-19 20:00,102,32,70,0,0,0
2020-01-19 20:15,114,31,83,0,0,0
2020-01-19 20:30,70,19,51,0,0,0
2020-01-19 20:45,71,30,41,0,0,0
2020-01-19 21:00,59,22,37,0,0,0
2020-01-19 21:15,54,18,36,0,0,0
2020-01-19 21:30,52,27,25,0,0,0
2020-01-19 21:45,57,16,41,0,0,0
2020-01-19 22:00,45,17,28,0,0,0
2020-01-19 22:15,50,17,33,0,0,0
2020-01-19 22:30,43,12,31,0,0,0
2020-01-19 22:45,61,14,47,0,0,0
2020-01-19 23:00,45,7,38,0,0,0
2020-01-19 23:15,32,12,20,0,0,0
2020-01-19 23:30,22,14,8,0,0,0
2020-01-19 23:45,22,6,16,0,0,0
2020-01-20 00:00,12,6,6,0,0,0
2020-01-20 00:15,19,5,14,0,0,0
2020-01-20 00:30,14,3,11,0,0,0
2020-01-20 00:45,13,3,10,0,0,0
2020-01-20 01:00,3,0,3,0,0,0
2020-01-20 01:15,8,1,7,0,0,0
2020-01-20 01:30,1,0,1,0,0,0
2020-01-20 01:45,4,2,2,0,0,0
2020-01-20 02:00,2,1,1,0,0,0
2020-01-20 02:15,1,0,1,0,0,0
2020-01-20 02:30,1,1,0,0,0,0
2020-01-20 02:45,2,1,1,0,0,0
2020-01-20 03:00,2,1,1,0,0,0
2020-01-20 03:15,1,0,1,0,0,0
2020-01-20 03:30,3,1,2,0,0,0
2020-01-20 03:45,4,3,1,0,0,0
2020-01-20 04:00,3,0,3,0,0,0
2020-01-20 04:15,1,0,1,0,0,0
2020-01-20 04:30,6,4,2,0,0,0
2020-01-20 04:45,11,6,5,0,0,0
2020-01-20 05:00,7,7,0,0,0,0
2020-01-20 05:15,7,6,1,0,0,0
2020-01-20 05:30,12,10,2,0,0,0
2020-01-20 05:45,25,15,10,0,0,0
2020-01-20 06:00,36,29,7,0,0,0
2020-01-20 06:15,47,32,15,0,0,0
2020-01-20 06:30,61,43,18,0,0,0
2020-01-20 06:45,67,41,26,0,0,0
2020-01-20 07:00,93,59,34,0,0,0
2020-01-20 07:15,154,103,51,0,0,0
2020-01-20 07:30,281,212,69,0,0,0
2020-01-20 07:45,393,272,121,0,0,0
2020-01-20 08:00,459,263,196,0,0,0
2020-01-20 08:15,376,199,177,0,0,0
2020-01-20 08:30,223,131,92,0,0,0
2020-01-20 08:45,275,159,116,0,0,0
2020-01-20 09:00,244,128,116,0,0,0
2020-01-20 09:15,159,102,57,0,0,0
2020-01-20 09:30,189,110,79,0,0,0
2020-01-20 09:45,374,206,168,0,0,0
2020-01-20 10:00,525,323,202,0,0,0
2020-01-20 10:15,157,83,74,0,0,0
2020-01-20 10:30,110,56,54,0,0,0
2020-01-20 10:45,147,73,74,0,0,0
2020-01-20 11:00,169,95,74,0,0,0
2020-01-20 11:15,140,63,77,0,0,0
2020-01-20 11:30,185,94,91,0,0,0
2020-01-20 11:45,362,206,156,0,0,0
2020-01-20 12:00,345,178,167,0,0,0
2020-01-20 12:15,230,110,120,0,0,0
2020-01-20 12:30,161,78,83,0,0,0
2020-01-20 12:45,213,97,116,0,0,0
2020-01-20 13:00,194,82,112,0,0,0
2020-01-20 13:15,206,94,112,0,0,0
2020-01-20 13:30,202,112,90,0,0,0
2020-01-20 13:45,411,217,194,0,0,0
2020-01-20 14:00,373,190,183,0,0,0
2020-01-20 14:15,221,124,97,0,0,0
2020-01-20 14:30,211,92,119,0,0,0
2020-01-20 14:45,207,97,110,0,0,0
2020-01-20 15:00,243,103,140,0,0,0
2020-01-20 15:15,173,86,87,0,0,0
2020-01-20 15:30,202,100,102,0,0,0
2020-01-20 15:45,437,209,228,0,0,0
2020-01-20 16:00,440,209,231,0,0,0
2020-01-20 16:15,292,138,154,0,0,0
2020-01-20 16:30,230,105,125,0,0,0
2020-01-20 16:45,279,134,145,0,0,0
2020-01-20 17:00,265,119,146,0,0,0
2020-01-20 17:15,279,135,144,0,0,0
2020-01-20 17:30,312,173,139,0,0,0
2020-01-20 17:45,460,207,253,0,0,0
2020-01-20 18:00,377,180,197,0,0,0
2020-01-20 18:15,283,126,157,0,0,0
2020-01-20 18:30,240,128,112,0,0,0
2020-01-20 18:45,280,150,130,0,0,0
2020-01-20 19:00,195,110,85,0,0,0
2020-01-20 19:15,232,121,111,0,0,0
2020-01-20 19:30,226,93,133,0,0,0
2020-01-20 19:45,264,131,133,0,0,0
2020-01-20 20:00,230,101,129,0,0,0
2020-01-20 20:15,171,69,102,0,0,0
2020-01-20 20:30,127,55,72,0,0,0
2020-01-20 20:45,130,45,85,0,0,0
2020-01-20 21:00,116,50,66,0,0,0
2020-01-20 21:15,121,40,81,0,0,0
2020-01-20 21:30,92,26,66,0,0,0
2020-01-20 21:45,121,38,83,0,0,0
2020-01-20 22:00,123,53,70,0,0,0
2020-01-20 22:15,138,52,86,0,0,0
2020-01-20 22:30,92,24,68,0,0,0
2020-01-20 22:45,63,17,46,0,0,0
2020-01-20 23:00,48,14,34,0,0,0
2020-01-20 23:15,49,16,33,0,0,0
2020-01-20 23:30,35,13,22,0,0,0
2020-01-20 23:45,28,9,19,0,0,0
2020-01-21 00:00,16,5,11,0,0,0
2020-01-21 00:15,19,4,15,0,0,0
2020-01-21 00:30,25,7,18,0,0,0
2020-01-21 00:45,10,2,8,0,0,0
2020-01-21 01:00,9,5,4,0,0,0
2020-01-21 01:15,7,2,5,0,0,0
2020-01-21 01:30,5,2,3,0,0,0
2020-01-21 01:45,4,1,3,0,0,0
2020-01-21 02:00,3,1,2,0,0,0
2020-01-21 02:15,2,1,1,0,0,0
2020-01-21 02:30,3,2,1,0,0,0
2020-01-21 02:45,1,0,1,0,0,0
2020-01-21 03:00,1,0,1,0,0,0
2020-01-21 03:15,1,0,1,0,0,0
2020-01-21 03:30,3,2,1,0,0,0
2020-01-21 03:45,4,4,0,0,0,0
2020-01-21 04:00,1,1,0,0,0,0
2020-01-21 04:15,1,0,1,0,0,0
2020-01-21 04:30,7,3,4,0,0,0
2020-01-21 04:45,11,6,5,0,0,0
2020-01-21 05:00,10,8,2,0,0,0
2020-01-21 05:15,11,10,1,0,0,0
2020-01-21 05:30,14,10,4,0,0,0
2020-01-21 05:45,22,11,11,0,0,0
2020-01-21 06:00,25,19,6,0,0,0
2020-01-21 06:15,40,32,8,0,0,0
2020-01-21 06:30,65,48,17,0,0,0
2020-01-21 06:45,87,52,35,0,0,0
2020-01-21 07:00,97,65,32,0,0,0
2020-01-21 07:15,155,102,53,0,0,0
2020-01-21 07:30,262,191,71,0,0,0
2020-01-21 07:45,421,266,155,0,0,0
2020-01-21 08:00,562,319,243,0,0,0
2020-01-21 08:15,344,182,162,0,0,0
2020-01-21 08:30,236,137,99,0,0,0
2020-01-21 08:45,317,203,114,0,0,0
2020-01-21 09:00,253,141,112,0,0,0
2020-01-21 09:15,184,106,78,0,0,0
2020-01-21 09:30,180,107,73,0,0,0
2020-01-21 09:45,430,232,198,0,0,0
2020-01-21 10:00,514,272,242,0,0,0
2020-01-21 10:15,185,97,88,0,0,0
2020-01-21 10:30,166,89,77,0,0,0
2020-01-21 10:45,129,67,62,0,0,0
2020-01-21 11:00,141,80,61,0,0,0
2020-01-21 11:15,180,103,77,0,0,0
2020-01-21 11:30,198,110,88,0,0,0
2020-01-21 11:45,373,238,135,0,0,0
2020-01-21 12:00,419,239,180,0,0,0
2020-01-21 12:15,257,125,132,0,0,0
2020-01-21 12:30,180,87,93,0,0,0
2020-01-21 12:45,235,126,109,0,0,0
2020-01-21 13:00,221,110,111,0,0,0
2020-01-21 13:15,257,93,164,0,0,0
2020-01-21 13:30,231,138,93,0,0,0
2020-01-21 13:45,401,193,208,0,0,0
2020-01-21 14:00,401,203,198,0,0,0
2020-01-21 14:15,244,128,116,0,0,0
2020-01-21 14:30,182,110,72,0,0,0
2020-01-21 14:45,202,89,113,0,0,0
2020-01-21 15:00,199,98,101,0,0,0
2020-01-21 15:15,212,115,97,0,0,0
2020-01-21 15:30,294,165,129,0,0,0
2020-01-21 15:45,477,246,231,0,0,0
2020-01-21 16:00,420,227,193,0,0,0
2020-01-21 16:15,307,154,153,0,0,0
2020-01-21 16:30,284,152,132,0,0,0
2020-01-21 16:45,330,162,168,0,0,0
2020-01-21 17:00,274,140,134,0,0,0
2020-01-21 17:15,311,156,155,0,0,0
2020-01-21 17:30,329,184,145,0,0,0
2020-01-21 17:45,496,250,246,0,0,0
2020-01-21 18:00,453,196,257,0,0,0
2020-01-21 18:15,324,153,171,0,0,0
2020-01-21 18:30,250,111,139,0,0,0
2020-01-21 18:45,278,121,157,0,0,0
2020-01-21 19:00,241,124,117,0,0,0
2020-01-21 19:15,259,135,124,0,0,0
2020-01-21 19:30,192,82,110,0,0,0
2020-01-21 19:45,286,122,164,0,0,0
2020-01-21 20:00,224,83,141,0,0,0
2020-01-21 20:15,167,71,96,0,0,0
2020-01-21 20:30,135,54,81,0,0,0
2020-01-21 20:45,117,42,75,0,0,0
2020-01-21 21:00,105,46,59,0,0,0
2020-01-21 21:15,165,85,80,0,0,0
2020-01-21 21:30,113,45,68,0,0,0
2020-01-21 21:45,107,35,72,0,0,0
2020-01-21 22:00,130,46,84,0,0,0
2020-01-21 22:15,125,57,68,0,0,0
2020-01-21 22:30,102,31,71,0,0,0
2020-01-21 22:45,71,39,32,0,0,0
2020-01-21 23:00,62,22,40,0,0,0
2020-01-21 23:15,74,34,40,0,0,0
2020-01-21 23:30,32,10,22,0,0,0
2020-01-21 23:45,42,13,29,0,0,0
2020-01-22 00:00,26,6,20,0,0,0
2020-01-22 00:15,25,6,19,0,0,0
2020-01-22 00:30,25,6,19,0,0,0
2020-01-22 00:45,19,5,14,0,0,0
2020-01-22 01:00,16,3,13,0,0,0
2020-01-22 01:15,24,5,19,0,0,0
2020-01-22 01:30,3,1,2,0,0,0
2020-01-22 01:45,6,2,4,0,0,0
2020-01-22 02:00,3,2,1,0,0,0
2020-01-22 02:15,1,1,0,0,0,0
2020-01-22 02:30,7,2,5,0,0,0
2020-01-22 02:45,4,2,2,0,0,0
2020-01-22 03:00,2,1,1,0,0,0
2020-01-22 03:15,1,0,1,0,0,0
2020-01-22 03:30,3,1,2,0,0,0
2020-01-22 03:45,2,1,1,0,0,0
2020-01-22 04:00,0,0,0,0,0,0
2020-01-22 04:15,2,1,1,0,0,0
2020-01-22 04:30,7,6,1,0,0,0
2020-01-22 04:45,9,5,4,0,0,0
2020-01-22 05:00,5,4,1,0,0,0
2020-01-22 05:15,11,9,2,0,0,0
2020-01-22 05:30,16,12,4,0,0,0
2020-01-22 05:45,32,20,12,0,0,0
2020-01-22 06:00,25,20,5,0,0,0
2020-01-22 06:15,37,28,9,0,0,0
2020-01-22 06:30,72,46,26,0,0,0
2020-01-22 06:45,79,55,24,0,0,0
2020-01-22 07:00,103,67,36,0,0,0
2020-01-22 07:15,144,92,52,0,0,0
2020-01-22 07:30,273,203,70,0,0,0
2020-01-22 07:45,413,287,126,0,0,0
2020-01-22 08:00,482,274,208,0,0,0
2020-01-22 08:15,335,182,153,0,0,0
2020-01-22 08:30,225,126,99,0,0,0
2020-01-22 08:45,292,183,109,0,0,0
2020-01-22 09:00,211,100,111,0,0,0
2020-01-22 09:15,164,99,65,0,0,0
2020-01-22 09:30,171,90,81,0,0,0
2020-01-22 09:45,327,189,138,0,0,0
2020-01-22 10:00,430,223,207,0,0,0
2020-01-22 10:15,204,120,84,0,0,0
2020-01-22 10:30,120,70,50,0,0,0
2020-01-22 10:45,139,76,63,0,0,0
2020-01-22 11:00,143,81,62,0,0,0
2020-01-22 11:15,142,77,65,0,0,0
2020-01-22 11:30,211,120,91,0,0,0
2020-01-22 11:45,395,273,122,0,0,0
2020-01-22 12:00,342,194,148,0,0,0
2020-01-22 12:15,205,100,105,0,0,0
2020-01-22 12:30,163,69,94,0,0,0
2020-01-22 12:45,225,121,104,0,0,0
2020-01-22 13:00,235,124,111,0,0,0
2020-01-22 13:15,227,108,119,0,0,0
2020-01-22 13:30,225,135,90,0,0,0
2020-01-22 13:45,317,168,149,0,0,0
2020-01-22 14:00,379,201,178,0,0,0
2020-01-22 14:15,216,96,120,0,0,0
2020-01-22 14:30,180,88,92,0,0,0
2020-01-22 14:45,182,90,92,0,0,0
2020-01-22 15:00,191,84,107,0,0,0
2020-01-22 15:15,192,105,87,0,0,0
2020-01-22 15:30,299,121,178,0,0,0
2020-01-22 15:45,396,192,204,0,0,0
2020-01-22 16:00,410,196,214,0,0,0
2020-01-22 16:15,288,126,162,0,0,0
2020-01-22 16:30,272,130,142,0,0,0
2020-01-22 16:45,285,126,159,0,0,0
2020-01-22 17:00,279,159,120,0,0,0
2020-01-22 17:15,239,113,126,0,0,0
2020-01-22 17:30,277,150,127,0,0,0
2020-01-22 17:45,388,209,179,0,0,0
2020-01-22 18:00,361,188,173,0,0,0
2020-01-22 18:15,283,121,162,0,0,0
2020-01-22 18:30,271,106,165,0,0,0
2020-01-22 18:45,316,170,146,0,0,0
2020-01-22 19:00,245,118,127,0,0,0
2020-01-22 19:15,227,99,128,0,0,0
2020-01-22 19:30,224,116,108,0,0,0
2020-01-22 19:45,269,112,157,0,0,0
2020-01-22 20:00,212,86,126,0,0,0
2020-01-22 20:15,143,50,93,0,0,0
2020-01-22 20:30,129,56,73,0,0,0
2020-01-22 20:45,104,36,68,0,0,0
2020-01-22 21:00,118,60,58,0,0,0
2020-01-22 21:15,110,42,68,0,0,0
2020-01-22 21:30,84,31,53,0,0,0
2020-01-22 21:45,118,42,76,0,0,0
2020-01-22 22:00,133,54,79,0,0,0
2020-01-22 22:15,198,144,54,0,0,0
2020-01-22 22:30,186,102,84,0,0,0
2020-01-22 22:45,118,55,63,0,0,0
2020-01-22 23:00,90,43,47,0,0,0
2020-01-22 23:15,62,18,44,0,0,0
2020-01-22 23:30,61,37,24,0,0,0
2020-01-22 23:45,60,23,37,0,0,0
2020-01-23 00:00,37,15,22,0,0,0
2020-01-23 00:15,28,8,20,0,0,0
2020-01-23 00:30,26,10,16,0,0,0
2020-01-23 00:45,37,14,23,0,0,0
2020-01-23 01:00,26,12,14,0,0,0
2020-01-23 01:15,24,8,16,0,0,0
2020-01-23 01:30,21,6,15,0,0,0
2020-01-23 01:45,14,2,12,0,0,0
2020-01-23 02:00,9,1,8,0,0,0
2020-01-23 02:15,3,0,3,0,0,0
2020-01-23 02:30,6,2,4,0,0,0
2020-01-23 02:45,12,2,10,0,0,0
2020-01-23 03:00,6,0,6,0,0,0
2020-01-23 03:15,4,1,3,0,0,0
2020-01-23 03:30,11,1,10,0,0,0
2020-01-23 03:45,1,0,1,0,0,0
2020-01-23 04:00,4,0,4,0,0,0
2020-01-23 04:15,3,1,2,0,0,0
2020-01-23 04:30,5,5,0,0,0,0
2020-01-23 04:45,11,9,2,0,0,0
2020-01-23 05:00,9,5,4,0,0,0
2020-01-23 05:15,9,8,1,0,0,0
2020-01-23 05:30,19,10,9,0,0,0
2020-01-23 05:45,18,11,7,0,0,0
2020-01-23 06:00,31,22,9,0,0,0
2020-01-23 06:15,38,26,12,0,0,0
2020-01-23 06:30,54,37,17,0,0,0
2020-01-23 06:45,68,46,22,0,0,0
2020-01-23 07:00,100,64,36,0,0,0
2020-01-23 07:15,153,111,42,0,0,0
2020-01-23 07:30,245,179,66,0,0,0
2020-01-23 07:45,396,260,136,0,0,0
2020-01-23 08:00,439,240,199,0,0,0
2020-01-23 08:15,363,213,150,0,0,0
2020-01-23 08:30,219,135,84,0,0,0
2020-01-23 08:45,245,146,99,0,0,0
2020-01-23 09:00,213,117,96,0,0,0
2020-01-23 09:15,194,111,83,0,0,0
2020-01-23 09:30,142,97,45,0,0,0
2020-01-23 09:45,381,223,158,0,0,0
2020-01-23 10:00,492,296,196,0,0,0
2020-01-23 10:15,189,103,86,0,0,0
2020-01-23 10:30,140,89,51,0,0,0
2020-01-23 10:45,138,75,63,0,0,0
2020-01-23 11:00,139,74,65,0,0,0
2020-01-23 11:15,153,84,69,0,0,0
2020-01-23 11:30,167,94,73,0,0,0
2020-01-23 11:45,397,215,182,0,0,0
2020-01-23 12:00,353,197,156,0,0,0
2020-01-23 12:15,241,113,128,0,0,0
2020-01-23 12:30,222,109,113,0,0,0
2020-01-23 12:45,215,119,96,0,0,0
2020-01-23 13:00,227,115,112,0,0,0
2020-01-23 13:15,224,93,131,0,0,0
2020-01-23 13:30,298,163,135,0,0,0
2020-01-23 13:45,346,203,143,0,0,0
2020-01-23 14:00,367,182,185,0,0,0
2020-01-23 14:15,246,132,114,0,0,0
2020-01-23 14:30,210,105,105,0,0,0
2020-01-23 14:45,198,102,96,0,0,0
2020-01-23 15:00,204,107,97,0,0,0
2020-01-23 15:15,219,110,109,0,0,0
2020-01-23 15:30,242,136,106,0,0,0
2020-01-23 15:45,405,234,171,0,0,0
2020-01-23 16:00,343,188,155,0,0,0
2020-01-23 16:15,294,156,138,0,0,0
2020-01-23 16:30,275,136,139,0,0,0
2020-01-23 16:45,294,146,148,0,0,0
2020-01-23 17:00,259,142,117,0,0,0
2020-01-23 17:15,256,135,121,0,0,0
2020-01-23 17:30,316,172,144,0,0,0
2020-01-23 17:45,426,208,218,0,0,0
2020-01-23 18:00,368,181,187,0,0,0
2020-01-23 18:15,284,156,128,0,0,0
2020-01-23 18:30,248,136,112,0,0,0
2020-01-23 18:45,273,158,115,0,0,0
2020-01-23 19:00,226,108,118,0,0,0
2020-01-23 19:15,214,105,109,0,0,0
2020-01-23 19:30,204,83,121,0,0,0
2020-01-23 19:45,298,114,184,0,0,0
2020-01-23 20:00,194,86,108,0,0,0
2020-01-23 20:15,210,89,121,0,0,0
2020-01-23 20:30,135,52,83,0,0,0
2020-01-23 20:45,130,49,81,0,0,0
2020-01-23 21:00,87,37,50,0,0,0
2020-01-23 21:15,131,42,89,0,0,0
2020-01-23 21:30,98,49,49,0,0,0
2020-01-23 21:45,111,48,63,0,0,0
2020-01-23 22:00,115,41,74,0,0,0
2020-01-23 22:15,131,54,77,0,0,0
2020-01-23 22:30,79,24,55,0,0,0
2020-01-23 22:45,98,29,69,0,0,0
2020-01-23 23:00,61,24,37,0,0,0
2020-01-23 23:15,53,21,32,0,0,0
2020-01-23 23:30,51,17,34,0,0,0
2020-01-23 23:45,45,12,33,0,0,0
2020-01-24 00:00,46,18,28,0,0,0
2020-01-24 00:15,38,15,23,0,0,0
2020-01-24 00:30,36,13,23,0,0,0
2020-01-24 00:45,24,8,16,0,0,0
2020-01-24 01:00,23,4,19,0,0,0
2020-01-24 01:15,14,1,13,0,0,0
2020-01-24 01:30,10,5,5,0,0,0
2020-01-24 01:45,7,2,5,0,0,0
2020-01-24 02:00,11,1,10,0,0,0
2020-01-24 02:15,4,1,3,0,0,0
2020-01-24 02:30,6,4,2,0,0,0
2020-01-24 02:45,9,4,5,0,0,0
2020-01-24 03:00,2,1,1,0,0,0
2020-01-24 03:15,5,1,4,0,0,0
2020-01-24 03:30,0,0,0,0,0,0
2020-01-24 03:45,4,1,3,0,0,0
2020-01-24 04:00,2,0,2,0,0,0
2020-01-24 04:15,3,3,0,0,0,0
2020-01-24 04:30,4,3,1,0,0,0
2020-01-24 04:45,11,8,3,0,0,0
2020-01-24 05:00,9,7,2,0,0,0
2020-01-24 05:15,7,6,1,0,0,0
2020-01-24 05:30,16,12,4,0,0,0
2020-01-24 05:45,27,19,8,0,0,0
2020-01-24 06:00,22,15,7,0,0,0
2020-01-24 06:15,36,26,10,0,0,0
2020-01-24 06:30,46,30,16,0,0,0
2020-01-24 06:45,70,44,26,0,0,0
2020-01-24 07:00,100,60,40,0,0,0
2020-01-24 07:15,148,95,53,0,0,0
2020-01-24 07:30,222,158,64,0,0,0
2020-01-24 07:45,351,225,126,0,0,0
2020-01-24 08:00,324,188,136,0,0,0
2020-01-24 08:15,265,138,127,0,0,0
2020-01-24 08:30,215,141,74,0,0,0
2020-01-24 08:45,276,176,100,0,0,0
2020-01-24 09:00,218,132,86,0,0,0
2020-01-24 09:15,163,108,55,0,0,0
2020-01-24 09:30,154,103,51,0,0,0
2020-01-24 09:45,267,174,93,0,0,0
2020-01-24 10:00,348,196,152,0,0,0
2020-01-24 10:15,154,85,69,0,0,0
2020-01-24 10:30,123,68,55,0,0,0
2020-01-24 10:45,141,84,57,0,0,0
2020-01-24 11:00,152,78,74,0,0,0
2020-01-24 11:15,179,91,88,0,0,0
2020-01-24 11:30,142,86,56,0,0,0
2020-01-24 11:45,238,129,109,0,0,0
2020-01-24 12:00,309,147,162,0,0,0
2020-01-24 12:15,195,87,108,0,0,0
2020-01-24 12:30,188,82,106,0,0,0
2020-01-24 12:45,216,118,98,0,0,0
2020-01-24 13:00,212,110,102,0,0,0
2020-01-24 13:15,283,119,164,0,0,0
2020-01-24 13:30,195,120,75,0,0,0
2020-01-24 13:45,301,186,115,0,0,0
2020-01-24 14:00,243,126,117,0,0,0
2020-01-24 14:15,249,113,136,0,0,0
2020-01-24 14:30,192,98,94,0,0,0
2020-01-24 14:45,172,83,89,0,0,0
2020-01-24 15:00,192,89,103,0,0,0
2020-01-24 15:15,199,96,103,0,0,0
2020-01-24 15:30,188,111,77,0,0,0
2020-01-24 15:45,267,156,111,0,0,0
2020-01-24 16:00,259,138,121,0,0,0
2020-01-24 16:15,234,121,113,0,0,0
2020-01-24 16:30,188,92,96,0,0,0
2020-01-24 16:45,231,117,114,0,0,0
2020-01-24 17:00,187,92,95,0,0,0
2020-01-24 17:15,187,98,89,0,0,0
2020-01-24 17:30,191,84,107,0,0,0
2020-01-24 17:45,243,117,126,0,0,0
2020-01-24 18:00,213,97,116,0,0,0
2020-01-24 18:15,196,98,98,0,0,0
2020-01-24 18:30,160,77,83,0,0,0
2020-01-24 18:45,234,136,98,0,0,0
2020-01-24 19:00,151,75,76,0,0,0
2020-01-24 19:15,204,112,92,0,0,0
2020-01-24 19:30,164,86,78,0,0,0
2020-01-24 19:45,179,119,60,0,0,0
2020-01-24 20:00,167,83,84,0,0,0
2020-01-24 20:15,150,79,71,0,0,0
2020-01-24 20:30,105,54,51,0,0,0
2020-01-24 20:45,96,38,58,0,0,0
2020-01-24 21:00,94,46,48,0,0,0
2020-01-24 21:15,96,41,55,0,0,0
2020-01-24 21:30,91,42,49,0,0,0
2020-01-24 21:45,80,31,49,0,0,0
2020-01-24 22:00,79,25,54,0,0,0
2020-01-24 22:15,62,17,45,0,0,0
2020-01-24 22:30,77,39,38,0,0,0
2020-01-24 22:45,97,28,69,0,0,0
2020-01-24 23:00,93,23,70,0,0,0
2020-01-24 23:15,89,32,57,0,0,0
2020-01-24 23:30,62,19,43,0,0,0
2020-01-24 23:45,91,39,52,0,0,0
2020-01-25 00:00,86,26,60,0,0,0
2020-01-25 00:15,58,17,41,0,0,0
2020-01-25 00:30,60,23,37,0,0,0
2020-01-25 00:45,66,25,41,0,0,0
2020-01-25 01:00,56,25,31,0,0,0
2020-01-25 01:15,51,13,38,0,0,0
2020-01-25 01:30,31,10,21,0,0,0
2020-01-25 01:45,46,14,32,0,0,0
2020-01-25 02:00,38,7,31,0,0,0
2020-01-25 02:15,29,9,20,0,0,0
2020-01-25 02:30,26,4,22,0,0,0
2020-01-25 02:45,20,3,17,0,0,0
2020-01-25 03:00,22,2,20,0,0,0
2020-01-25 03:15,17,2,15,0,0,0
2020-01-25 03:30,18,10,8,0,0,0
2020-01-25 03:45,23,3,20,0,0,0
2020-01-25 04:00,13,4,9,0,0,0
2020-01-25 04:15,8,0,8,0,0,0
2020-01-25 04:30,8,2,6,0,0,0
2020-01-25 04:45,9,6,3,0,0,0
2020-01-25 05:00,11,1,10,0,0,0
2020-01-25 05:15,10,4,6,0,0,0
2020-01-25 05:30,11,7,4,0,0,0
2020-01-25 05:45,11,9,2,0,0,0
2020-01-25 06:00,12,6,6,0,0,0
2020-01-25 06:15,10,8,2,0,0,0
2020-01-25 06:30,7,6,1,0,0,0
2020-01-25 06:45,7,5,2,0,0,0
2020-01-25 07:00,10,6,4,0,0,0
2020-01-25 07:15,18,10,8,0,0,0
2020-01-25 07:30,62,30,32,0,0,0
2020-01-25 07:45,125,119,6,0,0,0
2020-01-25 08:00,66,54,12,0,0,0
2020-01-25 08:15,45,32,13,0,0,0
2020-01-25 08:30,61,44,17,0,0,0
2020-01-25 08:45,83,53,30,0,0,0
2020-01-25 09:00,61,46,15,0,0,0
2020-01-25 09:15,74,49,25,0,0,0
2020-01-25 09:30,97,70,27,0,0,0
2020-01-25 09:45,149,114,35,0,0,0
2020-01-25 10:00,127,88,39,0,0,0
2020-01-25 10:15,100,69,31,0,0,0
2020-01-25 10:30,109,65,44,0,0,0
2020-01-25 10:45,107,67,40,0,0,0
2020-01-25 11:00,100,50,50,0,0,0
2020-01-25 11:15,120,83,37,0,0,0
2020-01-25 11:30,120,84,36,0,0,0
2020-01-25 11:45,126,79,47,0,0,0
2020-01-25 12:00,112,69,43,0,0,0
2020-01-25 12:15,114,75,39,0,0,0
2020-01-25 12:30,98,61,37,0,0,0
2020-01-25 12:45,167,101,66,0,0,0
2020-01-25 13:00,128,72,56,0,0,0
2020-01-25 13:15,139,73,66,0,0,0
2020-01-25 13:30,162,92,70,0,0,0
2020-01-25 13:45,157,85,72,0,0,0
2020-01-25 14:00,148,93,55,0,0,0
2020-01-25 14:15,151,80,71,0,0,0
2020-01-25 14:30,124,69,55,0,0,0
2020-01-25 14:45,154,74,80,0,0,0
2020-01-25 15:00,135,58,77,0,0,0
2020-01-25 15:15,163,69,94,0,0,0
2020-01-25 15:30,107,46,61,0,0,0
2020-01-25 15:45,135,71,64,0,0,0
2020-01-25 16:00,127,61,66,0,0,0
2020-01-25 16:15,124,57,67,0,0,0
2020-01-25 16:30,112,55,57,0,0,0
2020-01-25 16:45,112,58,54,0,0,0
2020-01-25 17:00,140,67,73,0,0,0
2020-01-25 17:15,125,58,67,0,0,0
2020-01-25 17:30,143,64,79,0,0,0
2020-01-25 17:45,148,79,69,0,0,0
2020-01-25 18:00,140,69,71,0,0,0
2020-01-25 18:15,171,79,92,0,0,0
2020-01-25 18:30,138,57,81,0,0,0
2020-01-25 18:45,175,95,80,0,0,0
2020-01-25 19:00,113,64,49,0,0,0
2020-01-25 19:15,117,64,53,0,0,0
2020-01-25 19:30,104,48,56,0,0,0
2020-01-25 19:45,108,62,46,0,0,0
2020-01-25 20:00,110,54,56,0,0,0
2020-01-25 20:15,101,50,51,0,0,0
2020-01-25 20:30,121,55,66,0,0,0
2020-01-25 20:45,91,52,39,0,0,0
2020-01-25 21:00,100,32,68,0,0,0
2020-01-25 21:15,61,27,34,0,0,0
2020-01-25 21:30,81,40,41,0,0,0
2020-01-25 21:45,86,28,58,0,0,0
2020-01-25 22:00,93,31,62,0,0,0
2020-01-25 22:15,57,19,38,0,0,0
2020-01-25 22:30,86,36,50,0,0,0
2020-01-25 22:45,73,30,43,0,0,0
2020-01-25 23:00,54,10,44,0,0,0
2020-01-25 23:15,53,22,31,0,0,0
2020-01-25 23:30,60,26,34,0,0,0
2020-01-25 23:45,51,23,28,0,0,0
2020-01-26 00:00,48,17,31,0,0,0
2020-01-26 00:15,76,29,47,0,0,0
2020-01-26 00:30,48,31,17,0,0,0
2020-01-26 00:45,56,27,29,0,0,0
2020-01-26 01:00,57,13,44,0,0,0
2020-01-26 01:15,52,21,31,0,0,0
2020-01-26 01:30,53,19,34,0,0,0
2020-01-26 01:45,29,7,22,0,0,0
2020-01-26 02:00,36,9,27,0,0,0
2020-01-26 02:15,53,22,31,0,0,0
2020-01-26 02:30,24,6,18,0,0,0
2020-01-26 02:45,17,5,12,0,0,0
2020-01-26 03:00,31,4,27,0,0,0
2020-01-26 03:15,27,4,23,0,0,0
2020-01-26 03:30,20,2,18,0,0,0
2020-01-26 03:45,21,4,17,0,0,0
2020-01-26 04:00,23,10,13,0,0,0
2020-01-26 04:15,16,1,15,0,0,0
2020-01-26 04:30,15,1,14,0,0,0
2020-01-26 04:45,12,2,10,0,0,0
2020-01-26 05:00,23,8,15,0,0,0
2020-01-26 05:15,7,2,5,0,0,0
2020-01-26 05:30,13,3,10,0,0,0
2020-01-26 05:45,10,6,4,0,0,0
2020-01-26 06:00,5,2,3,0,0,0
2020-01-26 06:15,6,5,1,0,0,0
2020-01-26 06:30,5,3,2,0,0,0
2020-01-26 06:45,5,3,2,0,0,0
2020-01-26 07:00,8,5,3,0,0,0
2020-01-26 07:15,16,9,7,0,0,0
2020-01-26 07:30,20,15,5,0,0,0
2020-01-26 07:45,93,86,7,0,0,0
2020-01-26 08:00,33,28,5,0,0,0
2020-01-26 08:15,31,20,11,0,0,0
2020-01-26 08:30,21,16,5,0,0,0
2020-01-26 08:45,31,21,10,0,0,0
2020-01-26 09:00,46,34,12,0,0,0
2020-01-26 09:15,32,18,14,0,0,0
2020-01-26 09:30,57,48,9,0,0,0
2020-01-26 09:45,140,114,26,0,0,0
2020-01-26 10:00,82,52,30,0,0,0
2020-01-26 10:15,51,33,18,0,0,0
2020-01-26 10:30,57,33,24,0,0,0
2020-01-26 10:45,73,45,28,0,0,0
2020-01-26 11:00,55,24,31,0,0,0
2020-01-26 11:15,60,29,31,0,0,0
2020-01-26 11:30,68,40,28,0,0,0
2020-01-26 11:45,67,36,31,0,0,0
2020-01-26 12:00,88,48,40,0,0,0
2020-01-26 12:15,99,52,47,0,0,0
2020-01-26 12:30,99,58,41,0,0,0
2020-01-26 12:45,93,50,43,0,0,0
2020-01-26 13:00,90,49,41,0,0,0
2020-01-26 13:15,123,61,62,0,0,0
2020-01-26 13:30,81,50,31,0,0,0
2020-01-26 13:45,132,65,67,0,0,0
2020-01-26 14:00,106,57,49,0,0,0
2020-01-26 14:15,109,61,48,0,0,0
2020-01-26 14:30,85,62,23,0,0,0
2020-01-26 14:45,154,92,62,0,0,0
2020-01-26 15:00,139,79,60,0,0,0
2020-01-26 15:15,123,63,60,0,0,0
2020-01-26 15:30,122,63,59,0,0,0
2020-01-26 15:45,163,92,71,0,0,0
2020-01-26 16:00,126,81,45,0,0,0
2020-01-26 16:15,111,58,53,0,0,0
2020-01-26 16:30,144,74,70,0,0,0
2020-01-26 16:45,122,45,77,0,0,0
2020-01-26 17:00,99,49,50,0,0,0
2020-01-26 17:15,125,48,77,0,0,0
2020-01-26 17:30,134,51,83,0,0,0
2020-01-26 17:45,139,69,70,0,0,0
2020-01-26 18:00,139,47,92,0,0,0
2020-01-26 18:15,128,58,70,0,0,0
2020-01-26 18:30,101,50,51,0,0,0
2020-01-26 18:45,118,63,55,0,0,0
2020-01-26 19:00,118,51,67,0,0,0
2020-01-26 19:15,112,54,58,0,0,0
2020-01-26 19:30,117,51,66,0,0,0
2020-01-26 19:45,85,32,53,0,0,0
2020-01-26 20:00,100,30,70,0,0,0
2020-01-26 20:15,79,28,51,0,0,0
2020-01-26 20:30,53,19,34,0,0,0
2020-01-26 20:45,55,15,40,0,0,0
2020-01-26 21:00,56,24,32,0,0,0
2020-01-26 21:15,44,13,31,0,0,0
2020-01-26 21:30,44,21,23,0,0,0
2020-01-26 21:45,74,12,62,0,0,0
2020-01-26 22:00,51,17,34,0,0,0
2020-01-26 22:15,70,30,40,0,0,0
2020-01-26 22:30,53,19,34,0,0,0
2020-01-26 22:45,41,11,30,0,0,0
2020-01-26 23:00,22,10,12,0,0,0
2020-01-26 23:15,34,11,23,0,0,0
2020-01-26 23:30,26,7,19,0,0,0
2020-01-26 23:45,22,8,14,0,0,0
2020-01-27 00:00,14,5,9,0,0,0
2020-01-27 00:15,9,2,7,0,0,0
2020-01-27 00:30,16,9,7,0,0,0
2020-01-27 00:45,3,0,3,0,0,0
2020-01-27 01:00,5,2,3,0,0,0
2020-01-27 01:15,9,2,7,0,0,0
2020-01-27 01:30,10,4,6,0,0,0
2020-01-27 01:45,1,1,0,0,0,0
2020-01-27 02:00,2,2,0,0,0,0
2020-01-27 02:15,2,0,2,0,0,0
2020-01-27 02:30,2,2,0,0,0,0
2020-01-27 02:45,3,1,2,0,0,0
2020-01-27 03:00,2,0,2,0,0,0
2020-01-27 03:15,2,0,2,0,0,0
2020-01-27 03:30,1,0,1,0,0,0
2020-01-27 03:45,3,3,0,0,0,0
2020-01-27 04:00,4,1,3,0,0,0
2020-01-27 04:15,0,0,0,0,0,0
2020-01-27 04:30,2,0,2,0,0,0
2020-01-27 04:45,8,5,3,0,0,0
2020-01-27 05:00,12,8,4,0,0,0
2020-01-27 05:15,8,6,2,0,0,0
2020-01-27 05:30,18,14,4,0,0,0
2020-01-27 05:45,23,15,8,0,0,0
2020-01-27 06:00,28,21,7,0,0,0
2020-01-27 06:15,29,22,7,0,0,0
2020-01-27 06:30,54,39,15,0,0,0
2020-01-27 06:45,64,37,27,0,0,0
2020-01-27 07:00,83,58,25,0,0,0
2020-01-27 07:15,117,78,39,0,0,0
2020-01-27 07:30,248,178,70,0,0,0
2020-01-27 07:45,338,240,98,0,0,0
2020-01-27 08:00,300,211,89,0,0,0
2020-01-27 08:15,252,147,105,0,0,0
2020-01-27 08:30,197,111,86,0,0,0
2020-01-27 08:45,250,140,110,0,0,0
2020-01-27 09:00,197,117,80,0,0,0
2020-01-27 09:15,152,86,66,0,0,0
2020-01-27 09:30,205,135,70,0,0,0
2020-01-27 09:45,313,169,144,0,0,0
2020-01-27 10:00,323,167,156,0,0,0
2020-01-27 10:15,131,57,74,0,0,0
2020-01-27 10:30,141,60,81,0,0,0
2020-01-27 10:45,132,73,59,0,0,0
2020-01-27 11:00,156,63,93,0,0,0
2020-01-27 11:15,135,65,70,0,0,0
2020-01-27 11:30,196,115,81,0,0,0
2020-01-27 11:45,239,137,102,0,0,0
2020-01-27 12:00,246,108,138,0,0,0
2020-01-27 12:15,184,78,106,0,0,0
2020-01-27 12:30,145,55,90,0,0,0
2020-01-27 12:45,213,105,108,0,0,0
2020-01-27 13:00,202,106,96,0,0,0
2020-01-27 13:15,194,92,102,0,0,0
2020-01-27 13:30,191,96,95,0,0,0
2020-01-27 13:45,257,134,123,0,0,0
2020-01-27 14:00,301,114,187,0,0,0
2020-01-27 14:15,191,96,95,0,0,0
2020-01-27 14:30,156,77,79,0,0,0
2020-01-27 14:45,154,79,75,0,0,0
2020-01-27 15:00,182,82,100,0,0,0
2020-01-27 15:15,180,94,86,0,0,0
2020-01-27 15:30,244,120,124,0,0,0
2020-01-27 15:45,360,191,169,0,0,0
2020-01-27 16:00,318,145,173,0,0,0
2020-01-27 16:15,211,105,106,0,0,0
2020-01-27 16:30,202,88,114,0,0,0
2020-01-27 16:45,244,116,128,0,0,0
2020-01-27 17:00,236,113,123,0,0,0
2020-01-27 17:15,231,101,130,0,0,0
2020-01-27 17:30,254,111,143,0,0,0
2020-01-27 17:45,360,198,162,0,0,0
2020-01-27 18:00,280,129,151,0,0,0
2020-01-27 18:15,251,97,154,0,0,0
2020-01-27 18:30,173,73,100,0,0,0
2020-01-27 18:45,224,116,108,0,0,0
2020-01-27 19:00,200,91,109,0,0,0
2020-01-27 19:15,183,79,104,0,0,0
2020-01-27 19:30,172,67,105,0,0,0
2020-01-27 19:45,184,85,99,0,0,0
2020-01-27 20:00,156,48,108,0,0,0
2020-01-27 20:15,130,55,75,0,0,0
2020-01-27 20:30,104,46,58,0,0,0
2020-01-27 20:45,95,35,60,0,0,0
2020-01-27 21:00,78,36,42,0,0,0
2020-01-27 21:15,90,44,46,0,0,0
2020-01-27 21:30,74,18,56,0,0,0
2020-01-27 21:45,97,19,78,0,0,0
2020-01-27 22:00,105,43,62,0,0,0
2020-01-27 22:15,85,38,47,0,0,0
2020-01-27 22:30,59,19,40,0,0,0
2020-01-27 22:45,48,10,38,0,0,0
2020-01-27 23:00,73,15,58,0,0,0
2020-01-27 23:15,46,16,30,0,0,0
2020-01-27 23:30,22,4,18,0,0,0
2020-01-27 23:45,28,10,18,0,0,0
2020-01-28 00:00,24,11,13,0,0,0
2020-01-28 00:15,19,5,14,0,0,0
2020-01-28 00:30,9,5,4,0,0,0
2020-01-28 00:45,15,2,13,0,0,0
2020-01-28 01:00,11,4,7,0,0,0
2020-01-28 01:15,6,4,2,0,0,0
2020-01-28 01:30,5,0,5,0,0,0
2020-01-28 01:45,5,3,2,0,0,0
2020-01-28 02:00,4,2,2,0,0,0
2020-01-28 02:15,5,2,3,0,0,0
2020-01-28 02:30,5,1,4,0,0,0
2020-01-28 02:45,0,0,0,0,0,0
2020-01-28 03:00,0,0,0,0,0,0
2020-01-28 03:15,3,0,3,0,0,0
2020-01-28 03:30,4,1,3,0,0,0
2020-01-28 03:45,4,1,3,0,0,0
2020-01-28 04:00,2,0,2,0,0,0
2020-01-28 04:15,2,2,0,0,0,0
2020-01-28 04:30,2,1,1,0,0,0
2020-01-28 04:45,8,6,2,0,0,0
2020-01-28 05:00,14,11,3,0,0,0
2020-01-28 05:15,8,7,1,0,0,0
2020-01-28 05:30,14,12,2,0,0,0
2020-01-28 05:45,19,13,6,0,0,0
2020-01-28 06:00,23,16,7,0,0,0
2020-01-28 06:15,42,32,10,0,0,0
2020-01-28 06:30,38,25,13,0,0,0
2020-01-28 06:45,55,34,21,0,0,0
2020-01-28 07:00,88,51,37,0,0,0
2020-01-28 07:15,151,94,57,0,0,0
2020-01-28 07:30,213,151,62,0,0,0
2020-01-28 07:45,362,254,108,0,0,0
2020-01-28 08:00,305,172,133,0,0,0
2020-01-28 08:15,220,123,97,0,0,0
2020-01-28 08:30,158,95,63,0,0,0
2020-01-28 08:45,220,127,93,0,0,0
2020-01-28 09:00,177,86,91,0,0,0
2020-01-28 09:15,172,77,95,0,0,0
2020-01-28 09:30,200,115,85,0,0,0
2020-01-28 09:45,243,122,121,0,0,0
2020-01-28 10:00,266,148,118,0,0,0
2020-01-28 10:15,123,41,82,0,0,0
2020-01-28 10:30,112,45,67,0,0,0
2020-01-28 10:45,148,72,76,0,0,0
2020-01-28 11:00,116,54,62,0,0,0
2020-01-28 11:15,133,65,68,0,0,0
2020-01-28 11:30,165,99,66,0,0,0
2020-01-28 11:45,266,169,97,0,0,0
2020-01-28 12:00,280,141,139,0,0,0
2020-01-28 12:15,165,71,94,0,0,0
2020-01-28 12:30,142,77,65,0,0,0
2020-01-28 12:45,188,94,94,0,0,0
2020-01-28 13:00,153,69,84,0,0,0
2020-01-28 13:15,230,95,135,0,0,0
2020-01-28 13:30,229,116,113,0,0,0
2020-01-28 13:45,279,146,133,0,0,0
2020-01-28 14:00,284,126,158,0,0,0
2020-01-28 14:15,155,76,79,0,0,0
2020-01-28 14:30,137,64,73,0,0,0
2020-01-28 14:45,161,79,82,0,0,0
2020-01-28 15:00,157,66,91,0,0,0
2020-01-28 15:15,184,80,104,0,0,0
2020-01-28 15:30,161,88,73,0,0,0
2020-01-28 15:45,278,145,133,0,0,0
2020-01-28 16:00,313,142,171,0,0,0
2020-01-28 16:15,223,105,118,0,0,0
2020-01-28 16:30,190,93,97,0,0,0
2020-01-28 16:45,269,114,155,0,0,0
2020-01-28 17:00,263,119,144,0,0,0
2020-01-28 17:15,218,106,112,0,0,0
2020-01-28 17:30,225,112,113,0,0,0
2020-01-28 17:45,309,155,154,0,0,0
2020-01-28 18:00,266,114,152,0,0,0
2020-01-28 18:15,233,100,133,0,0,0
2020-01-28 18:30,242,104,138,0,0,0
2020-01-28 18:45,207,101,106,0,0,0
2020-01-28 19:00,170,89,81,0,0,0
2020-01-28 19:15,184,101,83,0,0,0
2020-01-28 19:30,192,103,89,0,0,0
2020-01-28 19:45,172,67,105,0,0,0
2020-01-28 20:00,158,61,97,0,0,0
2020-01-28 20:15,162,70,92,0,0,0
2020-01-28 20:30,119,53,66,0,0,0
2020-01-28 20:45,116,37,79,0,0,0
2020-01-28 21:00,124,71,53,0,0,0
2020-01-28 21:15,117,50,67,0,0,0
2020-01-28 21:30,94,34,60,0,0,0
2020-01-28 21:45,108,52,56,0,0,0
2020-01-28 22:00,90,31,59,0,0,0
2020-01-28 22:15,108,63,45,0,0,0
2020-01-28 22:30,88,30,58,0,0,0
2020-01-28 22:45,66,21,45,0,0,0
2020-01-28 23:00,64,16,48,0,0,0
2020-01-28 23:15,36,11,25,0,0,0
2020-01-28 23:30,57,26,31,0,0,0
2020-01-28 23:45,28,9,19,0,0,0
2020-01-29 00:00,20,6,14,0,0,0
2020-01-29 00:15,17,5,12,0,0,0
2020-01-29 00:30,18,5,13,0,0,0
2020-01-29 00:45,9,3,6,0,0,0
2020-01-29 01:00,13,2,11,0,0,0
2020-01-29 01:15,18,8,10,0,0,0
2020-01-29 01:30,23,5,18,0,0,0
2020-01-29 01:45,8,2,6,0,0,0
2020-01-29 02:00,11,1,10,0,0,0
2020-01-29 02:15,5,1,4,0,0,0
2020-01-29 02:30,15,4,11,0,0,0
2020-01-29 02:45,4,1,3,0,0,0
2020-01-29 03:00,0,0,0,0,0,0
2020-01-29 03:15,4,2,2,0,0,0
2020-01-29 03:30,1,0,1,0,0,0
2020-01-29 03:45,5,3,2,0,0,0
2020-01-29 04:00,1,0,1,0,0,0
2020-01-29 04:15,4,2,2,0,0,0
2020-01-29 04:30,5,5,0,0,0,0
2020-01-29 04:45,10,6,4,0,0,0
2020-01-29 05:00,8,7,1,0,0,0
2020-01-29 05:15,8,8,0,0,0,0
2020-01-29 05:30,14,10,4,0,0,0
2020-01-29 05:45,21,13,8,0,0,0
2020-01-29 06:00,30,21,9,0,0,0
2020-01-29 06:15,42,29,13,0,0,0
2020-01-29 06:30,47,35,12,0,0,0
2020-01-29 06:45,69,44,25,0,0,0
2020-01-29 07:00,99,68,31,0,0,0
2020-01-29 07:15,131,90,41,0,0,0
2020-01-29 07:30,266,207,59,0,0,0
2020-01-29 07:45,365,268,97,0,0,0
2020-01-29 08:00,299,171,128,0,0,0
2020-01-29 08:15,308,182,126,0,0,0
2020-01-29 08:30,211,132,79,0,0,0
2020-01-29 08:45,266,159,107,0,0,0
2020-01-29 09:00,219,115,104,0,0,0
2020-01-29 09:15,179,116,63,0,0,0
2020-01-29 09:30,226,146,80,0,0,0
2020-01-29 09:45,274,147,127,0,0,0
2020-01-29 10:00,314,175,139,0,0,0
2020-01-29 10:15,163,80,83,0,0,0
2020-01-29 10:30,141,77,64,0,0,0
2020-01-29 10:45,175,105,70,0,0,0
2020-01-29 11:00,177,88,89,0,0,0
2020-01-29 11:15,171,107,64,0,0,0
2020-01-29 11:30,191,100,91,0,0,0
2020-01-29 11:45,206,123,83,0,0,0
2020-01-29 12:00,231,120,111,0,0,0
2020-01-29 12:15,151,76,75,0,0,0
2020-01-29 12:30,182,77,105,0,0,0
2020-01-29 12:45,204,100,104,0,0,0
2020-01-29 13:00,189,99,90,0,0,0
2020-01-29 13:15,190,92,98,0,0,0
2020-01-29 13:30,197,100,97,0,0,0
2020-01-29 13:45,286,160,126,0,0,0
2020-01-29 14:00,248,110,138,0,0,0
2020-01-29 14:15,174,83,91,0,0,0
2020-01-29 14:30,144,79,65,0,0,0
2020-01-29 14:45,188,86,102,0,0,0
2020-01-29 15:00,198,78,120,0,0,0
2020-01-29 15:15,177,81,96,0,0,0
2020-01-29 15:30,258,122,136,0,0,0
2020-01-29 15:45,307,148,159,0,0,0
2020-01-29 16:00,301,157,144,0,0,0
2020-01-29 16:15,260,110,150,0,0,0
2020-01-29 16:30,197,85,112,0,0,0
2020-01-29 16:45,273,106,167,0,0,0
2020-01-29 17:00,244,112,132,0,0,0
2020-01-29 17:15,259,119,140,0,0,0
2020-01-29 17:30,275,138,137,0,0,0
2020-01-29 17:45,331,164,167,0,0,0
2020-01-29 18:00,301,158,143,0,0,0
2020-01-29 18:15,265,117,148,0,0,0
2020-01-29 18:30,269,114,155,0,0,0
2020-01-29 18:45,261,137,124,0,0,0
2020-01-29 19:00,252,123,129,0,0,0
2020-01-29 19:15,218,117,101,0,0,0
2020-01-29 19:30,233,130,103,0,0,0
2020-01-29 19:45,256,118,138,0,0,0
2020-01-29 20:00,220,88,132,0,0,0
2020-01-29 20:15,169,78,91,0,0,0
2020-01-29 20:30,115,44,71,0,0,0
2020-01-29 20:45,111,46,65,0,0,0
2020-01-29 21:00,108,58,50,0,0,0
2020-01-29 21:15,91,35,56,0,0,0
2020-01-29 21:30,113,29,84,0,0,0
2020-01-29 21:45,101,43,58,0,0,0
2020-01-29 22:00,117,41,76,0,0,0
2020-01-29 22:15,156,67,89,0,0,0
2020-01-29 22:30,123,52,71,0,0,0
2020-01-29 22:45,90,28,62,0,0,0
2020-01-29 23:00,90,29,61,0,0,0
2020-01-29 23:15,77,43,34,0,0,0
2020-01-29 23:30,76,30,46,0,0,0
2020-01-29 23:45,52,16,36,0,0,0
2020-01-30 00:00,52,19,33,0,0,0
2020-01-30 00:15,60,36,24,0,0,0
2020-01-30 00:30,25,4,21,0,0,0
2020-01-30 00:45,25,12,13,0,0,0
2020-01-30 01:00,39,14,25,0,0,0
2020-01-30 01:15,31,4,27,0,0,0
2020-01-30 01:30,29,6,23,0,0,0
2020-01-30 01:45,12,5,7,0,0,0
2020-01-30 02:00,22,5,17,0,0,0
2020-01-30 02:15,23,4,19,0,0,0
2020-01-30 02:30,20,1,19,0,0,0
2020-01-30 02:45,14,2,12,0,0,0
2020-01-30 03:00,15,3,12,0,0,0
2020-01-30 03:15,18,1,17,0,0,0
2020-01-30 03:30,5,0,5,0,0,0
2020-01-30 03:45,17,4,13,0,0,0
2020-01-30 04:00,8,1,7,0,0,0
2020-01-30 04:15,10,4,6,0,0,0
2020-01-30 04:30,5,3,2,0,0,0
2020-01-30 04:45,10,6,4,0,0,0
2020-01-30 05:00,22,11,11,0,0,0
2020-01-30 05:15,14,11,3,0,0,0
2020-01-30 05:30,23,15,8,0,0,0
2020-01-30 05:45,20,11,9,0,0,0
2020-01-30 06:00,31,19,12,0,0,0
2020-01-30 06:15,34,24,10,0,0,0
2020-01-30 06:30,49,33,16,0,0,0
2020-01-30 06:45,70,39,31,0,0,0
2020-01-30 07:00,84,46,38,0,0,0
2020-01-30 07:15,130,87,43,0,0,0
2020-01-30 07:30,248,178,70,0,0,0
2020-01-30 07:45,311,212,99,0,0,0
2020-01-30 08:00,285,154,131,0,0,0
2020-01-30 08:15,258,144,114,0,0,0
2020-01-30 08:30,235,132,103,0,0,0
2020-01-30 08:45,232,133,99,0,0,0
2020-01-30 09:00,187,103,84,0,0,0
2020-01-30 09:15,174,103,71,0,0,0
2020-01-30 09:30,213,128,85,0,0,0
2020-01-30 09:45,240,123,117,0,0,0
2020-01-30 10:00,309,182,127,0,0,0
2020-01-30 10:15,175,95,80,0,0,0
2020-01-30 10:30,158,95,63,0,0,0
2020-01-30 10:45,158,90,68,0,0,0
2020-01-30 11:00,164,75,89,0,0,0
2020-01-30 11:15,182,101,81,0,0,0
2020-01-30 11:30,192,117,75,0,0,0
2020-01-30 11:45,255,154,101,0,0,0
2020-01-30 12:00,242,120,122,0,0,0
2020-01-30 12:15,207,99,108,0,0,0
2020-01-30 12:30,150,75,75,0,0,0
2020-01-30 12:45,202,123,79,0,0,0
2020-01-30 13:00,202,87,115,0,0,0
2020-01-30 13:15,210,85,125,0,0,0
2020-01-30 13:30,193,110,83,0,0,0
2020-01-30 13:45,293,138,155,0,0,0
2020-01-30 14:00,279,141,138,0,0,0
2020-01-30 14:15,221,117,104,0,0,0
2020-01-30 14:30,163,95,68,0,0,0
2020-01-30 14:45,269,127,142,0,0,0
2020-01-30 15:00,263,111,152,0,0,0
2020-01-30 15:15,232,111,121,0,0,0
2020-01-30 15:30,256,131,125,0,0,0
2020-01-30 15:45,290,130,160,0,0,0
2020-01-30 16:00,277,128,149,0,0,0
2020-01-30 16:15,263,103,160,0,0,0
2020-01-30 16:30,270,115,155,0,0,0
2020-01-30 16:45,264,143,121,0,0,0
2020-01-30 17:00,245,120,125,0,0,0
2020-01-30 17:15,273,119,154,0,0,0
2020-01-30 17:30,297,150,147,0,0,0
2020-01-30 17:45,336,160,176,0,0,0
2020-01-30 18:00,315,151,164,0,0,0
2020-01-30 18:15,250,114,136,0,0,0
2020-01-30 18:30,192,100,92,0,0,0
2020-01-30 18:45,264,132,132,0,0,0
2020-01-30 19:00,229,105,124,0,0,0
2020-01-30 19:15,232,107,125,0,0,0
2020-01-30 19:30,187,77,110,0,0,0
2020-01-30 19:45,274,115,159,0,0,0
2020-01-30 20:00,172,79,93,0,0,0
2020-01-30 20:15,118,42,76,0,0,0
2020-01-30 20:30,109,34,75,0,0,0
2020-01-30 20:45,122,47,75,0,0,0
2020-01-30 21:00,99,43,56,0,0,0
2020-01-30 21:15,110,41,69,0,0,0
2020-01-30 21:30,82,28,54,0,0,0
2020-01-30 21:45,111,30,81,0,0,0
2020-01-30 22:00,92,32,60,0,0,0
2020-01-30 22:15,100,45,55,0,0,0
2020-01-30 22:30,124,43,81,0,0,0
2020-01-30 22:45,87,31,56,0,0,0
2020-01-30 23:00,91,28,63,0,0,0
2020-01-30 23:15,83,36,47,0,0,0
2020-01-30 23:30,62,27,35,0,0,0
2020-01-30 23:45,42,17,25,0,0,0
2020-01-31 00:00,48,13,35,0,0,0
2020-01-31 00:15,38,7,31,0,0,0
2020-01-31 00:30,39,16,23,0,0,0
2020-01-31 00:45,18,7,11,0,0,0
2020-01-31 01:00,28,7,21,0,0,0
2020-01-31 01:15,20,4,16,0,0,0
2020-01-31 01:30,17,1,16,0,0,0
2020-01-31 01:45,23,3,20,0,0,0
2020-01-31 02:00,17,8,9,0,0,0
2020-01-31 02:15,19,7,12,0,0,0
2020-01-31 02:30,9,1,8,0,0,0
2020-01-31 02:45,13,0,13,0,0,0
2020-01-31 03:00,18,1,17,0,0,0
2020-01-31 03:15,6,1,5,0,0,0
2020-01-31 03:30,7,2,5,0,0,0
2020-01-31 03:45,9,1,8,0,0,0
2020-01-31 04:00,8,1,7,0,0,0
2020-01-31 04:15,2,2,0,0,0,0
2020-01-31 04:30,6,3,3,0,0,0
2020-01-31 04:45,7,2,5,0,0,0
2020-01-31 05:00,9,6,3,0,0,0
2020-01-31 05:15,11,8,3,0,0,0
2020-01-31 05:30,13,12,1,0,0,0
2020-01-31 05:45,18,10,8,0,0,0
2020-01-31 06:00,27,17,10,0,0,0
2020-01-31 06:15,38,23,15,0,0,0
2020-01-31 06:30,49,33,16,0,0,0
2020-01-31 06:45,59,34,25,0,0,0
2020-01-31 07:00,94,57,37,0,0,0
2020-01-31 07:15,139,75,64,0,0,0
2020-01-31 07:30,228,165,63,0,0,0
2020-01-31 07:45,346,221,125,0,0,0
2020-01-31 08:00,205,120,85,0,0,0
2020-01-31 08:15,244,138,106,0,0,0
2020-01-31 08:30,180,97,83,0,0,0
2020-01-31 08:45,259,143,116,0,0,0
2020-01-31 09:00,188,104,84,0,0,0
2020-01-31 09:15,168,105,63,0,0,0
2020-01-31 09:30,163,99,64,0,0,0
2020-01-31 09:45,213,133,80,0,0,0
2020-01-31 10:00,247,156,91,0,0,0
2020-01-31 10:15,163,64,99,0,0,0
2020-01-31 10:30,171,82,89,0,0,0
2020-01-31 10:45,204,77,127,0,0,0
2020-01-31 11:00,201,82,119,0,0,0
2020-01-31 11:15,158,86,72,0,0,0
2020-01-31 11:30,167,92,75,0,0,0
2020-01-31 11:45,229,125,104,0,0,0
2020-01-31 12:00,219,107,112,0,0,0
2020-01-31 12:15,176,92,84,0,0,0
2020-01-31 12:30,174,97,77,0,0,0
2020-01-31 12:45,226,115,111,0,0,0
2020-01-31 13:00,191,103,88,0,0,0
2020-01-31 13:15,230,120,110,0,0,0
2020-01-31 13:30,209,125,84,0,0,0
2020-01-31 13:45,299,157,142,0,0,0
2020-01-31 14:00,240,110,130,0,0,0
2020-01-31 14:15,195,97,98,0,0,0
2020-01-31 14:30,201,88,113,0,0,0
2020-01-31 14:45,201,95,106,0,0,0
2020-01-31 15:00,239,124,115,0,0,0
2020-01-31 15:15,227,114,113,0,0,0
2020-01-31 15:30,233,126,107,0,0,0
2020-01-31 15:45,264,138,126,0,0,0
2020-01-31 16:00,221,93,128,0,0,0
2020-01-31 16:15,185,95,90,0,0,0
2020-01-31 16:30,167,84,83,0,0,0
2020-01-31 16:45,283,125,158,0,0,0
2020-01-31 17:00,197,93,104,0,0,0
2020-01-31 17:15,176,86,90,0,0,0
2020-01-31 17:30,165,64,101,0,0,0
2020-01-31 17:45,209,102,107,0,0,0
2020-01-31 18:00,196,77,119,0,0,0
2020-01-31 18:15,197,91,106,0,0,0
2020-01-31 18:30,156,64,92,0,0,0
2020-01-31 18:45,247,125,122,0,0,0
2020-01-31 19:00,205,101,104,0,0,0
2020-01-31 19:15,192,89,103,0,0,0
2020-01-31 19:30,176,93,83,0,0,0
2020-01-31 19:45,155,74,81,0,0,0
2020-01-31 20:00,157,80,77,0,0,0
2020-01-31 20:15,143,58,85,0,0,0
2020-01-31 20:30,103,44,59,0,0,0
2020-01-31 20:45,104,44,60,0,0,0
2020-01-31 21:00,108,46,62,0,0,0
2020-01-31 21:15,70,31,39,0,0,0
2020-01-31 21:30,72,39,33,0,0,0
2020-01-31 21:45,84,28,56,0,0,0
2020-01-31 22:00,82,33,49,0,0,0
2020-01-31 22:15,79,41,38,0,0,0
2020-01-31 22:30,104,53,51,0,0,0
2020-01-31 22:45,79,30,49,0,0,0
2020-01-31 23:00,92,27,65,0,0,0
2020-01-31 23:15,88,43,45,0,0,0
2020-01-31 23:30,82,28,54,0,0,0
2020-01-31 23:45,89,27,62,0,0,0
