Datetime,100035541 (Neutor),101035541 (Neutor stadteinwÃ¤rts),102035541 (Neutor stadtauswÃ¤rts),100035541-status,101035541-status,102035541-status
2021-01-01 00:00,3,3,0,0,0,0
2021-01-01 00:15,6,4,2,0,0,0
2021-01-01 00:30,15,7,8,0,0,0
2021-01-01 00:45,16,2,14,0,0,0
2021-01-01 01:00,22,11,11,0,0,0
2021-01-01 01:15,22,6,16,0,0,0
2021-01-01 01:30,8,2,6,0,0,0
2021-01-01 01:45,21,8,13,0,0,0
2021-01-01 02:00,24,7,17,0,0,0
2021-01-01 02:15,24,11,13,0,0,0
2021-01-01 02:30,26,9,17,0,0,0
2021-01-01 02:45,26,9,17,0,0,0
2021-01-01 03:00,27,11,16,0,0,0
2021-01-01 03:15,22,16,6,0,0,0
2021-01-01 03:30,23,11,12,0,0,0
2021-01-01 03:45,19,13,6,0,0,0
2021-01-01 04:00,26,5,21,0,0,0
2021-01-01 04:15,21,9,12,0,0,0
2021-01-01 04:30,18,9,9,0,0,0
2021-01-01 04:45,12,7,5,0,0,0
2021-01-01 05:00,12,6,6,0,0,0
2021-01-01 05:15,7,3,4,0,0,0
2021-01-01 05:30,13,5,8,0,0,0
2021-01-01 05:45,16,8,8,0,0,0
2021-01-01 06:00,7,6,1,0,0,0
2021-01-01 06:15,5,3,2,0,0,0
2021-01-01 06:30,2,2,0,0,0,0
2021-01-01 06:45,9,6,3,0,0,0
2021-01-01 07:00,10,3,7,0,0,0
2021-01-01 07:15,8,4,4,0,0,0
2021-01-01 07:30,6,3,3,0,0,0
2021-01-01 07:45,6,3,3,0,0,0
2021-01-01 08:00,0,0,0,0,0,0
2021-01-01 08:15,5,2,3,0,0,0
2021-01-01 08:30,3,3,0,0,0,0
2021-01-01 08:45,6,1,5,0,0,0
2021-01-01 09:00,7,3,4,0,0,0
2021-01-01 09:15,5,1,4,0,0,0
2021-01-01 09:30,9,5,4,0,0,0
2021-01-01 09:45,6,5,1,0,0,0
2021-01-01 10:00,7,4,3,0,0,0
2021-01-01 10:15,13,5,8,0,0,0
2021-01-01 10:30,9,5,4,0,0,0
2021-01-01 10:45,18,12,6,0,0,0
2021-01-01 11:00,13,6,7,0,0,0
2021-01-01 11:15,11,1,10,0,0,0
2021-01-01 11:30,19,9,10,0,0,0
2021-01-01 11:45,24,15,9,0,0,0
2021-01-01 12:00,30,21,9,0,0,0
2021-01-01 12:15,32,19,13,0,0,0
2021-01-01 12:30,23,13,10,0,0,0
2021-01-01 12:45,22,12,10,0,0,0
2021-01-01 13:00,23,15,8,0,0,0
2021-01-01 13:15,27,17,10,0,0,0
2021-01-01 13:30,28,15,13,0,0,0
2021-01-01 13:45,43,24,19,0,0,0
2021-01-01 14:00,36,12,24,0,0,0
2021-01-01 14:15,53,22,31,0,0,0
2021-01-01 14:30,42,17,25,0,0,0
2021-01-01 14:45,40,24,16,0,0,0
2021-01-01 15:00,33,20,13,0,0,0
2021-01-01 15:15,57,26,31,0,0,0
2021-01-01 15:30,44,27,17,0,0,0
2021-01-01 15:45,46,24,22,0,0,0
2021-01-01 16:00,39,24,15,0,0,0
2021-01-01 16:15,34,8,26,0,0,0
2021-01-01 16:30,46,28,18,0,0,0
2021-01-01 16:45,35,15,20,0,0,0
2021-01-01 17:00,33,10,23,0,0,0
2021-01-01 17:15,34,17,17,0,0,0
2021-01-01 17:30,30,13,17,0,0,0
2021-01-01 17:45,29,15,14,0,0,0
2021-01-01 18:00,22,11,11,0,0,0
2021-01-01 18:15,25,9,16,0,0,0
2021-01-01 18:30,16,9,7,0,0,0
2021-01-01 18:45,28,13,15,0,0,0
2021-01-01 19:00,19,9,10,0,0,0
2021-01-01 19:15,17,5,12,0,0,0
2021-01-01 19:30,21,7,14,0,0,0
2021-01-01 19:45,19,6,13,0,0,0
2021-01-01 20:00,17,8,9,0,0,0
2021-01-01 20:15,25,9,16,0,0,0
2021-01-01 20:30,18,3,15,0,0,0
2021-01-01 20:45,11,2,9,0,0,0
2021-01-01 21:00,18,5,13,0,0,0
2021-01-01 21:15,19,10,9,0,0,0
2021-01-01 21:30,13,2,11,0,0,0
2021-01-01 21:45,10,4,6,0,0,0
2021-01-01 22:00,10,3,7,0,0,0
2021-01-01 22:15,6,1,5,0,0,0
2021-01-01 22:30,4,3,1,0,0,0
2021-01-01 22:45,12,5,7,0,0,0
2021-01-01 23:00,4,1,3,0,0,0
2021-01-01 23:15,5,2,3,0,0,0
2021-01-01 23:30,6,3,3,0,0,0
2021-01-01 23:45,1,0,1,0,0,0
2021-01-02 00:00,3,0,3,0,0,0
2021-01-02 00:15,3,3,0,0,0,0
2021-01-02 00:30,5,4,1,0,0,0
2021-01-02 00:45,2,0,2,0,0,0
2021-01-02 01:00,5,1,4,0,0,0
2021-01-02 01:15,2,0,2,0,0,0
2021-01-02 01:30,1,0,1,0,0,0
2021-01-02 01:45,2,1,1,0,0,0
2021-01-02 02:00,4,2,2,0,0,0
2021-01-02 02:15,1,1,0,0,0,0
2021-01-02 02:30,0,0,0,0,0,0
2021-01-02 02:45,1,1,0,0,0,0
2021-01-02 03:00,1,0,1,0,0,0
2021-01-02 03:15,2,2,0,0,0,0
2021-01-02 03:30,0,0,0,0,0,0
2021-01-02 03:45,1,0,1,0,0,0
2021-01-02 04:00,1,0,1,0,0,0
2021-01-02 04:15,1,1,0,0,0,0
2021-01-02 04:30,0,0,0,0,0,0
2021-01-02 04:45,1,0,1,0,0,0
2021-01-02 05:00,1,1,0,0,0,0
2021-01-02 05:15,5,5,0,0,0,0
2021-01-02 05:30,4,2,2,0,0,0
2021-01-02 05:45,5,1,4,0,0,0
2021-01-02 06:00,8,2,6,0,0,0
2021-01-02 06:15,5,2,3,0,0,0
2021-01-02 06:30,7,2,5,0,0,0
2021-01-02 06:45,8,5,3,0,0,0
2021-01-02 07:00,2,1,1,0,0,0
2021-01-02 07:15,6,4,2,0,0,0
2021-01-02 07:30,9,3,6,0,0,0
2021-01-02 07:45,5,3,2,0,0,0
2021-01-02 08:00,4,1,3,0,0,0
2021-01-02 08:15,7,4,3,0,0,0
2021-01-02 08:30,10,5,5,0,0,0
2021-01-02 08:45,16,12,4,0,0,0
2021-01-02 09:00,11,6,5,0,0,0
2021-01-02 09:15,8,5,3,0,0,0
2021-01-02 09:30,22,14,8,0,0,0
2021-01-02 09:45,27,19,8,0,0,0
2021-01-02 10:00,29,16,13,0,0,0
2021-01-02 10:15,32,20,12,0,0,0
2021-01-02 10:30,29,16,13,0,0,0
2021-01-02 10:45,56,29,27,0,0,0
2021-01-02 11:00,25,12,13,0,0,0
2021-01-02 11:15,42,25,17,0,0,0
2021-01-02 11:30,33,22,11,0,0,0
2021-01-02 11:45,43,22,21,0,0,0
2021-01-02 12:00,45,27,18,0,0,0
2021-01-02 12:15,56,37,19,0,0,0
2021-01-02 12:30,60,32,28,0,0,0
2021-01-02 12:45,57,34,23,0,0,0
2021-01-02 13:00,69,41,28,0,0,0
2021-01-02 13:15,63,37,26,0,0,0
2021-01-02 13:30,60,28,32,0,0,0
2021-01-02 13:45,66,43,23,0,0,0
2021-01-02 14:00,68,33,35,0,0,0
2021-01-02 14:15,79,39,40,0,0,0
2021-01-02 14:30,79,31,48,0,0,0
2021-01-02 14:45,70,37,33,0,0,0
2021-01-02 15:00,60,31,29,0,0,0
2021-01-02 15:15,83,40,43,0,0,0
2021-01-02 15:30,62,33,29,0,0,0
2021-01-02 15:45,74,35,39,0,0,0
2021-01-02 16:00,53,28,25,0,0,0
2021-01-02 16:15,65,24,41,0,0,0
2021-01-02 16:30,55,28,27,0,0,0
2021-01-02 16:45,67,27,40,0,0,0
2021-01-02 17:00,51,11,40,0,0,0
2021-01-02 17:15,43,20,23,0,0,0
2021-01-02 17:30,41,26,15,0,0,0
2021-01-02 17:45,48,27,21,0,0,0
2021-01-02 18:00,51,24,27,0,0,0
2021-01-02 18:15,41,17,24,0,0,0
2021-01-02 18:30,34,12,22,0,0,0
2021-01-02 18:45,41,18,23,0,0,0
2021-01-02 19:00,35,13,22,0,0,0
2021-01-02 19:15,25,11,14,0,0,0
2021-01-02 19:30,38,16,22,0,0,0
2021-01-02 19:45,28,9,19,0,0,0
2021-01-02 20:00,27,14,13,0,0,0
2021-01-02 20:15,28,11,17,0,0,0
2021-01-02 20:30,22,13,9,0,0,0
2021-01-02 20:45,16,4,12,0,0,0
2021-01-02 21:00,32,12,20,0,0,0
2021-01-02 21:15,9,5,4,0,0,0
2021-01-02 21:30,19,10,9,0,0,0
2021-01-02 21:45,18,9,9,0,0,0
2021-01-02 22:00,15,4,11,0,0,0
2021-01-02 22:15,12,4,8,0,0,0
2021-01-02 22:30,12,5,7,0,0,0
2021-01-02 22:45,8,3,5,0,0,0
2021-01-02 23:00,13,8,5,0,0,0
2021-01-02 23:15,13,9,4,0,0,0
2021-01-02 23:30,20,6,14,0,0,0
2021-01-02 23:45,9,3,6,0,0,0
2021-01-03 00:00,7,1,6,0,0,0
2021-01-03 00:15,9,3,6,0,0,0
2021-01-03 00:30,12,10,2,0,0,0
2021-01-03 00:45,13,2,11,0,0,0
2021-01-03 01:00,9,4,5,0,0,0
2021-01-03 01:15,9,4,5,0,0,0
2021-01-03 01:30,4,0,4,0,0,0
2021-01-03 01:45,9,6,3,0,0,0
2021-01-03 02:00,4,4,0,0,0,0
2021-01-03 02:15,3,1,2,0,0,0
2021-01-03 02:30,4,3,1,0,0,0
2021-01-03 02:45,4,2,2,0,0,0
2021-01-03 03:00,7,4,3,0,0,0
2021-01-03 03:15,11,5,6,0,0,0
2021-01-03 03:30,3,0,3,0,0,0
2021-01-03 03:45,8,1,7,0,0,0
2021-01-03 04:00,2,1,1,0,0,0
2021-01-03 04:15,1,1,0,0,0,0
2021-01-03 04:30,0,0,0,0,0,0
2021-01-03 04:45,0,0,0,0,0,0
2021-01-03 05:00,3,2,1,0,0,0
2021-01-03 05:15,2,1,1,0,0,0
2021-01-03 05:30,7,4,3,0,0,0
2021-01-03 05:45,4,2,2,0,0,0
2021-01-03 06:00,4,1,3,0,0,0
2021-01-03 06:15,4,1,3,0,0,0
2021-01-03 06:30,7,5,2,0,0,0
2021-01-03 06:45,5,4,1,0,0,0
2021-01-03 07:00,2,2,0,0,0,0
2021-01-03 07:15,5,2,3,0,0,0
2021-01-03 07:30,9,5,4,0,0,0
2021-01-03 07:45,5,2,3,0,0,0
2021-01-03 08:00,8,3,5,0,0,0
2021-01-03 08:15,10,2,8,0,0,0
2021-01-03 08:30,5,2,3,0,0,0
2021-01-03 08:45,6,4,2,0,0,0
2021-01-03 09:00,16,6,10,0,0,0
2021-01-03 09:15,14,7,7,0,0,0
2021-01-03 09:30,16,9,7,0,0,0
2021-01-03 09:45,20,12,8,0,0,0
2021-01-03 10:00,17,9,8,0,0,0
2021-01-03 10:15,26,10,16,0,0,0
2021-01-03 10:30,15,11,4,0,0,0
2021-01-03 10:45,37,28,9,0,0,0
2021-01-03 11:00,21,15,6,0,0,0
2021-01-03 11:15,28,16,12,0,0,0
2021-01-03 11:30,46,24,22,0,0,0
2021-01-03 11:45,32,21,11,0,0,0
2021-01-03 12:00,24,11,13,0,0,0
2021-01-03 12:15,49,30,19,0,0,0
2021-01-03 12:30,46,17,29,0,0,0
2021-01-03 12:45,43,24,19,0,0,0
2021-01-03 13:00,51,31,20,0,0,0
2021-01-03 13:15,41,20,21,0,0,0
2021-01-03 13:30,57,35,22,0,0,0
2021-01-03 13:45,67,34,33,0,0,0
2021-01-03 14:00,66,37,29,0,0,0
2021-01-03 14:15,44,25,19,0,0,0
2021-01-03 14:30,45,23,22,0,0,0
2021-01-03 14:45,68,33,35,0,0,0
2021-01-03 15:00,47,28,19,0,0,0
2021-01-03 15:15,47,26,21,0,0,0
2021-01-03 15:30,43,22,21,0,0,0
2021-01-03 15:45,58,25,33,0,0,0
2021-01-03 16:00,49,21,28,0,0,0
2021-01-03 16:15,34,16,18,0,0,0
2021-01-03 16:30,48,16,32,0,0,0
2021-01-03 16:45,44,20,24,0,0,0
2021-01-03 17:00,50,27,23,0,0,0
2021-01-03 17:15,47,18,29,0,0,0
2021-01-03 17:30,36,19,17,0,0,0
2021-01-03 17:45,51,26,25,0,0,0
2021-01-03 18:00,32,12,20,0,0,0
2021-01-03 18:15,38,17,21,0,0,0
2021-01-03 18:30,31,14,17,0,0,0
2021-01-03 18:45,34,13,21,0,0,0
2021-01-03 19:00,30,14,16,0,0,0
2021-01-03 19:15,32,16,16,0,0,0
2021-01-03 19:30,39,11,28,0,0,0
2021-01-03 19:45,25,13,12,0,0,0
2021-01-03 20:00,32,15,17,0,0,0
2021-01-03 20:15,19,8,11,0,0,0
2021-01-03 20:30,24,7,17,0,0,0
2021-01-03 20:45,19,10,9,0,0,0
2021-01-03 21:00,13,5,8,0,0,0
2021-01-03 21:15,19,3,16,0,0,0
2021-01-03 21:30,14,4,10,0,0,0
2021-01-03 21:45,8,4,4,0,0,0
2021-01-03 22:00,9,5,4,0,0,0
2021-01-03 22:15,18,3,15,0,0,0
2021-01-03 22:30,16,6,10,0,0,0
2021-01-03 22:45,8,3,5,0,0,0
2021-01-03 23:00,8,1,7,0,0,0
2021-01-03 23:15,6,2,4,0,0,0
2021-01-03 23:30,9,5,4,0,0,0
2021-01-03 23:45,13,3,10,0,0,0
2021-01-04 00:00,6,2,4,0,0,0
2021-01-04 00:15,4,0,4,0,0,0
2021-01-04 00:30,7,2,5,0,0,0
2021-01-04 00:45,4,2,2,0,0,0
2021-01-04 01:00,1,0,1,0,0,0
2021-01-04 01:15,1,1,0,0,0,0
2021-01-04 01:30,1,0,1,0,0,0
2021-01-04 01:45,3,2,1,0,0,0
2021-01-04 02:00,1,1,0,0,0,0
2021-01-04 02:15,1,0,1,0,0,0
2021-01-04 02:30,1,1,0,0,0,0
2021-01-04 02:45,0,0,0,0,0,0
2021-01-04 03:00,3,1,2,0,0,0
2021-01-04 03:15,1,0,1,0,0,0
2021-01-04 03:30,1,1,0,0,0,0
2021-01-04 03:45,0,0,0,0,0,0
2021-01-04 04:00,2,1,1,0,0,0
2021-01-04 04:15,1,0,1,0,0,0
2021-01-04 04:30,2,2,0,0,0,0
2021-01-04 04:45,4,2,2,0,0,0
2021-01-04 05:00,4,4,0,0,0,0
2021-01-04 05:15,8,5,3,0,0,0
2021-01-04 05:30,14,7,7,0,0,0
2021-01-04 05:45,18,11,7,0,0,0
2021-01-04 06:00,21,11,10,0,0,0
2021-01-04 06:15,16,9,7,0,0,0
2021-01-04 06:30,34,27,7,0,0,0
2021-01-04 06:45,43,31,12,0,0,0
2021-01-04 07:00,54,34,20,0,0,0
2021-01-04 07:15,49,29,20,0,0,0
2021-01-04 07:30,77,38,39,0,0,0
2021-01-04 07:45,72,44,28,0,0,0
2021-01-04 08:00,67,39,28,0,0,0
2021-01-04 08:15,66,41,25,0,0,0
2021-01-04 08:30,59,32,27,0,0,0
2021-01-04 08:45,80,46,34,0,0,0
2021-01-04 09:00,40,20,20,0,0,0
2021-01-04 09:15,46,28,18,0,0,0
2021-01-04 09:30,51,27,24,0,0,0
2021-01-04 09:45,44,20,24,0,0,0
2021-01-04 10:00,39,19,20,0,0,0
2021-01-04 10:15,31,17,14,0,0,0
2021-01-04 10:30,39,24,15,0,0,0
2021-01-04 10:45,49,24,25,0,0,0
2021-01-04 11:00,55,27,28,0,0,0
2021-01-04 11:15,44,24,20,0,0,0
2021-01-04 11:30,65,37,28,0,0,0
2021-01-04 11:45,61,26,35,0,0,0
2021-01-04 12:00,54,26,28,0,0,0
2021-01-04 12:15,60,34,26,0,0,0
2021-01-04 12:30,75,41,34,0,0,0
2021-01-04 12:45,71,29,42,0,0,0
2021-01-04 13:00,71,41,30,0,0,0
2021-01-04 13:15,58,35,23,0,0,0
2021-01-04 13:30,70,27,43,0,0,0
2021-01-04 13:45,77,48,29,0,0,0
2021-01-04 14:00,73,38,35,0,0,0
2021-01-04 14:15,63,35,28,0,0,0
2021-01-04 14:30,80,40,40,0,0,0
2021-01-04 14:45,80,32,48,0,0,0
2021-01-04 15:00,68,33,35,0,0,0
2021-01-04 15:15,63,25,38,0,0,0
2021-01-04 15:30,81,40,41,0,0,0
2021-01-04 15:45,88,41,47,0,0,0
2021-01-04 16:00,112,55,57,0,0,0
2021-01-04 16:15,108,54,54,0,0,0
2021-01-04 16:30,116,42,74,0,0,0
2021-01-04 16:45,95,44,51,0,0,0
2021-01-04 17:00,103,42,61,0,0,0
2021-01-04 17:15,103,47,56,0,0,0
2021-01-04 17:30,85,38,47,0,0,0
2021-01-04 17:45,82,35,47,0,0,0
2021-01-04 18:00,73,36,37,0,0,0
2021-01-04 18:15,71,34,37,0,0,0
2021-01-04 18:30,68,27,41,0,0,0
2021-01-04 18:45,57,28,29,0,0,0
2021-01-04 19:00,53,30,23,0,0,0
2021-01-04 19:15,48,21,27,0,0,0
2021-01-04 19:30,33,10,23,0,0,0
2021-01-04 19:45,41,24,17,0,0,0
2021-01-04 20:00,39,16,23,0,0,0
2021-01-04 20:15,37,18,19,0,0,0
2021-01-04 20:30,28,7,21,0,0,0
2021-01-04 20:45,29,8,21,0,0,0
2021-01-04 21:00,28,8,20,0,0,0
2021-01-04 21:15,14,3,11,0,0,0
2021-01-04 21:30,14,7,7,0,0,0
2021-01-04 21:45,22,17,5,0,0,0
2021-01-04 22:00,15,2,13,0,0,0
2021-01-04 22:15,20,4,16,0,0,0
2021-01-04 22:30,18,5,13,0,0,0
2021-01-04 22:45,13,5,8,0,0,0
2021-01-04 23:00,12,3,9,0,0,0
2021-01-04 23:15,10,5,5,0,0,0
2021-01-04 23:30,11,9,2,0,0,0
2021-01-04 23:45,12,7,5,0,0,0
2021-01-05 00:00,12,5,7,0,0,0
2021-01-05 00:15,9,3,6,0,0,0
2021-01-05 00:30,6,2,4,0,0,0
2021-01-05 00:45,4,4,0,0,0,0
2021-01-05 01:00,3,1,2,0,0,0
2021-01-05 01:15,1,0,1,0,0,0
2021-01-05 01:30,5,2,3,0,0,0
2021-01-05 01:45,3,3,0,0,0,0
2021-01-05 02:00,2,1,1,0,0,0
2021-01-05 02:15,4,2,2,0,0,0
2021-01-05 02:30,3,3,0,0,0,0
2021-01-05 02:45,4,3,1,0,0,0
2021-01-05 03:00,2,1,1,0,0,0
2021-01-05 03:15,1,0,1,0,0,0
2021-01-05 03:30,1,1,0,0,0,0
2021-01-05 03:45,0,0,0,0,0,0
2021-01-05 04:00,0,0,0,0,0,0
2021-01-05 04:15,3,1,2,0,0,0
2021-01-05 04:30,5,1,4,0,0,0
2021-01-05 04:45,2,1,1,0,0,0
2021-01-05 05:00,3,2,1,0,0,0
2021-01-05 05:15,7,6,1,0,0,0
2021-01-05 05:30,17,7,10,0,0,0
2021-01-05 05:45,16,10,6,0,0,0
2021-01-05 06:00,17,10,7,0,0,0
2021-01-05 06:15,26,16,10,0,0,0
2021-01-05 06:30,37,27,10,0,0,0
2021-01-05 06:45,40,24,16,0,0,0
2021-01-05 07:00,68,45,23,0,0,0
2021-01-05 07:15,64,40,24,0,0,0
2021-01-05 07:30,82,49,33,0,0,0
2021-01-05 07:45,98,56,42,0,0,0
2021-01-05 08:00,80,49,31,0,0,0
2021-01-05 08:15,98,58,40,0,0,0
2021-01-05 08:30,84,54,30,0,0,0
2021-01-05 08:45,99,54,45,0,0,0
2021-01-05 09:00,61,31,30,0,0,0
2021-01-05 09:15,68,34,34,0,0,0
2021-01-05 09:30,58,39,19,0,0,0
2021-01-05 09:45,58,35,23,0,0,0
2021-01-05 10:00,47,24,23,0,0,0
2021-01-05 10:15,57,32,25,0,0,0
2021-01-05 10:30,45,26,19,0,0,0
2021-01-05 10:45,67,32,35,0,0,0
2021-01-05 11:00,46,20,26,0,0,0
2021-01-05 11:15,55,25,30,0,0,0
2021-01-05 11:30,84,51,33,0,0,0
2021-01-05 11:45,81,44,37,0,0,0
2021-01-05 12:00,57,26,31,0,0,0
2021-01-05 12:15,79,40,39,0,0,0
2021-01-05 12:30,67,28,39,0,0,0
2021-01-05 12:45,64,37,27,0,0,0
2021-01-05 13:00,68,26,42,0,0,0
2021-01-05 13:15,77,49,28,0,0,0
2021-01-05 13:30,63,34,29,0,0,0
2021-01-05 13:45,81,43,38,0,0,0
2021-01-05 14:00,74,32,42,0,0,0
2021-01-05 14:15,82,44,38,0,0,0
2021-01-05 14:30,81,42,39,0,0,0
2021-01-05 14:45,73,39,34,0,0,0
2021-01-05 15:00,78,35,43,0,0,0
2021-01-05 15:15,84,35,49,0,0,0
2021-01-05 15:30,92,50,42,0,0,0
2021-01-05 15:45,101,46,55,0,0,0
2021-01-05 16:00,97,41,56,0,0,0
2021-01-05 16:15,118,50,68,0,0,0
2021-01-05 16:30,111,45,66,0,0,0
2021-01-05 16:45,114,55,59,0,0,0
2021-01-05 17:00,107,36,71,0,0,0
2021-01-05 17:15,98,45,53,0,0,0
2021-01-05 17:30,94,40,54,0,0,0
2021-01-05 17:45,104,47,57,0,0,0
2021-01-05 18:00,84,33,51,0,0,0
2021-01-05 18:15,87,28,59,0,0,0
2021-01-05 18:30,67,21,46,0,0,0
2021-01-05 18:45,60,27,33,0,0,0
2021-01-05 19:00,76,28,48,0,0,0
2021-01-05 19:15,60,23,37,0,0,0
2021-01-05 19:30,43,23,20,0,0,0
2021-01-05 19:45,52,25,27,0,0,0
2021-01-05 20:00,38,21,17,0,0,0
2021-01-05 20:15,44,18,26,0,0,0
2021-01-05 20:30,33,9,24,0,0,0
2021-01-05 20:45,40,13,27,0,0,0
2021-01-05 21:00,28,14,14,0,0,0
2021-01-05 21:15,23,6,17,0,0,0
2021-01-05 21:30,18,6,12,0,0,0
2021-01-05 21:45,20,10,10,0,0,0
2021-01-05 22:00,23,16,7,0,0,0
2021-01-05 22:15,14,4,10,0,0,0
2021-01-05 22:30,18,6,12,0,0,0
2021-01-05 22:45,19,8,11,0,0,0
2021-01-05 23:00,19,8,11,0,0,0
2021-01-05 23:15,20,12,8,0,0,0
2021-01-05 23:30,11,3,8,0,0,0
2021-01-05 23:45,8,1,7,0,0,0
2021-01-06 00:00,6,3,3,0,0,0
2021-01-06 00:15,4,1,3,0,0,0
2021-01-06 00:30,11,4,7,0,0,0
2021-01-06 00:45,4,1,3,0,0,0
2021-01-06 01:00,7,4,3,0,0,0
2021-01-06 01:15,4,0,4,0,0,0
2021-01-06 01:30,1,0,1,0,0,0
2021-01-06 01:45,3,1,2,0,0,0
2021-01-06 02:00,3,2,1,0,0,0
2021-01-06 02:15,4,2,2,0,0,0
2021-01-06 02:30,0,0,0,0,0,0
2021-01-06 02:45,2,2,0,0,0,0
2021-01-06 03:00,2,1,1,0,0,0
2021-01-06 03:15,1,1,0,0,0,0
2021-01-06 03:30,1,0,1,0,0,0
2021-01-06 03:45,1,1,0,0,0,0
2021-01-06 04:00,1,0,1,0,0,0
2021-01-06 04:15,0,0,0,0,0,0
2021-01-06 04:30,3,2,1,0,0,0
2021-01-06 04:45,4,3,1,0,0,0
2021-01-06 05:00,3,3,0,0,0,0
2021-01-06 05:15,7,6,1,0,0,0
2021-01-06 05:30,14,6,8,0,0,0
2021-01-06 05:45,13,7,6,0,0,0
2021-01-06 06:00,11,6,5,0,0,0
2021-01-06 06:15,27,14,13,0,0,0
2021-01-06 06:30,38,27,11,0,0,0
2021-01-06 06:45,47,32,15,0,0,0
2021-01-06 07:00,69,48,21,0,0,0
2021-01-06 07:15,60,40,20,0,0,0
2021-01-06 07:30,81,46,35,0,0,0
2021-01-06 07:45,116,60,56,0,0,0
2021-01-06 08:00,93,53,40,0,0,0
2021-01-06 08:15,78,46,32,0,0,0
2021-01-06 08:30,97,63,34,0,0,0
2021-01-06 08:45,82,45,37,0,0,0
2021-01-06 09:00,72,44,28,0,0,0
2021-01-06 09:15,73,39,34,0,0,0
2021-01-06 09:30,62,40,22,0,0,0
2021-01-06 09:45,61,34,27,0,0,0
2021-01-06 10:00,51,38,13,0,0,0
2021-01-06 10:15,62,33,29,0,0,0
2021-01-06 10:30,62,37,25,0,0,0
2021-01-06 10:45,59,39,20,0,0,0
2021-01-06 11:00,72,36,36,0,0,0
2021-01-06 11:15,86,43,43,0,0,0
2021-01-06 11:30,91,47,44,0,0,0
2021-01-06 11:45,81,46,35,0,0,0
2021-01-06 12:00,81,48,33,0,0,0
2021-01-06 12:15,95,47,48,0,0,0
2021-01-06 12:30,89,50,39,0,0,0
2021-01-06 12:45,90,47,43,0,0,0
2021-01-06 13:00,99,45,54,0,0,0
2021-01-06 13:15,88,44,44,0,0,0
2021-01-06 13:30,77,47,30,0,0,0
2021-01-06 13:45,105,46,59,0,0,0
2021-01-06 14:00,82,45,37,0,0,0
2021-01-06 14:15,77,43,34,0,0,0
2021-01-06 14:30,105,56,49,0,0,0
2021-01-06 14:45,80,39,41,0,0,0
2021-01-06 15:00,78,35,43,0,0,0
2021-01-06 15:15,85,37,48,0,0,0
2021-01-06 15:30,90,42,48,0,0,0
2021-01-06 15:45,96,52,44,0,0,0
2021-01-06 16:00,121,51,70,0,0,0
2021-01-06 16:15,115,54,61,0,0,0
2021-01-06 16:30,115,43,72,0,0,0
2021-01-06 16:45,115,55,60,0,0,0
2021-01-06 17:00,112,47,65,0,0,0
2021-01-06 17:15,107,33,74,0,0,0
2021-01-06 17:30,107,52,55,0,0,0
2021-01-06 17:45,91,38,53,0,0,0
2021-01-06 18:00,89,37,52,0,0,0
2021-01-06 18:15,95,42,53,0,0,0
2021-01-06 18:30,55,24,31,0,0,0
2021-01-06 18:45,87,38,49,0,0,0
2021-01-06 19:00,63,23,40,0,0,0
2021-01-06 19:15,52,20,32,0,0,0
2021-01-06 19:30,47,12,35,0,0,0
2021-01-06 19:45,38,15,23,0,0,0
2021-01-06 20:00,49,18,31,0,0,0
2021-01-06 20:15,37,19,18,0,0,0
2021-01-06 20:30,26,12,14,0,0,0
2021-01-06 20:45,25,13,12,0,0,0
2021-01-06 21:00,29,12,17,0,0,0
2021-01-06 21:15,29,11,18,0,0,0
2021-01-06 21:30,16,7,9,0,0,0
2021-01-06 21:45,24,11,13,0,0,0
2021-01-06 22:00,21,5,16,0,0,0
2021-01-06 22:15,14,3,11,0,0,0
2021-01-06 22:30,24,9,15,0,0,0
2021-01-06 22:45,15,8,7,0,0,0
2021-01-06 23:00,19,5,14,0,0,0
2021-01-06 23:15,9,3,6,0,0,0
2021-01-06 23:30,15,6,9,0,0,0
2021-01-06 23:45,16,8,8,0,0,0
2021-01-07 00:00,13,6,7,0,0,0
2021-01-07 00:15,14,6,8,0,0,0
2021-01-07 00:30,6,1,5,0,0,0
2021-01-07 00:45,6,4,2,0,0,0
2021-01-07 01:00,5,3,2,0,0,0
2021-01-07 01:15,3,0,3,0,0,0
2021-01-07 01:30,6,0,6,0,0,0
2021-01-07 01:45,3,1,2,0,0,0
2021-01-07 02:00,5,3,2,0,0,0
2021-01-07 02:15,1,1,0,0,0,0
2021-01-07 02:30,1,1,0,0,0,0
2021-01-07 02:45,2,1,1,0,0,0
2021-01-07 03:00,1,0,1,0,0,0
2021-01-07 03:15,2,2,0,0,0,0
2021-01-07 03:30,0,0,0,0,0,0
2021-01-07 03:45,1,1,0,0,0,0
2021-01-07 04:00,0,0,0,0,0,0
2021-01-07 04:15,1,1,0,0,0,0
2021-01-07 04:30,2,2,0,0,0,0
2021-01-07 04:45,5,4,1,0,0,0
2021-01-07 05:00,5,3,2,0,0,0
2021-01-07 05:15,5,4,1,0,0,0
2021-01-07 05:30,12,7,5,0,0,0
2021-01-07 05:45,12,9,3,0,0,0
2021-01-07 06:00,14,10,4,0,0,0
2021-01-07 06:15,21,12,9,0,0,0
2021-01-07 06:30,28,17,11,0,0,0
2021-01-07 06:45,42,30,12,0,0,0
2021-01-07 07:00,38,23,15,0,0,0
2021-01-07 07:15,62,41,21,0,0,0
2021-01-07 07:30,93,52,41,0,0,0
2021-01-07 07:45,122,58,64,0,0,0
2021-01-07 08:00,71,40,31,0,0,0
2021-01-07 08:15,95,58,37,0,0,0
2021-01-07 08:30,88,56,32,0,0,0
2021-01-07 08:45,108,68,40,0,0,0
2021-01-07 09:00,81,50,31,0,0,0
2021-01-07 09:15,57,29,28,0,0,0
2021-01-07 09:30,57,31,26,0,0,0
2021-01-07 09:45,68,39,29,0,0,0
2021-01-07 10:00,49,28,21,0,0,0
2021-01-07 10:15,43,28,15,0,0,0
2021-01-07 10:30,49,31,18,0,0,0
2021-01-07 10:45,68,32,36,0,0,0
2021-01-07 11:00,62,26,36,0,0,0
2021-01-07 11:15,54,27,27,0,0,0
2021-01-07 11:30,59,35,24,0,0,0
2021-01-07 11:45,63,26,37,0,0,0
2021-01-07 12:00,68,35,33,0,0,0
2021-01-07 12:15,68,32,36,0,0,0
2021-01-07 12:30,76,39,37,0,0,0
2021-01-07 12:45,82,36,46,0,0,0
2021-01-07 13:00,71,38,33,0,0,0
2021-01-07 13:15,67,38,29,0,0,0
2021-01-07 13:30,61,31,30,0,0,0
2021-01-07 13:45,81,35,46,0,0,0
2021-01-07 14:00,68,31,37,0,0,0
2021-01-07 14:15,67,29,38,0,0,0
2021-01-07 14:30,63,36,27,0,0,0
2021-01-07 14:45,92,55,37,0,0,0
2021-01-07 15:00,80,41,39,0,0,0
2021-01-07 15:15,92,35,57,0,0,0
2021-01-07 15:30,87,43,44,0,0,0
2021-01-07 15:45,85,45,40,0,0,0
2021-01-07 16:00,100,48,52,0,0,0
2021-01-07 16:15,121,55,66,0,0,0
2021-01-07 16:30,98,42,56,0,0,0
2021-01-07 16:45,118,39,79,0,0,0
2021-01-07 17:00,102,46,56,0,0,0
2021-01-07 17:15,108,52,56,0,0,0
2021-01-07 17:30,85,28,57,0,0,0
2021-01-07 17:45,101,47,54,0,0,0
2021-01-07 18:00,87,38,49,0,0,0
2021-01-07 18:15,90,38,52,0,0,0
2021-01-07 18:30,72,36,36,0,0,0
2021-01-07 18:45,79,40,39,0,0,0
2021-01-07 19:00,67,35,32,0,0,0
2021-01-07 19:15,63,27,36,0,0,0
2021-01-07 19:30,58,26,32,0,0,0
2021-01-07 19:45,36,20,16,0,0,0
2021-01-07 20:00,35,13,22,0,0,0
2021-01-07 20:15,53,24,29,0,0,0
2021-01-07 20:30,21,9,12,0,0,0
2021-01-07 20:45,28,14,14,0,0,0
2021-01-07 21:00,18,8,10,0,0,0
2021-01-07 21:15,27,13,14,0,0,0
2021-01-07 21:30,25,9,16,0,0,0
2021-01-07 21:45,19,9,10,0,0,0
2021-01-07 22:00,15,3,12,0,0,0
2021-01-07 22:15,20,9,11,0,0,0
2021-01-07 22:30,9,3,6,0,0,0
2021-01-07 22:45,10,4,6,0,0,0
2021-01-07 23:00,19,8,11,0,0,0
2021-01-07 23:15,14,5,9,0,0,0
2021-01-07 23:30,10,5,5,0,0,0
2021-01-07 23:45,11,7,4,0,0,0
2021-01-08 00:00,12,7,5,0,0,0
2021-01-08 00:15,14,3,11,0,0,0
2021-01-08 00:30,8,2,6,0,0,0
2021-01-08 00:45,1,1,0,0,0,0
2021-01-08 01:00,7,2,5,0,0,0
2021-01-08 01:15,4,2,2,0,0,0
2021-01-08 01:30,5,2,3,0,0,0
2021-01-08 01:45,4,2,2,0,0,0
2021-01-08 02:00,5,2,3,0,0,0
2021-01-08 02:15,2,2,0,0,0,0
2021-01-08 02:30,0,0,0,0,0,0
2021-01-08 02:45,0,0,0,0,0,0
2021-01-08 03:00,1,0,1,0,0,0
2021-01-08 03:15,3,2,1,0,0,0
2021-01-08 03:30,1,0,1,0,0,0
2021-01-08 03:45,0,0,0,0,0,0
2021-01-08 04:00,0,0,0,0,0,0
2021-01-08 04:15,2,1,1,0,0,0
2021-01-08 04:30,3,3,0,0,0,0
2021-01-08 04:45,3,2,1,0,0,0
2021-01-08 05:00,5,3,2,0,0,0
2021-01-08 05:15,6,4,2,0,0,0
2021-01-08 05:30,14,9,5,0,0,0
2021-01-08 05:45,8,5,3,0,0,0
2021-01-08 06:00,13,10,3,0,0,0
2021-01-08 06:15,18,10,8,0,0,0
2021-01-08 06:30,32,19,13,0,0,0
2021-01-08 06:45,31,23,8,0,0,0
2021-01-08 07:00,45,27,18,0,0,0
2021-01-08 07:15,52,29,23,0,0,0
2021-01-08 07:30,75,44,31,0,0,0
2021-01-08 07:45,102,49,53,0,0,0
2021-01-08 08:00,77,44,33,0,0,0
2021-01-08 08:15,75,44,31,0,0,0
2021-01-08 08:30,79,54,25,0,0,0
2021-01-08 08:45,92,53,39,0,0,0
2021-01-08 09:00,63,36,27,0,0,0
2021-01-08 09:15,61,36,25,0,0,0
2021-01-08 09:30,71,41,30,0,0,0
2021-01-08 09:45,73,42,31,0,0,0
2021-01-08 10:00,40,19,21,0,0,0
2021-01-08 10:15,56,36,20,0,0,0
2021-01-08 10:30,65,33,32,0,0,0
2021-01-08 10:45,72,34,38,0,0,0
2021-01-08 11:00,59,30,29,0,0,0
2021-01-08 11:15,62,34,28,0,0,0
2021-01-08 11:30,76,40,36,0,0,0
2021-01-08 11:45,67,42,25,0,0,0
2021-01-08 12:00,72,28,44,0,0,0
2021-01-08 12:15,78,37,41,0,0,0
2021-01-08 12:30,86,39,47,0,0,0
2021-01-08 12:45,97,43,54,0,0,0
2021-01-08 13:00,96,39,57,0,0,0
2021-01-08 13:15,79,44,35,0,0,0
2021-01-08 13:30,70,32,38,0,0,0
2021-01-08 13:45,96,60,36,0,0,0
2021-01-08 14:00,91,43,48,0,0,0
2021-01-08 14:15,80,45,35,0,0,0
2021-01-08 14:30,80,37,43,0,0,0
2021-01-08 14:45,75,45,30,0,0,0
2021-01-08 15:00,84,42,42,0,0,0
2021-01-08 15:15,110,42,68,0,0,0
2021-01-08 15:30,95,40,55,0,0,0
2021-01-08 15:45,116,63,53,0,0,0
2021-01-08 16:00,112,49,63,0,0,0
2021-01-08 16:15,109,51,58,0,0,0
2021-01-08 16:30,82,40,42,0,0,0
2021-01-08 16:45,90,51,39,0,0,0
2021-01-08 17:00,87,37,50,0,0,0
2021-01-08 17:15,86,41,45,0,0,0
2021-01-08 17:30,81,30,51,0,0,0
2021-01-08 17:45,103,49,54,0,0,0
2021-01-08 18:00,90,41,49,0,0,0
2021-01-08 18:15,73,33,40,0,0,0
2021-01-08 18:30,81,35,46,0,0,0
2021-01-08 18:45,75,30,45,0,0,0
2021-01-08 19:00,82,31,51,0,0,0
2021-01-08 19:15,63,25,38,0,0,0
2021-01-08 19:30,51,25,26,0,0,0
2021-01-08 19:45,62,27,35,0,0,0
2021-01-08 20:00,54,23,31,0,0,0
2021-01-08 20:15,42,21,21,0,0,0
2021-01-08 20:30,32,12,20,0,0,0
2021-01-08 20:45,28,15,13,0,0,0
2021-01-08 21:00,30,11,19,0,0,0
2021-01-08 21:15,23,14,9,0,0,0
2021-01-08 21:30,17,12,5,0,0,0
2021-01-08 21:45,15,8,7,0,0,0
2021-01-08 22:00,19,7,12,0,0,0
2021-01-08 22:15,20,5,15,0,0,0
2021-01-08 22:30,16,11,5,0,0,0
2021-01-08 22:45,12,7,5,0,0,0
2021-01-08 23:00,25,10,15,0,0,0
2021-01-08 23:15,20,6,14,0,0,0
2021-01-08 23:30,16,8,8,0,0,0
2021-01-08 23:45,14,5,9,0,0,0
2021-01-09 00:00,15,7,8,0,0,0
2021-01-09 00:15,12,5,7,0,0,0
2021-01-09 00:30,16,6,10,0,0,0
2021-01-09 00:45,15,6,9,0,0,0
2021-01-09 01:00,16,7,9,0,0,0
2021-01-09 01:15,10,4,6,0,0,0
2021-01-09 01:30,13,5,8,0,0,0
2021-01-09 01:45,8,6,2,0,0,0
2021-01-09 02:00,8,4,4,0,0,0
2021-01-09 02:15,6,1,5,0,0,0
2021-01-09 02:30,5,1,4,0,0,0
2021-01-09 02:45,6,3,3,0,0,0
2021-01-09 03:00,6,3,3,0,0,0
2021-01-09 03:15,2,1,1,0,0,0
2021-01-09 03:30,5,3,2,0,0,0
2021-01-09 03:45,4,3,1,0,0,0
2021-01-09 04:00,0,0,0,0,0,0
2021-01-09 04:15,2,1,1,0,0,0
2021-01-09 04:30,3,1,2,0,0,0
2021-01-09 04:45,3,0,3,0,0,0
2021-01-09 05:00,3,3,0,0,0,0
2021-01-09 05:15,10,8,2,0,0,0
2021-01-09 05:30,9,7,2,0,0,0
2021-01-09 05:45,5,2,3,0,0,0
2021-01-09 06:00,4,1,3,0,0,0
2021-01-09 06:15,7,5,2,0,0,0
2021-01-09 06:30,6,5,1,0,0,0
2021-01-09 06:45,8,4,4,0,0,0
2021-01-09 07:00,4,1,3,0,0,0
2021-01-09 07:15,5,4,1,0,0,0
2021-01-09 07:30,16,9,7,0,0,0
2021-01-09 07:45,16,11,5,0,0,0
2021-01-09 08:00,14,8,6,0,0,0
2021-01-09 08:15,5,3,2,0,0,0
2021-01-09 08:30,21,18,3,0,0,0
2021-01-09 08:45,33,21,12,0,0,0
2021-01-09 09:00,27,17,10,0,0,0
2021-01-09 09:15,29,15,14,0,0,0
2021-01-09 09:30,39,26,13,0,0,0
2021-01-09 09:45,50,32,18,0,0,0
2021-01-09 10:00,47,29,18,0,0,0
2021-01-09 10:15,48,25,23,0,0,0
2021-01-09 10:30,52,29,23,0,0,0
2021-01-09 10:45,58,38,20,0,0,0
2021-01-09 11:00,42,15,27,0,0,0
2021-01-09 11:15,65,42,23,0,0,0
2021-01-09 11:30,63,44,19,0,0,0
2021-01-09 11:45,90,57,33,0,0,0
2021-01-09 12:00,80,40,40,0,0,0
2021-01-09 12:15,74,41,33,0,0,0
2021-01-09 12:30,82,41,41,0,0,0
2021-01-09 12:45,94,59,35,0,0,0
2021-01-09 13:00,99,51,48,0,0,0
2021-01-09 13:15,72,37,35,0,0,0
2021-01-09 13:30,92,48,44,0,0,0
2021-01-09 13:45,96,48,48,0,0,0
2021-01-09 14:00,98,43,55,0,0,0
2021-01-09 14:15,76,33,43,0,0,0
2021-01-09 14:30,88,40,48,0,0,0
2021-01-09 14:45,93,41,52,0,0,0
2021-01-09 15:00,99,33,66,0,0,0
2021-01-09 15:15,87,39,48,0,0,0
2021-01-09 15:30,76,46,30,0,0,0
2021-01-09 15:45,72,38,34,0,0,0
2021-01-09 16:00,78,39,39,0,0,0
2021-01-09 16:15,82,39,43,0,0,0
2021-01-09 16:30,55,17,38,0,0,0
2021-01-09 16:45,73,30,43,0,0,0
2021-01-09 17:00,59,21,38,0,0,0
2021-01-09 17:15,72,29,43,0,0,0
2021-01-09 17:30,50,28,22,0,0,0
2021-01-09 17:45,72,39,33,0,0,0
2021-01-09 18:00,77,22,55,0,0,0
2021-01-09 18:15,67,30,37,0,0,0
2021-01-09 18:30,62,27,35,0,0,0
2021-01-09 18:45,52,29,23,0,0,0
2021-01-09 19:00,56,28,28,0,0,0
2021-01-09 19:15,49,23,26,0,0,0
2021-01-09 19:30,46,21,25,0,0,0
2021-01-09 19:45,45,22,23,0,0,0
2021-01-09 20:00,35,7,28,0,0,0
2021-01-09 20:15,42,20,22,0,0,0
2021-01-09 20:30,45,15,30,0,0,0
2021-01-09 20:45,27,12,15,0,0,0
2021-01-09 21:00,31,12,19,0,0,0
2021-01-09 21:15,28,8,20,0,0,0
2021-01-09 21:30,20,8,12,0,0,0
2021-01-09 21:45,17,5,12,0,0,0
2021-01-09 22:00,16,4,12,0,0,0
2021-01-09 22:15,19,8,11,0,0,0
2021-01-09 22:30,13,4,9,0,0,0
2021-01-09 22:45,22,13,9,0,0,0
2021-01-09 23:00,18,4,14,0,0,0
2021-01-09 23:15,26,9,17,0,0,0
2021-01-09 23:30,14,4,10,0,0,0
2021-01-09 23:45,27,12,15,0,0,0
2021-01-10 00:00,24,7,17,0,0,0
2021-01-10 00:15,19,6,13,0,0,0
2021-01-10 00:30,17,8,9,0,0,0
2021-01-10 00:45,16,10,6,0,0,0
2021-01-10 01:00,19,8,11,0,0,0
2021-01-10 01:15,13,5,8,0,0,0
2021-01-10 01:30,12,9,3,0,0,0
2021-01-10 01:45,13,5,8,0,0,0
2021-01-10 02:00,13,6,7,0,0,0
2021-01-10 02:15,15,4,11,0,0,0
2021-01-10 02:30,7,4,3,0,0,0
2021-01-10 02:45,10,4,6,0,0,0
2021-01-10 03:00,9,7,2,0,0,0
2021-01-10 03:15,1,0,1,0,0,0
2021-01-10 03:30,3,1,2,0,0,0
2021-01-10 03:45,6,1,5,0,0,0
2021-01-10 04:00,3,0,3,0,0,0
2021-01-10 04:15,2,2,0,0,0,0
2021-01-10 04:30,1,0,1,0,0,0
2021-01-10 04:45,3,1,2,0,0,0
2021-01-10 05:00,1,0,1,0,0,0
2021-01-10 05:15,7,0,7,0,0,0
2021-01-10 05:30,3,2,1,0,0,0
2021-01-10 05:45,2,1,1,0,0,0
2021-01-10 06:00,4,3,1,0,0,0
2021-01-10 06:15,1,0,1,0,0,0
2021-01-10 06:30,6,2,4,0,0,0
2021-01-10 06:45,3,1,2,0,0,0
2021-01-10 07:00,4,0,4,0,0,0
2021-01-10 07:15,2,0,2,0,0,0
2021-01-10 07:30,5,4,1,0,0,0
2021-01-10 07:45,2,1,1,0,0,0
2021-01-10 08:00,3,2,1,0,0,0
2021-01-10 08:15,6,2,4,0,0,0
2021-01-10 08:30,7,3,4,0,0,0
2021-01-10 08:45,7,3,4,0,0,0
2021-01-10 09:00,11,9,2,0,0,0
2021-01-10 09:15,17,11,6,0,0,0
2021-01-10 09:30,23,13,10,0,0,0
2021-01-10 09:45,31,24,7,0,0,0
2021-01-10 10:00,30,19,11,0,0,0
2021-01-10 10:15,19,16,3,0,0,0
2021-01-10 10:30,29,20,9,0,0,0
2021-01-10 10:45,37,19,18,0,0,0
2021-01-10 11:00,29,18,11,0,0,0
2021-01-10 11:15,38,16,22,0,0,0
2021-01-10 11:30,36,18,18,0,0,0
2021-01-10 11:45,43,24,19,0,0,0
2021-01-10 12:00,36,18,18,0,0,0
2021-01-10 12:15,33,19,14,0,0,0
2021-01-10 12:30,42,21,21,0,0,0
2021-01-10 12:45,66,29,37,0,0,0
2021-01-10 13:00,47,21,26,0,0,0
2021-01-10 13:15,74,53,21,0,0,0
2021-01-10 13:30,69,33,36,0,0,0
2021-01-10 13:45,87,48,39,0,0,0
2021-01-10 14:00,86,46,40,0,0,0
2021-01-10 14:15,78,46,32,0,0,0
2021-01-10 14:30,78,37,41,0,0,0
2021-01-10 14:45,107,52,55,0,0,0
2021-01-10 15:00,95,36,59,0,0,0
2021-01-10 15:15,103,54,49,0,0,0
2021-01-10 15:30,95,58,37,0,0,0
2021-01-10 15:45,106,50,56,0,0,0
2021-01-10 16:00,71,33,38,0,0,0
2021-01-10 16:15,104,53,51,0,0,0
2021-01-10 16:30,84,40,44,0,0,0
2021-01-10 16:45,80,37,43,0,0,0
2021-01-10 17:00,66,32,34,0,0,0
2021-01-10 17:15,68,24,44,0,0,0
2021-01-10 17:30,60,27,33,0,0,0
2021-01-10 17:45,61,29,32,0,0,0
2021-01-10 18:00,42,18,24,0,0,0
2021-01-10 18:15,37,17,20,0,0,0
2021-01-10 18:30,52,27,25,0,0,0
2021-01-10 18:45,62,35,27,0,0,0
2021-01-10 19:00,45,21,24,0,0,0
2021-01-10 19:15,25,9,16,0,0,0
2021-01-10 19:30,31,12,19,0,0,0
2021-01-10 19:45,33,14,19,0,0,0
2021-01-10 20:00,45,23,22,0,0,0
2021-01-10 20:15,33,15,18,0,0,0
2021-01-10 20:30,37,19,18,0,0,0
2021-01-10 20:45,21,9,12,0,0,0
2021-01-10 21:00,29,8,21,0,0,0
2021-01-10 21:15,24,10,14,0,0,0
2021-01-10 21:30,21,11,10,0,0,0
2021-01-10 21:45,17,5,12,0,0,0
2021-01-10 22:00,22,16,6,0,0,0
2021-01-10 22:15,11,2,9,0,0,0
2021-01-10 22:30,11,3,8,0,0,0
2021-01-10 22:45,21,7,14,0,0,0
2021-01-10 23:00,19,12,7,0,0,0
2021-01-10 23:15,13,5,8,0,0,0
2021-01-10 23:30,11,5,6,0,0,0
2021-01-10 23:45,9,2,7,0,0,0
2021-01-11 00:00,9,2,7,0,0,0
2021-01-11 00:15,7,4,3,0,0,0
2021-01-11 00:30,5,2,3,0,0,0
2021-01-11 00:45,4,3,1,0,0,0
2021-01-11 01:00,7,3,4,0,0,0
2021-01-11 01:15,4,3,1,0,0,0
2021-01-11 01:30,2,1,1,0,0,0
2021-01-11 01:45,2,1,1,0,0,0
2021-01-11 02:00,7,2,5,0,0,0
2021-01-11 02:15,3,0,3,0,0,0
2021-01-11 02:30,3,2,1,0,0,0
2021-01-11 02:45,0,0,0,0,0,0
2021-01-11 03:00,2,0,2,0,0,0
2021-01-11 03:15,0,0,0,0,0,0
2021-01-11 03:30,1,0,1,0,0,0
2021-01-11 03:45,0,0,0,0,0,0
2021-01-11 04:00,5,2,3,0,0,0
2021-01-11 04:15,1,1,0,0,0,0
2021-01-11 04:30,5,3,2,0,0,0
2021-01-11 04:45,7,6,1,0,0,0
2021-01-11 05:00,6,5,1,0,0,0
2021-01-11 05:15,5,3,2,0,0,0
2021-01-11 05:30,15,7,8,0,0,0
2021-01-11 05:45,18,11,7,0,0,0
2021-01-11 06:00,14,11,3,0,0,0
2021-01-11 06:15,24,17,7,0,0,0
2021-01-11 06:30,37,20,17,0,0,0
2021-01-11 06:45,66,50,16,0,0,0
2021-01-11 07:00,59,34,25,0,0,0
2021-01-11 07:15,82,50,32,0,0,0
2021-01-11 07:30,112,70,42,0,0,0
2021-01-11 07:45,120,61,59,0,0,0
2021-01-11 08:00,96,50,46,0,0,0
2021-01-11 08:15,88,39,49,0,0,0
2021-01-11 08:30,96,51,45,0,0,0
2021-01-11 08:45,109,59,50,0,0,0
2021-01-11 09:00,57,24,33,0,0,0
2021-01-11 09:15,87,49,38,0,0,0
2021-01-11 09:30,63,29,34,0,0,0
2021-01-11 09:45,68,37,31,0,0,0
2021-01-11 10:00,42,20,22,0,0,0
2021-01-11 10:15,60,31,29,0,0,0
2021-01-11 10:30,55,26,29,0,0,0
2021-01-11 10:45,65,35,30,0,0,0
2021-01-11 11:00,52,23,29,0,0,0
2021-01-11 11:15,82,45,37,0,0,0
2021-01-11 11:30,61,24,37,0,0,0
2021-01-11 11:45,83,47,36,0,0,0
2021-01-11 12:00,75,28,47,0,0,0
2021-01-11 12:15,65,36,29,0,0,0
2021-01-11 12:30,79,44,35,0,0,0
2021-01-11 12:45,92,47,45,0,0,0
2021-01-11 13:00,84,45,39,0,0,0
2021-01-11 13:15,75,32,43,0,0,0
2021-01-11 13:30,102,59,43,0,0,0
2021-01-11 13:45,79,39,40,0,0,0
2021-01-11 14:00,78,34,44,0,0,0
2021-01-11 14:15,86,44,42,0,0,0
2021-01-11 14:30,97,45,52,0,0,0
2021-01-11 14:45,118,65,53,0,0,0
2021-01-11 15:00,97,34,63,0,0,0
2021-01-11 15:15,112,51,61,0,0,0
2021-01-11 15:30,81,54,27,0,0,0
2021-01-11 15:45,130,56,74,0,0,0
2021-01-11 16:00,128,59,69,0,0,0
2021-01-11 16:15,138,58,80,0,0,0
2021-01-11 16:30,125,58,67,0,0,0
2021-01-11 16:45,127,58,69,0,0,0
2021-01-11 17:00,108,42,66,0,0,0
2021-01-11 17:15,141,54,87,0,0,0
2021-01-11 17:30,120,52,68,0,0,0
2021-01-11 17:45,87,38,49,0,0,0
2021-01-11 18:00,108,44,64,0,0,0
2021-01-11 18:15,101,42,59,0,0,0
2021-01-11 18:30,86,35,51,0,0,0
2021-01-11 18:45,75,40,35,0,0,0
2021-01-11 19:00,78,39,39,0,0,0
2021-01-11 19:15,60,17,43,0,0,0
2021-01-11 19:30,48,15,33,0,0,0
2021-01-11 19:45,49,23,26,0,0,0
2021-01-11 20:00,39,21,18,0,0,0
2021-01-11 20:15,38,20,18,0,0,0
2021-01-11 20:30,37,23,14,0,0,0
2021-01-11 20:45,27,11,16,0,0,0
2021-01-11 21:00,34,18,16,0,0,0
2021-01-11 21:15,14,9,5,0,0,0
2021-01-11 21:30,21,3,18,0,0,0
2021-01-11 21:45,22,11,11,0,0,0
2021-01-11 22:00,11,5,6,0,0,0
2021-01-11 22:15,13,7,6,0,0,0
2021-01-11 22:30,17,6,11,0,0,0
2021-01-11 22:45,22,4,18,0,0,0
2021-01-11 23:00,12,5,7,0,0,0
2021-01-11 23:15,6,2,4,0,0,0
2021-01-11 23:30,11,3,8,0,0,0
2021-01-11 23:45,16,10,6,0,0,0
2021-01-12 00:00,13,4,9,0,0,0
2021-01-12 00:15,7,4,3,0,0,0
2021-01-12 00:30,14,5,9,0,0,0
2021-01-12 00:45,1,1,0,0,0,0
2021-01-12 01:00,0,0,0,0,0,0
2021-01-12 01:15,5,1,4,0,0,0
2021-01-12 01:30,1,1,0,0,0,0
2021-01-12 01:45,1,0,1,0,0,0
2021-01-12 02:00,3,2,1,0,0,0
2021-01-12 02:15,3,0,3,0,0,0
2021-01-12 02:30,5,1,4,0,0,0
2021-01-12 02:45,1,0,1,0,0,0
2021-01-12 03:00,0,0,0,0,0,0
2021-01-12 03:15,0,0,0,0,0,0
2021-01-12 03:30,1,1,0,0,0,0
2021-01-12 03:45,1,0,1,0,0,0
2021-01-12 04:00,0,0,0,0,0,0
2021-01-12 04:15,2,0,2,0,0,0
2021-01-12 04:30,5,3,2,0,0,0
2021-01-12 04:45,3,2,1,0,0,0
2021-01-12 05:00,7,7,0,0,0,0
2021-01-12 05:15,6,4,2,0,0,0
2021-01-12 05:30,13,9,4,0,0,0
2021-01-12 05:45,14,7,7,0,0,0
2021-01-12 06:00,16,12,4,0,0,0
2021-01-12 06:15,21,17,4,0,0,0
2021-01-12 06:30,33,21,12,0,0,0
2021-01-12 06:45,50,37,13,0,0,0
2021-01-12 07:00,58,37,21,0,0,0
2021-01-12 07:15,62,38,24,0,0,0
2021-01-12 07:30,83,54,29,0,0,0
2021-01-12 07:45,107,55,52,0,0,0
2021-01-12 08:00,108,58,50,0,0,0
2021-01-12 08:15,88,52,36,0,0,0
2021-01-12 08:30,71,46,25,0,0,0
2021-01-12 08:45,87,53,34,0,0,0
2021-01-12 09:00,69,33,36,0,0,0
2021-01-12 09:15,57,35,22,0,0,0
2021-01-12 09:30,56,31,25,0,0,0
2021-01-12 09:45,58,37,21,0,0,0
2021-01-12 10:00,54,25,29,0,0,0
2021-01-12 10:15,66,32,34,0,0,0
2021-01-12 10:30,56,33,23,0,0,0
2021-01-12 10:45,53,24,29,0,0,0
2021-01-12 11:00,49,30,19,0,0,0
2021-01-12 11:15,48,22,26,0,0,0
2021-01-12 11:30,67,33,34,0,0,0
2021-01-12 11:45,77,37,40,0,0,0
2021-01-12 12:00,76,38,38,0,0,0
2021-01-12 12:15,67,25,42,0,0,0
2021-01-12 12:30,67,27,40,0,0,0
2021-01-12 12:45,78,46,32,0,0,0
2021-01-12 13:00,78,37,41,0,0,0
2021-01-12 13:15,77,39,38,0,0,0
2021-01-12 13:30,74,42,32,0,0,0
2021-01-12 13:45,85,54,31,0,0,0
2021-01-12 14:00,86,53,33,0,0,0
2021-01-12 14:15,82,41,41,0,0,0
2021-01-12 14:30,92,48,44,0,0,0
2021-01-12 14:45,99,58,41,0,0,0
2021-01-12 15:00,100,58,42,0,0,0
2021-01-12 15:15,132,70,62,0,0,0
2021-01-12 15:30,101,55,46,0,0,0
2021-01-12 15:45,120,69,51,0,0,0
2021-01-12 16:00,119,55,64,0,0,0
2021-01-12 16:15,129,56,73,0,0,0
2021-01-12 16:30,130,53,77,0,0,0
2021-01-12 16:45,130,60,70,0,0,0
2021-01-12 17:00,115,40,75,0,0,0
2021-01-12 17:15,108,47,61,0,0,0
2021-01-12 17:30,122,59,63,0,0,0
2021-01-12 17:45,115,50,65,0,0,0
2021-01-12 18:00,99,39,60,0,0,0
2021-01-12 18:15,109,42,67,0,0,0
2021-01-12 18:30,89,39,50,0,0,0
2021-01-12 18:45,69,28,41,0,0,0
2021-01-12 19:00,80,30,50,0,0,0
2021-01-12 19:15,74,34,40,0,0,0
2021-01-12 19:30,61,25,36,0,0,0
2021-01-12 19:45,62,27,35,0,0,0
2021-01-12 20:00,51,23,28,0,0,0
2021-01-12 20:15,35,13,22,0,0,0
2021-01-12 20:30,37,19,18,0,0,0
2021-01-12 20:45,43,20,23,0,0,0
2021-01-12 21:00,23,16,7,0,0,0
2021-01-12 21:15,21,3,18,0,0,0
2021-01-12 21:30,25,12,13,0,0,0
2021-01-12 21:45,22,10,12,0,0,0
2021-01-12 22:00,30,15,15,0,0,0
2021-01-12 22:15,14,6,8,0,0,0
2021-01-12 22:30,16,8,8,0,0,0
2021-01-12 22:45,14,6,8,0,0,0
2021-01-12 23:00,24,12,12,0,0,0
2021-01-12 23:15,17,5,12,0,0,0
2021-01-12 23:30,14,9,5,0,0,0
2021-01-12 23:45,18,8,10,0,0,0
2021-01-13 00:00,11,4,7,0,0,0
2021-01-13 00:15,8,2,6,0,0,0
2021-01-13 00:30,7,4,3,0,0,0
2021-01-13 00:45,5,1,4,0,0,0
2021-01-13 01:00,1,0,1,0,0,0
2021-01-13 01:15,5,2,3,0,0,0
2021-01-13 01:30,0,0,0,0,0,0
2021-01-13 01:45,3,2,1,0,0,0
2021-01-13 02:00,3,1,2,0,0,0
2021-01-13 02:15,1,0,1,0,0,0
2021-01-13 02:30,0,0,0,0,0,0
2021-01-13 02:45,0,0,0,0,0,0
2021-01-13 03:00,1,1,0,0,0,0
2021-01-13 03:15,1,1,0,0,0,0
2021-01-13 03:30,1,1,0,0,0,0
2021-01-13 03:45,3,3,0,0,0,0
2021-01-13 04:00,0,0,0,0,0,0
2021-01-13 04:15,2,2,0,0,0,0
2021-01-13 04:30,6,3,3,0,0,0
2021-01-13 04:45,6,4,2,0,0,0
2021-01-13 05:00,6,4,2,0,0,0
2021-01-13 05:15,8,5,3,0,0,0
2021-01-13 05:30,13,10,3,0,0,0
2021-01-13 05:45,16,10,6,0,0,0
2021-01-13 06:00,14,12,2,0,0,0
2021-01-13 06:15,21,18,3,0,0,0
2021-01-13 06:30,37,24,13,0,0,0
2021-01-13 06:45,44,26,18,0,0,0
2021-01-13 07:00,53,36,17,0,0,0
2021-01-13 07:15,69,44,25,0,0,0
2021-01-13 07:30,92,50,42,0,0,0
2021-01-13 07:45,119,60,59,0,0,0
2021-01-13 08:00,105,55,50,0,0,0
2021-01-13 08:15,107,57,50,0,0,0
2021-01-13 08:30,92,50,42,0,0,0
2021-01-13 08:45,117,63,54,0,0,0
2021-01-13 09:00,85,50,35,0,0,0
2021-01-13 09:15,88,47,41,0,0,0
2021-01-13 09:30,67,37,30,0,0,0
2021-01-13 09:45,90,49,41,0,0,0
2021-01-13 10:00,68,38,30,0,0,0
2021-01-13 10:15,78,50,28,0,0,0
2021-01-13 10:30,68,30,38,0,0,0
2021-01-13 10:45,84,42,42,0,0,0
2021-01-13 11:00,73,38,35,0,0,0
2021-01-13 11:15,81,54,27,0,0,0
2021-01-13 11:30,89,45,44,0,0,0
2021-01-13 11:45,105,59,46,0,0,0
2021-01-13 12:00,90,47,43,0,0,0
2021-01-13 12:15,109,57,52,0,0,0
2021-01-13 12:30,98,42,56,0,0,0
2021-01-13 12:45,109,56,53,0,0,0
2021-01-13 13:00,114,45,69,0,0,0
2021-01-13 13:15,89,42,47,0,0,0
2021-01-13 13:30,99,45,54,0,0,0
2021-01-13 13:45,125,63,62,0,0,0
2021-01-13 14:00,95,41,54,0,0,0
2021-01-13 14:15,101,44,57,0,0,0
2021-01-13 14:30,97,50,47,0,0,0
2021-01-13 14:45,99,51,48,0,0,0
2021-01-13 15:00,118,52,66,0,0,0
2021-01-13 15:15,94,43,51,0,0,0
2021-01-13 15:30,106,57,49,0,0,0
2021-01-13 15:45,118,55,63,0,0,0
2021-01-13 16:00,132,57,75,0,0,0
2021-01-13 16:15,122,50,72,0,0,0
2021-01-13 16:30,120,58,62,0,0,0
2021-01-13 16:45,116,56,60,0,0,0
2021-01-13 17:00,118,42,76,0,0,0
2021-01-13 17:15,117,53,64,0,0,0
2021-01-13 17:30,115,56,59,0,0,0
2021-01-13 17:45,115,54,61,0,0,0
2021-01-13 18:00,108,46,62,0,0,0
2021-01-13 18:15,112,45,67,0,0,0
2021-01-13 18:30,95,31,64,0,0,0
2021-01-13 18:45,88,40,48,0,0,0
2021-01-13 19:00,85,42,43,0,0,0
2021-01-13 19:15,71,36,35,0,0,0
2021-01-13 19:30,65,29,36,0,0,0
2021-01-13 19:45,66,36,30,0,0,0
2021-01-13 20:00,55,23,32,0,0,0
2021-01-13 20:15,47,22,25,0,0,0
2021-01-13 20:30,29,9,20,0,0,0
2021-01-13 20:45,37,16,21,0,0,0
2021-01-13 21:00,36,16,20,0,0,0
2021-01-13 21:15,35,14,21,0,0,0
2021-01-13 21:30,10,5,5,0,0,0
2021-01-13 21:45,17,4,13,0,0,0
2021-01-13 22:00,23,7,16,0,0,0
2021-01-13 22:15,17,7,10,0,0,0
2021-01-13 22:30,26,12,14,0,0,0
2021-01-13 22:45,19,5,14,0,0,0
2021-01-13 23:00,13,7,6,0,0,0
2021-01-13 23:15,13,5,8,0,0,0
2021-01-13 23:30,19,9,10,0,0,0
2021-01-13 23:45,26,11,15,0,0,0
2021-01-14 00:00,18,7,11,0,0,0
2021-01-14 00:15,12,4,8,0,0,0
2021-01-14 00:30,13,5,8,0,0,0
2021-01-14 00:45,5,2,3,0,0,0
2021-01-14 01:00,7,2,5,0,0,0
2021-01-14 01:15,13,7,6,0,0,0
2021-01-14 01:30,3,2,1,0,0,0
2021-01-14 01:45,2,1,1,0,0,0
2021-01-14 02:00,2,1,1,0,0,0
2021-01-14 02:15,2,2,0,0,0,0
2021-01-14 02:30,3,1,2,0,0,0
2021-01-14 02:45,3,1,2,0,0,0
2021-01-14 03:00,1,0,1,0,0,0
2021-01-14 03:15,1,0,1,0,0,0
2021-01-14 03:30,5,3,2,0,0,0
2021-01-14 03:45,3,2,1,0,0,0
2021-01-14 04:00,3,1,2,0,0,0
2021-01-14 04:15,1,0,1,0,0,0
2021-01-14 04:30,3,2,1,0,0,0
2021-01-14 04:45,6,4,2,0,0,0
2021-01-14 05:00,4,4,0,0,0,0
2021-01-14 05:15,5,2,3,0,0,0
2021-01-14 05:30,12,5,7,0,0,0
2021-01-14 05:45,12,5,7,0,0,0
2021-01-14 06:00,16,13,3,0,0,0
2021-01-14 06:15,24,18,6,0,0,0
2021-01-14 06:30,37,22,15,0,0,0
2021-01-14 06:45,61,43,18,0,0,0
2021-01-14 07:00,61,43,18,0,0,0
2021-01-14 07:15,58,36,22,0,0,0
2021-01-14 07:30,105,68,37,0,0,0
2021-01-14 07:45,132,79,53,0,0,0
2021-01-14 08:00,103,63,40,0,0,0
2021-01-14 08:15,112,56,56,0,0,0
2021-01-14 08:30,88,52,36,0,0,0
2021-01-14 08:45,119,72,47,0,0,0
2021-01-14 09:00,85,38,47,0,0,0
2021-01-14 09:15,65,43,22,0,0,0
2021-01-14 09:30,62,36,26,0,0,0
2021-01-14 09:45,67,30,37,0,0,0
2021-01-14 10:00,63,31,32,0,0,0
2021-01-14 10:15,53,20,33,0,0,0
2021-01-14 10:30,67,37,30,0,0,0
2021-01-14 10:45,73,37,36,0,0,0
2021-01-14 11:00,63,35,28,0,0,0
2021-01-14 11:15,76,42,34,0,0,0
2021-01-14 11:30,71,48,23,0,0,0
2021-01-14 11:45,107,50,57,0,0,0
2021-01-14 12:00,81,40,41,0,0,0
2021-01-14 12:15,82,50,32,0,0,0
2021-01-14 12:30,86,34,52,0,0,0
2021-01-14 12:45,94,44,50,0,0,0
2021-01-14 13:00,88,49,39,0,0,0
2021-01-14 13:15,100,43,57,0,0,0
2021-01-14 13:30,78,43,35,0,0,0
2021-01-14 13:45,122,61,61,0,0,0
2021-01-14 14:00,95,58,37,0,0,0
2021-01-14 14:15,68,36,32,0,0,0
2021-01-14 14:30,103,48,55,0,0,0
2021-01-14 14:45,127,67,60,0,0,0
2021-01-14 15:00,119,56,63,0,0,0
2021-01-14 15:15,126,66,60,0,0,0
2021-01-14 15:30,109,49,60,0,0,0
2021-01-14 15:45,127,60,67,0,0,0
2021-01-14 16:00,122,46,76,0,0,0
2021-01-14 16:15,145,63,82,0,0,0
2021-01-14 16:30,109,41,68,0,0,0
2021-01-14 16:45,137,68,69,0,0,0
2021-01-14 17:00,134,61,73,0,0,0
2021-01-14 17:15,152,51,101,0,0,0
2021-01-14 17:30,132,58,74,0,0,0
2021-01-14 17:45,143,62,81,0,0,0
2021-01-14 18:00,105,44,61,0,0,0
2021-01-14 18:15,113,39,74,0,0,0
2021-01-14 18:30,98,40,58,0,0,0
2021-01-14 18:45,83,39,44,0,0,0
2021-01-14 19:00,87,40,47,0,0,0
2021-01-14 19:15,76,33,43,0,0,0
2021-01-14 19:30,71,30,41,0,0,0
2021-01-14 19:45,71,35,36,0,0,0
2021-01-14 20:00,71,29,42,0,0,0
2021-01-14 20:15,49,24,25,0,0,0
2021-01-14 20:30,33,16,17,0,0,0
2021-01-14 20:45,27,12,15,0,0,0
2021-01-14 21:00,26,10,16,0,0,0
2021-01-14 21:15,35,14,21,0,0,0
2021-01-14 21:30,22,8,14,0,0,0
2021-01-14 21:45,29,9,20,0,0,0
2021-01-14 22:00,22,7,15,0,0,0
2021-01-14 22:15,17,8,9,0,0,0
2021-01-14 22:30,10,3,7,0,0,0
2021-01-14 22:45,19,8,11,0,0,0
2021-01-14 23:00,23,9,14,0,0,0
2021-01-14 23:15,14,4,10,0,0,0
2021-01-14 23:30,21,9,12,0,0,0
2021-01-14 23:45,18,6,12,0,0,0
2021-01-15 00:00,13,5,8,0,0,0
2021-01-15 00:15,8,1,7,0,0,0
2021-01-15 00:30,8,4,4,0,0,0
2021-01-15 00:45,6,2,4,0,0,0
2021-01-15 01:00,7,4,3,0,0,0
2021-01-15 01:15,10,3,7,0,0,0
2021-01-15 01:30,3,1,2,0,0,0
2021-01-15 01:45,6,5,1,0,0,0
2021-01-15 02:00,2,1,1,0,0,0
2021-01-15 02:15,3,1,2,0,0,0
2021-01-15 02:30,1,0,1,0,0,0
2021-01-15 02:45,1,0,1,0,0,0
2021-01-15 03:00,4,1,3,0,0,0
2021-01-15 03:15,2,1,1,0,0,0
2021-01-15 03:30,1,1,0,0,0,0
2021-01-15 03:45,1,1,0,0,0,0
2021-01-15 04:00,1,1,0,0,0,0
2021-01-15 04:15,3,0,3,0,0,0
2021-01-15 04:30,4,2,2,0,0,0
2021-01-15 04:45,6,3,3,0,0,0
2021-01-15 05:00,5,4,1,0,0,0
2021-01-15 05:15,12,8,4,0,0,0
2021-01-15 05:30,16,10,6,0,0,0
2021-01-15 05:45,12,4,8,0,0,0
2021-01-15 06:00,14,9,5,0,0,0
2021-01-15 06:15,25,17,8,0,0,0
2021-01-15 06:30,29,17,12,0,0,0
2021-01-15 06:45,52,33,19,0,0,0
2021-01-15 07:00,56,35,21,0,0,0
2021-01-15 07:15,75,49,26,0,0,0
2021-01-15 07:30,80,46,34,0,0,0
2021-01-15 07:45,124,68,56,0,0,0
2021-01-15 08:00,87,45,42,0,0,0
2021-01-15 08:15,95,47,48,0,0,0
2021-01-15 08:30,81,38,43,0,0,0
2021-01-15 08:45,105,66,39,0,0,0
2021-01-15 09:00,94,52,42,0,0,0
2021-01-15 09:15,63,32,31,0,0,0
2021-01-15 09:30,55,31,24,0,0,0
2021-01-15 09:45,74,42,32,0,0,0
2021-01-15 10:00,69,43,26,0,0,0
2021-01-15 10:15,65,30,35,0,0,0
2021-01-15 10:30,63,32,31,0,0,0
2021-01-15 10:45,68,39,29,0,0,0
2021-01-15 11:00,69,36,33,0,0,0
2021-01-15 11:15,67,35,32,0,0,0
2021-01-15 11:30,53,28,25,0,0,0
2021-01-15 11:45,94,55,39,0,0,0
2021-01-15 12:00,98,51,47,0,0,0
2021-01-15 12:15,90,43,47,0,0,0
2021-01-15 12:30,76,38,38,0,0,0
2021-01-15 12:45,109,49,60,0,0,0
2021-01-15 13:00,111,49,62,0,0,0
2021-01-15 13:15,128,54,74,0,0,0
2021-01-15 13:30,87,50,37,0,0,0
2021-01-15 13:45,96,53,43,0,0,0
2021-01-15 14:00,101,39,62,0,0,0
2021-01-15 14:15,116,65,51,0,0,0
2021-01-15 14:30,98,48,50,0,0,0
2021-01-15 14:45,116,64,52,0,0,0
2021-01-15 15:00,104,55,49,0,0,0
2021-01-15 15:15,139,61,78,0,0,0
2021-01-15 15:30,116,55,61,0,0,0
2021-01-15 15:45,112,59,53,0,0,0
2021-01-15 16:00,117,55,62,0,0,0
2021-01-15 16:15,118,51,67,0,0,0
2021-01-15 16:30,105,55,50,0,0,0
2021-01-15 16:45,112,45,67,0,0,0
2021-01-15 17:00,80,31,49,0,0,0
2021-01-15 17:15,84,40,44,0,0,0
2021-01-15 17:30,97,44,53,0,0,0
2021-01-15 17:45,87,38,49,0,0,0
2021-01-15 18:00,71,33,38,0,0,0
2021-01-15 18:15,82,28,54,0,0,0
2021-01-15 18:30,77,31,46,0,0,0
2021-01-15 18:45,78,43,35,0,0,0
2021-01-15 19:00,68,33,35,0,0,0
2021-01-15 19:15,73,34,39,0,0,0
2021-01-15 19:30,58,26,32,0,0,0
2021-01-15 19:45,48,22,26,0,0,0
2021-01-15 20:00,49,23,26,0,0,0
2021-01-15 20:15,50,19,31,0,0,0
2021-01-15 20:30,44,23,21,0,0,0
2021-01-15 20:45,47,12,35,0,0,0
2021-01-15 21:00,33,18,15,0,0,0
2021-01-15 21:15,29,5,24,0,0,0
2021-01-15 21:30,20,9,11,0,0,0
2021-01-15 21:45,18,11,7,0,0,0
2021-01-15 22:00,28,10,18,0,0,0
2021-01-15 22:15,11,7,4,0,0,0
2021-01-15 22:30,26,13,13,0,0,0
2021-01-15 22:45,21,8,13,0,0,0
2021-01-15 23:00,10,1,9,0,0,0
2021-01-15 23:15,22,11,11,0,0,0
2021-01-15 23:30,14,3,11,0,0,0
2021-01-15 23:45,16,7,9,0,0,0
2021-01-16 00:00,14,7,7,0,0,0
2021-01-16 00:15,24,10,14,0,0,0
2021-01-16 00:30,18,5,13,0,0,0
2021-01-16 00:45,7,3,4,0,0,0
2021-01-16 01:00,17,7,10,0,0,0
2021-01-16 01:15,16,4,12,0,0,0
2021-01-16 01:30,10,5,5,0,0,0
2021-01-16 01:45,16,4,12,0,0,0
2021-01-16 02:00,6,2,4,0,0,0
2021-01-16 02:15,10,4,6,0,0,0
2021-01-16 02:30,10,3,7,0,0,0
2021-01-16 02:45,6,3,3,0,0,0
2021-01-16 03:00,10,5,5,0,0,0
2021-01-16 03:15,5,3,2,0,0,0
2021-01-16 03:30,5,1,4,0,0,0
2021-01-16 03:45,5,1,4,0,0,0
2021-01-16 04:00,5,0,5,0,0,0
2021-01-16 04:15,4,2,2,0,0,0
2021-01-16 04:30,4,0,4,0,0,0
2021-01-16 04:45,5,3,2,0,0,0
2021-01-16 05:00,5,2,3,0,0,0
2021-01-16 05:15,9,8,1,0,0,0
2021-01-16 05:30,13,7,6,0,0,0
2021-01-16 05:45,7,5,2,0,0,0
2021-01-16 06:00,7,1,6,0,0,0
2021-01-16 06:15,7,2,5,0,0,0
2021-01-16 06:30,10,9,1,0,0,0
2021-01-16 06:45,6,4,2,0,0,0
2021-01-16 07:00,4,2,2,0,0,0
2021-01-16 07:15,7,3,4,0,0,0
2021-01-16 07:30,16,12,4,0,0,0
2021-01-16 07:45,14,10,4,0,0,0
2021-01-16 08:00,17,10,7,0,0,0
2021-01-16 08:15,18,13,5,0,0,0
2021-01-16 08:30,20,10,10,0,0,0
2021-01-16 08:45,40,25,15,0,0,0
2021-01-16 09:00,27,12,15,0,0,0
2021-01-16 09:15,30,18,12,0,0,0
2021-01-16 09:30,34,20,14,0,0,0
2021-01-16 09:45,67,40,27,0,0,0
2021-01-16 10:00,46,27,19,0,0,0
2021-01-16 10:15,54,29,25,0,0,0
2021-01-16 10:30,41,27,14,0,0,0
2021-01-16 10:45,60,32,28,0,0,0
2021-01-16 11:00,51,29,22,0,0,0
2021-01-16 11:15,70,45,25,0,0,0
2021-01-16 11:30,75,44,31,0,0,0
2021-01-16 11:45,94,64,30,0,0,0
2021-01-16 12:00,80,35,45,0,0,0
2021-01-16 12:15,96,58,38,0,0,0
2021-01-16 12:30,81,44,37,0,0,0
2021-01-16 12:45,88,47,41,0,0,0
2021-01-16 13:00,99,53,46,0,0,0
2021-01-16 13:15,117,57,60,0,0,0
2021-01-16 13:30,99,48,51,0,0,0
2021-01-16 13:45,105,60,45,0,0,0
2021-01-16 14:00,92,51,41,0,0,0
2021-01-16 14:15,114,54,60,0,0,0
2021-01-16 14:30,90,41,49,0,0,0
2021-01-16 14:45,90,45,45,0,0,0
2021-01-16 15:00,89,37,52,0,0,0
2021-01-16 15:15,90,37,53,0,0,0
2021-01-16 15:30,77,25,52,0,0,0
2021-01-16 15:45,85,41,44,0,0,0
2021-01-16 16:00,86,40,46,0,0,0
2021-01-16 16:15,93,34,59,0,0,0
2021-01-16 16:30,77,33,44,0,0,0
2021-01-16 16:45,65,33,32,0,0,0
2021-01-16 17:00,63,25,38,0,0,0
2021-01-16 17:15,55,23,32,0,0,0
2021-01-16 17:30,57,22,35,0,0,0
2021-01-16 17:45,66,29,37,0,0,0
2021-01-16 18:00,80,35,45,0,0,0
2021-01-16 18:15,71,33,38,0,0,0
2021-01-16 18:30,44,11,33,0,0,0
2021-01-16 18:45,66,30,36,0,0,0
2021-01-16 19:00,47,21,26,0,0,0
2021-01-16 19:15,47,23,24,0,0,0
2021-01-16 19:30,58,30,28,0,0,0
2021-01-16 19:45,36,10,26,0,0,0
2021-01-16 20:00,49,23,26,0,0,0
2021-01-16 20:15,36,13,23,0,0,0
2021-01-16 20:30,41,17,24,0,0,0
2021-01-16 20:45,33,17,16,0,0,0
2021-01-16 21:00,34,15,19,0,0,0
2021-01-16 21:15,20,6,14,0,0,0
2021-01-16 21:30,27,13,14,0,0,0
2021-01-16 21:45,27,10,17,0,0,0
2021-01-16 22:00,16,9,7,0,0,0
2021-01-16 22:15,14,5,9,0,0,0
2021-01-16 22:30,22,11,11,0,0,0
2021-01-16 22:45,12,4,8,0,0,0
2021-01-16 23:00,14,7,7,0,0,0
2021-01-16 23:15,24,8,16,0,0,0
2021-01-16 23:30,25,11,14,0,0,0
2021-01-16 23:45,13,7,6,0,0,0
2021-01-17 00:00,25,12,13,0,0,0
2021-01-17 00:15,28,9,19,0,0,0
2021-01-17 00:30,26,8,18,0,0,0
2021-01-17 00:45,28,7,21,0,0,0
2021-01-17 01:00,14,6,8,0,0,0
2021-01-17 01:15,13,5,8,0,0,0
2021-01-17 01:30,16,8,8,0,0,0
2021-01-17 01:45,13,6,7,0,0,0
2021-01-17 02:00,18,6,12,0,0,0
2021-01-17 02:15,10,5,5,0,0,0
2021-01-17 02:30,10,1,9,0,0,0
2021-01-17 02:45,6,5,1,0,0,0
2021-01-17 03:00,2,2,0,0,0,0
2021-01-17 03:15,4,4,0,0,0,0
2021-01-17 03:30,3,1,2,0,0,0
2021-01-17 03:45,1,1,0,0,0,0
2021-01-17 04:00,4,0,4,0,0,0
2021-01-17 04:15,0,0,0,0,0,0
2021-01-17 04:30,2,1,1,0,0,0
2021-01-17 04:45,3,3,0,0,0,0
2021-01-17 05:00,3,2,1,0,0,0
2021-01-17 05:15,3,1,2,0,0,0
2021-01-17 05:30,7,2,5,0,0,0
2021-01-17 05:45,2,1,1,0,0,0
2021-01-17 06:00,5,4,1,0,0,0
2021-01-17 06:15,0,0,0,0,0,0
2021-01-17 06:30,4,2,2,0,0,0
2021-01-17 06:45,3,1,2,0,0,0
2021-01-17 07:00,4,2,2,0,0,0
2021-01-17 07:15,3,2,1,0,0,0
2021-01-17 07:30,9,7,2,0,0,0
2021-01-17 07:45,6,2,4,0,0,0
2021-01-17 08:00,0,0,0,0,0,0
2021-01-17 08:15,8,2,6,0,0,0
2021-01-17 08:30,8,4,4,0,0,0
2021-01-17 08:45,11,6,5,0,0,0
2021-01-17 09:00,21,12,9,0,0,0
2021-01-17 09:15,12,4,8,0,0,0
2021-01-17 09:30,19,15,4,0,0,0
2021-01-17 09:45,24,11,13,0,0,0
2021-01-17 10:00,17,11,6,0,0,0
2021-01-17 10:15,23,15,8,0,0,0
2021-01-17 10:30,22,10,12,0,0,0
2021-01-17 10:45,36,25,11,0,0,0
2021-01-17 11:00,32,18,14,0,0,0
2021-01-17 11:15,29,16,13,0,0,0
2021-01-17 11:30,14,9,5,0,0,0
2021-01-17 11:45,32,20,12,0,0,0
2021-01-17 12:00,32,21,11,0,0,0
2021-01-17 12:15,49,17,32,0,0,0
2021-01-17 12:30,45,27,18,0,0,0
2021-01-17 12:45,45,20,25,0,0,0
2021-01-17 13:00,44,22,22,0,0,0
2021-01-17 13:15,46,26,20,0,0,0
2021-01-17 13:30,39,22,17,0,0,0
2021-01-17 13:45,67,35,32,0,0,0
2021-01-17 14:00,52,32,20,0,0,0
2021-01-17 14:15,53,29,24,0,0,0
2021-01-17 14:30,51,21,30,0,0,0
2021-01-17 14:45,66,34,32,0,0,0
2021-01-17 15:00,51,24,27,0,0,0
2021-01-17 15:15,62,24,38,0,0,0
2021-01-17 15:30,53,26,27,0,0,0
2021-01-17 15:45,44,21,23,0,0,0
2021-01-17 16:00,53,22,31,0,0,0
2021-01-17 16:15,36,21,15,0,0,0
2021-01-17 16:30,45,18,27,0,0,0
2021-01-17 16:45,49,24,25,0,0,0
2021-01-17 17:00,52,21,31,0,0,0
2021-01-17 17:15,47,25,22,0,0,0
2021-01-17 17:30,45,19,26,0,0,0
2021-01-17 17:45,53,24,29,0,0,0
2021-01-17 18:00,27,16,11,0,0,0
2021-01-17 18:15,29,10,19,0,0,0
2021-01-17 18:30,32,17,15,0,0,0
2021-01-17 18:45,41,22,19,0,0,0
2021-01-17 19:00,31,11,20,0,0,0
2021-01-17 19:15,21,4,17,0,0,0
2021-01-17 19:30,21,8,13,0,0,0
2021-01-17 19:45,33,15,18,0,0,0
2021-01-17 20:00,54,25,29,0,0,0
2021-01-17 20:15,33,9,24,0,0,0
2021-01-17 20:30,28,13,15,0,0,0
2021-01-17 20:45,28,7,21,0,0,0
2021-01-17 21:00,19,12,7,0,0,0
2021-01-17 21:15,22,9,13,0,0,0
2021-01-17 21:30,17,7,10,0,0,0
2021-01-17 21:45,13,3,10,0,0,0
2021-01-17 22:00,16,4,12,0,0,0
2021-01-17 22:15,15,5,10,0,0,0
2021-01-17 22:30,23,6,17,0,0,0
2021-01-17 22:45,10,5,5,0,0,0
2021-01-17 23:00,11,6,5,0,0,0
2021-01-17 23:15,16,8,8,0,0,0
2021-01-17 23:30,13,10,3,0,0,0
2021-01-17 23:45,6,5,1,0,0,0
2021-01-18 00:00,11,5,6,0,0,0
2021-01-18 00:15,7,4,3,0,0,0
2021-01-18 00:30,5,3,2,0,0,0
2021-01-18 00:45,10,5,5,0,0,0
2021-01-18 01:00,5,2,3,0,0,0
2021-01-18 01:15,4,2,2,0,0,0
2021-01-18 01:30,3,2,1,0,0,0
2021-01-18 01:45,0,0,0,0,0,0
2021-01-18 02:00,0,0,0,0,0,0
2021-01-18 02:15,0,0,0,0,0,0
2021-01-18 02:30,1,0,1,0,0,0
2021-01-18 02:45,2,1,1,0,0,0
2021-01-18 03:00,1,1,0,0,0,0
2021-01-18 03:15,0,0,0,0,0,0
2021-01-18 03:30,0,0,0,0,0,0
2021-01-18 03:45,2,1,1,0,0,0
2021-01-18 04:00,3,2,1,0,0,0
2021-01-18 04:15,2,0,2,0,0,0
2021-01-18 04:30,0,0,0,0,0,0
2021-01-18 04:45,7,4,3,0,0,0
2021-01-18 05:00,4,4,0,0,0,0
2021-01-18 05:15,7,3,4,0,0,0
2021-01-18 05:30,13,6,7,0,0,0
2021-01-18 05:45,19,10,9,0,0,0
2021-01-18 06:00,18,8,10,0,0,0
2021-01-18 06:15,23,12,11,0,0,0
2021-01-18 06:30,34,22,12,0,0,0
2021-01-18 06:45,55,32,23,0,0,0
2021-01-18 07:00,56,36,20,0,0,0
2021-01-18 07:15,81,59,22,0,0,0
2021-01-18 07:30,121,76,45,0,0,0
2021-01-18 07:45,119,75,44,0,0,0
2021-01-18 08:00,86,48,38,0,0,0
2021-01-18 08:15,110,58,52,0,0,0
2021-01-18 08:30,95,56,39,0,0,0
2021-01-18 08:45,107,60,47,0,0,0
2021-01-18 09:00,68,41,27,0,0,0
2021-01-18 09:15,76,44,32,0,0,0
2021-01-18 09:30,69,41,28,0,0,0
2021-01-18 09:45,85,48,37,0,0,0
2021-01-18 10:00,73,35,38,0,0,0
2021-01-18 10:15,62,33,29,0,0,0
2021-01-18 10:30,64,33,31,0,0,0
2021-01-18 10:45,77,35,42,0,0,0
2021-01-18 11:00,72,40,32,0,0,0
2021-01-18 11:15,60,29,31,0,0,0
2021-01-18 11:30,77,34,43,0,0,0
2021-01-18 11:45,74,45,29,0,0,0
2021-01-18 12:00,87,45,42,0,0,0
2021-01-18 12:15,74,43,31,0,0,0
2021-01-18 12:30,87,40,47,0,0,0
2021-01-18 12:45,86,48,38,0,0,0
2021-01-18 13:00,83,38,45,0,0,0
2021-01-18 13:15,69,25,44,0,0,0
2021-01-18 13:30,68,27,41,0,0,0
2021-01-18 13:45,97,52,45,0,0,0
2021-01-18 14:00,75,36,39,0,0,0
2021-01-18 14:15,83,44,39,0,0,0
2021-01-18 14:30,106,59,47,0,0,0
2021-01-18 14:45,103,55,48,0,0,0
2021-01-18 15:00,91,51,40,0,0,0
2021-01-18 15:15,90,42,48,0,0,0
2021-01-18 15:30,118,59,59,0,0,0
2021-01-18 15:45,113,61,52,0,0,0
2021-01-18 16:00,126,58,68,0,0,0
2021-01-18 16:15,135,52,83,0,0,0
2021-01-18 16:30,135,66,69,0,0,0
2021-01-18 16:45,142,74,68,0,0,0
2021-01-18 17:00,141,61,80,0,0,0
2021-01-18 17:15,109,52,57,0,0,0
2021-01-18 17:30,118,46,72,0,0,0
2021-01-18 17:45,97,39,58,0,0,0
2021-01-18 18:00,112,51,61,0,0,0
2021-01-18 18:15,105,32,73,0,0,0
2021-01-18 18:30,101,39,62,0,0,0
2021-01-18 18:45,75,44,31,0,0,0
2021-01-18 19:00,74,31,43,0,0,0
2021-01-18 19:15,61,28,33,0,0,0
2021-01-18 19:30,47,22,25,0,0,0
2021-01-18 19:45,57,20,37,0,0,0
2021-01-18 20:00,51,24,27,0,0,0
2021-01-18 20:15,36,16,20,0,0,0
2021-01-18 20:30,42,14,28,0,0,0
2021-01-18 20:45,35,15,20,0,0,0
2021-01-18 21:00,20,10,10,0,0,0
2021-01-18 21:15,30,19,11,0,0,0
2021-01-18 21:30,21,8,13,0,0,0
2021-01-18 21:45,22,10,12,0,0,0
2021-01-18 22:00,14,6,8,0,0,0
2021-01-18 22:15,18,9,9,0,0,0
2021-01-18 22:30,14,6,8,0,0,0
2021-01-18 22:45,22,5,17,0,0,0
2021-01-18 23:00,10,3,7,0,0,0
2021-01-18 23:15,10,8,2,0,0,0
2021-01-18 23:30,15,4,11,0,0,0
2021-01-18 23:45,12,3,9,0,0,0
2021-01-19 00:00,8,2,6,0,0,0
2021-01-19 00:15,12,4,8,0,0,0
2021-01-19 00:30,5,3,2,0,0,0
2021-01-19 00:45,3,0,3,0,0,0
2021-01-19 01:00,2,1,1,0,0,0
2021-01-19 01:15,4,2,2,0,0,0
2021-01-19 01:30,4,1,3,0,0,0
2021-01-19 01:45,1,0,1,0,0,0
2021-01-19 02:00,7,1,6,0,0,0
2021-01-19 02:15,2,2,0,0,0,0
2021-01-19 02:30,2,0,2,0,0,0
2021-01-19 02:45,2,0,2,0,0,0
2021-01-19 03:00,0,0,0,0,0,0
2021-01-19 03:15,0,0,0,0,0,0
2021-01-19 03:30,1,0,1,0,0,0
2021-01-19 03:45,1,0,1,0,0,0
2021-01-19 04:00,1,0,1,0,0,0
2021-01-19 04:15,4,1,3,0,0,0
2021-01-19 04:30,1,1,0,0,0,0
2021-01-19 04:45,6,4,2,0,0,0
2021-01-19 05:00,2,2,0,0,0,0
2021-01-19 05:15,7,5,2,0,0,0
2021-01-19 05:30,13,6,7,0,0,0
2021-01-19 05:45,16,8,8,0,0,0
2021-01-19 06:00,18,11,7,0,0,0
2021-01-19 06:15,35,17,18,0,0,0
2021-01-19 06:30,42,29,13,0,0,0
2021-01-19 06:45,47,35,12,0,0,0
2021-01-19 07:00,52,30,22,0,0,0
2021-01-19 07:15,72,51,21,0,0,0
2021-01-19 07:30,91,57,34,0,0,0
2021-01-19 07:45,125,69,56,0,0,0
2021-01-19 08:00,71,42,29,0,0,0
2021-01-19 08:15,79,42,37,0,0,0
2021-01-19 08:30,65,38,27,0,0,0
2021-01-19 08:45,87,56,31,0,0,0
2021-01-19 09:00,48,26,22,0,0,0
2021-01-19 09:15,54,30,24,0,0,0
2021-01-19 09:30,36,24,12,0,0,0
2021-01-19 09:45,34,34,0,0,0,0
2021-01-19 10:00,33,18,15,0,0,0
2021-01-19 10:15,26,9,17,0,0,0
2021-01-19 10:30,39,23,16,0,0,0
2021-01-19 10:45,39,17,22,0,0,0
2021-01-19 11:00,38,16,22,0,0,0
2021-01-19 11:15,37,22,15,0,0,0
2021-01-19 11:30,55,26,29,0,0,0
2021-01-19 11:45,53,28,25,0,0,0
2021-01-19 12:00,45,24,21,0,0,0
2021-01-19 12:15,57,32,25,0,0,0
2021-01-19 12:30,45,27,18,0,0,0
2021-01-19 12:45,63,36,27,0,0,0
2021-01-19 13:00,53,25,28,0,0,0
2021-01-19 13:15,46,21,25,0,0,0
2021-01-19 13:30,44,22,22,0,0,0
2021-01-19 13:45,69,39,30,0,0,0
2021-01-19 14:00,52,21,31,0,0,0
2021-01-19 14:15,71,39,32,0,0,0
2021-01-19 14:30,66,32,34,0,0,0
2021-01-19 14:45,71,38,33,0,0,0
2021-01-19 15:00,71,39,32,0,0,0
2021-01-19 15:15,57,27,30,0,0,0
2021-01-19 15:30,66,28,38,0,0,0
2021-01-19 15:45,73,37,36,0,0,0
2021-01-19 16:00,103,46,57,0,0,0
2021-01-19 16:15,85,39,46,0,0,0
2021-01-19 16:30,93,47,46,0,0,0
2021-01-19 16:45,104,52,52,0,0,0
2021-01-19 17:00,76,27,49,0,0,0
2021-01-19 17:15,107,42,65,0,0,0
2021-01-19 17:30,83,31,52,0,0,0
2021-01-19 17:45,85,40,45,0,0,0
2021-01-19 18:00,80,39,41,0,0,0
2021-01-19 18:15,81,28,53,0,0,0
2021-01-19 18:30,83,31,52,0,0,0
2021-01-19 18:45,86,46,40,0,0,0
2021-01-19 19:00,57,32,25,0,0,0
2021-01-19 19:15,54,23,31,0,0,0
2021-01-19 19:30,44,19,25,0,0,0
2021-01-19 19:45,64,38,26,0,0,0
2021-01-19 20:00,44,16,28,0,0,0
2021-01-19 20:15,44,13,31,0,0,0
2021-01-19 20:30,49,17,32,0,0,0
2021-01-19 20:45,32,12,20,0,0,0
2021-01-19 21:00,29,12,17,0,0,0
2021-01-19 21:15,23,13,10,0,0,0
2021-01-19 21:30,15,5,10,0,0,0
2021-01-19 21:45,14,9,5,0,0,0
2021-01-19 22:00,16,6,10,0,0,0
2021-01-19 22:15,16,10,6,0,0,0
2021-01-19 22:30,31,16,15,0,0,0
2021-01-19 22:45,16,7,9,0,0,0
2021-01-19 23:00,22,8,14,0,0,0
2021-01-19 23:15,18,7,11,0,0,0
2021-01-19 23:30,15,7,8,0,0,0
2021-01-19 23:45,9,4,5,0,0,0
2021-01-20 00:00,11,3,8,0,0,0
2021-01-20 00:15,10,5,5,0,0,0
2021-01-20 00:30,11,6,5,0,0,0
2021-01-20 00:45,4,2,2,0,0,0
2021-01-20 01:00,6,2,4,0,0,0
2021-01-20 01:15,9,5,4,0,0,0
2021-01-20 01:30,1,0,1,0,0,0
2021-01-20 01:45,1,1,0,0,0,0
2021-01-20 02:00,6,3,3,0,0,0
2021-01-20 02:15,3,1,2,0,0,0
2021-01-20 02:30,1,1,0,0,0,0
2021-01-20 02:45,1,0,1,0,0,0
2021-01-20 03:00,2,1,1,0,0,0
2021-01-20 03:15,2,0,2,0,0,0
2021-01-20 03:30,1,0,1,0,0,0
2021-01-20 03:45,1,1,0,0,0,0
2021-01-20 04:00,0,0,0,0,0,0
2021-01-20 04:15,2,0,2,0,0,0
2021-01-20 04:30,0,0,0,0,0,0
2021-01-20 04:45,6,3,3,0,0,0
2021-01-20 05:00,6,5,1,0,0,0
2021-01-20 05:15,8,6,2,0,0,0
2021-01-20 05:30,15,8,7,0,0,0
2021-01-20 05:45,13,8,5,0,0,0
2021-01-20 06:00,24,14,10,0,0,0
2021-01-20 06:15,32,20,12,0,0,0
2021-01-20 06:30,49,27,22,0,0,0
2021-01-20 06:45,54,41,13,0,0,0
2021-01-20 07:00,58,39,19,0,0,0
2021-01-20 07:15,87,59,28,0,0,0
2021-01-20 07:30,105,64,41,0,0,0
2021-01-20 07:45,140,81,59,0,0,0
2021-01-20 08:00,105,50,55,0,0,0
2021-01-20 08:15,110,69,41,0,0,0
2021-01-20 08:30,97,58,39,0,0,0
2021-01-20 08:45,141,80,61,0,0,0
2021-01-20 09:00,95,49,46,0,0,0
2021-01-20 09:15,101,56,45,0,0,0
2021-01-20 09:30,82,42,40,0,0,0
2021-01-20 09:45,107,67,40,0,0,0
2021-01-20 10:00,71,45,26,0,0,0
2021-01-20 10:15,69,37,32,0,0,0
2021-01-20 10:30,74,44,30,0,0,0
2021-01-20 10:45,83,43,40,0,0,0
2021-01-20 11:00,86,50,36,0,0,0
2021-01-20 11:15,85,45,40,0,0,0
2021-01-20 11:30,96,49,47,0,0,0
2021-01-20 11:45,114,53,61,0,0,0
2021-01-20 12:00,101,47,54,0,0,0
2021-01-20 12:15,97,57,40,0,0,0
2021-01-20 12:30,110,65,45,0,0,0
2021-01-20 12:45,165,92,73,0,0,0
2021-01-20 13:00,139,79,60,0,0,0
2021-01-20 13:15,111,62,49,0,0,0
2021-01-20 13:30,125,53,72,0,0,0
2021-01-20 13:45,129,66,63,0,0,0
2021-01-20 14:00,131,52,79,0,0,0
2021-01-20 14:15,124,56,68,0,0,0
2021-01-20 14:30,143,68,75,0,0,0
2021-01-20 14:45,133,79,54,0,0,0
2021-01-20 15:00,114,46,68,0,0,0
2021-01-20 15:15,130,72,58,0,0,0
2021-01-20 15:30,124,69,55,0,0,0
2021-01-20 15:45,156,79,77,0,0,0
2021-01-20 16:00,146,65,81,0,0,0
2021-01-20 16:15,158,77,81,0,0,0
2021-01-20 16:30,139,72,67,0,0,0
2021-01-20 16:45,164,58,106,0,0,0
2021-01-20 17:00,153,67,86,0,0,0
2021-01-20 17:15,142,53,89,0,0,0
2021-01-20 17:30,116,48,68,0,0,0
2021-01-20 17:45,145,60,85,0,0,0
2021-01-20 18:00,139,57,82,0,0,0
2021-01-20 18:15,113,55,58,0,0,0
2021-01-20 18:30,96,35,61,0,0,0
2021-01-20 18:45,83,43,40,0,0,0
2021-01-20 19:00,77,40,37,0,0,0
2021-01-20 19:15,77,32,45,0,0,0
2021-01-20 19:30,77,33,44,0,0,0
2021-01-20 19:45,66,27,39,0,0,0
2021-01-20 20:00,66,24,42,0,0,0
2021-01-20 20:15,66,35,31,0,0,0
2021-01-20 20:30,43,18,25,0,0,0
2021-01-20 20:45,33,15,18,0,0,0
2021-01-20 21:00,24,14,10,0,0,0
2021-01-20 21:15,35,13,22,0,0,0
2021-01-20 21:30,25,14,11,0,0,0
2021-01-20 21:45,18,12,6,0,0,0
2021-01-20 22:00,23,11,12,0,0,0
2021-01-20 22:15,35,12,23,0,0,0
2021-01-20 22:30,38,15,23,0,0,0
2021-01-20 22:45,28,10,18,0,0,0
2021-01-20 23:00,30,15,15,0,0,0
2021-01-20 23:15,19,10,9,0,0,0
2021-01-20 23:30,24,10,14,0,0,0
2021-01-20 23:45,15,5,10,0,0,0
2021-01-21 00:00,14,6,8,0,0,0
2021-01-21 00:15,9,5,4,0,0,0
2021-01-21 00:30,7,6,1,0,0,0
2021-01-21 00:45,1,0,1,0,0,0
2021-01-21 01:00,5,3,2,0,0,0
2021-01-21 01:15,9,5,4,0,0,0
2021-01-21 01:30,11,5,6,0,0,0
2021-01-21 01:45,5,2,3,0,0,0
2021-01-21 02:00,1,0,1,0,0,0
2021-01-21 02:15,2,1,1,0,0,0
2021-01-21 02:30,5,2,3,0,0,0
2021-01-21 02:45,3,1,2,0,0,0
2021-01-21 03:00,1,0,1,0,0,0
2021-01-21 03:15,1,0,1,0,0,0
2021-01-21 03:30,1,0,1,0,0,0
2021-01-21 03:45,0,0,0,0,0,0
2021-01-21 04:00,1,1,0,0,0,0
2021-01-21 04:15,2,0,2,0,0,0
2021-01-21 04:30,1,1,0,0,0,0
2021-01-21 04:45,5,2,3,0,0,0
2021-01-21 05:00,3,2,1,0,0,0
2021-01-21 05:15,8,4,4,0,0,0
2021-01-21 05:30,13,9,4,0,0,0
2021-01-21 05:45,15,10,5,0,0,0
2021-01-21 06:00,13,7,6,0,0,0
2021-01-21 06:15,24,14,10,0,0,0
2021-01-21 06:30,23,18,5,0,0,0
2021-01-21 06:45,54,35,19,0,0,0
2021-01-21 07:00,39,29,10,0,0,0
2021-01-21 07:15,61,41,20,0,0,0
2021-01-21 07:30,77,46,31,0,0,0
2021-01-21 07:45,89,56,33,0,0,0
2021-01-21 08:00,75,39,36,0,0,0
2021-01-21 08:15,98,61,37,0,0,0
2021-01-21 08:30,75,47,28,0,0,0
2021-01-21 08:45,89,52,37,0,0,0
2021-01-21 09:00,74,37,37,0,0,0
2021-01-21 09:15,64,36,28,0,0,0
2021-01-21 09:30,57,34,23,0,0,0
2021-01-21 09:45,75,33,42,0,0,0
2021-01-21 10:00,52,27,25,0,0,0
2021-01-21 10:15,64,34,30,0,0,0
2021-01-21 10:30,57,29,28,0,0,0
2021-01-21 10:45,72,40,32,0,0,0
2021-01-21 11:00,74,31,43,0,0,0
2021-01-21 11:15,63,34,29,0,0,0
2021-01-21 11:30,87,45,42,0,0,0
2021-01-21 11:45,89,54,35,0,0,0
2021-01-21 12:00,85,44,41,0,0,0
2021-01-21 12:15,87,43,44,0,0,0
2021-01-21 12:30,100,54,46,0,0,0
2021-01-21 12:45,98,53,45,0,0,0
2021-01-21 13:00,85,45,40,0,0,0
2021-01-21 13:15,94,56,38,0,0,0
2021-01-21 13:30,88,49,39,0,0,0
2021-01-21 13:45,104,56,48,0,0,0
2021-01-21 14:00,81,42,39,0,0,0
2021-01-21 14:15,105,57,48,0,0,0
2021-01-21 14:30,107,55,52,0,0,0
2021-01-21 14:45,117,69,48,0,0,0
2021-01-21 15:00,84,43,41,0,0,0
2021-01-21 15:15,102,53,49,0,0,0
2021-01-21 15:30,108,50,58,0,0,0
2021-01-21 15:45,111,56,55,0,0,0
2021-01-21 16:00,150,74,76,0,0,0
2021-01-21 16:15,127,58,69,0,0,0
2021-01-21 16:30,126,51,75,0,0,0
2021-01-21 16:45,132,61,71,0,0,0
2021-01-21 17:00,110,53,57,0,0,0
2021-01-21 17:15,104,45,59,0,0,0
2021-01-21 17:30,124,64,60,0,0,0
2021-01-21 17:45,109,58,51,0,0,0
2021-01-21 18:00,121,44,77,0,0,0
2021-01-21 18:15,90,36,54,0,0,0
2021-01-21 18:30,73,31,42,0,0,0
2021-01-21 18:45,97,43,54,0,0,0
2021-01-21 19:00,88,38,50,0,0,0
2021-01-21 19:15,93,27,66,0,0,0
2021-01-21 19:30,77,38,39,0,0,0
2021-01-21 19:45,73,31,42,0,0,0
2021-01-21 20:00,60,21,39,0,0,0
2021-01-21 20:15,43,21,22,0,0,0
2021-01-21 20:30,27,12,15,0,0,0
2021-01-21 20:45,35,14,21,0,0,0
2021-01-21 21:00,21,8,13,0,0,0
2021-01-21 21:15,32,14,18,0,0,0
2021-01-21 21:30,18,5,13,0,0,0
2021-01-21 21:45,23,13,10,0,0,0
2021-01-21 22:00,22,10,12,0,0,0
2021-01-21 22:15,16,6,10,0,0,0
2021-01-21 22:30,13,2,11,0,0,0
2021-01-21 22:45,12,6,6,0,0,0
2021-01-21 23:00,24,9,15,0,0,0
2021-01-21 23:15,18,8,10,0,0,0
2021-01-21 23:30,14,7,7,0,0,0
2021-01-21 23:45,18,11,7,0,0,0
2021-01-22 00:00,9,6,3,0,0,0
2021-01-22 00:15,13,7,6,0,0,0
2021-01-22 00:30,3,1,2,0,0,0
2021-01-22 00:45,7,1,6,0,0,0
2021-01-22 01:00,4,2,2,0,0,0
2021-01-22 01:15,5,1,4,0,0,0
2021-01-22 01:30,4,1,3,0,0,0
2021-01-22 01:45,1,0,1,0,0,0
2021-01-22 02:00,7,2,5,0,0,0
2021-01-22 02:15,4,1,3,0,0,0
2021-01-22 02:30,2,2,0,0,0,0
2021-01-22 02:45,2,1,1,0,0,0
2021-01-22 03:00,0,0,0,0,0,0
2021-01-22 03:15,2,0,2,0,0,0
2021-01-22 03:30,0,0,0,0,0,0
2021-01-22 03:45,1,1,0,0,0,0
2021-01-22 04:00,1,1,0,0,0,0
2021-01-22 04:15,0,0,0,0,0,0
2021-01-22 04:30,2,1,1,0,0,0
2021-01-22 04:45,6,2,4,0,0,0
2021-01-22 05:00,5,4,1,0,0,0
2021-01-22 05:15,8,4,4,0,0,0
2021-01-22 05:30,9,6,3,0,0,0
2021-01-22 05:45,16,7,9,0,0,0
2021-01-22 06:00,13,9,4,0,0,0
2021-01-22 06:15,31,23,8,0,0,0
2021-01-22 06:30,37,20,17,0,0,0
2021-01-22 06:45,47,35,12,0,0,0
2021-01-22 07:00,61,43,18,0,0,0
2021-01-22 07:15,75,58,17,0,0,0
2021-01-22 07:30,77,47,30,0,0,0
2021-01-22 07:45,124,74,50,0,0,0
2021-01-22 08:00,88,43,45,0,0,0
2021-01-22 08:15,102,61,41,0,0,0
2021-01-22 08:30,94,43,51,0,0,0
2021-01-22 08:45,118,71,47,0,0,0
2021-01-22 09:00,76,38,38,0,0,0
2021-01-22 09:15,63,33,30,0,0,0
2021-01-22 09:30,79,46,33,0,0,0
2021-01-22 09:45,88,45,43,0,0,0
2021-01-22 10:00,70,32,38,0,0,0
2021-01-22 10:15,71,41,30,0,0,0
2021-01-22 10:30,75,43,32,0,0,0
2021-01-22 10:45,88,39,49,0,0,0
2021-01-22 11:00,60,35,25,0,0,0
2021-01-22 11:15,74,43,31,0,0,0
2021-01-22 11:30,86,52,34,0,0,0
2021-01-22 11:45,86,46,40,0,0,0
2021-01-22 12:00,99,49,50,0,0,0
2021-01-22 12:15,102,48,54,0,0,0
2021-01-22 12:30,102,53,49,0,0,0
2021-01-22 12:45,105,56,49,0,0,0
2021-01-22 13:00,121,62,59,0,0,0
2021-01-22 13:15,110,42,68,0,0,0
2021-01-22 13:30,109,63,46,0,0,0
2021-01-22 13:45,112,58,54,0,0,0
2021-01-22 14:00,121,64,57,0,0,0
2021-01-22 14:15,142,74,68,0,0,0
2021-01-22 14:30,112,53,59,0,0,0
2021-01-22 14:45,154,79,75,0,0,0
2021-01-22 15:00,116,48,68,0,0,0
2021-01-22 15:15,136,66,70,0,0,0
2021-01-22 15:30,115,60,55,0,0,0
2021-01-22 15:45,127,76,51,0,0,0
2021-01-22 16:00,123,59,64,0,0,0
2021-01-22 16:15,112,63,49,0,0,0
2021-01-22 16:30,106,40,66,0,0,0
2021-01-22 16:45,126,46,80,0,0,0
2021-01-22 17:00,129,61,68,0,0,0
2021-01-22 17:15,114,51,63,0,0,0
2021-01-22 17:30,105,41,64,0,0,0
2021-01-22 17:45,100,47,53,0,0,0
2021-01-22 18:00,86,36,50,0,0,0
2021-01-22 18:15,115,57,58,0,0,0
2021-01-22 18:30,82,39,43,0,0,0
2021-01-22 18:45,74,31,43,0,0,0
2021-01-22 19:00,75,34,41,0,0,0
2021-01-22 19:15,98,48,50,0,0,0
2021-01-22 19:30,47,23,24,0,0,0
2021-01-22 19:45,77,41,36,0,0,0
2021-01-22 20:00,53,23,30,0,0,0
2021-01-22 20:15,55,21,34,0,0,0
2021-01-22 20:30,41,12,29,0,0,0
2021-01-22 20:45,39,24,15,0,0,0
2021-01-22 21:00,37,17,20,0,0,0
2021-01-22 21:15,28,12,16,0,0,0
2021-01-22 21:30,16,10,6,0,0,0
2021-01-22 21:45,16,9,7,0,0,0
2021-01-22 22:00,14,4,10,0,0,0
2021-01-22 22:15,28,7,21,0,0,0
2021-01-22 22:30,22,8,14,0,0,0
2021-01-22 22:45,23,10,13,0,0,0
2021-01-22 23:00,25,9,16,0,0,0
2021-01-22 23:15,16,6,10,0,0,0
2021-01-22 23:30,20,12,8,0,0,0
2021-01-22 23:45,26,7,19,0,0,0
2021-01-23 00:00,20,8,12,0,0,0
2021-01-23 00:15,15,6,9,0,0,0
2021-01-23 00:30,12,9,3,0,0,0
2021-01-23 00:45,22,8,14,0,0,0
2021-01-23 01:00,18,7,11,0,0,0
2021-01-23 01:15,14,7,7,0,0,0
2021-01-23 01:30,9,3,6,0,0,0
2021-01-23 01:45,18,8,10,0,0,0
2021-01-23 02:00,12,7,5,0,0,0
2021-01-23 02:15,12,3,9,0,0,0
2021-01-23 02:30,7,2,5,0,0,0
2021-01-23 02:45,5,2,3,0,0,0
2021-01-23 03:00,8,2,6,0,0,0
2021-01-23 03:15,5,1,4,0,0,0
2021-01-23 03:30,5,3,2,0,0,0
2021-01-23 03:45,1,1,0,0,0,0
2021-01-23 04:00,6,4,2,0,0,0
2021-01-23 04:15,3,1,2,0,0,0
2021-01-23 04:30,2,1,1,0,0,0
2021-01-23 04:45,2,1,1,0,0,0
2021-01-23 05:00,4,4,0,0,0,0
2021-01-23 05:15,4,3,1,0,0,0
2021-01-23 05:30,10,6,4,0,0,0
2021-01-23 05:45,5,4,1,0,0,0
2021-01-23 06:00,13,6,7,0,0,0
2021-01-23 06:15,5,3,2,0,0,0
2021-01-23 06:30,17,10,7,0,0,0
2021-01-23 06:45,6,5,1,0,0,0
2021-01-23 07:00,5,2,3,0,0,0
2021-01-23 07:15,8,7,1,0,0,0
2021-01-23 07:30,7,3,4,0,0,0
2021-01-23 07:45,21,13,8,0,0,0
2021-01-23 08:00,19,7,12,0,0,0
2021-01-23 08:15,17,11,6,0,0,0
2021-01-23 08:30,28,20,8,0,0,0
2021-01-23 08:45,26,19,7,0,0,0
2021-01-23 09:00,34,16,18,0,0,0
2021-01-23 09:15,40,20,20,0,0,0
2021-01-23 09:30,43,31,12,0,0,0
2021-01-23 09:45,60,38,22,0,0,0
2021-01-23 10:00,59,35,24,0,0,0
2021-01-23 10:15,65,34,31,0,0,0
2021-01-23 10:30,61,40,21,0,0,0
2021-01-23 10:45,85,58,27,0,0,0
2021-01-23 11:00,67,38,29,0,0,0
2021-01-23 11:15,95,55,40,0,0,0
2021-01-23 11:30,75,38,37,0,0,0
2021-01-23 11:45,123,60,63,0,0,0
2021-01-23 12:00,87,48,39,0,0,0
2021-01-23 12:15,90,51,39,0,0,0
2021-01-23 12:30,95,33,62,0,0,0
2021-01-23 12:45,118,66,52,0,0,0
2021-01-23 13:00,129,62,67,0,0,0
2021-01-23 13:15,90,46,44,0,0,0
2021-01-23 13:30,118,59,59,0,0,0
2021-01-23 13:45,125,76,49,0,0,0
2021-01-23 14:00,133,58,75,0,0,0
2021-01-23 14:15,126,59,67,0,0,0
2021-01-23 14:30,99,45,54,0,0,0
2021-01-23 14:45,136,78,58,0,0,0
2021-01-23 15:00,103,43,60,0,0,0
2021-01-23 15:15,128,63,65,0,0,0
2021-01-23 15:30,108,45,63,0,0,0
2021-01-23 15:45,126,61,65,0,0,0
2021-01-23 16:00,71,27,44,0,0,0
2021-01-23 16:15,84,29,55,0,0,0
2021-01-23 16:30,79,38,41,0,0,0
2021-01-23 16:45,89,39,50,0,0,0
2021-01-23 17:00,87,36,51,0,0,0
2021-01-23 17:15,77,41,36,0,0,0
2021-01-23 17:30,90,38,52,0,0,0
2021-01-23 17:45,95,38,57,0,0,0
2021-01-23 18:00,68,33,35,0,0,0
2021-01-23 18:15,72,27,45,0,0,0
2021-01-23 18:30,55,31,24,0,0,0
2021-01-23 18:45,48,27,21,0,0,0
2021-01-23 19:00,72,25,47,0,0,0
2021-01-23 19:15,62,32,30,0,0,0
2021-01-23 19:30,42,17,25,0,0,0
2021-01-23 19:45,42,23,19,0,0,0
2021-01-23 20:00,63,32,31,0,0,0
2021-01-23 20:15,43,17,26,0,0,0
2021-01-23 20:30,47,16,31,0,0,0
2021-01-23 20:45,22,10,12,0,0,0
2021-01-23 21:00,46,23,23,0,0,0
2021-01-23 21:15,30,12,18,0,0,0
2021-01-23 21:30,24,9,15,0,0,0
2021-01-23 21:45,14,6,8,0,0,0
2021-01-23 22:00,22,11,11,0,0,0
2021-01-23 22:15,16,5,11,0,0,0
2021-01-23 22:30,15,5,10,0,0,0
2021-01-23 22:45,16,7,9,0,0,0
2021-01-23 23:00,30,8,22,0,0,0
2021-01-23 23:15,20,9,11,0,0,0
2021-01-23 23:30,19,5,14,0,0,0
2021-01-23 23:45,26,10,16,0,0,0
2021-01-24 00:00,21,10,11,0,0,0
2021-01-24 00:15,16,7,9,0,0,0
2021-01-24 00:30,15,9,6,0,0,0
2021-01-24 00:45,23,9,14,0,0,0
2021-01-24 01:00,14,7,7,0,0,0
2021-01-24 01:15,11,8,3,0,0,0
2021-01-24 01:30,15,8,7,0,0,0
2021-01-24 01:45,12,7,5,0,0,0
2021-01-24 02:00,11,4,7,0,0,0
2021-01-24 02:15,11,6,5,0,0,0
2021-01-24 02:30,7,3,4,0,0,0
2021-01-24 02:45,7,3,4,0,0,0
2021-01-24 03:00,14,3,11,0,0,0
2021-01-24 03:15,8,3,5,0,0,0
2021-01-24 03:30,16,6,10,0,0,0
2021-01-24 03:45,7,2,5,0,0,0
2021-01-24 04:00,8,0,8,0,0,0
2021-01-24 04:15,2,1,1,0,0,0
2021-01-24 04:30,2,2,0,0,0,0
2021-01-24 04:45,4,2,2,0,0,0
2021-01-24 05:00,1,1,0,0,0,0
2021-01-24 05:15,5,2,3,0,0,0
2021-01-24 05:30,3,1,2,0,0,0
2021-01-24 05:45,3,3,0,0,0,0
2021-01-24 06:00,3,2,1,0,0,0
2021-01-24 06:15,2,1,1,0,0,0
2021-01-24 06:30,8,2,6,0,0,0
2021-01-24 06:45,2,1,1,0,0,0
2021-01-24 07:00,5,0,5,0,0,0
2021-01-24 07:15,3,3,0,0,0,0
2021-01-24 07:30,4,2,2,0,0,0
2021-01-24 07:45,3,1,2,0,0,0
2021-01-24 08:00,6,5,1,0,0,0
2021-01-24 08:15,10,2,8,0,0,0
2021-01-24 08:30,9,5,4,0,0,0
2021-01-24 08:45,11,9,2,0,0,0
2021-01-24 09:00,16,7,9,0,0,0
2021-01-24 09:15,8,6,2,0,0,0
2021-01-24 09:30,28,16,12,0,0,0
2021-01-24 09:45,23,16,7,0,0,0
2021-01-24 10:00,29,18,11,0,0,0
2021-01-24 10:15,12,8,4,0,0,0
2021-01-24 10:30,18,11,7,0,0,0
2021-01-24 10:45,36,22,14,0,0,0
2021-01-24 11:00,22,7,15,0,0,0
2021-01-24 11:15,33,16,17,0,0,0
2021-01-24 11:30,38,26,12,0,0,0
2021-01-24 11:45,42,23,19,0,0,0
2021-01-24 12:00,30,16,14,0,0,0
2021-01-24 12:15,49,24,25,0,0,0
2021-01-24 12:30,50,22,28,0,0,0
2021-01-24 12:45,67,32,35,0,0,0
2021-01-24 13:00,52,31,21,0,0,0
2021-01-24 13:15,46,13,33,0,0,0
2021-01-24 13:30,48,24,24,0,0,0
2021-01-24 13:45,76,47,29,0,0,0
2021-01-24 14:00,80,36,44,0,0,0
2021-01-24 14:15,64,23,41,0,0,0
2021-01-24 14:30,60,38,22,0,0,0
2021-01-24 14:45,75,47,28,0,0,0
2021-01-24 15:00,97,60,37,0,0,0
2021-01-24 15:15,86,50,36,0,0,0
2021-01-24 15:30,70,40,30,0,0,0
2021-01-24 15:45,84,42,42,0,0,0
2021-01-24 16:00,88,49,39,0,0,0
2021-01-24 16:15,66,32,34,0,0,0
2021-01-24 16:30,86,36,50,0,0,0
2021-01-24 16:45,82,32,50,0,0,0
2021-01-24 17:00,82,33,49,0,0,0
2021-01-24 17:15,63,22,41,0,0,0
2021-01-24 17:30,67,25,42,0,0,0
2021-01-24 17:45,52,20,32,0,0,0
2021-01-24 18:00,41,16,25,0,0,0
2021-01-24 18:15,41,22,19,0,0,0
2021-01-24 18:30,43,19,24,0,0,0
2021-01-24 18:45,57,31,26,0,0,0
2021-01-24 19:00,55,20,35,0,0,0
2021-01-24 19:15,53,19,34,0,0,0
2021-01-24 19:30,38,16,22,0,0,0
2021-01-24 19:45,34,12,22,0,0,0
2021-01-24 20:00,47,19,28,0,0,0
2021-01-24 20:15,37,15,22,0,0,0
2021-01-24 20:30,32,15,17,0,0,0
2021-01-24 20:45,38,19,19,0,0,0
2021-01-24 21:00,30,15,15,0,0,0
2021-01-24 21:15,27,8,19,0,0,0
2021-01-24 21:30,32,13,19,0,0,0
2021-01-24 21:45,26,13,13,0,0,0
2021-01-24 22:00,16,6,10,0,0,0
2021-01-24 22:15,17,6,11,0,0,0
2021-01-24 22:30,22,7,15,0,0,0
2021-01-24 22:45,13,4,9,0,0,0
2021-01-24 23:00,16,8,8,0,0,0
2021-01-24 23:15,15,4,11,0,0,0
2021-01-24 23:30,15,9,6,0,0,0
2021-01-24 23:45,8,2,6,0,0,0
2021-01-25 00:00,8,3,5,0,0,0
2021-01-25 00:15,12,7,5,0,0,0
2021-01-25 00:30,17,7,10,0,0,0
2021-01-25 00:45,9,4,5,0,0,0
2021-01-25 01:00,2,1,1,0,0,0
2021-01-25 01:15,5,1,4,0,0,0
2021-01-25 01:30,2,2,0,0,0,0
2021-01-25 01:45,1,0,1,0,0,0
2021-01-25 02:00,1,0,1,0,0,0
2021-01-25 02:15,0,0,0,0,0,0
2021-01-25 02:30,1,1,0,0,0,0
2021-01-25 02:45,0,0,0,0,0,0
2021-01-25 03:00,0,0,0,0,0,0
2021-01-25 03:15,1,0,1,0,0,0
2021-01-25 03:30,0,0,0,0,0,0
2021-01-25 03:45,1,0,1,0,0,0
2021-01-25 04:00,1,1,0,0,0,0
2021-01-25 04:15,5,2,3,0,0,0
2021-01-25 04:30,2,1,1,0,0,0
2021-01-25 04:45,5,3,2,0,0,0
2021-01-25 05:00,0,0,0,0,0,0
2021-01-25 05:15,7,5,2,0,0,0
2021-01-25 05:30,15,8,7,0,0,0
2021-01-25 05:45,14,4,10,0,0,0
2021-01-25 06:00,23,16,7,0,0,0
2021-01-25 06:15,27,17,10,0,0,0
2021-01-25 06:30,32,19,13,0,0,0
2021-01-25 06:45,61,46,15,0,0,0
2021-01-25 07:00,59,39,20,0,0,0
2021-01-25 07:15,73,39,34,0,0,0
2021-01-25 07:30,101,55,46,0,0,0
2021-01-25 07:45,120,73,47,0,0,0
2021-01-25 08:00,86,50,36,0,0,0
2021-01-25 08:15,95,51,44,0,0,0
2021-01-25 08:30,107,62,45,0,0,0
2021-01-25 08:45,114,65,49,0,0,0
2021-01-25 09:00,79,45,34,0,0,0
2021-01-25 09:15,75,39,36,0,0,0
2021-01-25 09:30,68,32,36,0,0,0
2021-01-25 09:45,98,42,56,0,0,0
2021-01-25 10:00,59,25,34,0,0,0
2021-01-25 10:15,51,28,23,0,0,0
2021-01-25 10:30,59,16,43,0,0,0
2021-01-25 10:45,87,54,33,0,0,0
2021-01-25 11:00,66,41,25,0,0,0
2021-01-25 11:15,49,27,22,0,0,0
2021-01-25 11:30,81,41,40,0,0,0
2021-01-25 11:45,79,45,34,0,0,0
2021-01-25 12:00,91,48,43,0,0,0
2021-01-25 12:15,82,46,36,0,0,0
2021-01-25 12:30,67,37,30,0,0,0
2021-01-25 12:45,77,37,40,0,0,0
2021-01-25 13:00,85,48,37,0,0,0
2021-01-25 13:15,104,58,46,0,0,0
2021-01-25 13:30,83,37,46,0,0,0
2021-01-25 13:45,106,56,50,0,0,0
2021-01-25 14:00,87,49,38,0,0,0
2021-01-25 14:15,99,52,47,0,0,0
2021-01-25 14:30,123,71,52,0,0,0
2021-01-25 14:45,139,67,72,0,0,0
2021-01-25 15:00,115,65,50,0,0,0
2021-01-25 15:15,120,58,62,0,0,0
2021-01-25 15:30,115,62,53,0,0,0
2021-01-25 15:45,135,73,62,0,0,0
2021-01-25 16:00,143,60,83,0,0,0
2021-01-25 16:15,168,76,92,0,0,0
2021-01-25 16:30,161,73,88,0,0,0
2021-01-25 16:45,134,62,72,0,0,0
2021-01-25 17:00,140,55,85,0,0,0
2021-01-25 17:15,119,52,67,0,0,0
2021-01-25 17:30,146,53,93,0,0,0
2021-01-25 17:45,113,48,65,0,0,0
2021-01-25 18:00,127,49,78,0,0,0
2021-01-25 18:15,107,38,69,0,0,0
2021-01-25 18:30,109,39,70,0,0,0
2021-01-25 18:45,75,40,35,0,0,0
2021-01-25 19:00,82,38,44,0,0,0
2021-01-25 19:15,56,22,34,0,0,0
2021-01-25 19:30,46,20,26,0,0,0
2021-01-25 19:45,73,32,41,0,0,0
2021-01-25 20:00,51,26,25,0,0,0
2021-01-25 20:15,50,23,27,0,0,0
2021-01-25 20:30,40,17,23,0,0,0
2021-01-25 20:45,21,11,10,0,0,0
2021-01-25 21:00,34,16,18,0,0,0
2021-01-25 21:15,30,10,20,0,0,0
2021-01-25 21:30,19,7,12,0,0,0
2021-01-25 21:45,26,7,19,0,0,0
2021-01-25 22:00,19,5,14,0,0,0
2021-01-25 22:15,13,6,7,0,0,0
2021-01-25 22:30,21,11,10,0,0,0
2021-01-25 22:45,21,8,13,0,0,0
2021-01-25 23:00,12,4,8,0,0,0
2021-01-25 23:15,14,2,12,0,0,0
2021-01-25 23:30,8,2,6,0,0,0
2021-01-25 23:45,9,3,6,0,0,0
2021-01-26 00:00,8,4,4,0,0,0
2021-01-26 00:15,13,4,9,0,0,0
2021-01-26 00:30,7,6,1,0,0,0
2021-01-26 00:45,5,1,4,0,0,0
2021-01-26 01:00,3,1,2,0,0,0
2021-01-26 01:15,6,2,4,0,0,0
2021-01-26 01:30,9,3,6,0,0,0
2021-01-26 01:45,6,1,5,0,0,0
2021-01-26 02:00,3,2,1,0,0,0
2021-01-26 02:15,0,0,0,0,0,0
2021-01-26 02:30,2,0,2,0,0,0
2021-01-26 02:45,2,2,0,0,0,0
2021-01-26 03:00,0,0,0,0,0,0
2021-01-26 03:15,4,2,2,0,0,0
2021-01-26 03:30,1,0,1,0,0,0
2021-01-26 03:45,2,2,0,0,0,0
2021-01-26 04:00,1,0,1,0,0,0
2021-01-26 04:15,4,0,4,0,0,0
2021-01-26 04:30,2,2,0,0,0,0
2021-01-26 04:45,4,2,2,0,0,0
2021-01-26 05:00,3,3,0,0,0,0
2021-01-26 05:15,4,4,0,0,0,0
2021-01-26 05:30,10,5,5,0,0,0
2021-01-26 05:45,14,7,7,0,0,0
2021-01-26 06:00,16,10,6,0,0,0
2021-01-26 06:15,31,18,13,0,0,0
2021-01-26 06:30,32,19,13,0,0,0
2021-01-26 06:45,47,32,15,0,0,0
2021-01-26 07:00,63,41,22,0,0,0
2021-01-26 07:15,70,38,32,0,0,0
2021-01-26 07:30,112,71,41,0,0,0
2021-01-26 07:45,126,66,60,0,0,0
2021-01-26 08:00,98,52,46,0,0,0
2021-01-26 08:15,103,60,43,0,0,0
2021-01-26 08:30,122,84,38,0,0,0
2021-01-26 08:45,92,58,34,0,0,0
2021-01-26 09:00,68,31,37,0,0,0
2021-01-26 09:15,56,36,20,0,0,0
2021-01-26 09:30,58,35,23,0,0,0
2021-01-26 09:45,89,47,42,0,0,0
2021-01-26 10:00,56,35,21,0,0,0
2021-01-26 10:15,62,30,32,0,0,0
2021-01-26 10:30,60,32,28,0,0,0
2021-01-26 10:45,57,33,24,0,0,0
2021-01-26 11:00,74,35,39,0,0,0
2021-01-26 11:15,64,35,29,0,0,0
2021-01-26 11:30,65,32,33,0,0,0
2021-01-26 11:45,72,41,31,0,0,0
2021-01-26 12:00,84,49,35,0,0,0
2021-01-26 12:15,84,47,37,0,0,0
2021-01-26 12:30,73,31,42,0,0,0
2021-01-26 12:45,103,51,52,0,0,0
2021-01-26 13:00,102,49,53,0,0,0
2021-01-26 13:15,88,36,52,0,0,0
2021-01-26 13:30,86,37,49,0,0,0
2021-01-26 13:45,94,49,45,0,0,0
2021-01-26 14:00,99,44,55,0,0,0
2021-01-26 14:15,105,56,49,0,0,0
2021-01-26 14:30,88,49,39,0,0,0
2021-01-26 14:45,87,34,53,0,0,0
2021-01-26 15:00,85,40,45,0,0,0
2021-01-26 15:15,112,58,54,0,0,0
2021-01-26 15:30,108,52,56,0,0,0
2021-01-26 15:45,130,70,60,0,0,0
2021-01-26 16:00,118,57,61,0,0,0
2021-01-26 16:15,129,71,58,0,0,0
2021-01-26 16:30,141,58,83,0,0,0
2021-01-26 16:45,173,75,98,0,0,0
2021-01-26 17:00,141,57,84,0,0,0
2021-01-26 17:15,123,59,64,0,0,0
2021-01-26 17:30,119,51,68,0,0,0
2021-01-26 17:45,136,58,78,0,0,0
2021-01-26 18:00,125,52,73,0,0,0
2021-01-26 18:15,128,51,77,0,0,0
2021-01-26 18:30,88,36,52,0,0,0
2021-01-26 18:45,89,48,41,0,0,0
2021-01-26 19:00,76,40,36,0,0,0
2021-01-26 19:15,69,28,41,0,0,0
2021-01-26 19:30,50,17,33,0,0,0
2021-01-26 19:45,50,19,31,0,0,0
2021-01-26 20:00,53,28,25,0,0,0
2021-01-26 20:15,47,16,31,0,0,0
2021-01-26 20:30,46,15,31,0,0,0
2021-01-26 20:45,35,16,19,0,0,0
2021-01-26 21:00,40,18,22,0,0,0
2021-01-26 21:15,22,12,10,0,0,0
2021-01-26 21:30,29,14,15,0,0,0
2021-01-26 21:45,23,10,13,0,0,0
2021-01-26 22:00,23,9,14,0,0,0
2021-01-26 22:15,18,9,9,0,0,0
2021-01-26 22:30,25,9,16,0,0,0
2021-01-26 22:45,22,4,18,0,0,0
2021-01-26 23:00,24,16,8,0,0,0
2021-01-26 23:15,22,11,11,0,0,0
2021-01-26 23:30,18,8,10,0,0,0
2021-01-26 23:45,7,2,5,0,0,0
2021-01-27 00:00,18,5,13,0,0,0
2021-01-27 00:15,9,4,5,0,0,0
2021-01-27 00:30,7,2,5,0,0,0
2021-01-27 00:45,4,2,2,0,0,0
2021-01-27 01:00,10,6,4,0,0,0
2021-01-27 01:15,3,2,1,0,0,0
2021-01-27 01:30,4,2,2,0,0,0
2021-01-27 01:45,2,1,1,0,0,0
2021-01-27 02:00,5,4,1,0,0,0
2021-01-27 02:15,2,1,1,0,0,0
2021-01-27 02:30,1,1,0,0,0,0
2021-01-27 02:45,1,0,1,0,0,0
2021-01-27 03:00,4,3,1,0,0,0
2021-01-27 03:15,0,0,0,0,0,0
2021-01-27 03:30,0,0,0,0,0,0
2021-01-27 03:45,1,0,1,0,0,0
2021-01-27 04:00,2,2,0,0,0,0
2021-01-27 04:15,5,3,2,0,0,0
2021-01-27 04:30,4,4,0,0,0,0
2021-01-27 04:45,3,2,1,0,0,0
2021-01-27 05:00,4,4,0,0,0,0
2021-01-27 05:15,7,5,2,0,0,0
2021-01-27 05:30,19,12,7,0,0,0
2021-01-27 05:45,9,5,4,0,0,0
2021-01-27 06:00,18,12,6,0,0,0
2021-01-27 06:15,29,22,7,0,0,0
2021-01-27 06:30,38,20,18,0,0,0
2021-01-27 06:45,64,48,16,0,0,0
2021-01-27 07:00,73,49,24,0,0,0
2021-01-27 07:15,67,49,18,0,0,0
2021-01-27 07:30,110,74,36,0,0,0
2021-01-27 07:45,132,76,56,0,0,0
2021-01-27 08:00,103,56,47,0,0,0
2021-01-27 08:15,99,54,45,0,0,0
2021-01-27 08:30,90,49,41,0,0,0
2021-01-27 08:45,98,67,31,0,0,0
2021-01-27 09:00,86,50,36,0,0,0
2021-01-27 09:15,70,29,41,0,0,0
2021-01-27 09:30,62,32,30,0,0,0
2021-01-27 09:45,73,30,43,0,0,0
2021-01-27 10:00,62,38,24,0,0,0
2021-01-27 10:15,44,24,20,0,0,0
2021-01-27 10:30,62,32,30,0,0,0
2021-01-27 10:45,65,34,31,0,0,0
2021-01-27 11:00,63,41,22,0,0,0
2021-01-27 11:15,68,37,31,0,0,0
2021-01-27 11:30,78,38,40,0,0,0
2021-01-27 11:45,72,40,32,0,0,0
2021-01-27 12:00,62,36,26,0,0,0
2021-01-27 12:15,80,41,39,0,0,0
2021-01-27 12:30,87,44,43,0,0,0
2021-01-27 12:45,90,53,37,0,0,0
2021-01-27 13:00,94,52,42,0,0,0
2021-01-27 13:15,71,36,35,0,0,0
2021-01-27 13:30,86,36,50,0,0,0
2021-01-27 13:45,113,48,65,0,0,0
2021-01-27 14:00,64,24,40,0,0,0
2021-01-27 14:15,71,32,39,0,0,0
2021-01-27 14:30,68,26,42,0,0,0
2021-01-27 14:45,112,59,53,0,0,0
2021-01-27 15:00,65,34,31,0,0,0
2021-01-27 15:15,105,54,51,0,0,0
2021-01-27 15:30,74,42,32,0,0,0
2021-01-27 15:45,97,47,50,0,0,0
2021-01-27 16:00,93,46,47,0,0,0
2021-01-27 16:15,115,60,55,0,0,0
2021-01-27 16:30,98,44,54,0,0,0
2021-01-27 16:45,123,57,66,0,0,0
2021-01-27 17:00,112,56,56,0,0,0
2021-01-27 17:15,120,45,75,0,0,0
2021-01-27 17:30,104,43,61,0,0,0
2021-01-27 17:45,117,47,70,0,0,0
2021-01-27 18:00,91,39,52,0,0,0
2021-01-27 18:15,98,33,65,0,0,0
2021-01-27 18:30,81,35,46,0,0,0
2021-01-27 18:45,71,29,42,0,0,0
2021-01-27 19:00,90,39,51,0,0,0
2021-01-27 19:15,70,34,36,0,0,0
2021-01-27 19:30,55,22,33,0,0,0
2021-01-27 19:45,68,36,32,0,0,0
2021-01-27 20:00,48,23,25,0,0,0
2021-01-27 20:15,42,11,31,0,0,0
2021-01-27 20:30,42,18,24,0,0,0
2021-01-27 20:45,35,17,18,0,0,0
2021-01-27 21:00,20,12,8,0,0,0
2021-01-27 21:15,26,9,17,0,0,0
2021-01-27 21:30,26,17,9,0,0,0
2021-01-27 21:45,30,11,19,0,0,0
2021-01-27 22:00,21,9,12,0,0,0
2021-01-27 22:15,25,15,10,0,0,0
2021-01-27 22:30,37,14,23,0,0,0
2021-01-27 22:45,26,12,14,0,0,0
2021-01-27 23:00,26,7,19,0,0,0
2021-01-27 23:15,22,8,14,0,0,0
2021-01-27 23:30,17,7,10,0,0,0
2021-01-27 23:45,17,8,9,0,0,0
2021-01-28 00:00,11,4,7,0,0,0
2021-01-28 00:15,9,3,6,0,0,0
2021-01-28 00:30,8,2,6,0,0,0
2021-01-28 00:45,8,6,2,0,0,0
2021-01-28 01:00,8,4,4,0,0,0
2021-01-28 01:15,11,2,9,0,0,0
2021-01-28 01:30,6,1,5,0,0,0
2021-01-28 01:45,4,2,2,0,0,0
2021-01-28 02:00,2,2,0,0,0,0
2021-01-28 02:15,2,1,1,0,0,0
2021-01-28 02:30,0,0,0,0,0,0
2021-01-28 02:45,2,0,2,0,0,0
2021-01-28 03:00,4,0,4,0,0,0
2021-01-28 03:15,3,3,0,0,0,0
2021-01-28 03:30,1,1,0,0,0,0
2021-01-28 03:45,0,0,0,0,0,0
2021-01-28 04:00,0,0,0,0,0,0
2021-01-28 04:15,1,1,0,0,0,0
2021-01-28 04:30,4,2,2,0,0,0
2021-01-28 04:45,3,2,1,0,0,0
2021-01-28 05:00,5,4,1,0,0,0
2021-01-28 05:15,7,4,3,0,0,0
2021-01-28 05:30,8,6,2,0,0,0
2021-01-28 05:45,11,5,6,0,0,0
2021-01-28 06:00,15,9,6,0,0,0
2021-01-28 06:15,27,19,8,0,0,0
2021-01-28 06:30,38,22,16,0,0,0
2021-01-28 06:45,48,30,18,0,0,0
2021-01-28 07:00,71,41,30,0,0,0
2021-01-28 07:15,68,47,21,0,0,0
2021-01-28 07:30,103,62,41,0,0,0
2021-01-28 07:45,127,70,57,0,0,0
2021-01-28 08:00,103,63,40,0,0,0
2021-01-28 08:15,96,63,33,0,0,0
2021-01-28 08:30,86,49,37,0,0,0
2021-01-28 08:45,93,51,42,0,0,0
2021-01-28 09:00,80,45,35,0,0,0
2021-01-28 09:15,75,44,31,0,0,0
2021-01-28 09:30,53,30,23,0,0,0
2021-01-28 09:45,70,30,40,0,0,0
2021-01-28 10:00,68,34,34,0,0,0
2021-01-28 10:15,46,27,19,0,0,0
2021-01-28 10:30,57,31,26,0,0,0
2021-01-28 10:45,64,32,32,0,0,0
2021-01-28 11:00,43,22,21,0,0,0
2021-01-28 11:15,44,24,20,0,0,0
2021-01-28 11:30,45,19,26,0,0,0
2021-01-28 11:45,58,24,34,0,0,0
2021-01-28 12:00,55,27,28,0,0,0
2021-01-28 12:15,52,26,26,0,0,0
2021-01-28 12:30,59,31,28,0,0,0
2021-01-28 12:45,74,41,33,0,0,0
2021-01-28 13:00,62,27,35,0,0,0
2021-01-28 13:15,61,28,33,0,0,0
2021-01-28 13:30,56,26,30,0,0,0
2021-01-28 13:45,54,21,33,0,0,0
2021-01-28 14:00,70,31,39,0,0,0
2021-01-28 14:15,63,31,32,0,0,0
2021-01-28 14:30,59,31,28,0,0,0
2021-01-28 14:45,85,46,39,0,0,0
2021-01-28 15:00,76,36,40,0,0,0
2021-01-28 15:15,53,28,25,0,0,0
2021-01-28 15:30,85,43,42,0,0,0
2021-01-28 15:45,85,46,39,0,0,0
2021-01-28 16:00,88,47,41,0,0,0
2021-01-28 16:15,112,46,66,0,0,0
2021-01-28 16:30,97,45,52,0,0,0
2021-01-28 16:45,127,60,67,0,0,0
2021-01-28 17:00,116,46,70,0,0,0
2021-01-28 17:15,116,48,68,0,0,0
2021-01-28 17:30,115,56,59,0,0,0
2021-01-28 17:45,111,48,63,0,0,0
2021-01-28 18:00,97,32,65,0,0,0
2021-01-28 18:15,100,40,60,0,0,0
2021-01-28 18:30,85,39,46,0,0,0
2021-01-28 18:45,93,48,45,0,0,0
2021-01-28 19:00,62,26,36,0,0,0
2021-01-28 19:15,67,30,37,0,0,0
2021-01-28 19:30,73,31,42,0,0,0
2021-01-28 19:45,60,24,36,0,0,0
2021-01-28 20:00,54,19,35,0,0,0
2021-01-28 20:15,44,25,19,0,0,0
2021-01-28 20:30,42,21,21,0,0,0
2021-01-28 20:45,30,12,18,0,0,0
2021-01-28 21:00,21,13,8,0,0,0
2021-01-28 21:15,33,8,25,0,0,0
2021-01-28 21:30,23,11,12,0,0,0
2021-01-28 21:45,29,18,11,0,0,0
2021-01-28 22:00,14,2,12,0,0,0
2021-01-28 22:15,22,7,15,0,0,0
2021-01-28 22:30,15,6,9,0,0,0
2021-01-28 22:45,16,5,11,0,0,0
2021-01-28 23:00,15,2,13,0,0,0
2021-01-28 23:15,21,8,13,0,0,0
2021-01-28 23:30,15,8,7,0,0,0
2021-01-28 23:45,15,7,8,0,0,0
2021-01-29 00:00,17,6,11,0,0,0
2021-01-29 00:15,18,8,10,0,0,0
2021-01-29 00:30,8,5,3,0,0,0
2021-01-29 00:45,6,3,3,0,0,0
2021-01-29 01:00,4,2,2,0,0,0
2021-01-29 01:15,9,2,7,0,0,0
2021-01-29 01:30,8,2,6,0,0,0
2021-01-29 01:45,6,2,4,0,0,0
2021-01-29 02:00,0,0,0,0,0,0
2021-01-29 02:15,5,2,3,0,0,0
2021-01-29 02:30,2,0,2,0,0,0
2021-01-29 02:45,2,1,1,0,0,0
2021-01-29 03:00,2,0,2,0,0,0
2021-01-29 03:15,0,0,0,0,0,0
2021-01-29 03:30,1,0,1,0,0,0
2021-01-29 03:45,0,0,0,0,0,0
2021-01-29 04:00,1,1,0,0,0,0
2021-01-29 04:15,2,0,2,0,0,0
2021-01-29 04:30,5,2,3,0,0,0
2021-01-29 04:45,4,4,0,0,0,0
2021-01-29 05:00,3,3,0,0,0,0
2021-01-29 05:15,10,9,1,0,0,0
2021-01-29 05:30,17,11,6,0,0,0
2021-01-29 05:45,11,8,3,0,0,0
2021-01-29 06:00,12,6,6,0,0,0
2021-01-29 06:15,12,9,3,0,0,0
2021-01-29 06:30,33,24,9,0,0,0
2021-01-29 06:45,34,22,12,0,0,0
2021-01-29 07:00,32,23,9,0,0,0
2021-01-29 07:15,45,26,19,0,0,0
2021-01-29 07:30,67,42,25,0,0,0
2021-01-29 07:45,88,49,39,0,0,0
2021-01-29 08:00,72,41,31,0,0,0
2021-01-29 08:15,77,46,31,0,0,0
2021-01-29 08:30,77,46,31,0,0,0
2021-01-29 08:45,84,52,32,0,0,0
2021-01-29 09:00,51,28,23,0,0,0
2021-01-29 09:15,60,39,21,0,0,0
2021-01-29 09:30,41,19,22,0,0,0
2021-01-29 09:45,46,30,16,0,0,0
2021-01-29 10:00,46,18,28,0,0,0
2021-01-29 10:15,43,24,19,0,0,0
2021-01-29 10:30,35,14,21,0,0,0
2021-01-29 10:45,44,25,19,0,0,0
2021-01-29 11:00,38,16,22,0,0,0
2021-01-29 11:15,56,33,23,0,0,0
2021-01-29 11:30,54,27,27,0,0,0
2021-01-29 11:45,55,29,26,0,0,0
2021-01-29 12:00,56,22,34,0,0,0
2021-01-29 12:15,72,38,34,0,0,0
2021-01-29 12:30,52,28,24,0,0,0
2021-01-29 12:45,73,39,34,0,0,0
2021-01-29 13:00,70,34,36,0,0,0
2021-01-29 13:15,91,44,47,0,0,0
2021-01-29 13:30,70,37,33,0,0,0
2021-01-29 13:45,73,38,35,0,0,0
2021-01-29 14:00,87,44,43,0,0,0
2021-01-29 14:15,83,47,36,0,0,0
2021-01-29 14:30,80,30,50,0,0,0
2021-01-29 14:45,119,76,43,0,0,0
2021-01-29 15:00,88,37,51,0,0,0
2021-01-29 15:15,76,44,32,0,0,0
2021-01-29 15:30,107,54,53,0,0,0
2021-01-29 15:45,112,64,48,0,0,0
2021-01-29 16:00,90,43,47,0,0,0
2021-01-29 16:15,103,53,50,0,0,0
2021-01-29 16:30,99,50,49,0,0,0
2021-01-29 16:45,114,69,45,0,0,0
2021-01-29 17:00,92,40,52,0,0,0
2021-01-29 17:15,91,42,49,0,0,0
2021-01-29 17:30,97,55,42,0,0,0
2021-01-29 17:45,95,49,46,0,0,0
2021-01-29 18:00,98,45,53,0,0,0
2021-01-29 18:15,81,31,50,0,0,0
2021-01-29 18:30,87,39,48,0,0,0
2021-01-29 18:45,104,48,56,0,0,0
2021-01-29 19:00,80,30,50,0,0,0
2021-01-29 19:15,61,32,29,0,0,0
2021-01-29 19:30,76,40,36,0,0,0
2021-01-29 19:45,49,27,22,0,0,0
2021-01-29 20:00,44,21,23,0,0,0
2021-01-29 20:15,60,30,30,0,0,0
2021-01-29 20:30,40,19,21,0,0,0
2021-01-29 20:45,24,13,11,0,0,0
2021-01-29 21:00,33,19,14,0,0,0
2021-01-29 21:15,23,9,14,0,0,0
2021-01-29 21:30,25,13,12,0,0,0
2021-01-29 21:45,12,7,5,0,0,0
2021-01-29 22:00,13,8,5,0,0,0
2021-01-29 22:15,15,5,10,0,0,0
2021-01-29 22:30,22,14,8,0,0,0
2021-01-29 22:45,18,7,11,0,0,0
2021-01-29 23:00,21,7,14,0,0,0
2021-01-29 23:15,15,7,8,0,0,0
2021-01-29 23:30,23,9,14,0,0,0
2021-01-29 23:45,23,11,12,0,0,0
2021-01-30 00:00,27,11,16,0,0,0
2021-01-30 00:15,10,4,6,0,0,0
2021-01-30 00:30,14,5,9,0,0,0
2021-01-30 00:45,16,9,7,0,0,0
2021-01-30 01:00,19,11,8,0,0,0
2021-01-30 01:15,12,7,5,0,0,0
2021-01-30 01:30,10,2,8,0,0,0
2021-01-30 01:45,17,4,13,0,0,0
2021-01-30 02:00,10,6,4,0,0,0
2021-01-30 02:15,9,4,5,0,0,0
2021-01-30 02:30,8,5,3,0,0,0
2021-01-30 02:45,3,1,2,0,0,0
2021-01-30 03:00,8,4,4,0,0,0
2021-01-30 03:15,1,0,1,0,0,0
2021-01-30 03:30,1,1,0,0,0,0
2021-01-30 03:45,3,0,3,0,0,0
2021-01-30 04:00,1,0,1,0,0,0
2021-01-30 04:15,1,0,1,0,0,0
2021-01-30 04:30,4,1,3,0,0,0
2021-01-30 04:45,4,3,1,0,0,0
2021-01-30 05:00,4,4,0,0,0,0
2021-01-30 05:15,4,3,1,0,0,0
2021-01-30 05:30,15,10,5,0,0,0
2021-01-30 05:45,8,5,3,0,0,0
2021-01-30 06:00,8,1,7,0,0,0
2021-01-30 06:15,9,5,4,0,0,0
2021-01-30 06:30,6,2,4,0,0,0
2021-01-30 06:45,10,8,2,0,0,0
2021-01-30 07:00,8,7,1,0,0,0
2021-01-30 07:15,9,7,2,0,0,0
2021-01-30 07:30,11,7,4,0,0,0
2021-01-30 07:45,16,10,6,0,0,0
2021-01-30 08:00,21,17,4,0,0,0
2021-01-30 08:15,28,19,9,0,0,0
2021-01-30 08:30,31,22,9,0,0,0
2021-01-30 08:45,47,27,20,0,0,0
2021-01-30 09:00,26,18,8,0,0,0
2021-01-30 09:15,44,27,17,0,0,0
2021-01-30 09:30,48,32,16,0,0,0
2021-01-30 09:45,61,36,25,0,0,0
2021-01-30 10:00,56,33,23,0,0,0
2021-01-30 10:15,69,44,25,0,0,0
2021-01-30 10:30,59,25,34,0,0,0
2021-01-30 10:45,80,54,26,0,0,0
2021-01-30 11:00,69,36,33,0,0,0
2021-01-30 11:15,90,53,37,0,0,0
2021-01-30 11:30,85,56,29,0,0,0
2021-01-30 11:45,79,39,40,0,0,0
2021-01-30 12:00,79,41,38,0,0,0
2021-01-30 12:15,101,56,45,0,0,0
2021-01-30 12:30,91,49,42,0,0,0
2021-01-30 12:45,94,58,36,0,0,0
2021-01-30 13:00,100,62,38,0,0,0
2021-01-30 13:15,119,62,57,0,0,0
2021-01-30 13:30,94,43,51,0,0,0
2021-01-30 13:45,111,60,51,0,0,0
2021-01-30 14:00,93,40,53,0,0,0
2021-01-30 14:15,108,47,61,0,0,0
2021-01-30 14:30,110,39,71,0,0,0
2021-01-30 14:45,126,61,65,0,0,0
2021-01-30 15:00,115,43,72,0,0,0
2021-01-30 15:15,85,35,50,0,0,0
2021-01-30 15:30,78,35,43,0,0,0
2021-01-30 15:45,81,42,39,0,0,0
2021-01-30 16:00,66,38,28,0,0,0
2021-01-30 16:15,83,41,42,0,0,0
2021-01-30 16:30,76,38,38,0,0,0
2021-01-30 16:45,79,37,42,0,0,0
2021-01-30 17:00,69,32,37,0,0,0
2021-01-30 17:15,69,29,40,0,0,0
2021-01-30 17:30,76,34,42,0,0,0
2021-01-30 17:45,73,33,40,0,0,0
2021-01-30 18:00,73,27,46,0,0,0
2021-01-30 18:15,47,21,26,0,0,0
2021-01-30 18:30,66,26,40,0,0,0
2021-01-30 18:45,48,20,28,0,0,0
2021-01-30 19:00,57,35,22,0,0,0
2021-01-30 19:15,62,33,29,0,0,0
2021-01-30 19:30,53,21,32,0,0,0
2021-01-30 19:45,43,19,24,0,0,0
2021-01-30 20:00,50,14,36,0,0,0
2021-01-30 20:15,43,16,27,0,0,0
2021-01-30 20:30,27,9,18,0,0,0
2021-01-30 20:45,40,18,22,0,0,0
2021-01-30 21:00,30,12,18,0,0,0
2021-01-30 21:15,24,12,12,0,0,0
2021-01-30 21:30,12,1,11,0,0,0
2021-01-30 21:45,14,6,8,0,0,0
2021-01-30 22:00,22,7,15,0,0,0
2021-01-30 22:15,27,10,17,0,0,0
2021-01-30 22:30,10,4,6,0,0,0
2021-01-30 22:45,19,7,12,0,0,0
2021-01-30 23:00,8,3,5,0,0,0
2021-01-30 23:15,9,4,5,0,0,0
2021-01-30 23:30,23,11,12,0,0,0
2021-01-30 23:45,17,8,9,0,0,0
2021-01-31 00:00,21,7,14,0,0,0
2021-01-31 00:15,20,11,9,0,0,0
2021-01-31 00:30,26,14,12,0,0,0
2021-01-31 00:45,13,5,8,0,0,0
2021-01-31 01:00,14,7,7,0,0,0
2021-01-31 01:15,17,10,7,0,0,0
2021-01-31 01:30,21,11,10,0,0,0
2021-01-31 01:45,8,6,2,0,0,0
2021-01-31 02:00,14,9,5,0,0,0
2021-01-31 02:15,6,5,1,0,0,0
2021-01-31 02:30,11,7,4,0,0,0
2021-01-31 02:45,8,2,6,0,0,0
2021-01-31 03:00,5,1,4,0,0,0
2021-01-31 03:15,1,1,0,0,0,0
2021-01-31 03:30,7,2,5,0,0,0
2021-01-31 03:45,6,3,3,0,0,0
2021-01-31 04:00,3,2,1,0,0,0
2021-01-31 04:15,7,3,4,0,0,0
2021-01-31 04:30,5,4,1,0,0,0
2021-01-31 04:45,1,0,1,0,0,0
2021-01-31 05:00,2,2,0,0,0,0
2021-01-31 05:15,1,1,0,0,0,0
2021-01-31 05:30,6,4,2,0,0,0
2021-01-31 05:45,5,2,3,0,0,0
2021-01-31 06:00,2,0,2,0,0,0
2021-01-31 06:15,6,0,6,0,0,0
2021-01-31 06:30,6,3,3,0,0,0
2021-01-31 06:45,7,4,3,0,0,0
2021-01-31 07:00,6,6,0,0,0,0
2021-01-31 07:15,4,1,3,0,0,0
2021-01-31 07:30,4,3,1,0,0,0
2021-01-31 07:45,12,6,6,0,0,0
2021-01-31 08:00,8,5,3,0,0,0
2021-01-31 08:15,10,5,5,0,0,0
2021-01-31 08:30,13,8,5,0,0,0
2021-01-31 08:45,8,4,4,0,0,0
2021-01-31 09:00,7,5,2,0,0,0
2021-01-31 09:15,21,13,8,0,0,0
2021-01-31 09:30,21,10,11,0,0,0
2021-01-31 09:45,37,17,20,0,0,0
2021-01-31 10:00,17,10,7,0,0,0
2021-01-31 10:15,29,17,12,0,0,0
2021-01-31 10:30,41,16,25,0,0,0
2021-01-31 10:45,39,22,17,0,0,0
2021-01-31 11:00,29,8,21,0,0,0
2021-01-31 11:15,10,0,10,0,0,0
2021-01-31 11:30,10,0,10,0,0,0
2021-01-31 11:45,16,0,16,0,0,0
2021-01-31 12:00,28,0,28,0,0,0
2021-01-31 12:15,18,0,18,0,0,0
2021-01-31 12:30,16,0,16,0,0,0
2021-01-31 12:45,41,0,41,0,0,0
2021-01-31 13:00,35,0,35,0,0,0
2021-01-31 13:15,46,0,46,0,0,0
2021-01-31 13:30,40,0,40,0,0,0
2021-01-31 13:45,50,0,50,0,0,0
2021-01-31 14:00,38,0,38,0,0,0
2021-01-31 14:15,37,0,37,0,0,0
2021-01-31 14:30,46,0,46,0,0,0
2021-01-31 14:45,38,0,38,0,0,0
2021-01-31 15:00,45,0,45,0,0,0
2021-01-31 15:15,38,0,38,0,0,0
2021-01-31 15:30,37,0,37,0,0,0
2021-01-31 15:45,51,0,51,0,0,0
2021-01-31 16:00,43,0,43,0,0,0
2021-01-31 16:15,32,0,32,0,0,0
2021-01-31 16:30,38,0,38,0,0,0
2021-01-31 16:45,42,1,41,0,0,0
2021-01-31 17:00,43,0,43,0,0,0
2021-01-31 17:15,36,0,36,0,0,0
2021-01-31 17:30,37,0,37,0,0,0
2021-01-31 17:45,33,0,33,0,0,0
2021-01-31 18:00,23,0,23,0,0,0
2021-01-31 18:15,23,0,23,0,0,0
2021-01-31 18:30,29,1,28,0,0,0
2021-01-31 18:45,16,0,16,0,0,0
2021-01-31 19:00,25,0,25,0,0,0
2021-01-31 19:15,39,0,39,0,0,0
2021-01-31 19:30,23,0,23,0,0,0
2021-01-31 19:45,18,0,18,0,0,0
2021-01-31 20:00,30,0,30,0,0,0
2021-01-31 20:15,18,0,18,0,0,0
2021-01-31 20:30,18,0,18,0,0,0
2021-01-31 20:45,15,0,15,0,0,0
2021-01-31 21:00,17,1,16,0,0,0
2021-01-31 21:15,13,0,13,0,0,0
2021-01-31 21:30,14,2,12,0,0,0
2021-01-31 21:45,11,0,11,0,0,0
2021-01-31 22:00,5,0,5,0,0,0
2021-01-31 22:15,11,0,11,0,0,0
2021-01-31 22:30,6,0,6,0,0,0
2021-01-31 22:45,8,0,8,0,0,0
2021-01-31 23:00,9,0,9,0,0,0
2021-01-31 23:15,6,0,6,0,0,0
2021-01-31 23:30,6,0,6,0,0,0
2021-01-31 23:45,3,0,3,0,0,0
