Datetime,100035541 (Neutor),101035541 (Neutor stadteinwÃ¤rts),102035541 (Neutor stadtauswÃ¤rts),100035541-status,101035541-status,102035541-status
2021-05-01 00:00,27,15,12,0,0,0
2021-05-01 00:15,26,11,15,0,0,0
2021-05-01 00:30,25,13,12,0,0,0
2021-05-01 00:45,26,17,9,0,0,0
2021-05-01 01:00,18,6,12,0,0,0
2021-05-01 01:15,21,5,16,0,0,0
2021-05-01 01:30,19,10,9,0,0,0
2021-05-01 01:45,21,8,13,0,0,0
2021-05-01 02:00,15,7,8,0,0,0
2021-05-01 02:15,11,8,3,0,0,0
2021-05-01 02:30,9,7,2,0,0,0
2021-05-01 02:45,12,8,4,0,0,0
2021-05-01 03:00,9,4,5,0,0,0
2021-05-01 03:15,14,8,6,0,0,0
2021-05-01 03:30,12,6,6,0,0,0
2021-05-01 03:45,10,5,5,0,0,0
2021-05-01 04:00,6,4,2,0,0,0
2021-05-01 04:15,5,3,2,0,0,0
2021-05-01 04:30,8,1,7,0,0,0
2021-05-01 04:45,5,2,3,0,0,0
2021-05-01 05:00,7,3,4,0,0,0
2021-05-01 05:15,3,2,1,0,0,0
2021-05-01 05:30,4,3,1,0,0,0
2021-05-01 05:45,6,1,5,0,0,0
2021-05-01 06:00,3,2,1,0,0,0
2021-05-01 06:15,5,1,4,0,0,0
2021-05-01 06:30,13,9,4,0,0,0
2021-05-01 06:45,10,8,2,0,0,0
2021-05-01 07:00,3,2,1,0,0,0
2021-05-01 07:15,8,6,2,0,0,0
2021-05-01 07:30,17,12,5,0,0,0
2021-05-01 07:45,11,10,1,0,0,0
2021-05-01 08:00,12,10,2,0,0,0
2021-05-01 08:15,25,14,11,0,0,0
2021-05-01 08:30,15,9,6,0,0,0
2021-05-01 08:45,36,20,16,0,0,0
2021-05-01 09:00,36,24,12,0,0,0
2021-05-01 09:15,33,18,15,0,0,0
2021-05-01 09:30,38,21,17,0,0,0
2021-05-01 09:45,59,28,31,0,0,0
2021-05-01 10:00,46,30,16,0,0,0
2021-05-01 10:15,50,27,23,0,0,0
2021-05-01 10:30,55,32,23,0,0,0
2021-05-01 10:45,84,59,25,0,0,0
2021-05-01 11:00,73,48,25,0,0,0
2021-05-01 11:15,100,60,40,0,0,0
2021-05-01 11:30,98,68,30,0,0,0
2021-05-01 11:45,71,46,25,0,0,0
2021-05-01 12:00,103,51,52,0,0,0
2021-05-01 12:15,111,63,48,0,0,0
2021-05-01 12:30,116,68,48,0,0,0
2021-05-01 12:45,100,45,55,0,0,0
2021-05-01 13:00,108,45,63,0,0,0
2021-05-01 13:15,121,59,62,0,0,0
2021-05-01 13:30,118,57,61,0,0,0
2021-05-01 13:45,150,93,57,0,0,0
2021-05-01 14:00,147,76,71,0,0,0
2021-05-01 14:15,154,86,68,0,0,0
2021-05-01 14:30,129,51,78,0,0,0
2021-05-01 14:45,168,76,92,0,0,0
2021-05-01 15:00,130,77,53,0,0,0
2021-05-01 15:15,125,74,51,0,0,0
2021-05-01 15:30,143,72,71,0,0,0
2021-05-01 15:45,142,69,73,0,0,0
2021-05-01 16:00,109,49,60,0,0,0
2021-05-01 16:15,100,51,49,0,0,0
2021-05-01 16:30,106,56,50,0,0,0
2021-05-01 16:45,120,60,60,0,0,0
2021-05-01 17:00,108,59,49,0,0,0
2021-05-01 17:15,122,55,67,0,0,0
2021-05-01 17:30,91,40,51,0,0,0
2021-05-01 17:45,128,64,64,0,0,0
2021-05-01 18:00,99,38,61,0,0,0
2021-05-01 18:15,104,45,59,0,0,0
2021-05-01 18:30,132,62,70,0,0,0
2021-05-01 18:45,101,38,63,0,0,0
2021-05-01 19:00,115,54,61,0,0,0
2021-05-01 19:15,81,44,37,0,0,0
2021-05-01 19:30,87,46,41,0,0,0
2021-05-01 19:45,93,44,49,0,0,0
2021-05-01 20:00,113,62,51,0,0,0
2021-05-01 20:15,85,43,42,0,0,0
2021-05-01 20:30,81,31,50,0,0,0
2021-05-01 20:45,67,31,36,0,0,0
2021-05-01 21:00,60,19,41,0,0,0
2021-05-01 21:15,53,26,27,0,0,0
2021-05-01 21:30,50,15,35,0,0,0
2021-05-01 21:45,50,27,23,0,0,0
2021-05-01 22:00,42,14,28,0,0,0
2021-05-01 22:15,51,20,31,0,0,0
2021-05-01 22:30,32,16,16,0,0,0
2021-05-01 22:45,51,14,37,0,0,0
2021-05-01 23:00,31,12,19,0,0,0
2021-05-01 23:15,46,19,27,0,0,0
2021-05-01 23:30,32,9,23,0,0,0
2021-05-01 23:45,19,7,12,0,0,0
2021-05-02 00:00,48,20,28,0,0,0
2021-05-02 00:15,28,14,14,0,0,0
2021-05-02 00:30,28,11,17,0,0,0
2021-05-02 00:45,19,10,9,0,0,0
2021-05-02 01:00,32,16,16,0,0,0
2021-05-02 01:15,29,13,16,0,0,0
2021-05-02 01:30,16,10,6,0,0,0
2021-05-02 01:45,26,6,20,0,0,0
2021-05-02 02:00,17,6,11,0,0,0
2021-05-02 02:15,32,12,20,0,0,0
2021-05-02 02:30,25,7,18,0,0,0
2021-05-02 02:45,8,5,3,0,0,0
2021-05-02 03:00,12,4,8,0,0,0
2021-05-02 03:15,7,1,6,0,0,0
2021-05-02 03:30,11,1,10,0,0,0
2021-05-02 03:45,16,4,12,0,0,0
2021-05-02 04:00,5,2,3,0,0,0
2021-05-02 04:15,5,2,3,0,0,0
2021-05-02 04:30,5,2,3,0,0,0
2021-05-02 04:45,2,1,1,0,0,0
2021-05-02 05:00,2,0,2,0,0,0
2021-05-02 05:15,8,5,3,0,0,0
2021-05-02 05:30,9,5,4,0,0,0
2021-05-02 05:45,8,4,4,0,0,0
2021-05-02 06:00,7,2,5,0,0,0
2021-05-02 06:15,3,3,0,0,0,0
2021-05-02 06:30,7,2,5,0,0,0
2021-05-02 06:45,6,4,2,0,0,0
2021-05-02 07:00,4,3,1,0,0,0
2021-05-02 07:15,5,1,4,0,0,0
2021-05-02 07:30,8,4,4,0,0,0
2021-05-02 07:45,4,3,1,0,0,0
2021-05-02 08:00,9,4,5,0,0,0
2021-05-02 08:15,18,12,6,0,0,0
2021-05-02 08:30,16,13,3,0,0,0
2021-05-02 08:45,10,7,3,0,0,0
2021-05-02 09:00,10,4,6,0,0,0
2021-05-02 09:15,19,11,8,0,0,0
2021-05-02 09:30,34,25,9,0,0,0
2021-05-02 09:45,60,36,24,0,0,0
2021-05-02 10:00,60,42,18,0,0,0
2021-05-02 10:15,37,22,15,0,0,0
2021-05-02 10:30,49,26,23,0,0,0
2021-05-02 10:45,67,45,22,0,0,0
2021-05-02 11:00,64,33,31,0,0,0
2021-05-02 11:15,56,32,24,0,0,0
2021-05-02 11:30,54,32,22,0,0,0
2021-05-02 11:45,58,33,25,0,0,0
2021-05-02 12:00,79,42,37,0,0,0
2021-05-02 12:15,91,36,55,0,0,0
2021-05-02 12:30,80,45,35,0,0,0
2021-05-02 12:45,98,57,41,0,0,0
2021-05-02 13:00,68,34,34,0,0,0
2021-05-02 13:15,82,49,33,0,0,0
2021-05-02 13:30,88,37,51,0,0,0
2021-05-02 13:45,87,56,31,0,0,0
2021-05-02 14:00,97,45,52,0,0,0
2021-05-02 14:15,98,57,41,0,0,0
2021-05-02 14:30,98,56,42,0,0,0
2021-05-02 14:45,96,53,43,0,0,0
2021-05-02 15:00,116,60,56,0,0,0
2021-05-02 15:15,92,45,47,0,0,0
2021-05-02 15:30,76,41,35,0,0,0
2021-05-02 15:45,118,63,55,0,0,0
2021-05-02 16:00,101,53,48,0,0,0
2021-05-02 16:15,100,58,42,0,0,0
2021-05-02 16:30,90,37,53,0,0,0
2021-05-02 16:45,108,53,55,0,0,0
2021-05-02 17:00,119,46,73,0,0,0
2021-05-02 17:15,125,63,62,0,0,0
2021-05-02 17:30,102,41,61,0,0,0
2021-05-02 17:45,106,51,55,0,0,0
2021-05-02 18:00,109,42,67,0,0,0
2021-05-02 18:15,73,41,32,0,0,0
2021-05-02 18:30,91,36,55,0,0,0
2021-05-02 18:45,90,56,34,0,0,0
2021-05-02 19:00,77,32,45,0,0,0
2021-05-02 19:15,73,34,39,0,0,0
2021-05-02 19:30,66,27,39,0,0,0
2021-05-02 19:45,72,38,34,0,0,0
2021-05-02 20:00,81,40,41,0,0,0
2021-05-02 20:15,66,33,33,0,0,0
2021-05-02 20:30,45,10,35,0,0,0
2021-05-02 20:45,47,18,29,0,0,0
2021-05-02 21:00,39,11,28,0,0,0
2021-05-02 21:15,31,11,20,0,0,0
2021-05-02 21:30,27,7,20,0,0,0
2021-05-02 21:45,33,18,15,0,0,0
2021-05-02 22:00,23,6,17,0,0,0
2021-05-02 22:15,27,12,15,0,0,0
2021-05-02 22:30,33,9,24,0,0,0
2021-05-02 22:45,15,4,11,0,0,0
2021-05-02 23:00,17,7,10,0,0,0
2021-05-02 23:15,16,10,6,0,0,0
2021-05-02 23:30,10,3,7,0,0,0
2021-05-02 23:45,10,4,6,0,0,0
2021-05-03 00:00,6,1,5,0,0,0
2021-05-03 00:15,15,4,11,0,0,0
2021-05-03 00:30,8,4,4,0,0,0
2021-05-03 00:45,4,1,3,0,0,0
2021-05-03 01:00,2,1,1,0,0,0
2021-05-03 01:15,5,4,1,0,0,0
2021-05-03 01:30,7,3,4,0,0,0
2021-05-03 01:45,8,3,5,0,0,0
2021-05-03 02:00,2,0,2,0,0,0
2021-05-03 02:15,3,2,1,0,0,0
2021-05-03 02:30,1,0,1,0,0,0
2021-05-03 02:45,2,1,1,0,0,0
2021-05-03 03:00,0,0,0,0,0,0
2021-05-03 03:15,1,0,1,0,0,0
2021-05-03 03:30,0,0,0,0,0,0
2021-05-03 03:45,3,1,2,0,0,0
2021-05-03 04:00,1,0,1,0,0,0
2021-05-03 04:15,3,1,2,0,0,0
2021-05-03 04:30,7,5,2,0,0,0
2021-05-03 04:45,2,1,1,0,0,0
2021-05-03 05:00,5,5,0,0,0,0
2021-05-03 05:15,9,6,3,0,0,0
2021-05-03 05:30,21,13,8,0,0,0
2021-05-03 05:45,10,3,7,0,0,0
2021-05-03 06:00,23,17,6,0,0,0
2021-05-03 06:15,42,28,14,0,0,0
2021-05-03 06:30,50,37,13,0,0,0
2021-05-03 06:45,63,44,19,0,0,0
2021-05-03 07:00,86,60,26,0,0,0
2021-05-03 07:15,117,82,35,0,0,0
2021-05-03 07:30,185,124,61,0,0,0
2021-05-03 07:45,241,162,79,0,0,0
2021-05-03 08:00,175,108,67,0,0,0
2021-05-03 08:15,162,93,69,0,0,0
2021-05-03 08:30,134,81,53,0,0,0
2021-05-03 08:45,156,75,81,0,0,0
2021-05-03 09:00,114,73,41,0,0,0
2021-05-03 09:15,111,65,46,0,0,0
2021-05-03 09:30,105,62,43,0,0,0
2021-05-03 09:45,128,70,58,0,0,0
2021-05-03 10:00,81,43,38,0,0,0
2021-05-03 10:15,96,54,42,0,0,0
2021-05-03 10:30,97,47,50,0,0,0
2021-05-03 10:45,96,49,47,0,0,0
2021-05-03 11:00,100,44,56,0,0,0
2021-05-03 11:15,84,46,38,0,0,0
2021-05-03 11:30,119,66,53,0,0,0
2021-05-03 11:45,138,63,75,0,0,0
2021-05-03 12:00,116,59,57,0,0,0
2021-05-03 12:15,129,69,60,0,0,0
2021-05-03 12:30,159,71,88,0,0,0
2021-05-03 12:45,121,69,52,0,0,0
2021-05-03 13:00,160,76,84,0,0,0
2021-05-03 13:15,185,79,106,0,0,0
2021-05-03 13:30,141,53,88,0,0,0
2021-05-03 13:45,170,80,90,0,0,0
2021-05-03 14:00,131,61,70,0,0,0
2021-05-03 14:15,133,57,76,0,0,0
2021-05-03 14:30,136,66,70,0,0,0
2021-05-03 14:45,125,61,64,0,0,0
2021-05-03 15:00,118,36,82,0,0,0
2021-05-03 15:15,122,50,72,0,0,0
2021-05-03 15:30,131,65,66,0,0,0
2021-05-03 15:45,140,64,76,0,0,0
2021-05-03 16:00,144,58,86,0,0,0
2021-05-03 16:15,172,82,90,0,0,0
2021-05-03 16:30,193,81,112,0,0,0
2021-05-03 16:45,187,83,104,0,0,0
2021-05-03 17:00,195,79,116,0,0,0
2021-05-03 17:15,204,94,110,0,0,0
2021-05-03 17:30,202,86,116,0,0,0
2021-05-03 17:45,211,122,89,0,0,0
2021-05-03 18:00,188,79,109,0,0,0
2021-05-03 18:15,199,83,116,0,0,0
2021-05-03 18:30,140,73,67,0,0,0
2021-05-03 18:45,138,63,75,0,0,0
2021-05-03 19:00,148,60,88,0,0,0
2021-05-03 19:15,104,45,59,0,0,0
2021-05-03 19:30,94,40,54,0,0,0
2021-05-03 19:45,86,49,37,0,0,0
2021-05-03 20:00,81,36,45,0,0,0
2021-05-03 20:15,79,36,43,0,0,0
2021-05-03 20:30,69,33,36,0,0,0
2021-05-03 20:45,46,23,23,0,0,0
2021-05-03 21:00,50,17,33,0,0,0
2021-05-03 21:15,46,18,28,0,0,0
2021-05-03 21:30,52,26,26,0,0,0
2021-05-03 21:45,33,17,16,0,0,0
2021-05-03 22:00,40,13,27,0,0,0
2021-05-03 22:15,24,10,14,0,0,0
2021-05-03 22:30,33,12,21,0,0,0
2021-05-03 22:45,19,11,8,0,0,0
2021-05-03 23:00,18,6,12,0,0,0
2021-05-03 23:15,16,10,6,0,0,0
2021-05-03 23:30,24,10,14,0,0,0
2021-05-03 23:45,6,2,4,0,0,0
2021-05-04 00:00,10,4,6,0,0,0
2021-05-04 00:15,13,2,11,0,0,0
2021-05-04 00:30,15,9,6,0,0,0
2021-05-04 00:45,10,3,7,0,0,0
2021-05-04 01:00,6,0,6,0,0,0
2021-05-04 01:15,5,2,3,0,0,0
2021-05-04 01:30,4,1,3,0,0,0
2021-05-04 01:45,7,4,3,0,0,0
2021-05-04 02:00,8,0,8,0,0,0
2021-05-04 02:15,2,1,1,0,0,0
2021-05-04 02:30,1,0,1,0,0,0
2021-05-04 02:45,0,0,0,0,0,0
2021-05-04 03:00,0,0,0,0,0,0
2021-05-04 03:15,1,1,0,0,0,0
2021-05-04 03:30,0,0,0,0,0,0
2021-05-04 03:45,1,1,0,0,0,0
2021-05-04 04:00,5,1,4,0,0,0
2021-05-04 04:15,6,2,4,0,0,0
2021-05-04 04:30,4,3,1,0,0,0
2021-05-04 04:45,8,5,3,0,0,0
2021-05-04 05:00,2,1,1,0,0,0
2021-05-04 05:15,5,4,1,0,0,0
2021-05-04 05:30,13,8,5,0,0,0
2021-05-04 05:45,16,10,6,0,0,0
2021-05-04 06:00,20,18,2,0,0,0
2021-05-04 06:15,31,25,6,0,0,0
2021-05-04 06:30,41,33,8,0,0,0
2021-05-04 06:45,52,33,19,0,0,0
2021-05-04 07:00,62,39,23,0,0,0
2021-05-04 07:15,108,71,37,0,0,0
2021-05-04 07:30,158,108,50,0,0,0
2021-05-04 07:45,196,121,75,0,0,0
2021-05-04 08:00,136,77,59,0,0,0
2021-05-04 08:15,119,77,42,0,0,0
2021-05-04 08:30,103,59,44,0,0,0
2021-05-04 08:45,117,72,45,0,0,0
2021-05-04 09:00,77,56,21,0,0,0
2021-05-04 09:15,89,48,41,0,0,0
2021-05-04 09:30,89,54,35,0,0,0
2021-05-04 09:45,80,47,33,0,0,0
2021-05-04 10:00,62,39,23,0,0,0
2021-05-04 10:15,64,37,27,0,0,0
2021-05-04 10:30,48,27,21,0,0,0
2021-05-04 10:45,55,26,29,0,0,0
2021-05-04 11:00,66,30,36,0,0,0
2021-05-04 11:15,59,20,39,0,0,0
2021-05-04 11:30,75,41,34,0,0,0
2021-05-04 11:45,82,40,42,0,0,0
2021-05-04 12:00,81,38,43,0,0,0
2021-05-04 12:15,72,40,32,0,0,0
2021-05-04 12:30,79,33,46,0,0,0
2021-05-04 12:45,93,53,40,0,0,0
2021-05-04 13:00,123,33,90,0,0,0
2021-05-04 13:15,104,34,70,0,0,0
2021-05-04 13:30,101,49,52,0,0,0
2021-05-04 13:45,99,53,46,0,0,0
2021-05-04 14:00,103,46,57,0,0,0
2021-05-04 14:15,88,45,43,0,0,0
2021-05-04 14:30,87,35,52,0,0,0
2021-05-04 14:45,98,53,45,0,0,0
2021-05-04 15:00,84,38,46,0,0,0
2021-05-04 15:15,77,39,38,0,0,0
2021-05-04 15:30,97,46,51,0,0,0
2021-05-04 15:45,112,71,41,0,0,0
2021-05-04 16:00,108,54,54,0,0,0
2021-05-04 16:15,155,70,85,0,0,0
2021-05-04 16:30,114,64,50,0,0,0
2021-05-04 16:45,112,58,54,0,0,0
2021-05-04 17:00,109,47,62,0,0,0
2021-05-04 17:15,114,46,68,0,0,0
2021-05-04 17:30,114,42,72,0,0,0
2021-05-04 17:45,134,72,62,0,0,0
2021-05-04 18:00,166,64,102,0,0,0
2021-05-04 18:15,117,61,56,0,0,0
2021-05-04 18:30,101,38,63,0,0,0
2021-05-04 18:45,83,37,46,0,0,0
2021-05-04 19:00,72,39,33,0,0,0
2021-05-04 19:15,80,31,49,0,0,0
2021-05-04 19:30,65,33,32,0,0,0
2021-05-04 19:45,61,24,37,0,0,0
2021-05-04 20:00,65,37,28,0,0,0
2021-05-04 20:15,53,24,29,0,0,0
2021-05-04 20:30,48,15,33,0,0,0
2021-05-04 20:45,55,18,37,0,0,0
2021-05-04 21:00,37,19,18,0,0,0
2021-05-04 21:15,41,20,21,0,0,0
2021-05-04 21:30,42,20,22,0,0,0
2021-05-04 21:45,30,13,17,0,0,0
2021-05-04 22:00,18,5,13,0,0,0
2021-05-04 22:15,15,7,8,0,0,0
2021-05-04 22:30,30,19,11,0,0,0
2021-05-04 22:45,23,5,18,0,0,0
2021-05-04 23:00,22,11,11,0,0,0
2021-05-04 23:15,26,11,15,0,0,0
2021-05-04 23:30,21,8,13,0,0,0
2021-05-04 23:45,12,4,8,0,0,0
2021-05-05 00:00,19,11,8,0,0,0
2021-05-05 00:15,15,5,10,0,0,0
2021-05-05 00:30,13,6,7,0,0,0
2021-05-05 00:45,7,3,4,0,0,0
2021-05-05 01:00,5,3,2,0,0,0
2021-05-05 01:15,6,3,3,0,0,0
2021-05-05 01:30,3,0,3,0,0,0
2021-05-05 01:45,4,2,2,0,0,0
2021-05-05 02:00,4,3,1,0,0,0
2021-05-05 02:15,2,1,1,0,0,0
2021-05-05 02:30,2,0,2,0,0,0
2021-05-05 02:45,0,0,0,0,0,0
2021-05-05 03:00,4,0,4,0,0,0
2021-05-05 03:15,0,0,0,0,0,0
2021-05-05 03:30,0,0,0,0,0,0
2021-05-05 03:45,0,0,0,0,0,0
2021-05-05 04:00,3,1,2,0,0,0
2021-05-05 04:15,5,2,3,0,0,0
2021-05-05 04:30,2,1,1,0,0,0
2021-05-05 04:45,8,6,2,0,0,0
2021-05-05 05:00,6,3,3,0,0,0
2021-05-05 05:15,15,9,6,0,0,0
2021-05-05 05:30,13,7,6,0,0,0
2021-05-05 05:45,10,8,2,0,0,0
2021-05-05 06:00,15,11,4,0,0,0
2021-05-05 06:15,29,20,9,0,0,0
2021-05-05 06:30,40,30,10,0,0,0
2021-05-05 06:45,56,40,16,0,0,0
2021-05-05 07:00,73,49,24,0,0,0
2021-05-05 07:15,107,72,35,0,0,0
2021-05-05 07:30,180,120,60,0,0,0
2021-05-05 07:45,170,110,60,0,0,0
2021-05-05 08:00,157,94,63,0,0,0
2021-05-05 08:15,137,85,52,0,0,0
2021-05-05 08:30,136,90,46,0,0,0
2021-05-05 08:45,157,94,63,0,0,0
2021-05-05 09:00,99,61,38,0,0,0
2021-05-05 09:15,118,62,56,0,0,0
2021-05-05 09:30,99,64,35,0,0,0
2021-05-05 09:45,119,77,42,0,0,0
2021-05-05 10:00,106,57,49,0,0,0
2021-05-05 10:15,96,53,43,0,0,0
2021-05-05 10:30,86,48,38,0,0,0
2021-05-05 10:45,123,78,45,0,0,0
2021-05-05 11:00,89,49,40,0,0,0
2021-05-05 11:15,80,32,48,0,0,0
2021-05-05 11:30,105,49,56,0,0,0
2021-05-05 11:45,122,73,49,0,0,0
2021-05-05 12:00,112,57,55,0,0,0
2021-05-05 12:15,151,82,69,0,0,0
2021-05-05 12:30,133,62,71,0,0,0
2021-05-05 12:45,133,58,75,0,0,0
2021-05-05 13:00,135,54,81,0,0,0
2021-05-05 13:15,150,62,88,0,0,0
2021-05-05 13:30,134,53,81,0,0,0
2021-05-05 13:45,126,49,77,0,0,0
2021-05-05 14:00,115,57,58,0,0,0
2021-05-05 14:15,113,59,54,0,0,0
2021-05-05 14:30,119,48,71,0,0,0
2021-05-05 14:45,138,72,66,0,0,0
2021-05-05 15:00,97,41,56,0,0,0
2021-05-05 15:15,86,41,45,0,0,0
2021-05-05 15:30,118,61,57,0,0,0
2021-05-05 15:45,127,58,69,0,0,0
2021-05-05 16:00,116,65,51,0,0,0
2021-05-05 16:15,149,63,86,0,0,0
2021-05-05 16:30,153,87,66,0,0,0
2021-05-05 16:45,159,84,75,0,0,0
2021-05-05 17:00,137,70,67,0,0,0
2021-05-05 17:15,162,77,85,0,0,0
2021-05-05 17:30,154,57,97,0,0,0
2021-05-05 17:45,146,63,83,0,0,0
2021-05-05 18:00,157,45,112,0,0,0
2021-05-05 18:15,174,75,99,0,0,0
2021-05-05 18:30,134,67,67,0,0,0
2021-05-05 18:45,121,52,69,0,0,0
2021-05-05 19:00,117,53,64,0,0,0
2021-05-05 19:15,104,50,54,0,0,0
2021-05-05 19:30,107,48,59,0,0,0
2021-05-05 19:45,94,40,54,0,0,0
2021-05-05 20:00,88,44,44,0,0,0
2021-05-05 20:15,75,41,34,0,0,0
2021-05-05 20:30,69,28,41,0,0,0
2021-05-05 20:45,60,31,29,0,0,0
2021-05-05 21:00,55,19,36,0,0,0
2021-05-05 21:15,31,16,15,0,0,0
2021-05-05 21:30,40,16,24,0,0,0
2021-05-05 21:45,45,20,25,0,0,0
2021-05-05 22:00,32,7,25,0,0,0
2021-05-05 22:15,27,6,21,0,0,0
2021-05-05 22:30,40,18,22,0,0,0
2021-05-05 22:45,20,6,14,0,0,0
2021-05-05 23:00,40,23,17,0,0,0
2021-05-05 23:15,39,17,22,0,0,0
2021-05-05 23:30,41,14,27,0,0,0
2021-05-05 23:45,24,9,15,0,0,0
2021-05-06 00:00,21,12,9,0,0,0
2021-05-06 00:15,15,6,9,0,0,0
2021-05-06 00:30,14,6,8,0,0,0
2021-05-06 00:45,16,3,13,0,0,0
2021-05-06 01:00,12,7,5,0,0,0
2021-05-06 01:15,4,2,2,0,0,0
2021-05-06 01:30,9,7,2,0,0,0
2021-05-06 01:45,9,5,4,0,0,0
2021-05-06 02:00,8,7,1,0,0,0
2021-05-06 02:15,3,2,1,0,0,0
2021-05-06 02:30,5,2,3,0,0,0
2021-05-06 02:45,0,0,0,0,0,0
2021-05-06 03:00,4,2,2,0,0,0
2021-05-06 03:15,2,2,0,0,0,0
2021-05-06 03:30,4,0,4,0,0,0
2021-05-06 03:45,1,1,0,0,0,0
2021-05-06 04:00,1,0,1,0,0,0
2021-05-06 04:15,3,2,1,0,0,0
2021-05-06 04:30,3,1,2,0,0,0
2021-05-06 04:45,11,9,2,0,0,0
2021-05-06 05:00,2,2,0,0,0,0
2021-05-06 05:15,10,7,3,0,0,0
2021-05-06 05:30,19,9,10,0,0,0
2021-05-06 05:45,15,11,4,0,0,0
2021-05-06 06:00,18,13,5,0,0,0
2021-05-06 06:15,33,17,16,0,0,0
2021-05-06 06:30,28,16,12,0,0,0
2021-05-06 06:45,44,33,11,0,0,0
2021-05-06 07:00,66,42,24,0,0,0
2021-05-06 07:15,88,58,30,0,0,0
2021-05-06 07:30,139,86,53,0,0,0
2021-05-06 07:45,203,137,66,0,0,0
2021-05-06 08:00,148,102,46,0,0,0
2021-05-06 08:15,139,86,53,0,0,0
2021-05-06 08:30,129,75,54,0,0,0
2021-05-06 08:45,155,91,64,0,0,0
2021-05-06 09:00,110,69,41,0,0,0
2021-05-06 09:15,106,52,54,0,0,0
2021-05-06 09:30,98,64,34,0,0,0
2021-05-06 09:45,110,59,51,0,0,0
2021-05-06 10:00,91,46,45,0,0,0
2021-05-06 10:15,79,41,38,0,0,0
2021-05-06 10:30,89,57,32,0,0,0
2021-05-06 10:45,104,62,42,0,0,0
2021-05-06 11:00,76,31,45,0,0,0
2021-05-06 11:15,94,46,48,0,0,0
2021-05-06 11:30,80,46,34,0,0,0
2021-05-06 11:45,115,67,48,0,0,0
2021-05-06 12:00,108,57,51,0,0,0
2021-05-06 12:15,137,78,59,0,0,0
2021-05-06 12:30,144,72,72,0,0,0
2021-05-06 12:45,128,73,55,0,0,0
2021-05-06 13:00,140,64,76,0,0,0
2021-05-06 13:15,139,52,87,0,0,0
2021-05-06 13:30,146,64,82,0,0,0
2021-05-06 13:45,175,96,79,0,0,0
2021-05-06 14:00,135,68,67,0,0,0
2021-05-06 14:15,130,78,52,0,0,0
2021-05-06 14:30,137,63,74,0,0,0
2021-05-06 14:45,133,55,78,0,0,0
2021-05-06 15:00,151,66,85,0,0,0
2021-05-06 15:15,128,50,78,0,0,0
2021-05-06 15:30,126,60,66,0,0,0
2021-05-06 15:45,167,78,89,0,0,0
2021-05-06 16:00,127,72,55,0,0,0
2021-05-06 16:15,154,73,81,0,0,0
2021-05-06 16:30,158,83,75,0,0,0
2021-05-06 16:45,172,67,105,0,0,0
2021-05-06 17:00,165,72,93,0,0,0
2021-05-06 17:15,193,82,111,0,0,0
2021-05-06 17:30,178,64,114,0,0,0
2021-05-06 17:45,167,72,95,0,0,0
2021-05-06 18:00,162,65,97,0,0,0
2021-05-06 18:15,133,51,82,0,0,0
2021-05-06 18:30,144,57,87,0,0,0
2021-05-06 18:45,147,65,82,0,0,0
2021-05-06 19:00,150,67,83,0,0,0
2021-05-06 19:15,104,43,61,0,0,0
2021-05-06 19:30,107,40,67,0,0,0
2021-05-06 19:45,129,63,66,0,0,0
2021-05-06 20:00,106,45,61,0,0,0
2021-05-06 20:15,81,28,53,0,0,0
2021-05-06 20:30,69,29,40,0,0,0
2021-05-06 20:45,54,24,30,0,0,0
2021-05-06 21:00,49,18,31,0,0,0
2021-05-06 21:15,41,21,20,0,0,0
2021-05-06 21:30,23,9,14,0,0,0
2021-05-06 21:45,37,23,14,0,0,0
2021-05-06 22:00,32,14,18,0,0,0
2021-05-06 22:15,30,13,17,0,0,0
2021-05-06 22:30,36,15,21,0,0,0
2021-05-06 22:45,18,9,9,0,0,0
2021-05-06 23:00,40,12,28,0,0,0
2021-05-06 23:15,28,9,19,0,0,0
2021-05-06 23:30,29,14,15,0,0,0
2021-05-06 23:45,24,16,8,0,0,0
2021-05-07 00:00,26,9,17,0,0,0
2021-05-07 00:15,19,10,9,0,0,0
2021-05-07 00:30,6,1,5,0,0,0
2021-05-07 00:45,17,10,7,0,0,0
2021-05-07 01:00,7,3,4,0,0,0
2021-05-07 01:15,14,7,7,0,0,0
2021-05-07 01:30,7,4,3,0,0,0
2021-05-07 01:45,6,2,4,0,0,0
2021-05-07 02:00,6,2,4,0,0,0
2021-05-07 02:15,6,3,3,0,0,0
2021-05-07 02:30,2,1,1,0,0,0
2021-05-07 02:45,2,0,2,0,0,0
2021-05-07 03:00,3,3,0,0,0,0
2021-05-07 03:15,3,1,2,0,0,0
2021-05-07 03:30,0,0,0,0,0,0
2021-05-07 03:45,1,1,0,0,0,0
2021-05-07 04:00,0,0,0,0,0,0
2021-05-07 04:15,1,0,1,0,0,0
2021-05-07 04:30,5,0,5,0,0,0
2021-05-07 04:45,5,3,2,0,0,0
2021-05-07 05:00,5,5,0,0,0,0
2021-05-07 05:15,8,7,1,0,0,0
2021-05-07 05:30,8,5,3,0,0,0
2021-05-07 05:45,18,15,3,0,0,0
2021-05-07 06:00,29,22,7,0,0,0
2021-05-07 06:15,45,31,14,0,0,0
2021-05-07 06:30,44,25,19,0,0,0
2021-05-07 06:45,58,35,23,0,0,0
2021-05-07 07:00,81,57,24,0,0,0
2021-05-07 07:15,96,54,42,0,0,0
2021-05-07 07:30,170,120,50,0,0,0
2021-05-07 07:45,224,144,80,0,0,0
2021-05-07 08:00,143,95,48,0,0,0
2021-05-07 08:15,161,97,64,0,0,0
2021-05-07 08:30,118,62,56,0,0,0
2021-05-07 08:45,144,89,55,0,0,0
2021-05-07 09:00,88,52,36,0,0,0
2021-05-07 09:15,91,55,36,0,0,0
2021-05-07 09:30,116,64,52,0,0,0
2021-05-07 09:45,128,75,53,0,0,0
2021-05-07 10:00,106,55,51,0,0,0
2021-05-07 10:15,102,70,32,0,0,0
2021-05-07 10:30,87,49,38,0,0,0
2021-05-07 10:45,96,56,40,0,0,0
2021-05-07 11:00,96,51,45,0,0,0
2021-05-07 11:15,100,41,59,0,0,0
2021-05-07 11:30,95,52,43,0,0,0
2021-05-07 11:45,120,72,48,0,0,0
2021-05-07 12:00,128,62,66,0,0,0
2021-05-07 12:15,142,68,74,0,0,0
2021-05-07 12:30,140,69,71,0,0,0
2021-05-07 12:45,158,79,79,0,0,0
2021-05-07 13:00,173,76,97,0,0,0
2021-05-07 13:15,159,66,93,0,0,0
2021-05-07 13:30,183,67,116,0,0,0
2021-05-07 13:45,184,101,83,0,0,0
2021-05-07 14:00,169,84,85,0,0,0
2021-05-07 14:15,140,67,73,0,0,0
2021-05-07 14:30,142,75,67,0,0,0
2021-05-07 14:45,167,85,82,0,0,0
2021-05-07 15:00,163,79,84,0,0,0
2021-05-07 15:15,151,59,92,0,0,0
2021-05-07 15:30,172,80,92,0,0,0
2021-05-07 15:45,180,92,88,0,0,0
2021-05-07 16:00,149,76,73,0,0,0
2021-05-07 16:15,118,63,55,0,0,0
2021-05-07 16:30,149,61,88,0,0,0
2021-05-07 16:45,161,86,75,0,0,0
2021-05-07 17:00,155,69,86,0,0,0
2021-05-07 17:15,158,69,89,0,0,0
2021-05-07 17:30,156,70,86,0,0,0
2021-05-07 17:45,143,55,88,0,0,0
2021-05-07 18:00,173,60,113,0,0,0
2021-05-07 18:15,153,65,88,0,0,0
2021-05-07 18:30,109,46,63,0,0,0
2021-05-07 18:45,119,56,63,0,0,0
2021-05-07 19:00,126,60,66,0,0,0
2021-05-07 19:15,136,67,69,0,0,0
2021-05-07 19:30,113,48,65,0,0,0
2021-05-07 19:45,107,56,51,0,0,0
2021-05-07 20:00,113,55,58,0,0,0
2021-05-07 20:15,87,33,54,0,0,0
2021-05-07 20:30,62,26,36,0,0,0
2021-05-07 20:45,59,29,30,0,0,0
2021-05-07 21:00,56,27,29,0,0,0
2021-05-07 21:15,54,27,27,0,0,0
2021-05-07 21:30,56,29,27,0,0,0
2021-05-07 21:45,20,9,11,0,0,0
2021-05-07 22:00,42,14,28,0,0,0
2021-05-07 22:15,38,14,24,0,0,0
2021-05-07 22:30,35,13,22,0,0,0
2021-05-07 22:45,30,9,21,0,0,0
2021-05-07 23:00,37,14,23,0,0,0
2021-05-07 23:15,38,7,31,0,0,0
2021-05-07 23:30,26,12,14,0,0,0
2021-05-07 23:45,22,11,11,0,0,0
2021-05-08 00:00,22,11,11,0,0,0
2021-05-08 00:15,20,7,13,0,0,0
2021-05-08 00:30,29,11,18,0,0,0
2021-05-08 00:45,34,18,16,0,0,0
2021-05-08 01:00,34,17,17,0,0,0
2021-05-08 01:15,22,9,13,0,0,0
2021-05-08 01:30,25,13,12,0,0,0
2021-05-08 01:45,26,12,14,0,0,0
2021-05-08 02:00,24,10,14,0,0,0
2021-05-08 02:15,18,9,9,0,0,0
2021-05-08 02:30,22,10,12,0,0,0
2021-05-08 02:45,15,6,9,0,0,0
2021-05-08 03:00,12,7,5,0,0,0
2021-05-08 03:15,18,7,11,0,0,0
2021-05-08 03:30,11,5,6,0,0,0
2021-05-08 03:45,10,3,7,0,0,0
2021-05-08 04:00,5,2,3,0,0,0
2021-05-08 04:15,1,0,1,0,0,0
2021-05-08 04:30,2,0,2,0,0,0
2021-05-08 04:45,9,4,5,0,0,0
2021-05-08 05:00,7,3,4,0,0,0
2021-05-08 05:15,10,10,0,0,0,0
2021-05-08 05:30,10,6,4,0,0,0
2021-05-08 05:45,16,8,8,0,0,0
2021-05-08 06:00,6,5,1,0,0,0
2021-05-08 06:15,10,5,5,0,0,0
2021-05-08 06:30,9,7,2,0,0,0
2021-05-08 06:45,10,6,4,0,0,0
2021-05-08 07:00,15,11,4,0,0,0
2021-05-08 07:15,24,18,6,0,0,0
2021-05-08 07:30,26,19,7,0,0,0
2021-05-08 07:45,24,13,11,0,0,0
2021-05-08 08:00,32,27,5,0,0,0
2021-05-08 08:15,49,29,20,0,0,0
2021-05-08 08:30,63,40,23,0,0,0
2021-05-08 08:45,62,36,26,0,0,0
2021-05-08 09:00,62,39,23,0,0,0
2021-05-08 09:15,57,36,21,0,0,0
2021-05-08 09:30,100,77,23,0,0,0
2021-05-08 09:45,116,76,40,0,0,0
2021-05-08 10:00,109,68,41,0,0,0
2021-05-08 10:15,111,70,41,0,0,0
2021-05-08 10:30,124,90,34,0,0,0
2021-05-08 10:45,156,93,63,0,0,0
2021-05-08 11:00,138,81,57,0,0,0
2021-05-08 11:15,131,71,60,0,0,0
2021-05-08 11:30,113,71,42,0,0,0
2021-05-08 11:45,174,113,61,0,0,0
2021-05-08 12:00,141,78,63,0,0,0
2021-05-08 12:15,135,85,50,0,0,0
2021-05-08 12:30,156,63,93,0,0,0
2021-05-08 12:45,161,91,70,0,0,0
2021-05-08 13:00,137,52,85,0,0,0
2021-05-08 13:15,155,68,87,0,0,0
2021-05-08 13:30,157,75,82,0,0,0
2021-05-08 13:45,145,62,83,0,0,0
2021-05-08 14:00,144,52,92,0,0,0
2021-05-08 14:15,156,70,86,0,0,0
2021-05-08 14:30,145,54,91,0,0,0
2021-05-08 14:45,137,56,81,0,0,0
2021-05-08 15:00,111,48,63,0,0,0
2021-05-08 15:15,151,69,82,0,0,0
2021-05-08 15:30,124,46,78,0,0,0
2021-05-08 15:45,97,39,58,0,0,0
2021-05-08 16:00,96,35,61,0,0,0
2021-05-08 16:15,82,28,54,0,0,0
2021-05-08 16:30,66,22,44,0,0,0
2021-05-08 16:45,97,49,48,0,0,0
2021-05-08 17:00,67,27,40,0,0,0
2021-05-08 17:15,90,38,52,0,0,0
2021-05-08 17:30,62,28,34,0,0,0
2021-05-08 17:45,101,41,60,0,0,0
2021-05-08 18:00,82,24,58,0,0,0
2021-05-08 18:15,79,41,38,0,0,0
2021-05-08 18:30,78,41,37,0,0,0
2021-05-08 18:45,95,45,50,0,0,0
2021-05-08 19:00,112,62,50,0,0,0
2021-05-08 19:15,94,51,43,0,0,0
2021-05-08 19:30,65,35,30,0,0,0
2021-05-08 19:45,82,30,52,0,0,0
2021-05-08 20:00,71,34,37,0,0,0
2021-05-08 20:15,69,38,31,0,0,0
2021-05-08 20:30,47,24,23,0,0,0
2021-05-08 20:45,40,17,23,0,0,0
2021-05-08 21:00,56,26,30,0,0,0
2021-05-08 21:15,50,16,34,0,0,0
2021-05-08 21:30,36,17,19,0,0,0
2021-05-08 21:45,41,18,23,0,0,0
2021-05-08 22:00,37,15,22,0,0,0
2021-05-08 22:15,37,15,22,0,0,0
2021-05-08 22:30,23,14,9,0,0,0
2021-05-08 22:45,27,10,17,0,0,0
2021-05-08 23:00,24,9,15,0,0,0
2021-05-08 23:15,19,5,14,0,0,0
2021-05-08 23:30,28,10,18,0,0,0
2021-05-08 23:45,34,16,18,0,0,0
2021-05-09 00:00,22,13,9,0,0,0
2021-05-09 00:15,46,14,32,0,0,0
2021-05-09 00:30,28,14,14,0,0,0
2021-05-09 00:45,45,17,28,0,0,0
2021-05-09 01:00,32,13,19,0,0,0
2021-05-09 01:15,21,7,14,0,0,0
2021-05-09 01:30,24,12,12,0,0,0
2021-05-09 01:45,24,10,14,0,0,0
2021-05-09 02:00,20,8,12,0,0,0
2021-05-09 02:15,18,10,8,0,0,0
2021-05-09 02:30,13,7,6,0,0,0
2021-05-09 02:45,14,3,11,0,0,0
2021-05-09 03:00,11,2,9,0,0,0
2021-05-09 03:15,7,2,5,0,0,0
2021-05-09 03:30,4,0,4,0,0,0
2021-05-09 03:45,9,5,4,0,0,0
2021-05-09 04:00,8,2,6,0,0,0
2021-05-09 04:15,7,3,4,0,0,0
2021-05-09 04:30,0,0,0,0,0,0
2021-05-09 04:45,2,0,2,0,0,0
2021-05-09 05:00,1,1,0,0,0,0
2021-05-09 05:15,4,3,1,0,0,0
2021-05-09 05:30,6,1,5,0,0,0
2021-05-09 05:45,4,3,1,0,0,0
2021-05-09 06:00,9,3,6,0,0,0
2021-05-09 06:15,8,6,2,0,0,0
2021-05-09 06:30,8,4,4,0,0,0
2021-05-09 06:45,4,1,3,0,0,0
2021-05-09 07:00,8,3,5,0,0,0
2021-05-09 07:15,5,2,3,0,0,0
2021-05-09 07:30,11,5,6,0,0,0
2021-05-09 07:45,14,7,7,0,0,0
2021-05-09 08:00,14,9,5,0,0,0
2021-05-09 08:15,22,10,12,0,0,0
2021-05-09 08:30,21,15,6,0,0,0
2021-05-09 08:45,34,23,11,0,0,0
2021-05-09 09:00,30,19,11,0,0,0
2021-05-09 09:15,29,18,11,0,0,0
2021-05-09 09:30,42,26,16,0,0,0
2021-05-09 09:45,86,53,33,0,0,0
2021-05-09 10:00,81,50,31,0,0,0
2021-05-09 10:15,69,50,19,0,0,0
2021-05-09 10:30,59,32,27,0,0,0
2021-05-09 10:45,91,38,53,0,0,0
2021-05-09 11:00,79,39,40,0,0,0
2021-05-09 11:15,76,45,31,0,0,0
2021-05-09 11:30,111,58,53,0,0,0
2021-05-09 11:45,100,47,53,0,0,0
2021-05-09 12:00,134,62,72,0,0,0
2021-05-09 12:15,131,76,55,0,0,0
2021-05-09 12:30,152,74,78,0,0,0
2021-05-09 12:45,127,82,45,0,0,0
2021-05-09 13:00,148,79,69,0,0,0
2021-05-09 13:15,129,59,70,0,0,0
2021-05-09 13:30,147,68,79,0,0,0
2021-05-09 13:45,171,100,71,0,0,0
2021-05-09 14:00,161,80,81,0,0,0
2021-05-09 14:15,147,91,56,0,0,0
2021-05-09 14:30,173,105,68,0,0,0
2021-05-09 14:45,194,100,94,0,0,0
2021-05-09 15:00,169,99,70,0,0,0
2021-05-09 15:15,159,81,78,0,0,0
2021-05-09 15:30,166,97,69,0,0,0
2021-05-09 15:45,155,84,71,0,0,0
2021-05-09 16:00,152,95,57,0,0,0
2021-05-09 16:15,121,71,50,0,0,0
2021-05-09 16:30,138,73,65,0,0,0
2021-05-09 16:45,152,68,84,0,0,0
2021-05-09 17:00,163,80,83,0,0,0
2021-05-09 17:15,139,72,67,0,0,0
2021-05-09 17:30,143,72,71,0,0,0
2021-05-09 17:45,157,84,73,0,0,0
2021-05-09 18:00,165,69,96,0,0,0
2021-05-09 18:15,136,64,72,0,0,0
2021-05-09 18:30,134,61,73,0,0,0
2021-05-09 18:45,130,67,63,0,0,0
2021-05-09 19:00,114,57,57,0,0,0
2021-05-09 19:15,112,39,73,0,0,0
2021-05-09 19:30,112,52,60,0,0,0
2021-05-09 19:45,107,45,62,0,0,0
2021-05-09 20:00,123,55,68,0,0,0
2021-05-09 20:15,90,44,46,0,0,0
2021-05-09 20:30,99,39,60,0,0,0
2021-05-09 20:45,91,40,51,0,0,0
2021-05-09 21:00,81,24,57,0,0,0
2021-05-09 21:15,80,34,46,0,0,0
2021-05-09 21:30,73,27,46,0,0,0
2021-05-09 21:45,65,24,41,0,0,0
2021-05-09 22:00,70,23,47,0,0,0
2021-05-09 22:15,60,17,43,0,0,0
2021-05-09 22:30,59,11,48,0,0,0
2021-05-09 22:45,33,8,25,0,0,0
2021-05-09 23:00,35,9,26,0,0,0
2021-05-09 23:15,26,7,19,0,0,0
2021-05-09 23:30,26,9,17,0,0,0
2021-05-09 23:45,20,6,14,0,0,0
2021-05-10 00:00,26,6,20,0,0,0
2021-05-10 00:15,8,3,5,0,0,0
2021-05-10 00:30,8,1,7,0,0,0
2021-05-10 00:45,14,3,11,0,0,0
2021-05-10 01:00,12,2,10,0,0,0
2021-05-10 01:15,12,2,10,0,0,0
2021-05-10 01:30,4,1,3,0,0,0
2021-05-10 01:45,2,0,2,0,0,0
2021-05-10 02:00,4,2,2,0,0,0
2021-05-10 02:15,2,1,1,0,0,0
2021-05-10 02:30,3,0,3,0,0,0
2021-05-10 02:45,2,2,0,0,0,0
2021-05-10 03:00,4,2,2,0,0,0
2021-05-10 03:15,0,0,0,0,0,0
2021-05-10 03:30,2,1,1,0,0,0
2021-05-10 03:45,0,0,0,0,0,0
2021-05-10 04:00,4,0,4,0,0,0
2021-05-10 04:15,0,0,0,0,0,0
2021-05-10 04:30,5,3,2,0,0,0
2021-05-10 04:45,8,5,3,0,0,0
2021-05-10 05:00,3,2,1,0,0,0
2021-05-10 05:15,14,10,4,0,0,0
2021-05-10 05:30,14,10,4,0,0,0
2021-05-10 05:45,24,18,6,0,0,0
2021-05-10 06:00,27,20,7,0,0,0
2021-05-10 06:15,42,28,14,0,0,0
2021-05-10 06:30,50,37,13,0,0,0
2021-05-10 06:45,92,59,33,0,0,0
2021-05-10 07:00,73,49,24,0,0,0
2021-05-10 07:15,115,82,33,0,0,0
2021-05-10 07:30,176,112,64,0,0,0
2021-05-10 07:45,235,151,84,0,0,0
2021-05-10 08:00,191,106,85,0,0,0
2021-05-10 08:15,155,94,61,0,0,0
2021-05-10 08:30,126,64,62,0,0,0
2021-05-10 08:45,144,72,72,0,0,0
2021-05-10 09:00,96,57,39,0,0,0
2021-05-10 09:15,109,63,46,0,0,0
2021-05-10 09:30,93,45,48,0,0,0
2021-05-10 09:45,105,59,46,0,0,0
2021-05-10 10:00,71,38,33,0,0,0
2021-05-10 10:15,78,39,39,0,0,0
2021-05-10 10:30,99,56,43,0,0,0
2021-05-10 10:45,100,50,50,0,0,0
2021-05-10 11:00,97,39,58,0,0,0
2021-05-10 11:15,108,45,63,0,0,0
2021-05-10 11:30,101,46,55,0,0,0
2021-05-10 11:45,123,55,68,0,0,0
2021-05-10 12:00,119,44,75,0,0,0
2021-05-10 12:15,120,57,63,0,0,0
2021-05-10 12:30,134,66,68,0,0,0
2021-05-10 12:45,135,52,83,0,0,0
2021-05-10 13:00,159,64,95,0,0,0
2021-05-10 13:15,141,61,80,0,0,0
2021-05-10 13:30,148,56,92,0,0,0
2021-05-10 13:45,151,73,78,0,0,0
2021-05-10 14:00,147,69,78,0,0,0
2021-05-10 14:15,134,77,57,0,0,0
2021-05-10 14:30,143,62,81,0,0,0
2021-05-10 14:45,153,62,91,0,0,0
2021-05-10 15:00,113,53,60,0,0,0
2021-05-10 15:15,133,55,78,0,0,0
2021-05-10 15:30,160,81,79,0,0,0
2021-05-10 15:45,181,86,95,0,0,0
2021-05-10 16:00,181,81,100,0,0,0
2021-05-10 16:15,172,69,103,0,0,0
2021-05-10 16:30,161,77,84,0,0,0
2021-05-10 16:45,163,74,89,0,0,0
2021-05-10 17:00,170,87,83,0,0,0
2021-05-10 17:15,184,85,99,0,0,0
2021-05-10 17:30,155,68,87,0,0,0
2021-05-10 17:45,174,73,101,0,0,0
2021-05-10 18:00,165,62,103,0,0,0
2021-05-10 18:15,169,62,107,0,0,0
2021-05-10 18:30,152,61,91,0,0,0
2021-05-10 18:45,132,52,80,0,0,0
2021-05-10 19:00,140,63,77,0,0,0
2021-05-10 19:15,106,48,58,0,0,0
2021-05-10 19:30,78,37,41,0,0,0
2021-05-10 19:45,102,37,65,0,0,0
2021-05-10 20:00,91,42,49,0,0,0
2021-05-10 20:15,104,53,51,0,0,0
2021-05-10 20:30,66,32,34,0,0,0
2021-05-10 20:45,56,22,34,0,0,0
2021-05-10 21:00,57,29,28,0,0,0
2021-05-10 21:15,56,19,37,0,0,0
2021-05-10 21:30,44,23,21,0,0,0
2021-05-10 21:45,48,17,31,0,0,0
2021-05-10 22:00,37,17,20,0,0,0
2021-05-10 22:15,43,14,29,0,0,0
2021-05-10 22:30,42,17,25,0,0,0
2021-05-10 22:45,27,12,15,0,0,0
2021-05-10 23:00,22,9,13,0,0,0
2021-05-10 23:15,18,5,13,0,0,0
2021-05-10 23:30,33,10,23,0,0,0
2021-05-10 23:45,16,7,9,0,0,0
2021-05-11 00:00,20,8,12,0,0,0
2021-05-11 00:15,14,8,6,0,0,0
2021-05-11 00:30,22,7,15,0,0,0
2021-05-11 00:45,5,2,3,0,0,0
2021-05-11 01:00,7,1,6,0,0,0
2021-05-11 01:15,7,4,3,0,0,0
2021-05-11 01:30,4,1,3,0,0,0
2021-05-11 01:45,5,4,1,0,0,0
2021-05-11 02:00,2,1,1,0,0,0
2021-05-11 02:15,6,1,5,0,0,0
2021-05-11 02:30,3,1,2,0,0,0
2021-05-11 02:45,3,2,1,0,0,0
2021-05-11 03:00,5,1,4,0,0,0
2021-05-11 03:15,0,0,0,0,0,0
2021-05-11 03:30,3,2,1,0,0,0
2021-05-11 03:45,0,0,0,0,0,0
2021-05-11 04:00,4,1,3,0,0,0
2021-05-11 04:15,4,0,4,0,0,0
2021-05-11 04:30,2,0,2,0,0,0
2021-05-11 04:45,9,7,2,0,0,0
2021-05-11 05:00,5,3,2,0,0,0
2021-05-11 05:15,6,4,2,0,0,0
2021-05-11 05:30,18,16,2,0,0,0
2021-05-11 05:45,20,15,5,0,0,0
2021-05-11 06:00,22,18,4,0,0,0
2021-05-11 06:15,41,24,17,0,0,0
2021-05-11 06:30,43,30,13,0,0,0
2021-05-11 06:45,63,46,17,0,0,0
2021-05-11 07:00,60,43,17,0,0,0
2021-05-11 07:15,108,74,34,0,0,0
2021-05-11 07:30,179,126,53,0,0,0
2021-05-11 07:45,261,177,84,0,0,0
2021-05-11 08:00,173,108,65,0,0,0
2021-05-11 08:15,150,82,68,0,0,0
2021-05-11 08:30,143,95,48,0,0,0
2021-05-11 08:45,144,76,68,0,0,0
2021-05-11 09:00,116,73,43,0,0,0
2021-05-11 09:15,98,60,38,0,0,0
2021-05-11 09:30,93,52,41,0,0,0
2021-05-11 09:45,122,69,53,0,0,0
2021-05-11 10:00,90,50,40,0,0,0
2021-05-11 10:15,92,60,32,0,0,0
2021-05-11 10:30,86,49,37,0,0,0
2021-05-11 10:45,104,56,48,0,0,0
2021-05-11 11:00,116,57,59,0,0,0
2021-05-11 11:15,107,51,56,0,0,0
2021-05-11 11:30,91,51,40,0,0,0
2021-05-11 11:45,117,68,49,0,0,0
2021-05-11 12:00,130,57,73,0,0,0
2021-05-11 12:15,95,50,45,0,0,0
2021-05-11 12:30,140,56,84,0,0,0
2021-05-11 12:45,138,68,70,0,0,0
2021-05-11 13:00,151,62,89,0,0,0
2021-05-11 13:15,134,53,81,0,0,0
2021-05-11 13:30,110,51,59,0,0,0
2021-05-11 13:45,114,63,51,0,0,0
2021-05-11 14:00,101,44,57,0,0,0
2021-05-11 14:15,102,50,52,0,0,0
2021-05-11 14:30,109,55,54,0,0,0
2021-05-11 14:45,114,60,54,0,0,0
2021-05-11 15:00,94,44,50,0,0,0
2021-05-11 15:15,108,52,56,0,0,0
2021-05-11 15:30,99,31,68,0,0,0
2021-05-11 15:45,120,57,63,0,0,0
2021-05-11 16:00,109,50,59,0,0,0
2021-05-11 16:15,132,57,75,0,0,0
2021-05-11 16:30,123,63,60,0,0,0
2021-05-11 16:45,149,65,84,0,0,0
2021-05-11 17:00,135,65,70,0,0,0
2021-05-11 17:15,141,68,73,0,0,0
2021-05-11 17:30,132,48,84,0,0,0
2021-05-11 17:45,122,62,60,0,0,0
2021-05-11 18:00,163,66,97,0,0,0
2021-05-11 18:15,154,62,92,0,0,0
2021-05-11 18:30,124,53,71,0,0,0
2021-05-11 18:45,108,48,60,0,0,0
2021-05-11 19:00,123,50,73,0,0,0
2021-05-11 19:15,91,34,57,0,0,0
2021-05-11 19:30,96,40,56,0,0,0
2021-05-11 19:45,83,43,40,0,0,0
2021-05-11 20:00,70,24,46,0,0,0
2021-05-11 20:15,59,32,27,0,0,0
2021-05-11 20:30,47,21,26,0,0,0
2021-05-11 20:45,53,26,27,0,0,0
2021-05-11 21:00,55,28,27,0,0,0
2021-05-11 21:15,39,17,22,0,0,0
2021-05-11 21:30,34,13,21,0,0,0
2021-05-11 21:45,41,19,22,0,0,0
2021-05-11 22:00,43,23,20,0,0,0
2021-05-11 22:15,30,12,18,0,0,0
2021-05-11 22:30,35,20,15,0,0,0
2021-05-11 22:45,29,10,19,0,0,0
2021-05-11 23:00,38,18,20,0,0,0
2021-05-11 23:15,16,3,13,0,0,0
2021-05-11 23:30,16,6,10,0,0,0
2021-05-11 23:45,26,14,12,0,0,0
2021-05-12 00:00,14,5,9,0,0,0
2021-05-12 00:15,10,2,8,0,0,0
2021-05-12 00:30,15,5,10,0,0,0
2021-05-12 00:45,3,1,2,0,0,0
2021-05-12 01:00,6,2,4,0,0,0
2021-05-12 01:15,9,2,7,0,0,0
2021-05-12 01:30,8,2,6,0,0,0
2021-05-12 01:45,7,5,2,0,0,0
2021-05-12 02:00,6,5,1,0,0,0
2021-05-12 02:15,3,2,1,0,0,0
2021-05-12 02:30,2,1,1,0,0,0
2021-05-12 02:45,5,0,5,0,0,0
2021-05-12 03:00,3,1,2,0,0,0
2021-05-12 03:15,4,2,2,0,0,0
2021-05-12 03:30,0,0,0,0,0,0
2021-05-12 03:45,2,2,0,0,0,0
2021-05-12 04:00,5,1,4,0,0,0
2021-05-12 04:15,7,3,4,0,0,0
2021-05-12 04:30,6,4,2,0,0,0
2021-05-12 04:45,9,7,2,0,0,0
2021-05-12 05:00,7,5,2,0,0,0
2021-05-12 05:15,9,6,3,0,0,0
2021-05-12 05:30,13,11,2,0,0,0
2021-05-12 05:45,21,17,4,0,0,0
2021-05-12 06:00,28,22,6,0,0,0
2021-05-12 06:15,31,25,6,0,0,0
2021-05-12 06:30,71,53,18,0,0,0
2021-05-12 06:45,81,53,28,0,0,0
2021-05-12 07:00,95,64,31,0,0,0
2021-05-12 07:15,121,87,34,0,0,0
2021-05-12 07:30,181,123,58,0,0,0
2021-05-12 07:45,182,112,70,0,0,0
2021-05-12 08:00,184,107,77,0,0,0
2021-05-12 08:15,170,111,59,0,0,0
2021-05-12 08:30,181,116,65,0,0,0
2021-05-12 08:45,180,103,77,0,0,0
2021-05-12 09:00,142,82,60,0,0,0
2021-05-12 09:15,129,69,60,0,0,0
2021-05-12 09:30,124,60,64,0,0,0
2021-05-12 09:45,118,72,46,0,0,0
2021-05-12 10:00,110,56,54,0,0,0
2021-05-12 10:15,120,91,29,0,0,0
2021-05-12 10:30,124,75,49,0,0,0
2021-05-12 10:45,121,74,47,0,0,0
2021-05-12 11:00,92,38,54,0,0,0
2021-05-12 11:15,138,69,69,0,0,0
2021-05-12 11:30,121,62,59,0,0,0
2021-05-12 11:45,163,88,75,0,0,0
2021-05-12 12:00,137,65,72,0,0,0
2021-05-12 12:15,151,69,82,0,0,0
2021-05-12 12:30,151,73,78,0,0,0
2021-05-12 12:45,191,89,102,0,0,0
2021-05-12 13:00,184,78,106,0,0,0
2021-05-12 13:15,161,81,80,0,0,0
2021-05-12 13:30,176,83,93,0,0,0
2021-05-12 13:45,193,75,118,0,0,0
2021-05-12 14:00,171,76,95,0,0,0
2021-05-12 14:15,180,76,104,0,0,0
2021-05-12 14:30,164,73,91,0,0,0
2021-05-12 14:45,174,81,93,0,0,0
2021-05-12 15:00,148,68,80,0,0,0
2021-05-12 15:15,130,46,84,0,0,0
2021-05-12 15:30,121,64,57,0,0,0
2021-05-12 15:45,171,72,99,0,0,0
2021-05-12 16:00,181,83,98,0,0,0
2021-05-12 16:15,197,108,89,0,0,0
2021-05-12 16:30,187,108,79,0,0,0
2021-05-12 16:45,204,108,96,0,0,0
2021-05-12 17:00,222,110,112,0,0,0
2021-05-12 17:15,194,105,89,0,0,0
2021-05-12 17:30,182,89,93,0,0,0
2021-05-12 17:45,175,70,105,0,0,0
2021-05-12 18:00,191,72,119,0,0,0
2021-05-12 18:15,157,54,103,0,0,0
2021-05-12 18:30,158,57,101,0,0,0
2021-05-12 18:45,138,64,74,0,0,0
2021-05-12 19:00,148,68,80,0,0,0
2021-05-12 19:15,121,48,73,0,0,0
2021-05-12 19:30,112,40,72,0,0,0
2021-05-12 19:45,145,79,66,0,0,0
2021-05-12 20:00,116,63,53,0,0,0
2021-05-12 20:15,115,50,65,0,0,0
2021-05-12 20:30,81,38,43,0,0,0
2021-05-12 20:45,81,31,50,0,0,0
2021-05-12 21:00,88,46,42,0,0,0
2021-05-12 21:15,72,28,44,0,0,0
2021-05-12 21:30,52,27,25,0,0,0
2021-05-12 21:45,43,15,28,0,0,0
2021-05-12 22:00,47,18,29,0,0,0
2021-05-12 22:15,51,17,34,0,0,0
2021-05-12 22:30,46,14,32,0,0,0
2021-05-12 22:45,34,11,23,0,0,0
2021-05-12 23:00,35,20,15,0,0,0
2021-05-12 23:15,38,17,21,0,0,0
2021-05-12 23:30,44,17,27,0,0,0
2021-05-12 23:45,35,13,22,0,0,0
2021-05-13 00:00,51,18,33,0,0,0
2021-05-13 00:15,26,14,12,0,0,0
2021-05-13 00:30,38,14,24,0,0,0
2021-05-13 00:45,39,19,20,0,0,0
2021-05-13 01:00,20,10,10,0,0,0
2021-05-13 01:15,33,8,25,0,0,0
2021-05-13 01:30,27,13,14,0,0,0
2021-05-13 01:45,23,9,14,0,0,0
2021-05-13 02:00,30,11,19,0,0,0
2021-05-13 02:15,29,12,17,0,0,0
2021-05-13 02:30,19,8,11,0,0,0
2021-05-13 02:45,19,10,9,0,0,0
2021-05-13 03:00,17,3,14,0,0,0
2021-05-13 03:15,15,7,8,0,0,0
2021-05-13 03:30,14,5,9,0,0,0
2021-05-13 03:45,8,3,5,0,0,0
2021-05-13 04:00,3,1,2,0,0,0
2021-05-13 04:15,2,1,1,0,0,0
2021-05-13 04:30,5,0,5,0,0,0
2021-05-13 04:45,4,3,1,0,0,0
2021-05-13 05:00,7,6,1,0,0,0
2021-05-13 05:15,8,4,4,0,0,0
2021-05-13 05:30,5,1,4,0,0,0
2021-05-13 05:45,8,3,5,0,0,0
2021-05-13 06:00,7,4,3,0,0,0
2021-05-13 06:15,9,4,5,0,0,0
2021-05-13 06:30,21,15,6,0,0,0
2021-05-13 06:45,12,5,7,0,0,0
2021-05-13 07:00,8,6,2,0,0,0
2021-05-13 07:15,9,9,0,0,0,0
2021-05-13 07:30,24,15,9,0,0,0
2021-05-13 07:45,22,14,8,0,0,0
2021-05-13 08:00,23,19,4,0,0,0
2021-05-13 08:15,27,12,15,0,0,0
2021-05-13 08:30,25,11,14,0,0,0
2021-05-13 08:45,32,13,19,0,0,0
2021-05-13 09:00,28,14,14,0,0,0
2021-05-13 09:15,43,30,13,0,0,0
2021-05-13 09:30,48,28,20,0,0,0
2021-05-13 09:45,65,44,21,0,0,0
2021-05-13 10:00,70,44,26,0,0,0
2021-05-13 10:15,79,38,41,0,0,0
2021-05-13 10:30,95,45,50,0,0,0
2021-05-13 10:45,93,61,32,0,0,0
2021-05-13 11:00,73,44,29,0,0,0
2021-05-13 11:15,90,44,46,0,0,0
2021-05-13 11:30,101,58,43,0,0,0
2021-05-13 11:45,104,61,43,0,0,0
2021-05-13 12:00,104,57,47,0,0,0
2021-05-13 12:15,129,64,65,0,0,0
2021-05-13 12:30,113,47,66,0,0,0
2021-05-13 12:45,68,28,40,0,0,0
2021-05-13 13:00,92,44,48,0,0,0
2021-05-13 13:15,142,55,87,0,0,0
2021-05-13 13:30,101,52,49,0,0,0
2021-05-13 13:45,129,73,56,0,0,0
2021-05-13 14:00,111,47,64,0,0,0
2021-05-13 14:15,119,69,50,0,0,0
2021-05-13 14:30,108,55,53,0,0,0
2021-05-13 14:45,117,59,58,0,0,0
2021-05-13 15:00,121,70,51,0,0,0
2021-05-13 15:15,108,54,54,0,0,0
2021-05-13 15:30,114,54,60,0,0,0
2021-05-13 15:45,126,67,59,0,0,0
2021-05-13 16:00,111,61,50,0,0,0
2021-05-13 16:15,101,48,53,0,0,0
2021-05-13 16:30,108,41,67,0,0,0
2021-05-13 16:45,105,50,55,0,0,0
2021-05-13 17:00,102,48,54,0,0,0
2021-05-13 17:15,110,67,43,0,0,0
2021-05-13 17:30,106,63,43,0,0,0
2021-05-13 17:45,131,64,67,0,0,0
2021-05-13 18:00,116,46,70,0,0,0
2021-05-13 18:15,100,52,48,0,0,0
2021-05-13 18:30,95,50,45,0,0,0
2021-05-13 18:45,119,59,60,0,0,0
2021-05-13 19:00,99,42,57,0,0,0
2021-05-13 19:15,98,55,43,0,0,0
2021-05-13 19:30,80,43,37,0,0,0
2021-05-13 19:45,116,56,60,0,0,0
2021-05-13 20:00,102,57,45,0,0,0
2021-05-13 20:15,89,38,51,0,0,0
2021-05-13 20:30,63,30,33,0,0,0
2021-05-13 20:45,58,29,29,0,0,0
2021-05-13 21:00,71,26,45,0,0,0
2021-05-13 21:15,48,19,29,0,0,0
2021-05-13 21:30,38,16,22,0,0,0
2021-05-13 21:45,43,20,23,0,0,0
2021-05-13 22:00,50,15,35,0,0,0
2021-05-13 22:15,32,10,22,0,0,0
2021-05-13 22:30,29,13,16,0,0,0
2021-05-13 22:45,56,18,38,0,0,0
2021-05-13 23:00,54,24,30,0,0,0
2021-05-13 23:15,63,18,45,0,0,0
2021-05-13 23:30,59,26,33,0,0,0
2021-05-13 23:45,43,17,26,0,0,0
2021-05-14 00:00,46,18,28,0,0,0
2021-05-14 00:15,19,4,15,0,0,0
2021-05-14 00:30,25,13,12,0,0,0
2021-05-14 00:45,43,16,27,0,0,0
2021-05-14 01:00,16,6,10,0,0,0
2021-05-14 01:15,21,7,14,0,0,0
2021-05-14 01:30,15,8,7,0,0,0
2021-05-14 01:45,17,10,7,0,0,0
2021-05-14 02:00,12,5,7,0,0,0
2021-05-14 02:15,9,4,5,0,0,0
2021-05-14 02:30,8,3,5,0,0,0
2021-05-14 02:45,10,4,6,0,0,0
2021-05-14 03:00,4,1,3,0,0,0
2021-05-14 03:15,4,0,4,0,0,0
2021-05-14 03:30,3,1,2,0,0,0
2021-05-14 03:45,5,1,4,0,0,0
2021-05-14 04:00,5,4,1,0,0,0
2021-05-14 04:15,4,1,3,0,0,0
2021-05-14 04:30,2,2,0,0,0,0
2021-05-14 04:45,10,6,4,0,0,0
2021-05-14 05:00,5,5,0,0,0,0
2021-05-14 05:15,11,7,4,0,0,0
2021-05-14 05:30,18,11,7,0,0,0
2021-05-14 05:45,9,6,3,0,0,0
2021-05-14 06:00,18,10,8,0,0,0
2021-05-14 06:15,29,18,11,0,0,0
2021-05-14 06:30,25,18,7,0,0,0
2021-05-14 06:45,42,26,16,0,0,0
2021-05-14 07:00,45,29,16,0,0,0
2021-05-14 07:15,40,22,18,0,0,0
2021-05-14 07:30,73,45,28,0,0,0
2021-05-14 07:45,97,56,41,0,0,0
2021-05-14 08:00,78,45,33,0,0,0
2021-05-14 08:15,79,45,34,0,0,0
2021-05-14 08:30,73,48,25,0,0,0
2021-05-14 08:45,90,56,34,0,0,0
2021-05-14 09:00,56,38,18,0,0,0
2021-05-14 09:15,77,41,36,0,0,0
2021-05-14 09:30,90,50,40,0,0,0
2021-05-14 09:45,93,53,40,0,0,0
2021-05-14 10:00,75,43,32,0,0,0
2021-05-14 10:15,72,44,28,0,0,0
2021-05-14 10:30,79,41,38,0,0,0
2021-05-14 10:45,89,56,33,0,0,0
2021-05-14 11:00,85,41,44,0,0,0
2021-05-14 11:15,79,46,33,0,0,0
2021-05-14 11:30,93,58,35,0,0,0
2021-05-14 11:45,104,67,37,0,0,0
2021-05-14 12:00,112,61,51,0,0,0
2021-05-14 12:15,105,50,55,0,0,0
2021-05-14 12:30,117,66,51,0,0,0
2021-05-14 12:45,127,80,47,0,0,0
2021-05-14 13:00,153,68,85,0,0,0
2021-05-14 13:15,129,70,59,0,0,0
2021-05-14 13:30,127,74,53,0,0,0
2021-05-14 13:45,128,76,52,0,0,0
2021-05-14 14:00,156,79,77,0,0,0
2021-05-14 14:15,143,76,67,0,0,0
2021-05-14 14:30,138,75,63,0,0,0
2021-05-14 14:45,127,74,53,0,0,0
2021-05-14 15:00,120,66,54,0,0,0
2021-05-14 15:15,136,66,70,0,0,0
2021-05-14 15:30,152,64,88,0,0,0
2021-05-14 15:45,143,91,52,0,0,0
2021-05-14 16:00,159,81,78,0,0,0
2021-05-14 16:15,157,76,81,0,0,0
2021-05-14 16:30,176,88,88,0,0,0
2021-05-14 16:45,168,84,84,0,0,0
2021-05-14 17:00,177,74,103,0,0,0
2021-05-14 17:15,148,64,84,0,0,0
2021-05-14 17:30,158,74,84,0,0,0
2021-05-14 17:45,183,80,103,0,0,0
2021-05-14 18:00,178,67,111,0,0,0
2021-05-14 18:15,159,76,83,0,0,0
2021-05-14 18:30,130,74,56,0,0,0
2021-05-14 18:45,141,66,75,0,0,0
2021-05-14 19:00,127,62,65,0,0,0
2021-05-14 19:15,142,81,61,0,0,0
2021-05-14 19:30,120,46,74,0,0,0
2021-05-14 19:45,123,69,54,0,0,0
2021-05-14 20:00,109,57,52,0,0,0
2021-05-14 20:15,93,46,47,0,0,0
2021-05-14 20:30,77,31,46,0,0,0
2021-05-14 20:45,63,28,35,0,0,0
2021-05-14 21:00,77,30,47,0,0,0
2021-05-14 21:15,66,30,36,0,0,0
2021-05-14 21:30,63,24,39,0,0,0
2021-05-14 21:45,65,27,38,0,0,0
2021-05-14 22:00,50,14,36,0,0,0
2021-05-14 22:15,51,17,34,0,0,0
2021-05-14 22:30,26,6,20,0,0,0
2021-05-14 22:45,39,17,22,0,0,0
2021-05-14 23:00,42,11,31,0,0,0
2021-05-14 23:15,36,13,23,0,0,0
2021-05-14 23:30,36,16,20,0,0,0
2021-05-14 23:45,48,16,32,0,0,0
2021-05-15 00:00,36,20,16,0,0,0
2021-05-15 00:15,37,15,22,0,0,0
2021-05-15 00:30,42,13,29,0,0,0
2021-05-15 00:45,38,8,30,0,0,0
2021-05-15 01:00,12,11,1,0,0,0
2021-05-15 01:15,26,10,16,0,0,0
2021-05-15 01:30,19,7,12,0,0,0
2021-05-15 01:45,13,0,13,0,0,0
2021-05-15 02:00,22,7,15,0,0,0
2021-05-15 02:15,20,10,10,0,0,0
2021-05-15 02:30,21,4,17,0,0,0
2021-05-15 02:45,5,4,1,0,0,0
2021-05-15 03:00,7,0,7,0,0,0
2021-05-15 03:15,21,7,14,0,0,0
2021-05-15 03:30,9,4,5,0,0,0
2021-05-15 03:45,6,5,1,0,0,0
2021-05-15 04:00,10,3,7,0,0,0
2021-05-15 04:15,7,1,6,0,0,0
2021-05-15 04:30,4,3,1,0,0,0
2021-05-15 04:45,6,5,1,0,0,0
2021-05-15 05:00,5,2,3,0,0,0
2021-05-15 05:15,11,7,4,0,0,0
2021-05-15 05:30,10,9,1,0,0,0
2021-05-15 05:45,9,5,4,0,0,0
2021-05-15 06:00,11,6,5,0,0,0
2021-05-15 06:15,13,10,3,0,0,0
2021-05-15 06:30,12,8,4,0,0,0
2021-05-15 06:45,22,14,8,0,0,0
2021-05-15 07:00,15,11,4,0,0,0
2021-05-15 07:15,19,12,7,0,0,0
2021-05-15 07:30,21,13,8,0,0,0
2021-05-15 07:45,33,21,12,0,0,0
2021-05-15 08:00,28,22,6,0,0,0
2021-05-15 08:15,41,30,11,0,0,0
2021-05-15 08:30,49,33,16,0,0,0
2021-05-15 08:45,66,46,20,0,0,0
2021-05-15 09:00,48,32,16,0,0,0
2021-05-15 09:15,67,48,19,0,0,0
2021-05-15 09:30,66,46,20,0,0,0
2021-05-15 09:45,47,32,15,0,0,0
2021-05-15 10:00,55,33,22,0,0,0
2021-05-15 10:15,87,69,18,0,0,0
2021-05-15 10:30,120,76,44,0,0,0
2021-05-15 10:45,87,59,28,0,0,0
2021-05-15 11:00,102,65,37,0,0,0
2021-05-15 11:15,73,51,22,0,0,0
2021-05-15 11:30,94,55,39,0,0,0
2021-05-15 11:45,111,52,59,0,0,0
2021-05-15 12:00,107,54,53,0,0,0
2021-05-15 12:15,100,52,48,0,0,0
2021-05-15 12:30,104,52,52,0,0,0
2021-05-15 12:45,147,75,72,0,0,0
2021-05-15 13:00,135,73,62,0,0,0
2021-05-15 13:15,130,74,56,0,0,0
2021-05-15 13:30,117,66,51,0,0,0
2021-05-15 13:45,168,91,77,0,0,0
2021-05-15 14:00,135,73,62,0,0,0
2021-05-15 14:15,108,46,62,0,0,0
2021-05-15 14:30,124,50,74,0,0,0
2021-05-15 14:45,128,63,65,0,0,0
2021-05-15 15:00,143,50,93,0,0,0
2021-05-15 15:15,83,41,42,0,0,0
2021-05-15 15:30,93,36,57,0,0,0
2021-05-15 15:45,108,48,60,0,0,0
2021-05-15 16:00,105,52,53,0,0,0
2021-05-15 16:15,83,35,48,0,0,0
2021-05-15 16:30,95,43,52,0,0,0
2021-05-15 16:45,88,40,48,0,0,0
2021-05-15 17:00,87,53,34,0,0,0
2021-05-15 17:15,93,49,44,0,0,0
2021-05-15 17:30,108,54,54,0,0,0
2021-05-15 17:45,110,38,72,0,0,0
2021-05-15 18:00,116,41,75,0,0,0
2021-05-15 18:15,63,12,51,0,0,0
2021-05-15 18:30,71,27,44,0,0,0
2021-05-15 18:45,52,11,41,0,0,0
2021-05-15 19:00,62,18,44,0,0,0
2021-05-15 19:15,94,43,51,0,0,0
2021-05-15 19:30,81,49,32,0,0,0
2021-05-15 19:45,90,45,45,0,0,0
2021-05-15 20:00,62,30,32,0,0,0
2021-05-15 20:15,53,18,35,0,0,0
2021-05-15 20:30,57,24,33,0,0,0
2021-05-15 20:45,53,17,36,0,0,0
2021-05-15 21:00,60,26,34,0,0,0
2021-05-15 21:15,37,17,20,0,0,0
2021-05-15 21:30,47,19,28,0,0,0
2021-05-15 21:45,34,16,18,0,0,0
2021-05-15 22:00,32,12,20,0,0,0
2021-05-15 22:15,43,20,23,0,0,0
2021-05-15 22:30,34,16,18,0,0,0
2021-05-15 22:45,31,7,24,0,0,0
2021-05-15 23:00,34,21,13,0,0,0
2021-05-15 23:15,30,13,17,0,0,0
2021-05-15 23:30,44,11,33,0,0,0
2021-05-15 23:45,50,15,35,0,0,0
2021-05-16 00:00,25,6,19,0,0,0
2021-05-16 00:15,29,13,16,0,0,0
2021-05-16 00:30,30,6,24,0,0,0
2021-05-16 00:45,12,2,10,0,0,0
2021-05-16 01:00,27,10,17,0,0,0
2021-05-16 01:15,25,14,11,0,0,0
2021-05-16 01:30,19,4,15,0,0,0
2021-05-16 01:45,32,14,18,0,0,0
2021-05-16 02:00,9,0,9,0,0,0
2021-05-16 02:15,20,6,14,0,0,0
2021-05-16 02:30,22,5,17,0,0,0
2021-05-16 02:45,7,3,4,0,0,0
2021-05-16 03:00,39,18,21,0,0,0
2021-05-16 03:15,9,4,5,0,0,0
2021-05-16 03:30,7,1,6,0,0,0
2021-05-16 03:45,8,5,3,0,0,0
2021-05-16 04:00,12,4,8,0,0,0
2021-05-16 04:15,6,4,2,0,0,0
2021-05-16 04:30,7,3,4,0,0,0
2021-05-16 04:45,3,1,2,0,0,0
2021-05-16 05:00,5,1,4,0,0,0
2021-05-16 05:15,2,1,1,0,0,0
2021-05-16 05:30,10,8,2,0,0,0
2021-05-16 05:45,6,2,4,0,0,0
2021-05-16 06:00,7,3,4,0,0,0
2021-05-16 06:15,8,6,2,0,0,0
2021-05-16 06:30,13,5,8,0,0,0
2021-05-16 06:45,7,3,4,0,0,0
2021-05-16 07:00,6,4,2,0,0,0
2021-05-16 07:15,5,5,0,0,0,0
2021-05-16 07:30,9,7,2,0,0,0
2021-05-16 07:45,6,1,5,0,0,0
2021-05-16 08:00,7,6,1,0,0,0
2021-05-16 08:15,10,7,3,0,0,0
2021-05-16 08:30,17,11,6,0,0,0
2021-05-16 08:45,27,22,5,0,0,0
2021-05-16 09:00,20,17,3,0,0,0
2021-05-16 09:15,23,12,11,0,0,0
2021-05-16 09:30,27,23,4,0,0,0
2021-05-16 09:45,46,38,8,0,0,0
2021-05-16 10:00,42,22,20,0,0,0
2021-05-16 10:15,55,31,24,0,0,0
2021-05-16 10:30,58,36,22,0,0,0
2021-05-16 10:45,60,37,23,0,0,0
2021-05-16 11:00,56,24,32,0,0,0
2021-05-16 11:15,52,23,29,0,0,0
2021-05-16 11:30,53,26,27,0,0,0
2021-05-16 11:45,58,37,21,0,0,0
2021-05-16 12:00,52,25,27,0,0,0
2021-05-16 12:15,83,48,35,0,0,0
2021-05-16 12:30,84,39,45,0,0,0
2021-05-16 12:45,63,30,33,0,0,0
2021-05-16 13:00,53,34,19,0,0,0
2021-05-16 13:15,65,32,33,0,0,0
2021-05-16 13:30,63,43,20,0,0,0
2021-05-16 13:45,88,48,40,0,0,0
2021-05-16 14:00,72,40,32,0,0,0
2021-05-16 14:15,90,47,43,0,0,0
2021-05-16 14:30,70,45,25,0,0,0
2021-05-16 14:45,110,67,43,0,0,0
2021-05-16 15:00,98,57,41,0,0,0
2021-05-16 15:15,89,55,34,0,0,0
2021-05-16 15:30,89,54,35,0,0,0
2021-05-16 15:45,142,69,73,0,0,0
2021-05-16 16:00,117,58,59,0,0,0
2021-05-16 16:15,100,55,45,0,0,0
2021-05-16 16:30,113,61,52,0,0,0
2021-05-16 16:45,122,57,65,0,0,0
2021-05-16 17:00,113,30,83,0,0,0
2021-05-16 17:15,101,36,65,0,0,0
2021-05-16 17:30,90,39,51,0,0,0
2021-05-16 17:45,130,56,74,0,0,0
2021-05-16 18:00,107,39,68,0,0,0
2021-05-16 18:15,91,41,50,0,0,0
2021-05-16 18:30,82,36,46,0,0,0
2021-05-16 18:45,111,49,62,0,0,0
2021-05-16 19:00,84,36,48,0,0,0
2021-05-16 19:15,79,38,41,0,0,0
2021-05-16 19:30,64,23,41,0,0,0
2021-05-16 19:45,66,31,35,0,0,0
2021-05-16 20:00,41,13,28,0,0,0
2021-05-16 20:15,41,20,21,0,0,0
2021-05-16 20:30,47,12,35,0,0,0
2021-05-16 20:45,47,18,29,0,0,0
2021-05-16 21:00,35,14,21,0,0,0
2021-05-16 21:15,40,24,16,0,0,0
2021-05-16 21:30,27,10,17,0,0,0
2021-05-16 21:45,15,6,9,0,0,0
2021-05-16 22:00,28,7,21,0,0,0
2021-05-16 22:15,38,9,29,0,0,0
2021-05-16 22:30,30,5,25,0,0,0
2021-05-16 22:45,17,6,11,0,0,0
2021-05-16 23:00,21,5,16,0,0,0
2021-05-16 23:15,9,6,3,0,0,0
2021-05-16 23:30,17,6,11,0,0,0
2021-05-16 23:45,22,13,9,0,0,0
2021-05-17 00:00,11,4,7,0,0,0
2021-05-17 00:15,15,10,5,0,0,0
2021-05-17 00:30,10,6,4,0,0,0
2021-05-17 00:45,6,3,3,0,0,0
2021-05-17 01:00,2,0,2,0,0,0
2021-05-17 01:15,4,0,4,0,0,0
2021-05-17 01:30,4,0,4,0,0,0
2021-05-17 01:45,3,2,1,0,0,0
2021-05-17 02:00,0,0,0,0,0,0
2021-05-17 02:15,3,1,2,0,0,0
2021-05-17 02:30,7,1,6,0,0,0
2021-05-17 02:45,0,0,0,0,0,0
2021-05-17 03:00,3,2,1,0,0,0
2021-05-17 03:15,0,0,0,0,0,0
2021-05-17 03:30,3,1,2,0,0,0
2021-05-17 03:45,1,1,0,0,0,0
2021-05-17 04:00,4,1,3,0,0,0
2021-05-17 04:15,6,1,5,0,0,0
2021-05-17 04:30,3,2,1,0,0,0
2021-05-17 04:45,8,7,1,0,0,0
2021-05-17 05:00,6,5,1,0,0,0
2021-05-17 05:15,7,4,3,0,0,0
2021-05-17 05:30,15,12,3,0,0,0
2021-05-17 05:45,13,12,1,0,0,0
2021-05-17 06:00,26,18,8,0,0,0
2021-05-17 06:15,37,26,11,0,0,0
2021-05-17 06:30,32,23,9,0,0,0
2021-05-17 06:45,64,38,26,0,0,0
2021-05-17 07:00,86,59,27,0,0,0
2021-05-17 07:15,115,76,39,0,0,0
2021-05-17 07:30,191,132,59,0,0,0
2021-05-17 07:45,214,132,82,0,0,0
2021-05-17 08:00,147,88,59,0,0,0
2021-05-17 08:15,143,81,62,0,0,0
2021-05-17 08:30,141,104,37,0,0,0
2021-05-17 08:45,148,85,63,0,0,0
2021-05-17 09:00,110,57,53,0,0,0
2021-05-17 09:15,114,80,34,0,0,0
2021-05-17 09:30,114,63,51,0,0,0
2021-05-17 09:45,82,42,40,0,0,0
2021-05-17 10:00,74,41,33,0,0,0
2021-05-17 10:15,84,47,37,0,0,0
2021-05-17 10:30,60,29,31,0,0,0
2021-05-17 10:45,60,40,20,0,0,0
2021-05-17 11:00,82,46,36,0,0,0
2021-05-17 11:15,69,25,44,0,0,0
2021-05-17 11:30,97,52,45,0,0,0
2021-05-17 11:45,116,64,52,0,0,0
2021-05-17 12:00,96,45,51,0,0,0
2021-05-17 12:15,97,45,52,0,0,0
2021-05-17 12:30,112,43,69,0,0,0
2021-05-17 12:45,100,39,61,0,0,0
2021-05-17 13:00,122,44,78,0,0,0
2021-05-17 13:15,140,55,85,0,0,0
2021-05-17 13:30,125,48,77,0,0,0
2021-05-17 13:45,125,68,57,0,0,0
2021-05-17 14:00,131,54,77,0,0,0
2021-05-17 14:15,81,40,41,0,0,0
2021-05-17 14:30,79,31,48,0,0,0
2021-05-17 14:45,108,60,48,0,0,0
2021-05-17 15:00,100,37,63,0,0,0
2021-05-17 15:15,109,48,61,0,0,0
2021-05-17 15:30,129,69,60,0,0,0
2021-05-17 15:45,113,46,67,0,0,0
2021-05-17 16:00,134,45,89,0,0,0
2021-05-17 16:15,123,52,71,0,0,0
2021-05-17 16:30,125,64,61,0,0,0
2021-05-17 16:45,146,70,76,0,0,0
2021-05-17 17:00,141,52,89,0,0,0
2021-05-17 17:15,140,75,65,0,0,0
2021-05-17 17:30,161,72,89,0,0,0
2021-05-17 17:45,163,67,96,0,0,0
2021-05-17 18:00,142,55,87,0,0,0
2021-05-17 18:15,131,48,83,0,0,0
2021-05-17 18:30,121,53,68,0,0,0
2021-05-17 18:45,105,52,53,0,0,0
2021-05-17 19:00,107,51,56,0,0,0
2021-05-17 19:15,88,40,48,0,0,0
2021-05-17 19:30,84,39,45,0,0,0
2021-05-17 19:45,72,32,40,0,0,0
2021-05-17 20:00,77,28,49,0,0,0
2021-05-17 20:15,59,26,33,0,0,0
2021-05-17 20:30,63,24,39,0,0,0
2021-05-17 20:45,40,15,25,0,0,0
2021-05-17 21:00,47,16,31,0,0,0
2021-05-17 21:15,38,15,23,0,0,0
2021-05-17 21:30,33,10,23,0,0,0
2021-05-17 21:45,27,8,19,0,0,0
2021-05-17 22:00,35,15,20,0,0,0
2021-05-17 22:15,50,18,32,0,0,0
2021-05-17 22:30,22,6,16,0,0,0
2021-05-17 22:45,39,11,28,0,0,0
2021-05-17 23:00,19,8,11,0,0,0
2021-05-17 23:15,17,5,12,0,0,0
2021-05-17 23:30,12,1,11,0,0,0
2021-05-17 23:45,14,8,6,0,0,0
2021-05-18 00:00,11,7,4,0,0,0
2021-05-18 00:15,11,4,7,0,0,0
2021-05-18 00:30,4,0,4,0,0,0
2021-05-18 00:45,7,1,6,0,0,0
2021-05-18 01:00,5,4,1,0,0,0
2021-05-18 01:15,10,4,6,0,0,0
2021-05-18 01:30,4,1,3,0,0,0
2021-05-18 01:45,5,0,5,0,0,0
2021-05-18 02:00,3,2,1,0,0,0
2021-05-18 02:15,5,0,5,0,0,0
2021-05-18 02:30,3,2,1,0,0,0
2021-05-18 02:45,6,0,6,0,0,0
2021-05-18 03:00,2,1,1,0,0,0
2021-05-18 03:15,1,1,0,0,0,0
2021-05-18 03:30,6,2,4,0,0,0
2021-05-18 03:45,0,0,0,0,0,0
2021-05-18 04:00,3,1,2,0,0,0
2021-05-18 04:15,2,1,1,0,0,0
2021-05-18 04:30,4,2,2,0,0,0
2021-05-18 04:45,5,4,1,0,0,0
2021-05-18 05:00,5,4,1,0,0,0
2021-05-18 05:15,13,9,4,0,0,0
2021-05-18 05:30,20,14,6,0,0,0
2021-05-18 05:45,23,18,5,0,0,0
2021-05-18 06:00,36,26,10,0,0,0
2021-05-18 06:15,39,22,17,0,0,0
2021-05-18 06:30,49,36,13,0,0,0
2021-05-18 06:45,85,50,35,0,0,0
2021-05-18 07:00,87,60,27,0,0,0
2021-05-18 07:15,129,82,47,0,0,0
2021-05-18 07:30,172,120,52,0,0,0
2021-05-18 07:45,233,145,88,0,0,0
2021-05-18 08:00,178,98,80,0,0,0
2021-05-18 08:15,141,94,47,0,0,0
2021-05-18 08:30,162,86,76,0,0,0
2021-05-18 08:45,156,91,65,0,0,0
2021-05-18 09:00,95,48,47,0,0,0
2021-05-18 09:15,103,69,34,0,0,0
2021-05-18 09:30,103,54,49,0,0,0
2021-05-18 09:45,127,65,62,0,0,0
2021-05-18 10:00,72,36,36,0,0,0
2021-05-18 10:15,75,45,30,0,0,0
2021-05-18 10:30,84,43,41,0,0,0
2021-05-18 10:45,98,39,59,0,0,0
2021-05-18 11:00,80,48,32,0,0,0
2021-05-18 11:15,69,34,35,0,0,0
2021-05-18 11:30,87,46,41,0,0,0
2021-05-18 11:45,82,39,43,0,0,0
2021-05-18 12:00,96,41,55,0,0,0
2021-05-18 12:15,111,52,59,0,0,0
2021-05-18 12:30,80,36,44,0,0,0
2021-05-18 12:45,102,46,56,0,0,0
2021-05-18 13:00,153,57,96,0,0,0
2021-05-18 13:15,133,50,83,0,0,0
2021-05-18 13:30,106,34,72,0,0,0
2021-05-18 13:45,130,69,61,0,0,0
2021-05-18 14:00,109,46,63,0,0,0
2021-05-18 14:15,106,63,43,0,0,0
2021-05-18 14:30,109,44,65,0,0,0
2021-05-18 14:45,126,62,64,0,0,0
2021-05-18 15:00,122,54,68,0,0,0
2021-05-18 15:15,119,55,64,0,0,0
2021-05-18 15:30,123,66,57,0,0,0
2021-05-18 15:45,132,61,71,0,0,0
2021-05-18 16:00,146,63,83,0,0,0
2021-05-18 16:15,146,59,87,0,0,0
2021-05-18 16:30,137,62,75,0,0,0
2021-05-18 16:45,187,91,96,0,0,0
2021-05-18 17:00,171,79,92,0,0,0
2021-05-18 17:15,190,89,101,0,0,0
2021-05-18 17:30,167,73,94,0,0,0
2021-05-18 17:45,196,88,108,0,0,0
2021-05-18 18:00,195,80,115,0,0,0
2021-05-18 18:15,156,76,80,0,0,0
2021-05-18 18:30,163,64,99,0,0,0
2021-05-18 18:45,167,72,95,0,0,0
2021-05-18 19:00,123,48,75,0,0,0
2021-05-18 19:15,134,69,65,0,0,0
2021-05-18 19:30,100,40,60,0,0,0
2021-05-18 19:45,89,40,49,0,0,0
2021-05-18 20:00,91,40,51,0,0,0
2021-05-18 20:15,96,44,52,0,0,0
2021-05-18 20:30,67,25,42,0,0,0
2021-05-18 20:45,51,23,28,0,0,0
2021-05-18 21:00,65,35,30,0,0,0
2021-05-18 21:15,56,19,37,0,0,0
2021-05-18 21:30,45,23,22,0,0,0
2021-05-18 21:45,53,19,34,0,0,0
2021-05-18 22:00,36,13,23,0,0,0
2021-05-18 22:15,56,23,33,0,0,0
2021-05-18 22:30,31,10,21,0,0,0
2021-05-18 22:45,50,12,38,0,0,0
2021-05-18 23:00,48,15,33,0,0,0
2021-05-18 23:15,36,11,25,0,0,0
2021-05-18 23:30,33,9,24,0,0,0
2021-05-18 23:45,23,6,17,0,0,0
2021-05-19 00:00,21,11,10,0,0,0
2021-05-19 00:15,27,8,19,0,0,0
2021-05-19 00:30,15,4,11,0,0,0
2021-05-19 00:45,13,2,11,0,0,0
2021-05-19 01:00,7,0,7,0,0,0
2021-05-19 01:15,7,4,3,0,0,0
2021-05-19 01:30,6,3,3,0,0,0
2021-05-19 01:45,5,2,3,0,0,0
2021-05-19 02:00,4,0,4,0,0,0
2021-05-19 02:15,5,3,2,0,0,0
2021-05-19 02:30,1,1,0,0,0,0
2021-05-19 02:45,3,1,2,0,0,0
2021-05-19 03:00,3,1,2,0,0,0
2021-05-19 03:15,5,4,1,0,0,0
2021-05-19 03:30,5,3,2,0,0,0
2021-05-19 03:45,2,2,0,0,0,0
2021-05-19 04:00,3,3,0,0,0,0
2021-05-19 04:15,5,3,2,0,0,0
2021-05-19 04:30,2,2,0,0,0,0
2021-05-19 04:45,8,7,1,0,0,0
2021-05-19 05:00,5,5,0,0,0,0
2021-05-19 05:15,15,11,4,0,0,0
2021-05-19 05:30,15,11,4,0,0,0
2021-05-19 05:45,24,16,8,0,0,0
2021-05-19 06:00,34,21,13,0,0,0
2021-05-19 06:15,38,31,7,0,0,0
2021-05-19 06:30,44,25,19,0,0,0
2021-05-19 06:45,78,56,22,0,0,0
2021-05-19 07:00,84,58,26,0,0,0
2021-05-19 07:15,128,87,41,0,0,0
2021-05-19 07:30,207,139,68,0,0,0
2021-05-19 07:45,245,157,88,0,0,0
2021-05-19 08:00,175,90,85,0,0,0
2021-05-19 08:15,142,88,54,0,0,0
2021-05-19 08:30,179,116,63,0,0,0
2021-05-19 08:45,178,94,84,0,0,0
2021-05-19 09:00,133,80,53,0,0,0
2021-05-19 09:15,140,85,55,0,0,0
2021-05-19 09:30,113,64,49,0,0,0
2021-05-19 09:45,153,93,60,0,0,0
2021-05-19 10:00,112,70,42,0,0,0
2021-05-19 10:15,94,56,38,0,0,0
2021-05-19 10:30,106,66,40,0,0,0
2021-05-19 10:45,114,62,52,0,0,0
2021-05-19 11:00,113,55,58,0,0,0
2021-05-19 11:15,100,46,54,0,0,0
2021-05-19 11:30,110,54,56,0,0,0
2021-05-19 11:45,154,68,86,0,0,0
2021-05-19 12:00,117,65,52,0,0,0
2021-05-19 12:15,136,63,73,0,0,0
2021-05-19 12:30,171,61,110,0,0,0
2021-05-19 12:45,150,58,92,0,0,0
2021-05-19 13:00,152,63,89,0,0,0
2021-05-19 13:15,165,55,110,0,0,0
2021-05-19 13:30,137,58,79,0,0,0
2021-05-19 13:45,165,78,87,0,0,0
2021-05-19 14:00,146,68,78,0,0,0
2021-05-19 14:15,150,60,90,0,0,0
2021-05-19 14:30,154,70,84,0,0,0
2021-05-19 14:45,170,94,76,0,0,0
2021-05-19 15:00,162,65,97,0,0,0
2021-05-19 15:15,166,63,103,0,0,0
2021-05-19 15:30,150,82,68,0,0,0
2021-05-19 15:45,159,65,94,0,0,0
2021-05-19 16:00,159,81,78,0,0,0
2021-05-19 16:15,171,79,92,0,0,0
2021-05-19 16:30,139,57,82,0,0,0
2021-05-19 16:45,136,67,69,0,0,0
2021-05-19 17:00,158,51,107,0,0,0
2021-05-19 17:15,180,94,86,0,0,0
2021-05-19 17:30,152,69,83,0,0,0
2021-05-19 17:45,178,77,101,0,0,0
2021-05-19 18:00,179,77,102,0,0,0
2021-05-19 18:15,179,80,99,0,0,0
2021-05-19 18:30,186,87,99,0,0,0
2021-05-19 18:45,149,72,77,0,0,0
2021-05-19 19:00,143,62,81,0,0,0
2021-05-19 19:15,121,49,72,0,0,0
2021-05-19 19:30,105,55,50,0,0,0
2021-05-19 19:45,92,40,52,0,0,0
2021-05-19 20:00,117,56,61,0,0,0
2021-05-19 20:15,107,59,48,0,0,0
2021-05-19 20:30,76,38,38,0,0,0
2021-05-19 20:45,71,35,36,0,0,0
2021-05-19 21:00,67,26,41,0,0,0
2021-05-19 21:15,49,24,25,0,0,0
2021-05-19 21:30,58,25,33,0,0,0
2021-05-19 21:45,55,26,29,0,0,0
2021-05-19 22:00,40,12,28,0,0,0
2021-05-19 22:15,48,11,37,0,0,0
2021-05-19 22:30,58,15,43,0,0,0
2021-05-19 22:45,66,25,41,0,0,0
2021-05-19 23:00,38,8,30,0,0,0
2021-05-19 23:15,59,29,30,0,0,0
2021-05-19 23:30,26,13,13,0,0,0
2021-05-19 23:45,44,17,27,0,0,0
2021-05-20 00:00,24,11,13,0,0,0
2021-05-20 00:15,38,16,22,0,0,0
2021-05-20 00:30,27,9,18,0,0,0
2021-05-20 00:45,13,2,11,0,0,0
2021-05-20 01:00,15,7,8,0,0,0
2021-05-20 01:15,18,4,14,0,0,0
2021-05-20 01:30,8,3,5,0,0,0
2021-05-20 01:45,15,5,10,0,0,0
2021-05-20 02:00,10,5,5,0,0,0
2021-05-20 02:15,4,1,3,0,0,0
2021-05-20 02:30,7,3,4,0,0,0
2021-05-20 02:45,5,3,2,0,0,0
2021-05-20 03:00,8,8,0,0,0,0
2021-05-20 03:15,5,3,2,0,0,0
2021-05-20 03:30,2,1,1,0,0,0
2021-05-20 03:45,5,4,1,0,0,0
2021-05-20 04:00,2,0,2,0,0,0
2021-05-20 04:15,5,3,2,0,0,0
2021-05-20 04:30,4,3,1,0,0,0
2021-05-20 04:45,9,8,1,0,0,0
2021-05-20 05:00,6,5,1,0,0,0
2021-05-20 05:15,10,9,1,0,0,0
2021-05-20 05:30,23,14,9,0,0,0
2021-05-20 05:45,29,20,9,0,0,0
2021-05-20 06:00,32,21,11,0,0,0
2021-05-20 06:15,48,29,19,0,0,0
2021-05-20 06:30,57,41,16,0,0,0
2021-05-20 06:45,79,49,30,0,0,0
2021-05-20 07:00,88,52,36,0,0,0
2021-05-20 07:15,141,84,57,0,0,0
2021-05-20 07:30,212,154,58,0,0,0
2021-05-20 07:45,245,153,92,0,0,0
2021-05-20 08:00,172,103,69,0,0,0
2021-05-20 08:15,181,117,64,0,0,0
2021-05-20 08:30,160,105,55,0,0,0
2021-05-20 08:45,156,81,75,0,0,0
2021-05-20 09:00,152,92,60,0,0,0
2021-05-20 09:15,138,80,58,0,0,0
2021-05-20 09:30,113,61,52,0,0,0
2021-05-20 09:45,124,73,51,0,0,0
2021-05-20 10:00,88,51,37,0,0,0
2021-05-20 10:15,90,55,35,0,0,0
2021-05-20 10:30,100,60,40,0,0,0
2021-05-20 10:45,123,72,51,0,0,0
2021-05-20 11:00,117,57,60,0,0,0
2021-05-20 11:15,109,53,56,0,0,0
2021-05-20 11:30,92,45,47,0,0,0
2021-05-20 11:45,160,76,84,0,0,0
2021-05-20 12:00,144,68,76,0,0,0
2021-05-20 12:15,153,78,75,0,0,0
2021-05-20 12:30,155,77,78,0,0,0
2021-05-20 12:45,143,64,79,0,0,0
2021-05-20 13:00,172,66,106,0,0,0
2021-05-20 13:15,165,58,107,0,0,0
2021-05-20 13:30,163,78,85,0,0,0
2021-05-20 13:45,160,72,88,0,0,0
2021-05-20 14:00,149,62,87,0,0,0
2021-05-20 14:15,162,84,78,0,0,0
2021-05-20 14:30,152,74,78,0,0,0
2021-05-20 14:45,169,66,103,0,0,0
2021-05-20 15:00,160,77,83,0,0,0
2021-05-20 15:15,148,69,79,0,0,0
2021-05-20 15:30,167,77,90,0,0,0
2021-05-20 15:45,198,85,113,0,0,0
2021-05-20 16:00,182,91,91,0,0,0
2021-05-20 16:15,183,85,98,0,0,0
2021-05-20 16:30,193,93,100,0,0,0
2021-05-20 16:45,214,92,122,0,0,0
2021-05-20 17:00,209,96,113,0,0,0
2021-05-20 17:15,193,82,111,0,0,0
2021-05-20 17:30,217,98,119,0,0,0
2021-05-20 17:45,229,112,117,0,0,0
2021-05-20 18:00,228,109,119,0,0,0
2021-05-20 18:15,213,92,121,0,0,0
2021-05-20 18:30,187,90,97,0,0,0
2021-05-20 18:45,187,97,90,0,0,0
2021-05-20 19:00,162,71,91,0,0,0
2021-05-20 19:15,161,86,75,0,0,0
2021-05-20 19:30,122,54,68,0,0,0
2021-05-20 19:45,137,73,64,0,0,0
2021-05-20 20:00,128,56,72,0,0,0
2021-05-20 20:15,107,49,58,0,0,0
2021-05-20 20:30,87,34,53,0,0,0
2021-05-20 20:45,77,35,42,0,0,0
2021-05-20 21:00,65,32,33,0,0,0
2021-05-20 21:15,60,26,34,0,0,0
2021-05-20 21:30,69,32,37,0,0,0
2021-05-20 21:45,61,24,37,0,0,0
2021-05-20 22:00,42,16,26,0,0,0
2021-05-20 22:15,47,22,25,0,0,0
2021-05-20 22:30,56,15,41,0,0,0
2021-05-20 22:45,54,24,30,0,0,0
2021-05-20 23:00,62,13,49,0,0,0
2021-05-20 23:15,55,19,36,0,0,0
2021-05-20 23:30,43,14,29,0,0,0
2021-05-20 23:45,42,10,32,0,0,0
2021-05-21 00:00,37,13,24,0,0,0
2021-05-21 00:15,39,9,30,0,0,0
2021-05-21 00:30,18,7,11,0,0,0
2021-05-21 00:45,23,7,16,0,0,0
2021-05-21 01:00,18,5,13,0,0,0
2021-05-21 01:15,18,5,13,0,0,0
2021-05-21 01:30,16,7,9,0,0,0
2021-05-21 01:45,10,5,5,0,0,0
2021-05-21 02:00,14,3,11,0,0,0
2021-05-21 02:15,10,3,7,0,0,0
2021-05-21 02:30,6,4,2,0,0,0
2021-05-21 02:45,4,0,4,0,0,0
2021-05-21 03:00,2,0,2,0,0,0
2021-05-21 03:15,5,2,3,0,0,0
2021-05-21 03:30,2,1,1,0,0,0
2021-05-21 03:45,2,1,1,0,0,0
2021-05-21 04:00,3,1,2,0,0,0
2021-05-21 04:15,3,2,1,0,0,0
2021-05-21 04:30,4,1,3,0,0,0
2021-05-21 04:45,12,7,5,0,0,0
2021-05-21 05:00,1,1,0,0,0,0
2021-05-21 05:15,17,11,6,0,0,0
2021-05-21 05:30,18,12,6,0,0,0
2021-05-21 05:45,20,12,8,0,0,0
2021-05-21 06:00,35,26,9,0,0,0
2021-05-21 06:15,39,25,14,0,0,0
2021-05-21 06:30,48,35,13,0,0,0
2021-05-21 06:45,65,43,22,0,0,0
2021-05-21 07:00,86,53,33,0,0,0
2021-05-21 07:15,112,76,36,0,0,0
2021-05-21 07:30,178,132,46,0,0,0
2021-05-21 07:45,226,127,99,0,0,0
2021-05-21 08:00,169,110,59,0,0,0
2021-05-21 08:15,122,64,58,0,0,0
2021-05-21 08:30,123,67,56,0,0,0
2021-05-21 08:45,132,75,57,0,0,0
2021-05-21 09:00,121,76,45,0,0,0
2021-05-21 09:15,95,55,40,0,0,0
2021-05-21 09:30,105,59,46,0,0,0
2021-05-21 09:45,137,80,57,0,0,0
2021-05-21 10:00,101,60,41,0,0,0
2021-05-21 10:15,93,45,48,0,0,0
2021-05-21 10:30,73,41,32,0,0,0
2021-05-21 10:45,102,68,34,0,0,0
2021-05-21 11:00,108,55,53,0,0,0
2021-05-21 11:15,89,49,40,0,0,0
2021-05-21 11:30,102,54,48,0,0,0
2021-05-21 11:45,113,61,52,0,0,0
2021-05-21 12:00,101,57,44,0,0,0
2021-05-21 12:15,136,57,79,0,0,0
2021-05-21 12:30,156,74,82,0,0,0
2021-05-21 12:45,142,58,84,0,0,0
2021-05-21 13:00,170,56,114,0,0,0
2021-05-21 13:15,169,60,109,0,0,0
2021-05-21 13:30,160,66,94,0,0,0
2021-05-21 13:45,187,94,93,0,0,0
2021-05-21 14:00,212,109,103,0,0,0
2021-05-21 14:15,170,77,93,0,0,0
2021-05-21 14:30,159,74,85,0,0,0
2021-05-21 14:45,161,80,81,0,0,0
2021-05-21 15:00,129,72,57,0,0,0
2021-05-21 15:15,161,78,83,0,0,0
2021-05-21 15:30,162,73,89,0,0,0
2021-05-21 15:45,147,74,73,0,0,0
2021-05-21 16:00,171,83,88,0,0,0
2021-05-21 16:15,151,71,80,0,0,0
2021-05-21 16:30,130,69,61,0,0,0
2021-05-21 16:45,167,96,71,0,0,0
2021-05-21 17:00,175,103,72,0,0,0
2021-05-21 17:15,173,89,84,0,0,0
2021-05-21 17:30,165,72,93,0,0,0
2021-05-21 17:45,164,82,82,0,0,0
2021-05-21 18:00,165,67,98,0,0,0
2021-05-21 18:15,154,72,82,0,0,0
2021-05-21 18:30,132,77,55,0,0,0
2021-05-21 18:45,166,91,75,0,0,0
2021-05-21 19:00,131,69,62,0,0,0
2021-05-21 19:15,150,78,72,0,0,0
2021-05-21 19:30,129,78,51,0,0,0
2021-05-21 19:45,165,94,71,0,0,0
2021-05-21 20:00,156,93,63,0,0,0
2021-05-21 20:15,125,65,60,0,0,0
2021-05-21 20:30,102,40,62,0,0,0
2021-05-21 20:45,82,40,42,0,0,0
2021-05-21 21:00,64,27,37,0,0,0
2021-05-21 21:15,72,31,41,0,0,0
2021-05-21 21:30,56,22,34,0,0,0
2021-05-21 21:45,59,28,31,0,0,0
2021-05-21 22:00,77,23,54,0,0,0
2021-05-21 22:15,87,40,47,0,0,0
2021-05-21 22:30,54,14,40,0,0,0
2021-05-21 22:45,68,20,48,0,0,0
2021-05-21 23:00,50,10,40,0,0,0
2021-05-21 23:15,60,16,44,0,0,0
2021-05-21 23:30,57,13,44,0,0,0
2021-05-21 23:45,63,17,46,0,0,0
2021-05-22 00:00,63,20,43,0,0,0
2021-05-22 00:15,70,16,54,0,0,0
2021-05-22 00:30,60,24,36,0,0,0
2021-05-22 00:45,48,12,36,0,0,0
2021-05-22 01:00,31,12,19,0,0,0
2021-05-22 01:15,39,11,28,0,0,0
2021-05-22 01:30,52,13,39,0,0,0
2021-05-22 01:45,33,13,20,0,0,0
2021-05-22 02:00,20,3,17,0,0,0
2021-05-22 02:15,38,5,33,0,0,0
2021-05-22 02:30,33,6,27,0,0,0
2021-05-22 02:45,25,7,18,0,0,0
2021-05-22 03:00,26,4,22,0,0,0
2021-05-22 03:15,32,3,29,0,0,0
2021-05-22 03:30,31,13,18,0,0,0
2021-05-22 03:45,18,4,14,0,0,0
2021-05-22 04:00,13,5,8,0,0,0
2021-05-22 04:15,9,0,9,0,0,0
2021-05-22 04:30,4,1,3,0,0,0
2021-05-22 04:45,9,4,5,0,0,0
2021-05-22 05:00,11,6,5,0,0,0
2021-05-22 05:15,14,8,6,0,0,0
2021-05-22 05:30,8,8,0,0,0,0
2021-05-22 05:45,17,10,7,0,0,0
2021-05-22 06:00,11,4,7,0,0,0
2021-05-22 06:15,11,8,3,0,0,0
2021-05-22 06:30,14,7,7,0,0,0
2021-05-22 06:45,18,12,6,0,0,0
2021-05-22 07:00,16,12,4,0,0,0
2021-05-22 07:15,22,13,9,0,0,0
2021-05-22 07:30,18,14,4,0,0,0
2021-05-22 07:45,33,24,9,0,0,0
2021-05-22 08:00,21,14,7,0,0,0
2021-05-22 08:15,35,27,8,0,0,0
2021-05-22 08:30,37,25,12,0,0,0
2021-05-22 08:45,40,27,13,0,0,0
2021-05-22 09:00,45,29,16,0,0,0
2021-05-22 09:15,52,33,19,0,0,0
2021-05-22 09:30,56,32,24,0,0,0
2021-05-22 09:45,59,43,16,0,0,0
2021-05-22 10:00,58,40,18,0,0,0
2021-05-22 10:15,51,37,14,0,0,0
2021-05-22 10:30,45,24,21,0,0,0
2021-05-22 10:45,65,42,23,0,0,0
2021-05-22 11:00,76,48,28,0,0,0
2021-05-22 11:15,74,37,37,0,0,0
2021-05-22 11:30,61,36,25,0,0,0
2021-05-22 11:45,78,52,26,0,0,0
2021-05-22 12:00,91,50,41,0,0,0
2021-05-22 12:15,76,56,20,0,0,0
2021-05-22 12:30,111,58,53,0,0,0
2021-05-22 12:45,101,53,48,0,0,0
2021-05-22 13:00,93,46,47,0,0,0
2021-05-22 13:15,91,58,33,0,0,0
2021-05-22 13:30,71,34,37,0,0,0
2021-05-22 13:45,61,31,30,0,0,0
2021-05-22 14:00,70,30,40,0,0,0
2021-05-22 14:15,84,37,47,0,0,0
2021-05-22 14:30,121,58,63,0,0,0
2021-05-22 14:45,87,44,43,0,0,0
2021-05-22 15:00,86,35,51,0,0,0
2021-05-22 15:15,90,41,49,0,0,0
2021-05-22 15:30,72,29,43,0,0,0
2021-05-22 15:45,56,29,27,0,0,0
2021-05-22 16:00,50,24,26,0,0,0
2021-05-22 16:15,60,29,31,0,0,0
2021-05-22 16:30,69,31,38,0,0,0
2021-05-22 16:45,73,30,43,0,0,0
2021-05-22 17:00,58,30,28,0,0,0
2021-05-22 17:15,63,32,31,0,0,0
2021-05-22 17:30,73,31,42,0,0,0
2021-05-22 17:45,67,39,28,0,0,0
2021-05-22 18:00,88,48,40,0,0,0
2021-05-22 18:15,93,50,43,0,0,0
2021-05-22 18:30,94,43,51,0,0,0
2021-05-22 18:45,94,56,38,0,0,0
2021-05-22 19:00,87,40,47,0,0,0
2021-05-22 19:15,96,40,56,0,0,0
2021-05-22 19:30,80,44,36,0,0,0
2021-05-22 19:45,65,33,32,0,0,0
2021-05-22 20:00,75,37,38,0,0,0
2021-05-22 20:15,66,28,38,0,0,0
2021-05-22 20:30,58,29,29,0,0,0
2021-05-22 20:45,68,40,28,0,0,0
2021-05-22 21:00,44,25,19,0,0,0
2021-05-22 21:15,44,24,20,0,0,0
2021-05-22 21:30,51,33,18,0,0,0
2021-05-22 21:45,36,10,26,0,0,0
2021-05-22 22:00,31,15,16,0,0,0
2021-05-22 22:15,26,9,17,0,0,0
2021-05-22 22:30,45,17,28,0,0,0
2021-05-22 22:45,28,9,19,0,0,0
2021-05-22 23:00,33,11,22,0,0,0
2021-05-22 23:15,30,17,13,0,0,0
2021-05-22 23:30,31,15,16,0,0,0
2021-05-22 23:45,40,12,28,0,0,0
2021-05-23 00:00,39,4,35,0,0,0
2021-05-23 00:15,21,7,14,0,0,0
2021-05-23 00:30,24,5,19,0,0,0
2021-05-23 00:45,28,11,17,0,0,0
2021-05-23 01:00,28,13,15,0,0,0
2021-05-23 01:15,32,5,27,0,0,0
2021-05-23 01:30,26,7,19,0,0,0
2021-05-23 01:45,30,1,29,0,0,0
2021-05-23 02:00,22,6,16,0,0,0
2021-05-23 02:15,19,4,15,0,0,0
2021-05-23 02:30,24,8,16,0,0,0
2021-05-23 02:45,21,6,15,0,0,0
2021-05-23 03:00,16,1,15,0,0,0
2021-05-23 03:15,15,2,13,0,0,0
2021-05-23 03:30,23,2,21,0,0,0
2021-05-23 03:45,12,5,7,0,0,0
2021-05-23 04:00,14,1,13,0,0,0
2021-05-23 04:15,9,2,7,0,0,0
2021-05-23 04:30,6,1,5,0,0,0
2021-05-23 04:45,12,5,7,0,0,0
2021-05-23 05:00,10,2,8,0,0,0
2021-05-23 05:15,8,1,7,0,0,0
2021-05-23 05:30,15,7,8,0,0,0
2021-05-23 05:45,4,2,2,0,0,0
2021-05-23 06:00,10,6,4,0,0,0
2021-05-23 06:15,6,2,4,0,0,0
2021-05-23 06:30,5,2,3,0,0,0
2021-05-23 06:45,5,3,2,0,0,0
2021-05-23 07:00,2,1,1,0,0,0
2021-05-23 07:15,7,5,2,0,0,0
2021-05-23 07:30,7,4,3,0,0,0
2021-05-23 07:45,10,7,3,0,0,0
2021-05-23 08:00,2,2,0,0,0,0
2021-05-23 08:15,8,1,7,0,0,0
2021-05-23 08:30,11,6,5,0,0,0
2021-05-23 08:45,14,11,3,0,0,0
2021-05-23 09:00,11,4,7,0,0,0
2021-05-23 09:15,27,15,12,0,0,0
2021-05-23 09:30,15,12,3,0,0,0
2021-05-23 09:45,50,34,16,0,0,0
2021-05-23 10:00,29,20,9,0,0,0
2021-05-23 10:15,21,13,8,0,0,0
2021-05-23 10:30,32,23,9,0,0,0
2021-05-23 10:45,33,22,11,0,0,0
2021-05-23 11:00,33,15,18,0,0,0
2021-05-23 11:15,41,23,18,0,0,0
2021-05-23 11:30,55,37,18,0,0,0
2021-05-23 11:45,64,29,35,0,0,0
2021-05-23 12:00,38,29,9,0,0,0
2021-05-23 12:15,61,23,38,0,0,0
2021-05-23 12:30,85,45,40,0,0,0
2021-05-23 12:45,99,54,45,0,0,0
2021-05-23 13:00,102,55,47,0,0,0
2021-05-23 13:15,93,53,40,0,0,0
2021-05-23 13:30,94,60,34,0,0,0
2021-05-23 13:45,100,59,41,0,0,0
2021-05-23 14:00,85,37,48,0,0,0
2021-05-23 14:15,97,54,43,0,0,0
2021-05-23 14:30,70,46,24,0,0,0
2021-05-23 14:45,119,62,57,0,0,0
2021-05-23 15:00,99,45,54,0,0,0
2021-05-23 15:15,94,48,46,0,0,0
2021-05-23 15:30,123,53,70,0,0,0
2021-05-23 15:45,120,69,51,0,0,0
2021-05-23 16:00,103,56,47,0,0,0
2021-05-23 16:15,91,45,46,0,0,0
2021-05-23 16:30,82,49,33,0,0,0
2021-05-23 16:45,120,64,56,0,0,0
2021-05-23 17:00,106,46,60,0,0,0
2021-05-23 17:15,110,56,54,0,0,0
2021-05-23 17:30,110,55,55,0,0,0
2021-05-23 17:45,105,45,60,0,0,0
2021-05-23 18:00,108,46,62,0,0,0
2021-05-23 18:15,99,49,50,0,0,0
2021-05-23 18:30,106,53,53,0,0,0
2021-05-23 18:45,102,63,39,0,0,0
2021-05-23 19:00,109,60,49,0,0,0
2021-05-23 19:15,89,47,42,0,0,0
2021-05-23 19:30,95,45,50,0,0,0
2021-05-23 19:45,89,41,48,0,0,0
2021-05-23 20:00,93,45,48,0,0,0
2021-05-23 20:15,81,35,46,0,0,0
2021-05-23 20:30,74,36,38,0,0,0
2021-05-23 20:45,57,29,28,0,0,0
2021-05-23 21:00,71,28,43,0,0,0
2021-05-23 21:15,55,20,35,0,0,0
2021-05-23 21:30,49,7,42,0,0,0
2021-05-23 21:45,31,7,24,0,0,0
2021-05-23 22:00,57,14,43,0,0,0
2021-05-23 22:15,54,19,35,0,0,0
2021-05-23 22:30,44,13,31,0,0,0
2021-05-23 22:45,45,14,31,0,0,0
2021-05-23 23:00,27,6,21,0,0,0
2021-05-23 23:15,28,12,16,0,0,0
2021-05-23 23:30,47,9,38,0,0,0
2021-05-23 23:45,43,17,26,0,0,0
2021-05-24 00:00,23,5,18,0,0,0
2021-05-24 00:15,43,16,27,0,0,0
2021-05-24 00:30,31,10,21,0,0,0
2021-05-24 00:45,30,7,23,0,0,0
2021-05-24 01:00,16,5,11,0,0,0
2021-05-24 01:15,22,7,15,0,0,0
2021-05-24 01:30,22,8,14,0,0,0
2021-05-24 01:45,19,5,14,0,0,0
2021-05-24 02:00,16,6,10,0,0,0
2021-05-24 02:15,21,9,12,0,0,0
2021-05-24 02:30,13,7,6,0,0,0
2021-05-24 02:45,10,5,5,0,0,0
2021-05-24 03:00,7,3,4,0,0,0
2021-05-24 03:15,10,1,9,0,0,0
2021-05-24 03:30,9,1,8,0,0,0
2021-05-24 03:45,8,3,5,0,0,0
2021-05-24 04:00,5,2,3,0,0,0
2021-05-24 04:15,2,0,2,0,0,0
2021-05-24 04:30,9,1,8,0,0,0
2021-05-24 04:45,3,3,0,0,0,0
2021-05-24 05:00,3,1,2,0,0,0
2021-05-24 05:15,9,1,8,0,0,0
2021-05-24 05:30,8,2,6,0,0,0
2021-05-24 05:45,8,5,3,0,0,0
2021-05-24 06:00,8,3,5,0,0,0
2021-05-24 06:15,12,9,3,0,0,0
2021-05-24 06:30,3,2,1,0,0,0
2021-05-24 06:45,6,3,3,0,0,0
2021-05-24 07:00,6,3,3,0,0,0
2021-05-24 07:15,9,8,1,0,0,0
2021-05-24 07:30,7,5,2,0,0,0
2021-05-24 07:45,11,4,7,0,0,0
2021-05-24 08:00,12,8,4,0,0,0
2021-05-24 08:15,18,10,8,0,0,0
2021-05-24 08:30,22,15,7,0,0,0
2021-05-24 08:45,28,20,8,0,0,0
2021-05-24 09:00,30,14,16,0,0,0
2021-05-24 09:15,42,26,16,0,0,0
2021-05-24 09:30,57,32,25,0,0,0
2021-05-24 09:45,71,43,28,0,0,0
2021-05-24 10:00,59,37,22,0,0,0
2021-05-24 10:15,66,39,27,0,0,0
2021-05-24 10:30,86,46,40,0,0,0
2021-05-24 10:45,87,52,35,0,0,0
2021-05-24 11:00,71,32,39,0,0,0
2021-05-24 11:15,71,38,33,0,0,0
2021-05-24 11:30,86,57,29,0,0,0
2021-05-24 11:45,88,45,43,0,0,0
2021-05-24 12:00,83,38,45,0,0,0
2021-05-24 12:15,88,44,44,0,0,0
2021-05-24 12:30,101,49,52,0,0,0
2021-05-24 12:45,78,46,32,0,0,0
2021-05-24 13:00,77,38,39,0,0,0
2021-05-24 13:15,100,48,52,0,0,0
2021-05-24 13:30,97,52,45,0,0,0
2021-05-24 13:45,94,47,47,0,0,0
2021-05-24 14:00,80,34,46,0,0,0
2021-05-24 14:15,86,41,45,0,0,0
2021-05-24 14:30,74,43,31,0,0,0
2021-05-24 14:45,74,48,26,0,0,0
2021-05-24 15:00,91,34,57,0,0,0
2021-05-24 15:15,62,38,24,0,0,0
2021-05-24 15:30,54,22,32,0,0,0
2021-05-24 15:45,80,39,41,0,0,0
2021-05-24 16:00,68,26,42,0,0,0
2021-05-24 16:15,61,26,35,0,0,0
2021-05-24 16:30,84,27,57,0,0,0
2021-05-24 16:45,98,55,43,0,0,0
2021-05-24 17:00,80,35,45,0,0,0
2021-05-24 17:15,73,31,42,0,0,0
2021-05-24 17:30,77,39,38,0,0,0
2021-05-24 17:45,73,43,30,0,0,0
2021-05-24 18:00,95,40,55,0,0,0
2021-05-24 18:15,74,35,39,0,0,0
2021-05-24 18:30,61,20,41,0,0,0
2021-05-24 18:45,52,21,31,0,0,0
2021-05-24 19:00,70,37,33,0,0,0
2021-05-24 19:15,72,39,33,0,0,0
2021-05-24 19:30,61,25,36,0,0,0
2021-05-24 19:45,64,32,32,0,0,0
2021-05-24 20:00,61,24,37,0,0,0
2021-05-24 20:15,64,35,29,0,0,0
2021-05-24 20:30,60,33,27,0,0,0
2021-05-24 20:45,69,25,44,0,0,0
2021-05-24 21:00,53,16,37,0,0,0
2021-05-24 21:15,42,19,23,0,0,0
2021-05-24 21:30,56,16,40,0,0,0
2021-05-24 21:45,34,11,23,0,0,0
2021-05-24 22:00,41,18,23,0,0,0
2021-05-24 22:15,47,15,32,0,0,0
2021-05-24 22:30,24,10,14,0,0,0
2021-05-24 22:45,36,11,25,0,0,0
2021-05-24 23:00,33,7,26,0,0,0
2021-05-24 23:15,25,5,20,0,0,0
2021-05-24 23:30,32,5,27,0,0,0
2021-05-24 23:45,14,5,9,0,0,0
2021-05-25 00:00,20,5,15,0,0,0
2021-05-25 00:15,23,7,16,0,0,0
2021-05-25 00:30,24,7,17,0,0,0
2021-05-25 00:45,18,5,13,0,0,0
2021-05-25 01:00,6,3,3,0,0,0
2021-05-25 01:15,11,5,6,0,0,0
2021-05-25 01:30,10,3,7,0,0,0
2021-05-25 01:45,12,1,11,0,0,0
2021-05-25 02:00,4,0,4,0,0,0
2021-05-25 02:15,9,4,5,0,0,0
2021-05-25 02:30,4,2,2,0,0,0
2021-05-25 02:45,1,0,1,0,0,0
2021-05-25 03:00,8,3,5,0,0,0
2021-05-25 03:15,4,2,2,0,0,0
2021-05-25 03:30,1,1,0,0,0,0
2021-05-25 03:45,3,2,1,0,0,0
2021-05-25 04:00,0,0,0,0,0,0
2021-05-25 04:15,3,2,1,0,0,0
2021-05-25 04:30,10,2,8,0,0,0
2021-05-25 04:45,5,5,0,0,0,0
2021-05-25 05:00,8,5,3,0,0,0
2021-05-25 05:15,9,6,3,0,0,0
2021-05-25 05:30,24,14,10,0,0,0
2021-05-25 05:45,20,13,7,0,0,0
2021-05-25 06:00,21,11,10,0,0,0
2021-05-25 06:15,37,25,12,0,0,0
2021-05-25 06:30,48,35,13,0,0,0
2021-05-25 06:45,61,37,24,0,0,0
2021-05-25 07:00,76,48,28,0,0,0
2021-05-25 07:15,80,59,21,0,0,0
2021-05-25 07:30,115,74,41,0,0,0
2021-05-25 07:45,148,80,68,0,0,0
2021-05-25 08:00,126,76,50,0,0,0
2021-05-25 08:15,121,69,52,0,0,0
2021-05-25 08:30,97,59,38,0,0,0
2021-05-25 08:45,147,87,60,0,0,0
2021-05-25 09:00,82,52,30,0,0,0
2021-05-25 09:15,75,40,35,0,0,0
2021-05-25 09:30,89,47,42,0,0,0
2021-05-25 09:45,91,52,39,0,0,0
2021-05-25 10:00,76,45,31,0,0,0
2021-05-25 10:15,90,57,33,0,0,0
2021-05-25 10:30,73,49,24,0,0,0
2021-05-25 10:45,92,49,43,0,0,0
2021-05-25 11:00,99,64,35,0,0,0
2021-05-25 11:15,89,50,39,0,0,0
2021-05-25 11:30,76,41,35,0,0,0
2021-05-25 11:45,79,45,34,0,0,0
2021-05-25 12:00,95,46,49,0,0,0
2021-05-25 12:15,102,54,48,0,0,0
2021-05-25 12:30,111,55,56,0,0,0
2021-05-25 12:45,106,54,52,0,0,0
2021-05-25 13:00,131,56,75,0,0,0
2021-05-25 13:15,125,66,59,0,0,0
2021-05-25 13:30,102,43,59,0,0,0
2021-05-25 13:45,73,33,40,0,0,0
2021-05-25 14:00,96,44,52,0,0,0
2021-05-25 14:15,112,61,51,0,0,0
2021-05-25 14:30,104,47,57,0,0,0
2021-05-25 14:45,114,47,67,0,0,0
2021-05-25 15:00,102,44,58,0,0,0
2021-05-25 15:15,87,31,56,0,0,0
2021-05-25 15:30,98,46,52,0,0,0
2021-05-25 15:45,104,52,52,0,0,0
2021-05-25 16:00,101,40,61,0,0,0
2021-05-25 16:15,125,52,73,0,0,0
2021-05-25 16:30,92,42,50,0,0,0
2021-05-25 16:45,115,40,75,0,0,0
2021-05-25 17:00,153,80,73,0,0,0
2021-05-25 17:15,167,65,102,0,0,0
2021-05-25 17:30,120,41,79,0,0,0
2021-05-25 17:45,134,50,84,0,0,0
2021-05-25 18:00,136,59,77,0,0,0
2021-05-25 18:15,96,42,54,0,0,0
2021-05-25 18:30,107,53,54,0,0,0
2021-05-25 18:45,136,72,64,0,0,0
2021-05-25 19:00,95,41,54,0,0,0
2021-05-25 19:15,66,22,44,0,0,0
2021-05-25 19:30,63,26,37,0,0,0
2021-05-25 19:45,87,33,54,0,0,0
2021-05-25 20:00,77,35,42,0,0,0
2021-05-25 20:15,75,34,41,0,0,0
2021-05-25 20:30,49,19,30,0,0,0
2021-05-25 20:45,43,11,32,0,0,0
2021-05-25 21:00,43,13,30,0,0,0
2021-05-25 21:15,35,12,23,0,0,0
2021-05-25 21:30,42,17,25,0,0,0
2021-05-25 21:45,40,13,27,0,0,0
2021-05-25 22:00,44,22,22,0,0,0
2021-05-25 22:15,25,12,13,0,0,0
2021-05-25 22:30,31,8,23,0,0,0
2021-05-25 22:45,20,5,15,0,0,0
2021-05-25 23:00,24,7,17,0,0,0
2021-05-25 23:15,25,7,18,0,0,0
2021-05-25 23:30,25,10,15,0,0,0
2021-05-25 23:45,14,2,12,0,0,0
2021-05-26 00:00,24,7,17,0,0,0
2021-05-26 00:15,13,3,10,0,0,0
2021-05-26 00:30,16,6,10,0,0,0
2021-05-26 00:45,15,2,13,0,0,0
2021-05-26 01:00,5,2,3,0,0,0
2021-05-26 01:15,6,2,4,0,0,0
2021-05-26 01:30,7,1,6,0,0,0
2021-05-26 01:45,7,2,5,0,0,0
2021-05-26 02:00,3,2,1,0,0,0
2021-05-26 02:15,8,4,4,0,0,0
2021-05-26 02:30,4,3,1,0,0,0
2021-05-26 02:45,2,0,2,0,0,0
2021-05-26 03:00,2,1,1,0,0,0
2021-05-26 03:15,2,0,2,0,0,0
2021-05-26 03:30,2,1,1,0,0,0
2021-05-26 03:45,1,1,0,0,0,0
2021-05-26 04:00,5,0,5,0,0,0
2021-05-26 04:15,2,1,1,0,0,0
2021-05-26 04:30,3,0,3,0,0,0
2021-05-26 04:45,6,6,0,0,0,0
2021-05-26 05:00,9,5,4,0,0,0
2021-05-26 05:15,12,9,3,0,0,0
2021-05-26 05:30,18,11,7,0,0,0
2021-05-26 05:45,24,17,7,0,0,0
2021-05-26 06:00,26,15,11,0,0,0
2021-05-26 06:15,36,26,10,0,0,0
2021-05-26 06:30,48,38,10,0,0,0
2021-05-26 06:45,70,48,22,0,0,0
2021-05-26 07:00,77,54,23,0,0,0
2021-05-26 07:15,111,78,33,0,0,0
2021-05-26 07:30,165,132,33,0,0,0
2021-05-26 07:45,222,153,69,0,0,0
2021-05-26 08:00,171,94,77,0,0,0
2021-05-26 08:15,161,109,52,0,0,0
2021-05-26 08:30,123,74,49,0,0,0
2021-05-26 08:45,157,78,79,0,0,0
2021-05-26 09:00,129,79,50,0,0,0
2021-05-26 09:15,131,76,55,0,0,0
2021-05-26 09:30,118,69,49,0,0,0
2021-05-26 09:45,121,76,45,0,0,0
2021-05-26 10:00,96,61,35,0,0,0
2021-05-26 10:15,86,49,37,0,0,0
2021-05-26 10:30,85,47,38,0,0,0
2021-05-26 10:45,115,59,56,0,0,0
2021-05-26 11:00,114,61,53,0,0,0
2021-05-26 11:15,111,60,51,0,0,0
2021-05-26 11:30,121,60,61,0,0,0
2021-05-26 11:45,133,63,70,0,0,0
2021-05-26 12:00,110,52,58,0,0,0
2021-05-26 12:15,141,65,76,0,0,0
2021-05-26 12:30,143,67,76,0,0,0
2021-05-26 12:45,161,91,70,0,0,0
2021-05-26 13:00,172,71,101,0,0,0
2021-05-26 13:15,167,63,104,0,0,0
2021-05-26 13:30,142,74,68,0,0,0
2021-05-26 13:45,182,83,99,0,0,0
2021-05-26 14:00,133,55,78,0,0,0
2021-05-26 14:15,151,64,87,0,0,0
2021-05-26 14:30,132,49,83,0,0,0
2021-05-26 14:45,152,58,94,0,0,0
2021-05-26 15:00,136,56,80,0,0,0
2021-05-26 15:15,121,40,81,0,0,0
2021-05-26 15:30,141,61,80,0,0,0
2021-05-26 15:45,140,75,65,0,0,0
2021-05-26 16:00,130,52,78,0,0,0
2021-05-26 16:15,155,77,78,0,0,0
2021-05-26 16:30,172,78,94,0,0,0
2021-05-26 16:45,155,74,81,0,0,0
2021-05-26 17:00,194,87,107,0,0,0
2021-05-26 17:15,163,75,88,0,0,0
2021-05-26 17:30,161,81,80,0,0,0
2021-05-26 17:45,194,97,97,0,0,0
2021-05-26 18:00,184,76,108,0,0,0
2021-05-26 18:15,165,70,95,0,0,0
2021-05-26 18:30,175,81,94,0,0,0
2021-05-26 18:45,174,99,75,0,0,0
2021-05-26 19:00,171,84,87,0,0,0
2021-05-26 19:15,125,65,60,0,0,0
2021-05-26 19:30,121,63,58,0,0,0
2021-05-26 19:45,110,47,63,0,0,0
2021-05-26 20:00,96,43,53,0,0,0
2021-05-26 20:15,99,43,56,0,0,0
2021-05-26 20:30,69,20,49,0,0,0
2021-05-26 20:45,70,20,50,0,0,0
2021-05-26 21:00,59,27,32,0,0,0
2021-05-26 21:15,45,11,34,0,0,0
2021-05-26 21:30,61,15,46,0,0,0
2021-05-26 21:45,56,19,37,0,0,0
2021-05-26 22:00,60,31,29,0,0,0
2021-05-26 22:15,47,14,33,0,0,0
2021-05-26 22:30,45,17,28,0,0,0
2021-05-26 22:45,46,7,39,0,0,0
2021-05-26 23:00,32,11,21,0,0,0
2021-05-26 23:15,42,10,32,0,0,0
2021-05-26 23:30,46,13,33,0,0,0
2021-05-26 23:45,36,17,19,0,0,0
2021-05-27 00:00,40,13,27,0,0,0
2021-05-27 00:15,45,17,28,0,0,0
2021-05-27 00:30,27,13,14,0,0,0
2021-05-27 00:45,29,8,21,0,0,0
2021-05-27 01:00,21,3,18,0,0,0
2021-05-27 01:15,28,3,25,0,0,0
2021-05-27 01:30,19,7,12,0,0,0
2021-05-27 01:45,16,6,10,0,0,0
2021-05-27 02:00,10,4,6,0,0,0
2021-05-27 02:15,35,6,29,0,0,0
2021-05-27 02:30,18,0,18,0,0,0
2021-05-27 02:45,6,2,4,0,0,0
2021-05-27 03:00,6,0,6,0,0,0
2021-05-27 03:15,9,3,6,0,0,0
2021-05-27 03:30,6,1,5,0,0,0
2021-05-27 03:45,7,2,5,0,0,0
2021-05-27 04:00,1,0,1,0,0,0
2021-05-27 04:15,4,1,3,0,0,0
2021-05-27 04:30,1,0,1,0,0,0
2021-05-27 04:45,11,8,3,0,0,0
2021-05-27 05:00,3,2,1,0,0,0
2021-05-27 05:15,9,8,1,0,0,0
2021-05-27 05:30,22,17,5,0,0,0
2021-05-27 05:45,17,9,8,0,0,0
2021-05-27 06:00,21,16,5,0,0,0
2021-05-27 06:15,38,20,18,0,0,0
2021-05-27 06:30,33,25,8,0,0,0
2021-05-27 06:45,62,45,17,0,0,0
2021-05-27 07:00,64,37,27,0,0,0
2021-05-27 07:15,125,81,44,0,0,0
2021-05-27 07:30,159,112,47,0,0,0
2021-05-27 07:45,214,123,91,0,0,0
2021-05-27 08:00,141,94,47,0,0,0
2021-05-27 08:15,125,86,39,0,0,0
2021-05-27 08:30,115,82,33,0,0,0
2021-05-27 08:45,146,80,66,0,0,0
2021-05-27 09:00,115,70,45,0,0,0
2021-05-27 09:15,109,68,41,0,0,0
2021-05-27 09:30,110,67,43,0,0,0
2021-05-27 09:45,126,73,53,0,0,0
2021-05-27 10:00,75,43,32,0,0,0
2021-05-27 10:15,88,48,40,0,0,0
2021-05-27 10:30,83,48,35,0,0,0
2021-05-27 10:45,92,49,43,0,0,0
2021-05-27 11:00,105,46,59,0,0,0
2021-05-27 11:15,91,41,50,0,0,0
2021-05-27 11:30,103,53,50,0,0,0
2021-05-27 11:45,87,43,44,0,0,0
2021-05-27 12:00,89,47,42,0,0,0
2021-05-27 12:15,80,38,42,0,0,0
2021-05-27 12:30,103,43,60,0,0,0
2021-05-27 12:45,102,60,42,0,0,0
2021-05-27 13:00,146,54,92,0,0,0
2021-05-27 13:15,123,43,80,0,0,0
2021-05-27 13:30,102,39,63,0,0,0
2021-05-27 13:45,117,63,54,0,0,0
2021-05-27 14:00,97,43,54,0,0,0
2021-05-27 14:15,137,70,67,0,0,0
2021-05-27 14:30,127,58,69,0,0,0
2021-05-27 14:45,125,48,77,0,0,0
2021-05-27 15:00,108,47,61,0,0,0
2021-05-27 15:15,89,43,46,0,0,0
2021-05-27 15:30,116,59,57,0,0,0
2021-05-27 15:45,164,66,98,0,0,0
2021-05-27 16:00,133,51,82,0,0,0
2021-05-27 16:15,102,40,62,0,0,0
2021-05-27 16:30,145,64,81,0,0,0
2021-05-27 16:45,161,85,76,0,0,0
2021-05-27 17:00,151,65,86,0,0,0
2021-05-27 17:15,167,91,76,0,0,0
2021-05-27 17:30,169,74,95,0,0,0
2021-05-27 17:45,161,77,84,0,0,0
2021-05-27 18:00,163,48,115,0,0,0
2021-05-27 18:15,160,71,89,0,0,0
2021-05-27 18:30,124,52,72,0,0,0
2021-05-27 18:45,127,68,59,0,0,0
2021-05-27 19:00,127,63,64,0,0,0
2021-05-27 19:15,128,56,72,0,0,0
2021-05-27 19:30,98,63,35,0,0,0
2021-05-27 19:45,104,52,52,0,0,0
2021-05-27 20:00,94,29,65,0,0,0
2021-05-27 20:15,74,31,43,0,0,0
2021-05-27 20:30,53,13,40,0,0,0
2021-05-27 20:45,49,23,26,0,0,0
2021-05-27 21:00,61,22,39,0,0,0
2021-05-27 21:15,46,20,26,0,0,0
2021-05-27 21:30,54,24,30,0,0,0
2021-05-27 21:45,39,12,27,0,0,0
2021-05-27 22:00,44,11,33,0,0,0
2021-05-27 22:15,49,15,34,0,0,0
2021-05-27 22:30,31,7,24,0,0,0
2021-05-27 22:45,44,16,28,0,0,0
2021-05-27 23:00,49,16,33,0,0,0
2021-05-27 23:15,48,11,37,0,0,0
2021-05-27 23:30,34,8,26,0,0,0
2021-05-27 23:45,26,6,20,0,0,0
2021-05-28 00:00,35,8,27,0,0,0
2021-05-28 00:15,25,8,17,0,0,0
2021-05-28 00:30,15,3,12,0,0,0
2021-05-28 00:45,16,5,11,0,0,0
2021-05-28 01:00,13,2,11,0,0,0
2021-05-28 01:15,14,5,9,0,0,0
2021-05-28 01:30,11,3,8,0,0,0
2021-05-28 01:45,15,5,10,0,0,0
2021-05-28 02:00,16,4,12,0,0,0
2021-05-28 02:15,11,1,10,0,0,0
2021-05-28 02:30,16,4,12,0,0,0
2021-05-28 02:45,5,1,4,0,0,0
2021-05-28 03:00,8,1,7,0,0,0
2021-05-28 03:15,6,0,6,0,0,0
2021-05-28 03:30,2,1,1,0,0,0
2021-05-28 03:45,5,0,5,0,0,0
2021-05-28 04:00,7,6,1,0,0,0
2021-05-28 04:15,3,0,3,0,0,0
2021-05-28 04:30,9,4,5,0,0,0
2021-05-28 04:45,7,5,2,0,0,0
2021-05-28 05:00,7,5,2,0,0,0
2021-05-28 05:15,11,10,1,0,0,0
2021-05-28 05:30,18,16,2,0,0,0
2021-05-28 05:45,25,20,5,0,0,0
2021-05-28 06:00,28,17,11,0,0,0
2021-05-28 06:15,41,30,11,0,0,0
2021-05-28 06:30,53,37,16,0,0,0
2021-05-28 06:45,70,46,24,0,0,0
2021-05-28 07:00,84,63,21,0,0,0
2021-05-28 07:15,115,75,40,0,0,0
2021-05-28 07:30,179,122,57,0,0,0
2021-05-28 07:45,212,143,69,0,0,0
2021-05-28 08:00,159,87,72,0,0,0
2021-05-28 08:15,154,97,57,0,0,0
2021-05-28 08:30,131,74,57,0,0,0
2021-05-28 08:45,159,106,53,0,0,0
2021-05-28 09:00,136,79,57,0,0,0
2021-05-28 09:15,111,74,37,0,0,0
2021-05-28 09:30,132,69,63,0,0,0
2021-05-28 09:45,167,117,50,0,0,0
2021-05-28 10:00,118,61,57,0,0,0
2021-05-28 10:15,97,63,34,0,0,0
2021-05-28 10:30,97,56,41,0,0,0
2021-05-28 10:45,136,71,65,0,0,0
2021-05-28 11:00,95,44,51,0,0,0
2021-05-28 11:15,119,55,64,0,0,0
2021-05-28 11:30,120,50,70,0,0,0
2021-05-28 11:45,143,69,74,0,0,0
2021-05-28 12:00,128,56,72,0,0,0
2021-05-28 12:15,158,86,72,0,0,0
2021-05-28 12:30,144,68,76,0,0,0
2021-05-28 12:45,181,85,96,0,0,0
2021-05-28 13:00,198,92,106,0,0,0
2021-05-28 13:15,194,76,118,0,0,0
2021-05-28 13:30,185,100,85,0,0,0
2021-05-28 13:45,214,93,121,0,0,0
2021-05-28 14:00,186,94,92,0,0,0
2021-05-28 14:15,199,102,97,0,0,0
2021-05-28 14:30,164,79,85,0,0,0
2021-05-28 14:45,203,102,101,0,0,0
2021-05-28 15:00,200,100,100,0,0,0
2021-05-28 15:15,189,107,82,0,0,0
2021-05-28 15:30,200,99,101,0,0,0
2021-05-28 15:45,208,119,89,0,0,0
2021-05-28 16:00,173,101,72,0,0,0
2021-05-28 16:15,180,101,79,0,0,0
2021-05-28 16:30,195,101,94,0,0,0
2021-05-28 16:45,223,112,111,0,0,0
2021-05-28 17:00,205,104,101,0,0,0
2021-05-28 17:15,175,80,95,0,0,0
2021-05-28 17:30,218,92,126,0,0,0
2021-05-28 17:45,237,117,120,0,0,0
2021-05-28 18:00,241,116,125,0,0,0
2021-05-28 18:15,213,115,98,0,0,0
2021-05-28 18:30,207,100,107,0,0,0
2021-05-28 18:45,252,132,120,0,0,0
2021-05-28 19:00,196,119,77,0,0,0
2021-05-28 19:15,178,94,84,0,0,0
2021-05-28 19:30,155,71,84,0,0,0
2021-05-28 19:45,203,124,79,0,0,0
2021-05-28 20:00,164,95,69,0,0,0
2021-05-28 20:15,156,71,85,0,0,0
2021-05-28 20:30,82,39,43,0,0,0
2021-05-28 20:45,86,44,42,0,0,0
2021-05-28 21:00,111,54,57,0,0,0
2021-05-28 21:15,94,48,46,0,0,0
2021-05-28 21:30,82,29,53,0,0,0
2021-05-28 21:45,73,29,44,0,0,0
2021-05-28 22:00,101,34,67,0,0,0
2021-05-28 22:15,91,32,59,0,0,0
2021-05-28 22:30,77,29,48,0,0,0
2021-05-28 22:45,85,28,57,0,0,0
2021-05-28 23:00,75,28,47,0,0,0
2021-05-28 23:15,65,16,49,0,0,0
2021-05-28 23:30,73,18,55,0,0,0
2021-05-28 23:45,65,20,45,0,0,0
2021-05-29 00:00,56,17,39,0,0,0
2021-05-29 00:15,68,16,52,0,0,0
2021-05-29 00:30,54,11,43,0,0,0
2021-05-29 00:45,71,13,58,0,0,0
2021-05-29 01:00,64,10,54,0,0,0
2021-05-29 01:15,59,9,50,0,0,0
2021-05-29 01:30,69,16,53,0,0,0
2021-05-29 01:45,60,13,47,0,0,0
2021-05-29 02:00,59,15,44,0,0,0
2021-05-29 02:15,50,10,40,0,0,0
2021-05-29 02:30,52,4,48,0,0,0
2021-05-29 02:45,28,9,19,0,0,0
2021-05-29 03:00,32,9,23,0,0,0
2021-05-29 03:15,29,3,26,0,0,0
2021-05-29 03:30,30,7,23,0,0,0
2021-05-29 03:45,21,10,11,0,0,0
2021-05-29 04:00,28,5,23,0,0,0
2021-05-29 04:15,10,3,7,0,0,0
2021-05-29 04:30,11,5,6,0,0,0
2021-05-29 04:45,19,5,14,0,0,0
2021-05-29 05:00,9,3,6,0,0,0
2021-05-29 05:15,14,5,9,0,0,0
2021-05-29 05:30,13,7,6,0,0,0
2021-05-29 05:45,11,4,7,0,0,0
2021-05-29 06:00,12,5,7,0,0,0
2021-05-29 06:15,12,10,2,0,0,0
2021-05-29 06:30,11,9,2,0,0,0
2021-05-29 06:45,17,13,4,0,0,0
2021-05-29 07:00,20,16,4,0,0,0
2021-05-29 07:15,31,20,11,0,0,0
2021-05-29 07:30,39,23,16,0,0,0
2021-05-29 07:45,45,24,21,0,0,0
2021-05-29 08:00,57,39,18,0,0,0
2021-05-29 08:15,46,34,12,0,0,0
2021-05-29 08:30,62,35,27,0,0,0
2021-05-29 08:45,78,48,30,0,0,0
2021-05-29 09:00,69,46,23,0,0,0
2021-05-29 09:15,73,53,20,0,0,0
2021-05-29 09:30,89,58,31,0,0,0
2021-05-29 09:45,115,66,49,0,0,0
2021-05-29 10:00,96,74,22,0,0,0
2021-05-29 10:15,90,52,38,0,0,0
2021-05-29 10:30,103,67,36,0,0,0
2021-05-29 10:45,103,59,44,0,0,0
2021-05-29 11:00,118,60,58,0,0,0
2021-05-29 11:15,135,81,54,0,0,0
2021-05-29 11:30,114,67,47,0,0,0
2021-05-29 11:45,147,89,58,0,0,0
2021-05-29 12:00,135,76,59,0,0,0
2021-05-29 12:15,132,72,60,0,0,0
2021-05-29 12:30,141,71,70,0,0,0
2021-05-29 12:45,168,103,65,0,0,0
2021-05-29 13:00,176,95,81,0,0,0
2021-05-29 13:15,169,93,76,0,0,0
2021-05-29 13:30,179,96,83,0,0,0
2021-05-29 13:45,175,86,89,0,0,0
2021-05-29 14:00,147,88,59,0,0,0
2021-05-29 14:15,158,77,81,0,0,0
2021-05-29 14:30,152,71,81,0,0,0
2021-05-29 14:45,188,109,79,0,0,0
2021-05-29 15:00,140,71,69,0,0,0
2021-05-29 15:15,185,107,78,0,0,0
2021-05-29 15:30,185,96,89,0,0,0
2021-05-29 15:45,170,81,89,0,0,0
2021-05-29 16:00,162,84,78,0,0,0
2021-05-29 16:15,189,89,100,0,0,0
2021-05-29 16:30,179,102,77,0,0,0
2021-05-29 16:45,176,83,93,0,0,0
2021-05-29 17:00,158,86,72,0,0,0
2021-05-29 17:15,168,81,87,0,0,0
2021-05-29 17:30,190,82,108,0,0,0
2021-05-29 17:45,197,99,98,0,0,0
2021-05-29 18:00,201,99,102,0,0,0
2021-05-29 18:15,176,87,89,0,0,0
2021-05-29 18:30,136,65,71,0,0,0
2021-05-29 18:45,210,99,111,0,0,0
2021-05-29 19:00,167,91,76,0,0,0
2021-05-29 19:15,178,89,89,0,0,0
2021-05-29 19:30,168,89,79,0,0,0
2021-05-29 19:45,163,85,78,0,0,0
2021-05-29 20:00,155,67,88,0,0,0
2021-05-29 20:15,142,82,60,0,0,0
2021-05-29 20:30,96,50,46,0,0,0
2021-05-29 20:45,151,58,93,0,0,0
2021-05-29 21:00,112,42,70,0,0,0
2021-05-29 21:15,95,36,59,0,0,0
2021-05-29 21:30,91,33,58,0,0,0
2021-05-29 21:45,78,30,48,0,0,0
2021-05-29 22:00,75,33,42,0,0,0
2021-05-29 22:15,62,17,45,0,0,0
2021-05-29 22:30,70,24,46,0,0,0
2021-05-29 22:45,86,36,50,0,0,0
2021-05-29 23:00,88,39,49,0,0,0
2021-05-29 23:15,73,21,52,0,0,0
2021-05-29 23:30,87,22,65,0,0,0
2021-05-29 23:45,103,34,69,0,0,0
2021-05-30 00:00,27,27,,0,0,
2021-05-30 00:15,24,24,,0,0,
2021-05-30 00:30,9,9,,0,0,
2021-05-30 00:45,16,16,,0,0,
2021-05-30 01:00,28,28,,0,0,
2021-05-30 01:15,18,18,,0,0,
2021-05-30 01:30,21,21,,0,0,
2021-05-30 01:45,15,15,,0,0,
2021-05-30 02:00,12,12,,0,0,
2021-05-30 02:15,10,10,,0,0,
2021-05-30 02:30,11,11,,0,0,
2021-05-30 02:45,8,8,,0,0,
2021-05-30 03:00,14,14,,0,0,
2021-05-30 03:15,5,5,,0,0,
2021-05-30 03:30,7,7,,0,0,
2021-05-30 03:45,10,10,,0,0,
2021-05-30 04:00,7,7,,0,0,
2021-05-30 04:15,7,7,,0,0,
2021-05-30 04:30,4,4,,0,0,
2021-05-30 04:45,6,6,,0,0,
2021-05-30 05:00,3,3,,0,0,
2021-05-30 05:15,4,4,,0,0,
2021-05-30 05:30,5,5,,0,0,
2021-05-30 05:45,5,5,,0,0,
2021-05-30 06:00,3,3,,0,0,
2021-05-30 06:15,4,4,,0,0,
2021-05-30 06:30,3,3,,0,0,
2021-05-30 06:45,4,4,,0,0,
2021-05-30 07:00,8,8,,0,0,
2021-05-30 07:15,4,4,,0,0,
2021-05-30 07:30,12,12,,0,0,
2021-05-30 07:45,6,6,,0,0,
2021-05-30 08:00,12,12,,0,0,
2021-05-30 08:15,10,10,,0,0,
2021-05-30 08:30,16,16,,0,0,
2021-05-30 08:45,18,18,,0,0,
2021-05-30 09:00,16,16,,0,0,
2021-05-30 09:15,20,20,,0,0,
2021-05-30 09:30,37,37,,0,0,
2021-05-30 09:45,40,40,,0,0,
2021-05-30 10:00,51,51,,0,0,
2021-05-30 10:15,29,29,,0,0,
2021-05-30 10:30,48,48,,0,0,
2021-05-30 10:45,64,64,,0,0,
2021-05-30 11:00,51,51,,0,0,
2021-05-30 11:15,51,51,,0,0,
2021-05-30 11:30,58,58,,0,0,
2021-05-30 11:45,70,70,,0,0,
2021-05-30 12:00,76,76,,0,0,
2021-05-30 12:15,68,68,,0,0,
2021-05-30 12:30,68,68,,0,0,
2021-05-30 12:45,71,71,,0,0,
2021-05-30 13:00,80,80,,0,0,
2021-05-30 13:15,67,67,,0,0,
2021-05-30 13:30,76,76,,0,0,
2021-05-30 13:45,94,94,,0,0,
2021-05-30 14:00,108,108,,0,0,
2021-05-30 14:15,119,119,,0,0,
2021-05-30 14:30,80,80,,0,0,
2021-05-30 14:45,132,132,,0,0,
2021-05-30 15:00,116,116,,0,0,
2021-05-30 15:15,103,103,,0,0,
2021-05-30 15:30,86,86,,0,0,
2021-05-30 15:45,115,115,,0,0,
2021-05-30 16:00,105,105,,0,0,
2021-05-30 16:15,93,93,,0,0,
2021-05-30 16:30,89,89,,0,0,
2021-05-30 16:45,85,85,,0,0,
2021-05-30 17:00,97,97,,0,0,
2021-05-30 17:15,104,104,,0,0,
2021-05-30 17:30,88,88,,0,0,
2021-05-30 17:45,117,117,,0,0,
2021-05-30 18:00,93,93,,0,0,
2021-05-30 18:15,93,93,,0,0,
2021-05-30 18:30,120,120,,0,0,
2021-05-30 18:45,79,79,,0,0,
2021-05-30 19:00,85,85,,0,0,
2021-05-30 19:15,74,74,,0,0,
2021-05-30 19:30,74,74,,0,0,
2021-05-30 19:45,72,72,,0,0,
2021-05-30 20:00,69,69,,0,0,
2021-05-30 20:15,56,56,,0,0,
2021-05-30 20:30,57,57,,0,0,
2021-05-30 20:45,44,44,,0,0,
2021-05-30 21:00,33,33,,0,0,
2021-05-30 21:15,27,27,,0,0,
2021-05-30 21:30,31,31,,0,0,
2021-05-30 21:45,28,28,,0,0,
2021-05-30 22:00,26,26,,0,0,
2021-05-30 22:15,29,29,,0,0,
2021-05-30 22:30,23,23,,0,0,
2021-05-30 22:45,22,22,,0,0,
2021-05-30 23:00,12,12,,0,0,
2021-05-30 23:15,13,13,,0,0,
2021-05-30 23:30,11,11,,0,0,
2021-05-30 23:45,5,5,,0,0,
