Datetime,100034980 (Hammer Straße),101034980 (Hammer Straße stadteinwärts),102034980 (Hammer Straße stadtauswärts),100034980-status,101034980-status,102034980-status
2019-11-01 00:00,40,18,22,0,0,0
2019-11-01 00:15,35,14,21,0,0,0
2019-11-01 00:30,52,27,25,0,0,0
2019-11-01 00:45,52,36,16,0,0,0
2019-11-01 01:00,59,35,24,0,0,0
2019-11-01 01:15,41,19,22,0,0,0
2019-11-01 01:30,50,24,26,0,0,0
2019-11-01 01:45,44,22,22,0,0,0
2019-11-01 02:00,39,12,27,0,0,0
2019-11-01 02:15,29,4,25,0,0,0
2019-11-01 02:30,29,6,23,0,0,0
2019-11-01 02:45,22,6,16,0,0,0
2019-11-01 03:00,18,5,13,0,0,0
2019-11-01 03:15,28,11,17,0,0,0
2019-11-01 03:30,29,14,15,0,0,0
2019-11-01 03:45,27,4,23,0,0,0
2019-11-01 04:00,20,7,13,0,0,0
2019-11-01 04:15,18,11,7,0,0,0
2019-11-01 04:30,14,1,13,0,0,0
2019-11-01 04:45,20,11,9,0,0,0
2019-11-01 05:00,8,4,4,0,0,0
2019-11-01 05:15,6,3,3,0,0,0
2019-11-01 05:30,15,9,6,0,0,0
2019-11-01 05:45,8,7,1,0,0,0
2019-11-01 06:00,6,3,3,0,0,0
2019-11-01 06:15,11,8,3,0,0,0
2019-11-01 06:30,6,5,1,0,0,0
2019-11-01 06:45,5,3,2,0,0,0
2019-11-01 07:00,4,0,4,0,0,0
2019-11-01 07:15,8,7,1,0,0,0
2019-11-01 07:30,7,5,2,0,0,0
2019-11-01 07:45,15,13,2,0,0,0
2019-11-01 08:00,21,10,11,0,0,0
2019-11-01 08:15,9,5,4,0,0,0
2019-11-01 08:30,8,3,5,0,0,0
2019-11-01 08:45,19,13,6,0,0,0
2019-11-01 09:00,17,11,6,0,0,0
2019-11-01 09:15,21,15,6,0,0,0
2019-11-01 09:30,27,17,10,0,0,0
2019-11-01 09:45,42,29,13,0,0,0
2019-11-01 10:00,35,19,16,0,0,0
2019-11-01 10:15,30,15,15,0,0,0
2019-11-01 10:30,32,23,9,0,0,0
2019-11-01 10:45,48,29,19,0,0,0
2019-11-01 11:00,23,11,12,0,0,0
2019-11-01 11:15,36,18,18,0,0,0
2019-11-01 11:30,42,19,23,0,0,0
2019-11-01 11:45,30,16,14,0,0,0
2019-11-01 12:00,53,26,27,0,0,0
2019-11-01 12:15,38,22,16,0,0,0
2019-11-01 12:30,39,16,23,0,0,0
2019-11-01 12:45,47,23,24,0,0,0
2019-11-01 13:00,24,8,16,0,0,0
2019-11-01 13:15,27,12,15,0,0,0
2019-11-01 13:30,36,17,19,0,0,0
2019-11-01 13:45,27,13,14,0,0,0
2019-11-01 14:00,24,13,11,0,0,0
2019-11-01 14:15,33,18,15,0,0,0
2019-11-01 14:30,26,9,17,0,0,0
2019-11-01 14:45,39,11,28,0,0,0
2019-11-01 15:00,26,8,18,0,0,0
2019-11-01 15:15,24,12,12,0,0,0
2019-11-01 15:30,37,16,21,0,0,0
2019-11-01 15:45,44,14,30,0,0,0
2019-11-01 16:00,39,20,19,0,0,0
2019-11-01 16:15,21,12,9,0,0,0
2019-11-01 16:30,35,21,14,0,0,0
2019-11-01 16:45,42,24,18,0,0,0
2019-11-01 17:00,36,21,15,0,0,0
2019-11-01 17:15,51,21,30,0,0,0
2019-11-01 17:30,52,26,26,0,0,0
2019-11-01 17:45,49,23,26,0,0,0
2019-11-01 18:00,43,17,26,0,0,0
2019-11-01 18:15,30,17,13,0,0,0
2019-11-01 18:30,24,14,10,0,0,0
2019-11-01 18:45,46,26,20,0,0,0
2019-11-01 19:00,55,30,25,0,0,0
2019-11-01 19:15,51,21,30,0,0,0
2019-11-01 19:30,42,18,24,0,0,0
2019-11-01 19:45,60,35,25,0,0,0
2019-11-01 20:00,34,23,11,0,0,0
2019-11-01 20:15,48,25,23,0,0,0
2019-11-01 20:30,23,11,12,0,0,0
2019-11-01 20:45,27,14,13,0,0,0
2019-11-01 21:00,30,15,15,0,0,0
2019-11-01 21:15,33,11,22,0,0,0
2019-11-01 21:30,29,15,14,0,0,0
2019-11-01 21:45,24,11,13,0,0,0
2019-11-01 22:00,33,7,26,0,0,0
2019-11-01 22:15,43,10,33,0,0,0
2019-11-01 22:30,26,5,21,0,0,0
2019-11-01 22:45,21,6,15,0,0,0
2019-11-01 23:00,21,2,19,0,0,0
2019-11-01 23:15,16,1,15,0,0,0
2019-11-01 23:30,24,5,19,0,0,0
2019-11-01 23:45,30,15,15,0,0,0
2019-11-02 00:00,12,3,9,0,0,0
2019-11-02 00:15,20,5,15,0,0,0
2019-11-02 00:30,12,5,7,0,0,0
2019-11-02 00:45,11,2,9,0,0,0
2019-11-02 01:00,10,2,8,0,0,0
2019-11-02 01:15,13,3,10,0,0,0
2019-11-02 01:30,13,7,6,0,0,0
2019-11-02 01:45,9,4,5,0,0,0
2019-11-02 02:00,5,0,5,0,0,0
2019-11-02 02:15,9,4,5,0,0,0
2019-11-02 02:30,4,1,3,0,0,0
2019-11-02 02:45,4,2,2,0,0,0
2019-11-02 03:00,2,1,1,0,0,0
2019-11-02 03:15,2,1,1,0,0,0
2019-11-02 03:30,2,2,0,0,0,0
2019-11-02 03:45,7,2,5,0,0,0
2019-11-02 04:00,4,2,2,0,0,0
2019-11-02 04:15,3,3,0,0,0,0
2019-11-02 04:30,0,0,0,0,0,0
2019-11-02 04:45,2,1,1,0,0,0
2019-11-02 05:00,0,0,0,0,0,0
2019-11-02 05:15,3,3,0,0,0,0
2019-11-02 05:30,7,3,4,0,0,0
2019-11-02 05:45,6,4,2,0,0,0
2019-11-02 06:00,7,5,2,0,0,0
2019-11-02 06:15,4,4,0,0,0,0
2019-11-02 06:30,5,2,3,0,0,0
2019-11-02 06:45,6,3,3,0,0,0
2019-11-02 07:00,10,6,4,0,0,0
2019-11-02 07:15,10,7,3,0,0,0
2019-11-02 07:30,15,10,5,0,0,0
2019-11-02 07:45,25,15,10,0,0,0
2019-11-02 08:00,25,18,7,0,0,0
2019-11-02 08:15,25,18,7,0,0,0
2019-11-02 08:30,27,12,15,0,0,0
2019-11-02 08:45,57,30,27,0,0,0
2019-11-02 09:00,38,29,9,0,0,0
2019-11-02 09:15,81,57,24,0,0,0
2019-11-02 09:30,68,49,19,0,0,0
2019-11-02 09:45,105,79,26,0,0,0
2019-11-02 10:00,106,74,32,0,0,0
2019-11-02 10:15,109,78,31,0,0,0
2019-11-02 10:30,105,76,29,0,0,0
2019-11-02 10:45,131,89,42,0,0,0
2019-11-02 11:00,146,94,52,0,0,0
2019-11-02 11:15,143,78,65,0,0,0
2019-11-02 11:30,139,79,60,0,0,0
2019-11-02 11:45,165,82,83,0,0,0
2019-11-02 12:00,186,93,93,0,0,0
2019-11-02 12:15,186,83,103,0,0,0
2019-11-02 12:30,162,79,83,0,0,0
2019-11-02 12:45,206,91,115,0,0,0
2019-11-02 13:00,121,50,71,0,0,0
2019-11-02 13:15,108,30,78,0,0,0
2019-11-02 13:30,191,58,133,0,0,0
2019-11-02 13:45,162,68,94,0,0,0
2019-11-02 14:00,139,70,69,0,0,0
2019-11-02 14:15,136,49,87,0,0,0
2019-11-02 14:30,132,57,75,0,0,0
2019-11-02 14:45,150,66,84,0,0,0
2019-11-02 15:00,113,41,72,0,0,0
2019-11-02 15:15,133,60,73,0,0,0
2019-11-02 15:30,115,60,55,0,0,0
2019-11-02 15:45,114,46,68,0,0,0
2019-11-02 16:00,152,91,61,0,0,0
2019-11-02 16:15,161,91,70,0,0,0
2019-11-02 16:30,123,60,63,0,0,0
2019-11-02 16:45,108,39,69,0,0,0
2019-11-02 17:00,136,53,83,0,0,0
2019-11-02 17:15,138,53,85,0,0,0
2019-11-02 17:30,110,49,61,0,0,0
2019-11-02 17:45,99,36,63,0,0,0
2019-11-02 18:00,132,45,87,0,0,0
2019-11-02 18:15,92,33,59,0,0,0
2019-11-02 18:30,72,41,31,0,0,0
2019-11-02 18:45,106,52,54,0,0,0
2019-11-02 19:00,75,27,48,0,0,0
2019-11-02 19:15,62,36,26,0,0,0
2019-11-02 19:30,72,24,48,0,0,0
2019-11-02 19:45,79,42,37,0,0,0
2019-11-02 20:00,59,23,36,0,0,0
2019-11-02 20:15,64,31,33,0,0,0
2019-11-02 20:30,38,16,22,0,0,0
2019-11-02 20:45,59,22,37,0,0,0
2019-11-02 21:00,45,16,29,0,0,0
2019-11-02 21:15,50,19,31,0,0,0
2019-11-02 21:30,25,11,14,0,0,0
2019-11-02 21:45,40,11,29,0,0,0
2019-11-02 22:00,35,7,28,0,0,0
2019-11-02 22:15,27,13,14,0,0,0
2019-11-02 22:30,41,17,24,0,0,0
2019-11-02 22:45,39,15,24,0,0,0
2019-11-02 23:00,36,9,27,0,0,0
2019-11-02 23:15,27,9,18,0,0,0
2019-11-02 23:30,32,11,21,0,0,0
2019-11-02 23:45,42,19,23,0,0,0
2019-11-03 00:00,37,12,25,0,0,0
2019-11-03 00:15,12,3,9,0,0,0
2019-11-03 00:30,20,6,14,0,0,0
2019-11-03 00:45,18,4,14,0,0,0
2019-11-03 01:00,17,9,8,0,0,0
2019-11-03 01:15,31,5,26,0,0,0
2019-11-03 01:30,22,4,18,0,0,0
2019-11-03 01:45,26,7,19,0,0,0
2019-11-03 02:00,18,6,12,0,0,0
2019-11-03 02:15,19,12,7,0,0,0
2019-11-03 02:30,15,10,5,0,0,0
2019-11-03 02:45,25,16,9,0,0,0
2019-11-03 03:00,8,1,7,0,0,0
2019-11-03 03:15,13,5,8,0,0,0
2019-11-03 03:30,7,3,4,0,0,0
2019-11-03 03:45,5,1,4,0,0,0
2019-11-03 04:00,4,1,3,0,0,0
2019-11-03 04:15,2,1,1,0,0,0
2019-11-03 04:30,11,6,5,0,0,0
2019-11-03 04:45,5,2,3,0,0,0
2019-11-03 05:00,2,1,1,0,0,0
2019-11-03 05:15,4,2,2,0,0,0
2019-11-03 05:30,3,1,2,0,0,0
2019-11-03 05:45,2,0,2,0,0,0
2019-11-03 06:00,3,3,0,0,0,0
2019-11-03 06:15,4,1,3,0,0,0
2019-11-03 06:30,3,2,1,0,0,0
2019-11-03 06:45,1,0,1,0,0,0
2019-11-03 07:00,0,0,0,0,0,0
2019-11-03 07:15,2,2,0,0,0,0
2019-11-03 07:30,7,5,2,0,0,0
2019-11-03 07:45,11,5,6,0,0,0
2019-11-03 08:00,10,7,3,0,0,0
2019-11-03 08:15,2,2,0,0,0,0
2019-11-03 08:30,7,3,4,0,0,0
2019-11-03 08:45,11,4,7,0,0,0
2019-11-03 09:00,13,9,4,0,0,0
2019-11-03 09:15,21,13,8,0,0,0
2019-11-03 09:30,16,11,5,0,0,0
2019-11-03 09:45,47,25,22,0,0,0
2019-11-03 10:00,41,19,22,0,0,0
2019-11-03 10:15,40,23,17,0,0,0
2019-11-03 10:30,30,20,10,0,0,0
2019-11-03 10:45,56,33,23,0,0,0
2019-11-03 11:00,43,25,18,0,0,0
2019-11-03 11:15,35,21,14,0,0,0
2019-11-03 11:30,46,26,20,0,0,0
2019-11-03 11:45,71,43,28,0,0,0
2019-11-03 12:00,46,22,24,0,0,0
2019-11-03 12:15,58,31,27,0,0,0
2019-11-03 12:30,59,36,23,0,0,0
2019-11-03 12:45,52,24,28,0,0,0
2019-11-03 13:00,55,32,23,0,0,0
2019-11-03 13:15,62,27,35,0,0,0
2019-11-03 13:30,60,24,36,0,0,0
2019-11-03 13:45,63,30,33,0,0,0
2019-11-03 14:00,60,24,36,0,0,0
2019-11-03 14:15,79,38,41,0,0,0
2019-11-03 14:30,69,25,44,0,0,0
2019-11-03 14:45,105,54,51,0,0,0
2019-11-03 15:00,87,32,55,0,0,0
2019-11-03 15:15,69,26,43,0,0,0
2019-11-03 15:30,72,38,34,0,0,0
2019-11-03 15:45,85,50,35,0,0,0
2019-11-03 16:00,62,42,20,0,0,0
2019-11-03 16:15,59,29,30,0,0,0
2019-11-03 16:30,74,38,36,0,0,0
2019-11-03 16:45,90,51,39,0,0,0
2019-11-03 17:00,76,25,51,0,0,0
2019-11-03 17:15,77,34,43,0,0,0
2019-11-03 17:30,68,29,39,0,0,0
2019-11-03 17:45,74,35,39,0,0,0
2019-11-03 18:00,66,20,46,0,0,0
2019-11-03 18:15,75,28,47,0,0,0
2019-11-03 18:30,75,35,40,0,0,0
2019-11-03 18:45,64,34,30,0,0,0
2019-11-03 19:00,65,27,38,0,0,0
2019-11-03 19:15,58,23,35,0,0,0
2019-11-03 19:30,40,13,27,0,0,0
2019-11-03 19:45,48,22,26,0,0,0
2019-11-03 20:00,61,17,44,0,0,0
2019-11-03 20:15,48,22,26,0,0,0
2019-11-03 20:30,39,17,22,0,0,0
2019-11-03 20:45,26,8,18,0,0,0
2019-11-03 21:00,26,8,18,0,0,0
2019-11-03 21:15,33,7,26,0,0,0
2019-11-03 21:30,27,6,21,0,0,0
2019-11-03 21:45,22,4,18,0,0,0
2019-11-03 22:00,38,9,29,0,0,0
2019-11-03 22:15,30,12,18,0,0,0
2019-11-03 22:30,50,28,22,0,0,0
2019-11-03 22:45,27,16,11,0,0,0
2019-11-03 23:00,15,8,7,0,0,0
2019-11-03 23:15,14,7,7,0,0,0
2019-11-03 23:30,5,1,4,0,0,0
2019-11-03 23:45,11,6,5,0,0,0
2019-11-04 00:00,9,2,7,0,0,0
2019-11-04 00:15,4,1,3,0,0,0
2019-11-04 00:30,8,2,6,0,0,0
2019-11-04 00:45,14,1,13,0,0,0
2019-11-04 01:00,3,0,3,0,0,0
2019-11-04 01:15,3,1,2,0,0,0
2019-11-04 01:30,5,1,4,0,0,0
2019-11-04 01:45,0,0,0,0,0,0
2019-11-04 02:00,1,0,1,0,0,0
2019-11-04 02:15,0,0,0,0,0,0
2019-11-04 02:30,1,1,0,0,0,0
2019-11-04 02:45,0,0,0,0,0,0
2019-11-04 03:00,1,0,1,0,0,0
2019-11-04 03:15,1,1,0,0,0,0
2019-11-04 03:30,2,0,2,0,0,0
2019-11-04 03:45,0,0,0,0,0,0
2019-11-04 04:00,0,0,0,0,0,0
2019-11-04 04:15,2,1,1,0,0,0
2019-11-04 04:30,0,0,0,0,0,0
2019-11-04 04:45,3,3,0,0,0,0
2019-11-04 05:00,5,5,0,0,0,0
2019-11-04 05:15,5,5,0,0,0,0
2019-11-04 05:30,20,11,9,0,0,0
2019-11-04 05:45,22,17,5,0,0,0
2019-11-04 06:00,18,13,5,0,0,0
2019-11-04 06:15,40,30,10,0,0,0
2019-11-04 06:30,46,31,15,0,0,0
2019-11-04 06:45,65,47,18,0,0,0
2019-11-04 07:00,73,49,24,0,0,0
2019-11-04 07:15,132,84,48,0,0,0
2019-11-04 07:30,173,110,63,0,0,0
2019-11-04 07:45,177,121,56,0,0,0
2019-11-04 08:00,132,105,27,0,0,0
2019-11-04 08:15,134,93,41,0,0,0
2019-11-04 08:30,132,97,35,0,0,0
2019-11-04 08:45,157,106,51,0,0,0
2019-11-04 09:00,118,89,29,0,0,0
2019-11-04 09:15,106,72,34,0,0,0
2019-11-04 09:30,114,71,43,0,0,0
2019-11-04 09:45,164,108,56,0,0,0
2019-11-04 10:00,155,113,42,0,0,0
2019-11-04 10:15,98,55,43,0,0,0
2019-11-04 10:30,97,51,46,0,0,0
2019-11-04 10:45,122,71,51,0,0,0
2019-11-04 11:00,82,36,46,0,0,0
2019-11-04 11:15,103,51,52,0,0,0
2019-11-04 11:30,122,61,61,0,0,0
2019-11-04 11:45,162,79,83,0,0,0
2019-11-04 12:00,120,61,59,0,0,0
2019-11-04 12:15,119,58,61,0,0,0
2019-11-04 12:30,149,64,85,0,0,0
2019-11-04 12:45,114,51,63,0,0,0
2019-11-04 13:00,146,61,85,0,0,0
2019-11-04 13:15,132,56,76,0,0,0
2019-11-04 13:30,141,62,79,0,0,0
2019-11-04 13:45,171,86,85,0,0,0
2019-11-04 14:00,145,57,88,0,0,0
2019-11-04 14:15,146,61,85,0,0,0
2019-11-04 14:30,142,72,70,0,0,0
2019-11-04 14:45,168,71,97,0,0,0
2019-11-04 15:00,159,57,102,0,0,0
2019-11-04 15:15,161,62,99,0,0,0
2019-11-04 15:30,180,71,109,0,0,0
2019-11-04 15:45,199,80,119,0,0,0
2019-11-04 16:00,222,87,135,0,0,0
2019-11-04 16:15,205,75,130,0,0,0
2019-11-04 16:30,198,74,124,0,0,0
2019-11-04 16:45,198,91,107,0,0,0
2019-11-04 17:00,192,80,112,0,0,0
2019-11-04 17:15,173,60,113,0,0,0
2019-11-04 17:30,228,74,154,0,0,0
2019-11-04 17:45,231,110,121,0,0,0
2019-11-04 18:00,195,69,126,0,0,0
2019-11-04 18:15,148,53,95,0,0,0
2019-11-04 18:30,127,35,92,0,0,0
2019-11-04 18:45,160,68,92,0,0,0
2019-11-04 19:00,121,30,91,0,0,0
2019-11-04 19:15,134,46,88,0,0,0
2019-11-04 19:30,115,44,71,0,0,0
2019-11-04 19:45,122,40,82,0,0,0
2019-11-04 20:00,104,26,78,0,0,0
2019-11-04 20:15,84,33,51,0,0,0
2019-11-04 20:30,57,17,40,0,0,0
2019-11-04 20:45,49,13,36,0,0,0
2019-11-04 21:00,63,19,44,0,0,0
2019-11-04 21:15,58,14,44,0,0,0
2019-11-04 21:30,57,14,43,0,0,0
2019-11-04 21:45,67,21,46,0,0,0
2019-11-04 22:00,49,12,37,0,0,0
2019-11-04 22:15,73,19,54,0,0,0
2019-11-04 22:30,33,6,27,0,0,0
2019-11-04 22:45,24,8,16,0,0,0
2019-11-04 23:00,28,14,14,0,0,0
2019-11-04 23:15,28,2,26,0,0,0
2019-11-04 23:30,31,6,25,0,0,0
2019-11-04 23:45,9,3,6,0,0,0
2019-11-05 00:00,17,3,14,0,0,0
2019-11-05 00:15,11,3,8,0,0,0
2019-11-05 00:30,14,3,11,0,0,0
2019-11-05 00:45,4,2,2,0,0,0
2019-11-05 01:00,2,0,2,0,0,0
2019-11-05 01:15,0,0,0,0,0,0
2019-11-05 01:30,3,2,1,0,0,0
2019-11-05 01:45,2,0,2,0,0,0
2019-11-05 02:00,1,0,1,0,0,0
2019-11-05 02:15,0,0,0,0,0,0
2019-11-05 02:30,2,0,2,0,0,0
2019-11-05 02:45,1,1,0,0,0,0
2019-11-05 03:00,3,1,2,0,0,0
2019-11-05 03:15,1,0,1,0,0,0
2019-11-05 03:30,0,0,0,0,0,0
2019-11-05 03:45,1,1,0,0,0,0
2019-11-05 04:00,0,0,0,0,0,0
2019-11-05 04:15,2,1,1,0,0,0
2019-11-05 04:30,2,2,0,0,0,0
2019-11-05 04:45,3,2,1,0,0,0
2019-11-05 05:00,2,1,1,0,0,0
2019-11-05 05:15,6,5,1,0,0,0
2019-11-05 05:30,12,8,4,0,0,0
2019-11-05 05:45,20,17,3,0,0,0
2019-11-05 06:00,22,15,7,0,0,0
2019-11-05 06:15,36,29,7,0,0,0
2019-11-05 06:30,56,43,13,0,0,0
2019-11-05 06:45,68,40,28,0,0,0
2019-11-05 07:00,79,48,31,0,0,0
2019-11-05 07:15,113,75,38,0,0,0
2019-11-05 07:30,176,127,49,0,0,0
2019-11-05 07:45,185,130,55,0,0,0
2019-11-05 08:00,185,140,45,0,0,0
2019-11-05 08:15,184,138,46,0,0,0
2019-11-05 08:30,127,86,41,0,0,0
2019-11-05 08:45,166,120,46,0,0,0
2019-11-05 09:00,117,80,37,0,0,0
2019-11-05 09:15,126,82,44,0,0,0
2019-11-05 09:30,120,71,49,0,0,0
2019-11-05 09:45,143,113,30,0,0,0
2019-11-05 10:00,119,87,32,0,0,0
2019-11-05 10:15,101,55,46,0,0,0
2019-11-05 10:30,90,47,43,0,0,0
2019-11-05 10:45,124,73,51,0,0,0
2019-11-05 11:00,87,52,35,0,0,0
2019-11-05 11:15,98,48,50,0,0,0
2019-11-05 11:30,100,42,58,0,0,0
2019-11-05 11:45,136,73,63,0,0,0
2019-11-05 12:00,132,59,73,0,0,0
2019-11-05 12:15,104,47,57,0,0,0
2019-11-05 12:30,138,44,94,0,0,0
2019-11-05 12:45,117,48,69,0,0,0
2019-11-05 13:00,131,55,76,0,0,0
2019-11-05 13:15,158,54,104,0,0,0
2019-11-05 13:30,129,51,78,0,0,0
2019-11-05 13:45,181,79,102,0,0,0
2019-11-05 14:00,157,57,100,0,0,0
2019-11-05 14:15,120,45,75,0,0,0
2019-11-05 14:30,159,66,93,0,0,0
2019-11-05 14:45,167,69,98,0,0,0
2019-11-05 15:00,146,47,99,0,0,0
2019-11-05 15:15,148,63,85,0,0,0
2019-11-05 15:30,141,54,87,0,0,0
2019-11-05 15:45,203,84,119,0,0,0
2019-11-05 16:00,212,74,138,0,0,0
2019-11-05 16:15,199,64,135,0,0,0
2019-11-05 16:30,181,69,112,0,0,0
2019-11-05 16:45,180,63,117,0,0,0
2019-11-05 17:00,199,62,137,0,0,0
2019-11-05 17:15,183,67,116,0,0,0
2019-11-05 17:30,183,86,97,0,0,0
2019-11-05 17:45,233,95,138,0,0,0
2019-11-05 18:00,198,62,136,0,0,0
2019-11-05 18:15,199,67,132,0,0,0
2019-11-05 18:30,164,63,101,0,0,0
2019-11-05 18:45,160,61,99,0,0,0
2019-11-05 19:00,157,63,94,0,0,0
2019-11-05 19:15,127,53,74,0,0,0
2019-11-05 19:30,114,50,64,0,0,0
2019-11-05 19:45,116,38,78,0,0,0
2019-11-05 20:00,90,29,61,0,0,0
2019-11-05 20:15,75,26,49,0,0,0
2019-11-05 20:30,55,11,44,0,0,0
2019-11-05 20:45,81,33,48,0,0,0
2019-11-05 21:00,58,25,33,0,0,0
2019-11-05 21:15,66,14,52,0,0,0
2019-11-05 21:30,76,18,58,0,0,0
2019-11-05 21:45,60,18,42,0,0,0
2019-11-05 22:00,75,18,57,0,0,0
2019-11-05 22:15,58,22,36,0,0,0
2019-11-05 22:30,60,10,50,0,0,0
2019-11-05 22:45,49,15,34,0,0,0
2019-11-05 23:00,49,21,28,0,0,0
2019-11-05 23:15,31,15,16,0,0,0
2019-11-05 23:30,27,4,23,0,0,0
2019-11-05 23:45,29,11,18,0,0,0
2019-11-06 00:00,29,8,21,0,0,0
2019-11-06 00:15,8,1,7,0,0,0
2019-11-06 00:30,12,2,10,0,0,0
2019-11-06 00:45,6,0,6,0,0,0
2019-11-06 01:00,10,0,10,0,0,0
2019-11-06 01:15,2,0,2,0,0,0
2019-11-06 01:30,4,1,3,0,0,0
2019-11-06 01:45,1,0,1,0,0,0
2019-11-06 02:00,4,1,3,0,0,0
2019-11-06 02:15,2,1,1,0,0,0
2019-11-06 02:30,2,2,0,0,0,0
2019-11-06 02:45,2,1,1,0,0,0
2019-11-06 03:00,3,0,3,0,0,0
2019-11-06 03:15,1,1,0,0,0,0
2019-11-06 03:30,2,0,2,0,0,0
2019-11-06 03:45,0,0,0,0,0,0
2019-11-06 04:00,0,0,0,0,0,0
2019-11-06 04:15,1,0,1,0,0,0
2019-11-06 04:30,1,1,0,0,0,0
2019-11-06 04:45,6,5,1,0,0,0
2019-11-06 05:00,1,0,1,0,0,0
2019-11-06 05:15,8,7,1,0,0,0
2019-11-06 05:30,11,10,1,0,0,0
2019-11-06 05:45,18,14,4,0,0,0
2019-11-06 06:00,21,19,2,0,0,0
2019-11-06 06:15,43,35,8,0,0,0
2019-11-06 06:30,41,28,13,0,0,0
2019-11-06 06:45,50,33,17,0,0,0
2019-11-06 07:00,61,40,21,0,0,0
2019-11-06 07:15,119,77,42,0,0,0
2019-11-06 07:30,163,117,46,0,0,0
2019-11-06 07:45,180,122,58,0,0,0
2019-11-06 08:00,168,135,33,0,0,0
2019-11-06 08:15,155,108,47,0,0,0
2019-11-06 08:30,109,70,39,0,0,0
2019-11-06 08:45,142,104,38,0,0,0
2019-11-06 09:00,104,66,38,0,0,0
2019-11-06 09:15,96,65,31,0,0,0
2019-11-06 09:30,100,64,36,0,0,0
2019-11-06 09:45,120,81,39,0,0,0
2019-11-06 10:00,122,74,48,0,0,0
2019-11-06 10:15,86,44,42,0,0,0
2019-11-06 10:30,97,64,33,0,0,0
2019-11-06 10:45,99,55,44,0,0,0
2019-11-06 11:00,112,55,57,0,0,0
2019-11-06 11:15,112,54,58,0,0,0
2019-11-06 11:30,150,82,68,0,0,0
2019-11-06 11:45,147,84,63,0,0,0
2019-11-06 12:00,126,50,76,0,0,0
2019-11-06 12:15,117,54,63,0,0,0
2019-11-06 12:30,126,46,80,0,0,0
2019-11-06 12:45,143,57,86,0,0,0
2019-11-06 13:00,135,47,88,0,0,0
2019-11-06 13:15,140,54,86,0,0,0
2019-11-06 13:30,157,77,80,0,0,0
2019-11-06 13:45,148,61,87,0,0,0
2019-11-06 14:00,166,75,91,0,0,0
2019-11-06 14:15,127,49,78,0,0,0
2019-11-06 14:30,132,67,65,0,0,0
2019-11-06 14:45,127,58,69,0,0,0
2019-11-06 15:00,136,45,91,0,0,0
2019-11-06 15:15,142,78,64,0,0,0
2019-11-06 15:30,160,64,96,0,0,0
2019-11-06 15:45,202,75,127,0,0,0
2019-11-06 16:00,207,82,125,0,0,0
2019-11-06 16:15,190,84,106,0,0,0
2019-11-06 16:30,184,80,104,0,0,0
2019-11-06 16:45,209,75,134,0,0,0
2019-11-06 17:00,199,79,120,0,0,0
2019-11-06 17:15,177,68,109,0,0,0
2019-11-06 17:30,180,76,104,0,0,0
2019-11-06 17:45,204,73,131,0,0,0
2019-11-06 18:00,206,75,131,0,0,0
2019-11-06 18:15,171,69,102,0,0,0
2019-11-06 18:30,160,71,89,0,0,0
2019-11-06 18:45,160,72,88,0,0,0
2019-11-06 19:00,152,52,100,0,0,0
2019-11-06 19:15,131,51,80,0,0,0
2019-11-06 19:30,134,36,98,0,0,0
2019-11-06 19:45,131,56,75,0,0,0
2019-11-06 20:00,110,33,77,0,0,0
2019-11-06 20:15,108,42,66,0,0,0
2019-11-06 20:30,86,28,58,0,0,0
2019-11-06 20:45,84,30,54,0,0,0
2019-11-06 21:00,77,33,44,0,0,0
2019-11-06 21:15,92,24,68,0,0,0
2019-11-06 21:30,60,22,38,0,0,0
2019-11-06 21:45,68,19,49,0,0,0
2019-11-06 22:00,62,23,39,0,0,0
2019-11-06 22:15,62,19,43,0,0,0
2019-11-06 22:30,64,14,50,0,0,0
2019-11-06 22:45,55,20,35,0,0,0
2019-11-06 23:00,69,31,38,0,0,0
2019-11-06 23:15,45,32,13,0,0,0
2019-11-06 23:30,55,22,33,0,0,0
2019-11-06 23:45,51,20,31,0,0,0
2019-11-07 00:00,21,8,13,0,0,0
2019-11-07 00:15,29,17,12,0,0,0
2019-11-07 00:30,13,5,8,0,0,0
2019-11-07 00:45,15,7,8,0,0,0
2019-11-07 01:00,9,0,9,0,0,0
2019-11-07 01:15,11,1,10,0,0,0
2019-11-07 01:30,8,3,5,0,0,0
2019-11-07 01:45,8,0,8,0,0,0
2019-11-07 02:00,5,2,3,0,0,0
2019-11-07 02:15,5,1,4,0,0,0
2019-11-07 02:30,8,3,5,0,0,0
2019-11-07 02:45,9,1,8,0,0,0
2019-11-07 03:00,9,0,9,0,0,0
2019-11-07 03:15,11,1,10,0,0,0
2019-11-07 03:30,9,0,9,0,0,0
2019-11-07 03:45,4,0,4,0,0,0
2019-11-07 04:00,1,0,1,0,0,0
2019-11-07 04:15,7,1,6,0,0,0
2019-11-07 04:30,5,3,2,0,0,0
2019-11-07 04:45,6,5,1,0,0,0
2019-11-07 05:00,4,1,3,0,0,0
2019-11-07 05:15,4,3,1,0,0,0
2019-11-07 05:30,14,9,5,0,0,0
2019-11-07 05:45,23,15,8,0,0,0
2019-11-07 06:00,18,12,6,0,0,0
2019-11-07 06:15,36,26,10,0,0,0
2019-11-07 06:30,43,31,12,0,0,0
2019-11-07 06:45,57,39,18,0,0,0
2019-11-07 07:00,67,49,18,0,0,0
2019-11-07 07:15,119,78,41,0,0,0
2019-11-07 07:30,141,89,52,0,0,0
2019-11-07 07:45,159,115,44,0,0,0
2019-11-07 08:00,152,103,49,0,0,0
2019-11-07 08:15,141,93,48,0,0,0
2019-11-07 08:30,128,87,41,0,0,0
2019-11-07 08:45,145,107,38,0,0,0
2019-11-07 09:00,93,59,34,0,0,0
2019-11-07 09:15,119,84,35,0,0,0
2019-11-07 09:30,96,70,26,0,0,0
2019-11-07 09:45,119,84,35,0,0,0
2019-11-07 10:00,113,78,35,0,0,0
2019-11-07 10:15,92,55,37,0,0,0
2019-11-07 10:30,103,58,45,0,0,0
2019-11-07 10:45,112,68,44,0,0,0
2019-11-07 11:00,96,52,44,0,0,0
2019-11-07 11:15,101,52,49,0,0,0
2019-11-07 11:30,117,57,60,0,0,0
2019-11-07 11:45,149,73,76,0,0,0
2019-11-07 12:00,158,73,85,0,0,0
2019-11-07 12:15,141,64,77,0,0,0
2019-11-07 12:30,173,58,115,0,0,0
2019-11-07 12:45,166,68,98,0,0,0
2019-11-07 13:00,164,60,104,0,0,0
2019-11-07 13:15,122,43,79,0,0,0
2019-11-07 13:30,131,56,75,0,0,0
2019-11-07 13:45,144,57,87,0,0,0
2019-11-07 14:00,138,48,90,0,0,0
2019-11-07 14:15,124,38,86,0,0,0
2019-11-07 14:30,112,53,59,0,0,0
2019-11-07 14:45,115,57,58,0,0,0
2019-11-07 15:00,124,37,87,0,0,0
2019-11-07 15:15,117,34,83,0,0,0
2019-11-07 15:30,134,50,84,0,0,0
2019-11-07 15:45,143,62,81,0,0,0
2019-11-07 16:00,161,70,91,0,0,0
2019-11-07 16:15,181,74,107,0,0,0
2019-11-07 16:30,171,70,101,0,0,0
2019-11-07 16:45,188,81,107,0,0,0
2019-11-07 17:00,185,65,120,0,0,0
2019-11-07 17:15,158,49,109,0,0,0
2019-11-07 17:30,174,64,110,0,0,0
2019-11-07 17:45,194,78,116,0,0,0
2019-11-07 18:00,182,59,123,0,0,0
2019-11-07 18:15,169,66,103,0,0,0
2019-11-07 18:30,144,57,87,0,0,0
2019-11-07 18:45,152,71,81,0,0,0
2019-11-07 19:00,134,63,71,0,0,0
2019-11-07 19:15,117,52,65,0,0,0
2019-11-07 19:30,116,35,81,0,0,0
2019-11-07 19:45,140,49,91,0,0,0
2019-11-07 20:00,102,42,60,0,0,0
2019-11-07 20:15,94,32,62,0,0,0
2019-11-07 20:30,63,23,40,0,0,0
2019-11-07 20:45,72,27,45,0,0,0
2019-11-07 21:00,52,8,44,0,0,0
2019-11-07 21:15,48,15,33,0,0,0
2019-11-07 21:30,56,17,39,0,0,0
2019-11-07 21:45,68,16,52,0,0,0
2019-11-07 22:00,60,17,43,0,0,0
2019-11-07 22:15,54,18,36,0,0,0
2019-11-07 22:30,64,13,51,0,0,0
2019-11-07 22:45,58,20,38,0,0,0
2019-11-07 23:00,58,14,44,0,0,0
2019-11-07 23:15,35,8,27,0,0,0
2019-11-07 23:30,35,6,29,0,0,0
2019-11-07 23:45,25,3,22,0,0,0
2019-11-08 00:00,26,6,20,0,0,0
2019-11-08 00:15,16,10,6,0,0,0
2019-11-08 00:30,10,1,9,0,0,0
2019-11-08 00:45,8,3,5,0,0,0
2019-11-08 01:00,8,3,5,0,0,0
2019-11-08 01:15,5,3,2,0,0,0
2019-11-08 01:30,4,3,1,0,0,0
2019-11-08 01:45,3,0,3,0,0,0
2019-11-08 02:00,2,2,0,0,0,0
2019-11-08 02:15,1,0,1,0,0,0
2019-11-08 02:30,4,1,3,0,0,0
2019-11-08 02:45,2,1,1,0,0,0
2019-11-08 03:00,3,1,2,0,0,0
2019-11-08 03:15,2,2,0,0,0,0
2019-11-08 03:30,2,0,2,0,0,0
2019-11-08 03:45,4,0,4,0,0,0
2019-11-08 04:00,0,0,0,0,0,0
2019-11-08 04:15,1,1,0,0,0,0
2019-11-08 04:30,2,1,1,0,0,0
2019-11-08 04:45,5,4,1,0,0,0
2019-11-08 05:00,3,2,1,0,0,0
2019-11-08 05:15,4,3,1,0,0,0
2019-11-08 05:30,15,15,0,0,0,0
2019-11-08 05:45,18,11,7,0,0,0
2019-11-08 06:00,14,11,3,0,0,0
2019-11-08 06:15,36,26,10,0,0,0
2019-11-08 06:30,45,29,16,0,0,0
2019-11-08 06:45,61,42,19,0,0,0
2019-11-08 07:00,72,42,30,0,0,0
2019-11-08 07:15,122,82,40,0,0,0
2019-11-08 07:30,159,104,55,0,0,0
2019-11-08 07:45,164,105,59,0,0,0
2019-11-08 08:00,131,99,32,0,0,0
2019-11-08 08:15,120,74,46,0,0,0
2019-11-08 08:30,127,95,32,0,0,0
2019-11-08 08:45,141,98,43,0,0,0
2019-11-08 09:00,115,82,33,0,0,0
2019-11-08 09:15,117,82,35,0,0,0
2019-11-08 09:30,132,96,36,0,0,0
2019-11-08 09:45,111,80,31,0,0,0
2019-11-08 10:00,145,95,50,0,0,0
2019-11-08 10:15,104,54,50,0,0,0
2019-11-08 10:30,123,70,53,0,0,0
2019-11-08 10:45,127,72,55,0,0,0
2019-11-08 11:00,130,59,71,0,0,0
2019-11-08 11:15,128,70,58,0,0,0
2019-11-08 11:30,129,63,66,0,0,0
2019-11-08 11:45,146,80,66,0,0,0
2019-11-08 12:00,169,70,99,0,0,0
2019-11-08 12:15,142,60,82,0,0,0
2019-11-08 12:30,183,75,108,0,0,0
2019-11-08 12:45,184,79,105,0,0,0
2019-11-08 13:00,206,80,126,0,0,0
2019-11-08 13:15,197,80,117,0,0,0
2019-11-08 13:30,193,70,123,0,0,0
2019-11-08 13:45,229,112,117,0,0,0
2019-11-08 14:00,210,96,114,0,0,0
2019-11-08 14:15,177,72,105,0,0,0
2019-11-08 14:30,181,87,94,0,0,0
2019-11-08 14:45,203,79,124,0,0,0
2019-11-08 15:00,204,81,123,0,0,0
2019-11-08 15:15,213,77,136,0,0,0
2019-11-08 15:30,184,72,112,0,0,0
2019-11-08 15:45,238,107,131,0,0,0
2019-11-08 16:00,204,97,107,0,0,0
2019-11-08 16:15,189,78,111,0,0,0
2019-11-08 16:30,169,71,98,0,0,0
2019-11-08 16:45,188,79,109,0,0,0
2019-11-08 17:00,144,64,80,0,0,0
2019-11-08 17:15,160,53,107,0,0,0
2019-11-08 17:30,185,69,116,0,0,0
2019-11-08 17:45,166,70,96,0,0,0
2019-11-08 18:00,162,50,112,0,0,0
2019-11-08 18:15,180,62,118,0,0,0
2019-11-08 18:30,141,57,84,0,0,0
2019-11-08 18:45,154,61,93,0,0,0
2019-11-08 19:00,140,65,75,0,0,0
2019-11-08 19:15,124,51,73,0,0,0
2019-11-08 19:30,115,48,67,0,0,0
2019-11-08 19:45,126,66,60,0,0,0
2019-11-08 20:00,116,45,71,0,0,0
2019-11-08 20:15,94,48,46,0,0,0
2019-11-08 20:30,75,30,45,0,0,0
2019-11-08 20:45,72,36,36,0,0,0
2019-11-08 21:00,76,22,54,0,0,0
2019-11-08 21:15,70,37,33,0,0,0
2019-11-08 21:30,40,16,24,0,0,0
2019-11-08 21:45,49,18,31,0,0,0
2019-11-08 22:00,62,29,33,0,0,0
2019-11-08 22:15,63,30,33,0,0,0
2019-11-08 22:30,88,26,62,0,0,0
2019-11-08 22:45,58,18,40,0,0,0
2019-11-08 23:00,55,24,31,0,0,0
2019-11-08 23:15,58,12,46,0,0,0
2019-11-08 23:30,57,15,42,0,0,0
2019-11-08 23:45,84,36,48,0,0,0
2019-11-09 00:00,60,30,30,0,0,0
2019-11-09 00:15,63,21,42,0,0,0
2019-11-09 00:30,37,14,23,0,0,0
2019-11-09 00:45,34,7,27,0,0,0
2019-11-09 01:00,32,8,24,0,0,0
2019-11-09 01:15,25,10,15,0,0,0
2019-11-09 01:30,25,9,16,0,0,0
2019-11-09 01:45,19,4,15,0,0,0
2019-11-09 02:00,12,1,11,0,0,0
2019-11-09 02:15,14,2,12,0,0,0
2019-11-09 02:30,18,7,11,0,0,0
2019-11-09 02:45,13,6,7,0,0,0
2019-11-09 03:00,23,5,18,0,0,0
2019-11-09 03:15,12,3,9,0,0,0
2019-11-09 03:30,10,1,9,0,0,0
2019-11-09 03:45,10,5,5,0,0,0
2019-11-09 04:00,10,3,7,0,0,0
2019-11-09 04:15,11,1,10,0,0,0
2019-11-09 04:30,2,0,2,0,0,0
2019-11-09 04:45,5,3,2,0,0,0
2019-11-09 05:00,3,2,1,0,0,0
2019-11-09 05:15,3,1,2,0,0,0
2019-11-09 05:30,7,5,2,0,0,0
2019-11-09 05:45,10,6,4,0,0,0
2019-11-09 06:00,13,6,7,0,0,0
2019-11-09 06:15,3,2,1,0,0,0
2019-11-09 06:30,4,4,0,0,0,0
2019-11-09 06:45,15,11,4,0,0,0
2019-11-09 07:00,12,8,4,0,0,0
2019-11-09 07:15,18,9,9,0,0,0
2019-11-09 07:30,24,15,9,0,0,0
2019-11-09 07:45,41,26,15,0,0,0
2019-11-09 08:00,31,17,14,0,0,0
2019-11-09 08:15,26,13,13,0,0,0
2019-11-09 08:30,40,28,12,0,0,0
2019-11-09 08:45,63,41,22,0,0,0
2019-11-09 09:00,61,36,25,0,0,0
2019-11-09 09:15,67,47,20,0,0,0
2019-11-09 09:30,86,67,19,0,0,0
2019-11-09 09:45,117,88,29,0,0,0
2019-11-09 10:00,85,60,25,0,0,0
2019-11-09 10:15,94,63,31,0,0,0
2019-11-09 10:30,130,90,40,0,0,0
2019-11-09 10:45,111,76,35,0,0,0
2019-11-09 11:00,140,95,45,0,0,0
2019-11-09 11:15,137,68,69,0,0,0
2019-11-09 11:30,161,96,65,0,0,0
2019-11-09 11:45,152,88,64,0,0,0
2019-11-09 12:00,168,79,89,0,0,0
2019-11-09 12:15,161,107,54,0,0,0
2019-11-09 12:30,168,82,86,0,0,0
2019-11-09 12:45,172,108,64,0,0,0
2019-11-09 13:00,167,74,93,0,0,0
2019-11-09 13:15,157,72,85,0,0,0
2019-11-09 13:30,137,63,74,0,0,0
2019-11-09 13:45,187,78,109,0,0,0
2019-11-09 14:00,153,80,73,0,0,0
2019-11-09 14:15,111,48,63,0,0,0
2019-11-09 14:30,145,49,96,0,0,0
2019-11-09 14:45,167,74,93,0,0,0
2019-11-09 15:00,149,56,93,0,0,0
2019-11-09 15:15,134,71,63,0,0,0
2019-11-09 15:30,123,49,74,0,0,0
2019-11-09 15:45,115,57,58,0,0,0
2019-11-09 16:00,134,64,70,0,0,0
2019-11-09 16:15,122,51,71,0,0,0
2019-11-09 16:30,149,74,75,0,0,0
2019-11-09 16:45,135,44,91,0,0,0
2019-11-09 17:00,98,36,62,0,0,0
2019-11-09 17:15,140,62,78,0,0,0
2019-11-09 17:30,128,47,81,0,0,0
2019-11-09 17:45,121,48,73,0,0,0
2019-11-09 18:00,128,46,82,0,0,0
2019-11-09 18:15,128,46,82,0,0,0
2019-11-09 18:30,110,50,60,0,0,0
2019-11-09 18:45,109,50,59,0,0,0
2019-11-09 19:00,87,39,48,0,0,0
2019-11-09 19:15,76,37,39,0,0,0
2019-11-09 19:30,79,40,39,0,0,0
2019-11-09 19:45,85,31,54,0,0,0
2019-11-09 20:00,80,21,59,0,0,0
2019-11-09 20:15,65,30,35,0,0,0
2019-11-09 20:30,85,38,47,0,0,0
2019-11-09 20:45,62,27,35,0,0,0
2019-11-09 21:00,62,24,38,0,0,0
2019-11-09 21:15,35,16,19,0,0,0
2019-11-09 21:30,49,20,29,0,0,0
2019-11-09 21:45,38,19,19,0,0,0
2019-11-09 22:00,33,19,14,0,0,0
2019-11-09 22:15,56,10,46,0,0,0
2019-11-09 22:30,23,4,19,0,0,0
2019-11-09 22:45,44,10,34,0,0,0
2019-11-09 23:00,51,17,34,0,0,0
2019-11-09 23:15,50,11,39,0,0,0
2019-11-09 23:30,43,19,24,0,0,0
2019-11-09 23:45,40,8,32,0,0,0
2019-11-10 00:00,42,14,28,0,0,0
2019-11-10 00:15,44,19,25,0,0,0
2019-11-10 00:30,38,11,27,0,0,0
2019-11-10 00:45,36,10,26,0,0,0
2019-11-10 01:00,31,12,19,0,0,0
2019-11-10 01:15,46,22,24,0,0,0
2019-11-10 01:30,22,7,15,0,0,0
2019-11-10 01:45,20,8,12,0,0,0
2019-11-10 02:00,15,4,11,0,0,0
2019-11-10 02:15,15,6,9,0,0,0
2019-11-10 02:30,18,1,17,0,0,0
2019-11-10 02:45,16,3,13,0,0,0
2019-11-10 03:00,19,4,15,0,0,0
2019-11-10 03:15,13,2,11,0,0,0
2019-11-10 03:30,10,3,7,0,0,0
2019-11-10 03:45,14,6,8,0,0,0
2019-11-10 04:00,2,1,1,0,0,0
2019-11-10 04:15,6,1,5,0,0,0
2019-11-10 04:30,5,1,4,0,0,0
2019-11-10 04:45,4,1,3,0,0,0
2019-11-10 05:00,4,0,4,0,0,0
2019-11-10 05:15,4,3,1,0,0,0
2019-11-10 05:30,8,3,5,0,0,0
2019-11-10 05:45,3,3,0,0,0,0
2019-11-10 06:00,4,3,1,0,0,0
2019-11-10 06:15,6,2,4,0,0,0
2019-11-10 06:30,2,1,1,0,0,0
2019-11-10 06:45,6,2,4,0,0,0
2019-11-10 07:00,3,0,3,0,0,0
2019-11-10 07:15,5,3,2,0,0,0
2019-11-10 07:30,2,1,1,0,0,0
2019-11-10 07:45,10,7,3,0,0,0
2019-11-10 08:00,7,4,3,0,0,0
2019-11-10 08:15,9,5,4,0,0,0
2019-11-10 08:30,12,5,7,0,0,0
2019-11-10 08:45,20,16,4,0,0,0
2019-11-10 09:00,17,9,8,0,0,0
2019-11-10 09:15,26,20,6,0,0,0
2019-11-10 09:30,35,19,16,0,0,0
2019-11-10 09:45,61,43,18,0,0,0
2019-11-10 10:00,48,30,18,0,0,0
2019-11-10 10:15,66,40,26,0,0,0
2019-11-10 10:30,31,23,8,0,0,0
2019-11-10 10:45,59,42,17,0,0,0
2019-11-10 11:00,54,30,24,0,0,0
2019-11-10 11:15,30,15,15,0,0,0
2019-11-10 11:30,41,21,20,0,0,0
2019-11-10 11:45,64,36,28,0,0,0
2019-11-10 12:00,66,32,34,0,0,0
2019-11-10 12:15,51,26,25,0,0,0
2019-11-10 12:30,63,38,25,0,0,0
2019-11-10 12:45,74,36,38,0,0,0
2019-11-10 13:00,53,29,24,0,0,0
2019-11-10 13:15,49,22,27,0,0,0
2019-11-10 13:30,67,36,31,0,0,0
2019-11-10 13:45,67,30,37,0,0,0
2019-11-10 14:00,85,35,50,0,0,0
2019-11-10 14:15,87,51,36,0,0,0
2019-11-10 14:30,79,43,36,0,0,0
2019-11-10 14:45,86,41,45,0,0,0
2019-11-10 15:00,68,29,39,0,0,0
2019-11-10 15:15,86,37,49,0,0,0
2019-11-10 15:30,86,41,45,0,0,0
2019-11-10 15:45,95,43,52,0,0,0
2019-11-10 16:00,85,28,57,0,0,0
2019-11-10 16:15,69,36,33,0,0,0
2019-11-10 16:30,87,24,63,0,0,0
2019-11-10 16:45,70,35,35,0,0,0
2019-11-10 17:00,59,28,31,0,0,0
2019-11-10 17:15,60,25,35,0,0,0
2019-11-10 17:30,64,34,30,0,0,0
2019-11-10 17:45,73,39,34,0,0,0
2019-11-10 18:00,83,29,54,0,0,0
2019-11-10 18:15,54,21,33,0,0,0
2019-11-10 18:30,55,23,32,0,0,0
2019-11-10 18:45,67,36,31,0,0,0
2019-11-10 19:00,47,12,35,0,0,0
2019-11-10 19:15,30,14,16,0,0,0
2019-11-10 19:30,44,15,29,0,0,0
2019-11-10 19:45,41,13,28,0,0,0
2019-11-10 20:00,27,10,17,0,0,0
2019-11-10 20:15,33,10,23,0,0,0
2019-11-10 20:30,24,11,13,0,0,0
2019-11-10 20:45,30,7,23,0,0,0
2019-11-10 21:00,19,6,13,0,0,0
2019-11-10 21:15,19,6,13,0,0,0
2019-11-10 21:30,35,2,33,0,0,0
2019-11-10 21:45,27,7,20,0,0,0
2019-11-10 22:00,32,12,20,0,0,0
2019-11-10 22:15,31,9,22,0,0,0
2019-11-10 22:30,29,3,26,0,0,0
2019-11-10 22:45,22,4,18,0,0,0
2019-11-10 23:00,9,5,4,0,0,0
2019-11-10 23:15,7,1,6,0,0,0
2019-11-10 23:30,1,0,1,0,0,0
2019-11-10 23:45,5,2,3,0,0,0
2019-11-11 00:00,6,2,4,0,0,0
2019-11-11 00:15,4,1,3,0,0,0
2019-11-11 00:30,0,0,0,0,0,0
2019-11-11 00:45,1,0,1,0,0,0
2019-11-11 01:00,6,0,6,0,0,0
2019-11-11 01:15,1,0,1,0,0,0
2019-11-11 01:30,1,0,1,0,0,0
2019-11-11 01:45,2,2,0,0,0,0
2019-11-11 02:00,1,0,1,0,0,0
2019-11-11 02:15,0,0,0,0,0,0
2019-11-11 02:30,3,3,0,0,0,0
2019-11-11 02:45,1,0,1,0,0,0
2019-11-11 03:00,1,0,1,0,0,0
2019-11-11 03:15,1,1,0,0,0,0
2019-11-11 03:30,1,0,1,0,0,0
2019-11-11 03:45,0,0,0,0,0,0
2019-11-11 04:00,1,0,1,0,0,0
2019-11-11 04:15,3,3,0,0,0,0
2019-11-11 04:30,3,2,1,0,0,0
2019-11-11 04:45,9,7,2,0,0,0
2019-11-11 05:00,5,5,0,0,0,0
2019-11-11 05:15,5,5,0,0,0,0
2019-11-11 05:30,12,9,3,0,0,0
2019-11-11 05:45,14,10,4,0,0,0
2019-11-11 06:00,20,14,6,0,0,0
2019-11-11 06:15,40,34,6,0,0,0
2019-11-11 06:30,44,33,11,0,0,0
2019-11-11 06:45,69,50,19,0,0,0
2019-11-11 07:00,80,54,26,0,0,0
2019-11-11 07:15,113,87,26,0,0,0
2019-11-11 07:30,171,127,44,0,0,0
2019-11-11 07:45,199,139,60,0,0,0
2019-11-11 08:00,147,109,38,0,0,0
2019-11-11 08:15,151,119,32,0,0,0
2019-11-11 08:30,139,85,54,0,0,0
2019-11-11 08:45,160,126,34,0,0,0
2019-11-11 09:00,115,82,33,0,0,0
2019-11-11 09:15,127,90,37,0,0,0
2019-11-11 09:30,98,75,23,0,0,0
2019-11-11 09:45,137,100,37,0,0,0
2019-11-11 10:00,142,95,47,0,0,0
2019-11-11 10:15,92,45,47,0,0,0
2019-11-11 10:30,94,53,41,0,0,0
2019-11-11 10:45,81,50,31,0,0,0
2019-11-11 11:00,97,60,37,0,0,0
2019-11-11 11:15,112,52,60,0,0,0
2019-11-11 11:30,124,72,52,0,0,0
2019-11-11 11:45,153,68,85,0,0,0
2019-11-11 12:00,124,55,69,0,0,0
2019-11-11 12:15,120,60,60,0,0,0
2019-11-11 12:30,120,48,72,0,0,0
2019-11-11 12:45,134,64,70,0,0,0
2019-11-11 13:00,160,73,87,0,0,0
2019-11-11 13:15,125,51,74,0,0,0
2019-11-11 13:30,125,50,75,0,0,0
2019-11-11 13:45,144,68,76,0,0,0
2019-11-11 14:00,136,53,83,0,0,0
2019-11-11 14:15,129,45,84,0,0,0
2019-11-11 14:30,124,40,84,0,0,0
2019-11-11 14:45,154,76,78,0,0,0
2019-11-11 15:00,142,52,90,0,0,0
2019-11-11 15:15,152,68,84,0,0,0
2019-11-11 15:30,154,60,94,0,0,0
2019-11-11 15:45,214,89,125,0,0,0
2019-11-11 16:00,217,91,126,0,0,0
2019-11-11 16:15,190,67,123,0,0,0
2019-11-11 16:30,210,81,129,0,0,0
2019-11-11 16:45,218,71,147,0,0,0
2019-11-11 17:00,204,62,142,0,0,0
2019-11-11 17:15,200,78,122,0,0,0
2019-11-11 17:30,218,63,155,0,0,0
2019-11-11 17:45,238,79,159,0,0,0
2019-11-11 18:00,239,82,157,0,0,0
2019-11-11 18:15,240,51,189,0,0,0
2019-11-11 18:30,148,33,115,0,0,0
2019-11-11 18:45,158,59,99,0,0,0
2019-11-11 19:00,98,33,65,0,0,0
2019-11-11 19:15,113,48,65,0,0,0
2019-11-11 19:30,109,44,65,0,0,0
2019-11-11 19:45,128,48,80,0,0,0
2019-11-11 20:00,90,25,65,0,0,0
2019-11-11 20:15,49,15,34,0,0,0
2019-11-11 20:30,75,25,50,0,0,0
2019-11-11 20:45,44,21,23,0,0,0
2019-11-11 21:00,115,85,30,0,0,0
2019-11-11 21:15,145,113,32,0,0,0
2019-11-11 21:30,56,26,30,0,0,0
2019-11-11 21:45,66,28,38,0,0,0
2019-11-11 22:00,50,12,38,0,0,0
2019-11-11 22:15,62,28,34,0,0,0
2019-11-11 22:30,40,17,23,0,0,0
2019-11-11 22:45,30,9,21,0,0,0
2019-11-11 23:00,36,15,21,0,0,0
2019-11-11 23:15,17,8,9,0,0,0
2019-11-11 23:30,19,1,18,0,0,0
2019-11-11 23:45,20,10,10,0,0,0
2019-11-12 00:00,13,5,8,0,0,0
2019-11-12 00:15,9,4,5,0,0,0
2019-11-12 00:30,7,1,6,0,0,0
2019-11-12 00:45,9,1,8,0,0,0
2019-11-12 01:00,7,4,3,0,0,0
2019-11-12 01:15,6,3,3,0,0,0
2019-11-12 01:30,4,1,3,0,0,0
2019-11-12 01:45,0,0,0,0,0,0
2019-11-12 02:00,2,0,2,0,0,0
2019-11-12 02:15,0,0,0,0,0,0
2019-11-12 02:30,1,0,1,0,0,0
2019-11-12 02:45,2,1,1,0,0,0
2019-11-12 03:00,0,0,0,0,0,0
2019-11-12 03:15,1,1,0,0,0,0
2019-11-12 03:30,0,0,0,0,0,0
2019-11-12 03:45,2,0,2,0,0,0
2019-11-12 04:00,0,0,0,0,0,0
2019-11-12 04:15,2,2,0,0,0,0
2019-11-12 04:30,0,0,0,0,0,0
2019-11-12 04:45,6,5,1,0,0,0
2019-11-12 05:00,2,2,0,0,0,0
2019-11-12 05:15,6,3,3,0,0,0
2019-11-12 05:30,15,13,2,0,0,0
2019-11-12 05:45,31,22,9,0,0,0
2019-11-12 06:00,26,19,7,0,0,0
2019-11-12 06:15,47,40,7,0,0,0
2019-11-12 06:30,47,40,7,0,0,0
2019-11-12 06:45,59,48,11,0,0,0
2019-11-12 07:00,88,58,30,0,0,0
2019-11-12 07:15,125,92,33,0,0,0
2019-11-12 07:30,175,129,46,0,0,0
2019-11-12 07:45,179,125,54,0,0,0
2019-11-12 08:00,183,135,48,0,0,0
2019-11-12 08:15,159,118,41,0,0,0
2019-11-12 08:30,130,94,36,0,0,0
2019-11-12 08:45,174,134,40,0,0,0
2019-11-12 09:00,98,73,25,0,0,0
2019-11-12 09:15,113,79,34,0,0,0
2019-11-12 09:30,92,68,24,0,0,0
2019-11-12 09:45,155,104,51,0,0,0
2019-11-12 10:00,109,81,28,0,0,0
2019-11-12 10:15,78,39,39,0,0,0
2019-11-12 10:30,66,42,24,0,0,0
2019-11-12 10:45,105,61,44,0,0,0
2019-11-12 11:00,97,47,50,0,0,0
2019-11-12 11:15,74,38,36,0,0,0
2019-11-12 11:30,92,50,42,0,0,0
2019-11-12 11:45,104,47,57,0,0,0
2019-11-12 12:00,107,50,57,0,0,0
2019-11-12 12:15,74,30,44,0,0,0
2019-11-12 12:30,109,40,69,0,0,0
2019-11-12 12:45,109,44,65,0,0,0
2019-11-12 13:00,100,38,62,0,0,0
2019-11-12 13:15,146,52,94,0,0,0
2019-11-12 13:30,118,52,66,0,0,0
2019-11-12 13:45,135,62,73,0,0,0
2019-11-12 14:00,149,53,96,0,0,0
2019-11-12 14:15,117,56,61,0,0,0
2019-11-12 14:30,109,43,66,0,0,0
2019-11-12 14:45,134,64,70,0,0,0
2019-11-12 15:00,143,50,93,0,0,0
2019-11-12 15:15,115,45,70,0,0,0
2019-11-12 15:30,155,63,92,0,0,0
2019-11-12 15:45,185,75,110,0,0,0
2019-11-12 16:00,208,81,127,0,0,0
2019-11-12 16:15,165,60,105,0,0,0
2019-11-12 16:30,188,69,119,0,0,0
2019-11-12 16:45,188,68,120,0,0,0
2019-11-12 17:00,198,70,128,0,0,0
2019-11-12 17:15,183,71,112,0,0,0
2019-11-12 17:30,169,70,99,0,0,0
2019-11-12 17:45,215,73,142,0,0,0
2019-11-12 18:00,221,85,136,0,0,0
2019-11-12 18:15,167,67,100,0,0,0
2019-11-12 18:30,148,49,99,0,0,0
2019-11-12 18:45,149,63,86,0,0,0
2019-11-12 19:00,135,46,89,0,0,0
2019-11-12 19:15,113,33,80,0,0,0
2019-11-12 19:30,104,42,62,0,0,0
2019-11-12 19:45,132,58,74,0,0,0
2019-11-12 20:00,93,28,65,0,0,0
2019-11-12 20:15,82,25,57,0,0,0
2019-11-12 20:30,57,13,44,0,0,0
2019-11-12 20:45,53,30,23,0,0,0
2019-11-12 21:00,49,12,37,0,0,0
2019-11-12 21:15,56,18,38,0,0,0
2019-11-12 21:30,59,16,43,0,0,0
2019-11-12 21:45,51,16,35,0,0,0
2019-11-12 22:00,52,9,43,0,0,0
2019-11-12 22:15,66,18,48,0,0,0
2019-11-12 22:30,50,18,32,0,0,0
2019-11-12 22:45,50,14,36,0,0,0
2019-11-12 23:00,30,8,22,0,0,0
2019-11-12 23:15,29,11,18,0,0,0
2019-11-12 23:30,16,4,12,0,0,0
2019-11-12 23:45,20,6,14,0,0,0
2019-11-13 00:00,10,4,6,0,0,0
2019-11-13 00:15,18,2,16,0,0,0
2019-11-13 00:30,12,3,9,0,0,0
2019-11-13 00:45,14,1,13,0,0,0
2019-11-13 01:00,3,1,2,0,0,0
2019-11-13 01:15,5,2,3,0,0,0
2019-11-13 01:30,2,0,2,0,0,0
2019-11-13 01:45,2,1,1,0,0,0
2019-11-13 02:00,4,0,4,0,0,0
2019-11-13 02:15,3,1,2,0,0,0
2019-11-13 02:30,1,1,0,0,0,0
2019-11-13 02:45,2,2,0,0,0,0
2019-11-13 03:00,0,0,0,0,0,0
2019-11-13 03:15,1,1,0,0,0,0
2019-11-13 03:30,0,0,0,0,0,0
2019-11-13 03:45,4,2,2,0,0,0
2019-11-13 04:00,1,0,1,0,0,0
2019-11-13 04:15,4,3,1,0,0,0
2019-11-13 04:30,0,0,0,0,0,0
2019-11-13 04:45,10,8,2,0,0,0
2019-11-13 05:00,4,4,0,0,0,0
2019-11-13 05:15,6,6,0,0,0,0
2019-11-13 05:30,20,12,8,0,0,0
2019-11-13 05:45,20,17,3,0,0,0
2019-11-13 06:00,31,25,6,0,0,0
2019-11-13 06:15,52,43,9,0,0,0
2019-11-13 06:30,56,42,14,0,0,0
2019-11-13 06:45,59,45,14,0,0,0
2019-11-13 07:00,75,51,24,0,0,0
2019-11-13 07:15,135,94,41,0,0,0
2019-11-13 07:30,193,136,57,0,0,0
2019-11-13 07:45,188,141,47,0,0,0
2019-11-13 08:00,180,137,43,0,0,0
2019-11-13 08:15,169,117,52,0,0,0
2019-11-13 08:30,129,97,32,0,0,0
2019-11-13 08:45,169,129,40,0,0,0
2019-11-13 09:00,116,82,34,0,0,0
2019-11-13 09:15,112,84,28,0,0,0
2019-11-13 09:30,120,86,34,0,0,0
2019-11-13 09:45,137,94,43,0,0,0
2019-11-13 10:00,134,101,33,0,0,0
2019-11-13 10:15,104,57,47,0,0,0
2019-11-13 10:30,110,63,47,0,0,0
2019-11-13 10:45,126,74,52,0,0,0
2019-11-13 11:00,103,60,43,0,0,0
2019-11-13 11:15,115,59,56,0,0,0
2019-11-13 11:30,100,51,49,0,0,0
2019-11-13 11:45,147,81,66,0,0,0
2019-11-13 12:00,126,63,63,0,0,0
2019-11-13 12:15,148,66,82,0,0,0
2019-11-13 12:30,146,53,93,0,0,0
2019-11-13 12:45,147,63,84,0,0,0
2019-11-13 13:00,140,55,85,0,0,0
2019-11-13 13:15,151,52,99,0,0,0
2019-11-13 13:30,147,61,86,0,0,0
2019-11-13 13:45,165,79,86,0,0,0
2019-11-13 14:00,147,53,94,0,0,0
2019-11-13 14:15,134,49,85,0,0,0
2019-11-13 14:30,147,60,87,0,0,0
2019-11-13 14:45,161,76,85,0,0,0
2019-11-13 15:00,150,54,96,0,0,0
2019-11-13 15:15,127,44,83,0,0,0
2019-11-13 15:30,152,66,86,0,0,0
2019-11-13 15:45,174,63,111,0,0,0
2019-11-13 16:00,176,58,118,0,0,0
2019-11-13 16:15,177,49,128,0,0,0
2019-11-13 16:30,187,56,131,0,0,0
2019-11-13 16:45,164,57,107,0,0,0
2019-11-13 17:00,190,62,128,0,0,0
2019-11-13 17:15,183,79,104,0,0,0
2019-11-13 17:30,207,86,121,0,0,0
2019-11-13 17:45,197,87,110,0,0,0
2019-11-13 18:00,204,80,124,0,0,0
2019-11-13 18:15,168,61,107,0,0,0
2019-11-13 18:30,150,39,111,0,0,0
2019-11-13 18:45,160,60,100,0,0,0
2019-11-13 19:00,139,46,93,0,0,0
2019-11-13 19:15,137,47,90,0,0,0
2019-11-13 19:30,87,22,65,0,0,0
2019-11-13 19:45,94,36,58,0,0,0
2019-11-13 20:00,96,26,70,0,0,0
2019-11-13 20:15,73,32,41,0,0,0
2019-11-13 20:30,66,23,43,0,0,0
2019-11-13 20:45,66,24,42,0,0,0
2019-11-13 21:00,90,27,63,0,0,0
2019-11-13 21:15,66,20,46,0,0,0
2019-11-13 21:30,66,11,55,0,0,0
2019-11-13 21:45,47,13,34,0,0,0
2019-11-13 22:00,56,11,45,0,0,0
2019-11-13 22:15,46,14,32,0,0,0
2019-11-13 22:30,47,11,36,0,0,0
2019-11-13 22:45,29,6,23,0,0,0
2019-11-13 23:00,32,8,24,0,0,0
2019-11-13 23:15,24,10,14,0,0,0
2019-11-13 23:30,27,12,15,0,0,0
2019-11-13 23:45,23,8,15,0,0,0
2019-11-14 00:00,13,5,8,0,0,0
2019-11-14 00:15,13,6,7,0,0,0
2019-11-14 00:30,11,2,9,0,0,0
2019-11-14 00:45,17,5,12,0,0,0
2019-11-14 01:00,18,6,12,0,0,0
2019-11-14 01:15,7,0,7,0,0,0
2019-11-14 01:30,13,2,11,0,0,0
2019-11-14 01:45,3,0,3,0,0,0
2019-11-14 02:00,3,0,3,0,0,0
2019-11-14 02:15,7,0,7,0,0,0
2019-11-14 02:30,1,1,0,0,0,0
2019-11-14 02:45,3,2,1,0,0,0
2019-11-14 03:00,7,0,7,0,0,0
2019-11-14 03:15,0,0,0,0,0,0
2019-11-14 03:30,2,0,2,0,0,0
2019-11-14 03:45,1,0,1,0,0,0
2019-11-14 04:00,9,0,9,0,0,0
2019-11-14 04:15,3,2,1,0,0,0
2019-11-14 04:30,1,0,1,0,0,0
2019-11-14 04:45,9,8,1,0,0,0
2019-11-14 05:00,4,4,0,0,0,0
2019-11-14 05:15,5,5,0,0,0,0
2019-11-14 05:30,20,14,6,0,0,0
2019-11-14 05:45,19,15,4,0,0,0
2019-11-14 06:00,23,17,6,0,0,0
2019-11-14 06:15,34,25,9,0,0,0
2019-11-14 06:30,54,43,11,0,0,0
2019-11-14 06:45,57,41,16,0,0,0
2019-11-14 07:00,73,44,29,0,0,0
2019-11-14 07:15,130,90,40,0,0,0
2019-11-14 07:30,158,107,51,0,0,0
2019-11-14 07:45,181,129,52,0,0,0
2019-11-14 08:00,165,116,49,0,0,0
2019-11-14 08:15,160,110,50,0,0,0
2019-11-14 08:30,129,98,31,0,0,0
2019-11-14 08:45,160,123,37,0,0,0
2019-11-14 09:00,108,86,22,0,0,0
2019-11-14 09:15,112,82,30,0,0,0
2019-11-14 09:30,131,92,39,0,0,0
2019-11-14 09:45,143,104,39,0,0,0
2019-11-14 10:00,110,83,27,0,0,0
2019-11-14 10:15,87,53,34,0,0,0
2019-11-14 10:30,90,51,39,0,0,0
2019-11-14 10:45,129,80,49,0,0,0
2019-11-14 11:00,95,55,40,0,0,0
2019-11-14 11:15,97,45,52,0,0,0
2019-11-14 11:30,112,58,54,0,0,0
2019-11-14 11:45,138,80,58,0,0,0
2019-11-14 12:00,131,60,71,0,0,0
2019-11-14 12:15,125,50,75,0,0,0
2019-11-14 12:30,165,55,110,0,0,0
2019-11-14 12:45,129,61,68,0,0,0
2019-11-14 13:00,147,59,88,0,0,0
2019-11-14 13:15,150,63,87,0,0,0
2019-11-14 13:30,119,52,67,0,0,0
2019-11-14 13:45,188,91,97,0,0,0
2019-11-14 14:00,160,51,109,0,0,0
2019-11-14 14:15,146,59,87,0,0,0
2019-11-14 14:30,154,75,79,0,0,0
2019-11-14 14:45,185,84,101,0,0,0
2019-11-14 15:00,181,65,116,0,0,0
2019-11-14 15:15,165,75,90,0,0,0
2019-11-14 15:30,186,79,107,0,0,0
2019-11-14 15:45,210,87,123,0,0,0
2019-11-14 16:00,231,85,146,0,0,0
2019-11-14 16:15,201,73,128,0,0,0
2019-11-14 16:30,201,81,120,0,0,0
2019-11-14 16:45,206,68,138,0,0,0
2019-11-14 17:00,168,69,99,0,0,0
2019-11-14 17:15,175,75,100,0,0,0
2019-11-14 17:30,201,64,137,0,0,0
2019-11-14 17:45,225,87,138,0,0,0
2019-11-14 18:00,177,54,123,0,0,0
2019-11-14 18:15,179,65,114,0,0,0
2019-11-14 18:30,137,39,98,0,0,0
2019-11-14 18:45,177,72,105,0,0,0
2019-11-14 19:00,134,42,92,0,0,0
2019-11-14 19:15,125,42,83,0,0,0
2019-11-14 19:30,119,32,87,0,0,0
2019-11-14 19:45,142,58,84,0,0,0
2019-11-14 20:00,107,29,78,0,0,0
2019-11-14 20:15,82,20,62,0,0,0
2019-11-14 20:30,71,18,53,0,0,0
2019-11-14 20:45,67,29,38,0,0,0
2019-11-14 21:00,59,19,40,0,0,0
2019-11-14 21:15,60,17,43,0,0,0
2019-11-14 21:30,55,11,44,0,0,0
2019-11-14 21:45,68,15,53,0,0,0
2019-11-14 22:00,51,15,36,0,0,0
2019-11-14 22:15,58,21,37,0,0,0
2019-11-14 22:30,47,9,38,0,0,0
2019-11-14 22:45,54,22,32,0,0,0
2019-11-14 23:00,50,19,31,0,0,0
2019-11-14 23:15,42,18,24,0,0,0
2019-11-14 23:30,37,12,25,0,0,0
2019-11-14 23:45,19,7,12,0,0,0
2019-11-15 00:00,30,17,13,0,0,0
2019-11-15 00:15,17,4,13,0,0,0
2019-11-15 00:30,16,4,12,0,0,0
2019-11-15 00:45,9,2,7,0,0,0
2019-11-15 01:00,7,1,6,0,0,0
2019-11-15 01:15,10,2,8,0,0,0
2019-11-15 01:30,3,1,2,0,0,0
2019-11-15 01:45,4,1,3,0,0,0
2019-11-15 02:00,8,4,4,0,0,0
2019-11-15 02:15,5,1,4,0,0,0
2019-11-15 02:30,3,0,3,0,0,0
2019-11-15 02:45,3,3,0,0,0,0
2019-11-15 03:00,2,0,2,0,0,0
2019-11-15 03:15,2,0,2,0,0,0
2019-11-15 03:30,2,1,1,0,0,0
2019-11-15 03:45,1,0,1,0,0,0
2019-11-15 04:00,0,0,0,0,0,0
2019-11-15 04:15,1,1,0,0,0,0
2019-11-15 04:30,3,3,0,0,0,0
2019-11-15 04:45,8,7,1,0,0,0
2019-11-15 05:00,5,4,1,0,0,0
2019-11-15 05:15,4,4,0,0,0,0
2019-11-15 05:30,13,12,1,0,0,0
2019-11-15 05:45,15,13,2,0,0,0
2019-11-15 06:00,27,19,8,0,0,0
2019-11-15 06:15,38,29,9,0,0,0
2019-11-15 06:30,48,35,13,0,0,0
2019-11-15 06:45,68,49,19,0,0,0
2019-11-15 07:00,76,47,29,0,0,0
2019-11-15 07:15,128,95,33,0,0,0
2019-11-15 07:30,158,108,50,0,0,0
2019-11-15 07:45,210,148,62,0,0,0
2019-11-15 08:00,153,104,49,0,0,0
2019-11-15 08:15,139,97,42,0,0,0
2019-11-15 08:30,124,98,26,0,0,0
2019-11-15 08:45,152,109,43,0,0,0
2019-11-15 09:00,99,77,22,0,0,0
2019-11-15 09:15,110,70,40,0,0,0
2019-11-15 09:30,109,75,34,0,0,0
2019-11-15 09:45,119,95,24,0,0,0
2019-11-15 10:00,112,75,37,0,0,0
2019-11-15 10:15,103,60,43,0,0,0
2019-11-15 10:30,92,60,32,0,0,0
2019-11-15 10:45,89,56,33,0,0,0
2019-11-15 11:00,103,46,57,0,0,0
2019-11-15 11:15,99,49,50,0,0,0
2019-11-15 11:30,94,56,38,0,0,0
2019-11-15 11:45,136,64,72,0,0,0
2019-11-15 12:00,122,42,80,0,0,0
2019-11-15 12:15,152,51,101,0,0,0
2019-11-15 12:30,191,68,123,0,0,0
2019-11-15 12:45,173,75,98,0,0,0
2019-11-15 13:00,226,97,129,0,0,0
2019-11-15 13:15,206,89,117,0,0,0
2019-11-15 13:30,144,63,81,0,0,0
2019-11-15 13:45,197,106,91,0,0,0
2019-11-15 14:00,189,65,124,0,0,0
2019-11-15 14:15,168,55,113,0,0,0
2019-11-15 14:30,135,52,83,0,0,0
2019-11-15 14:45,194,78,116,0,0,0
2019-11-15 15:00,186,77,109,0,0,0
2019-11-15 15:15,185,79,106,0,0,0
2019-11-15 15:30,148,68,80,0,0,0
2019-11-15 15:45,167,66,101,0,0,0
2019-11-15 16:00,177,79,98,0,0,0
2019-11-15 16:15,148,51,97,0,0,0
2019-11-15 16:30,161,62,99,0,0,0
2019-11-15 16:45,148,67,81,0,0,0
2019-11-15 17:00,153,54,99,0,0,0
2019-11-15 17:15,149,52,97,0,0,0
2019-11-15 17:30,147,60,87,0,0,0
2019-11-15 17:45,160,51,109,0,0,0
2019-11-15 18:00,110,43,67,0,0,0
2019-11-15 18:15,163,62,101,0,0,0
2019-11-15 18:30,112,44,68,0,0,0
2019-11-15 18:45,139,72,67,0,0,0
2019-11-15 19:00,139,50,89,0,0,0
2019-11-15 19:15,116,60,56,0,0,0
2019-11-15 19:30,102,46,56,0,0,0
2019-11-15 19:45,117,50,67,0,0,0
2019-11-15 20:00,99,40,59,0,0,0
2019-11-15 20:15,90,36,54,0,0,0
2019-11-15 20:30,79,30,49,0,0,0
2019-11-15 20:45,71,33,38,0,0,0
2019-11-15 21:00,55,21,34,0,0,0
2019-11-15 21:15,56,22,34,0,0,0
2019-11-15 21:30,61,21,40,0,0,0
2019-11-15 21:45,49,16,33,0,0,0
2019-11-15 22:00,58,18,40,0,0,0
2019-11-15 22:15,48,15,33,0,0,0
2019-11-15 22:30,33,7,26,0,0,0
2019-11-15 22:45,52,21,31,0,0,0
2019-11-15 23:00,46,15,31,0,0,0
2019-11-15 23:15,43,13,30,0,0,0
2019-11-15 23:30,49,14,35,0,0,0
2019-11-15 23:45,50,14,36,0,0,0
2019-11-16 00:00,33,8,25,0,0,0
2019-11-16 00:15,35,5,30,0,0,0
2019-11-16 00:30,27,17,10,0,0,0
2019-11-16 00:45,33,11,22,0,0,0
2019-11-16 01:00,31,10,21,0,0,0
2019-11-16 01:15,27,7,20,0,0,0
2019-11-16 01:30,22,7,15,0,0,0
2019-11-16 01:45,21,8,13,0,0,0
2019-11-16 02:00,18,9,9,0,0,0
2019-11-16 02:15,14,5,9,0,0,0
2019-11-16 02:30,9,2,7,0,0,0
2019-11-16 02:45,12,3,9,0,0,0
2019-11-16 03:00,6,1,5,0,0,0
2019-11-16 03:15,8,4,4,0,0,0
2019-11-16 03:30,15,8,7,0,0,0
2019-11-16 03:45,8,2,6,0,0,0
2019-11-16 04:00,6,2,4,0,0,0
2019-11-16 04:15,15,6,9,0,0,0
2019-11-16 04:30,6,0,6,0,0,0
2019-11-16 04:45,2,1,1,0,0,0
2019-11-16 05:00,4,1,3,0,0,0
2019-11-16 05:15,8,5,3,0,0,0
2019-11-16 05:30,8,5,3,0,0,0
2019-11-16 05:45,10,5,5,0,0,0
2019-11-16 06:00,9,6,3,0,0,0
2019-11-16 06:15,12,7,5,0,0,0
2019-11-16 06:30,8,4,4,0,0,0
2019-11-16 06:45,16,9,7,0,0,0
2019-11-16 07:00,4,4,0,0,0,0
2019-11-16 07:15,16,13,3,0,0,0
2019-11-16 07:30,23,16,7,0,0,0
2019-11-16 07:45,39,23,16,0,0,0
2019-11-16 08:00,32,21,11,0,0,0
2019-11-16 08:15,58,39,19,0,0,0
2019-11-16 08:30,69,34,35,0,0,0
2019-11-16 08:45,74,51,23,0,0,0
2019-11-16 09:00,66,50,16,0,0,0
2019-11-16 09:15,84,60,24,0,0,0
2019-11-16 09:30,97,68,29,0,0,0
2019-11-16 09:45,110,88,22,0,0,0
2019-11-16 10:00,110,72,38,0,0,0
2019-11-16 10:15,104,70,34,0,0,0
2019-11-16 10:30,140,98,42,0,0,0
2019-11-16 10:45,132,99,33,0,0,0
2019-11-16 11:00,119,67,52,0,0,0
2019-11-16 11:15,138,93,45,0,0,0
2019-11-16 11:30,152,103,49,0,0,0
2019-11-16 11:45,175,121,54,0,0,0
2019-11-16 12:00,172,81,91,0,0,0
2019-11-16 12:15,157,86,71,0,0,0
2019-11-16 12:30,181,98,83,0,0,0
2019-11-16 12:45,198,123,75,0,0,0
2019-11-16 13:00,186,87,99,0,0,0
2019-11-16 13:15,195,86,109,0,0,0
2019-11-16 13:30,161,91,70,0,0,0
2019-11-16 13:45,180,92,88,0,0,0
2019-11-16 14:00,169,84,85,0,0,0
2019-11-16 14:15,136,55,81,0,0,0
2019-11-16 14:30,189,65,124,0,0,0
2019-11-16 14:45,163,49,114,0,0,0
2019-11-16 15:00,138,51,87,0,0,0
2019-11-16 15:15,164,63,101,0,0,0
2019-11-16 15:30,152,64,88,0,0,0
2019-11-16 15:45,172,75,97,0,0,0
2019-11-16 16:00,125,47,78,0,0,0
2019-11-16 16:15,165,56,109,0,0,0
2019-11-16 16:30,154,55,99,0,0,0
2019-11-16 16:45,135,53,82,0,0,0
2019-11-16 17:00,129,42,87,0,0,0
2019-11-16 17:15,98,34,64,0,0,0
2019-11-16 17:30,126,50,76,0,0,0
2019-11-16 17:45,133,51,82,0,0,0
2019-11-16 18:00,103,36,67,0,0,0
2019-11-16 18:15,115,31,84,0,0,0
2019-11-16 18:30,126,39,87,0,0,0
2019-11-16 18:45,142,61,81,0,0,0
2019-11-16 19:00,118,46,72,0,0,0
2019-11-16 19:15,108,46,62,0,0,0
2019-11-16 19:30,102,33,69,0,0,0
2019-11-16 19:45,118,45,73,0,0,0
2019-11-16 20:00,77,23,54,0,0,0
2019-11-16 20:15,75,31,44,0,0,0
2019-11-16 20:30,62,30,32,0,0,0
2019-11-16 20:45,64,19,45,0,0,0
2019-11-16 21:00,54,29,25,0,0,0
2019-11-16 21:15,63,32,31,0,0,0
2019-11-16 21:30,126,109,17,0,0,0
2019-11-16 21:45,54,37,17,0,0,0
2019-11-16 22:00,39,16,23,0,0,0
2019-11-16 22:15,47,12,35,0,0,0
2019-11-16 22:30,35,14,21,0,0,0
2019-11-16 22:45,58,34,24,0,0,0
2019-11-16 23:00,26,9,17,0,0,0
2019-11-16 23:15,57,17,40,0,0,0
2019-11-16 23:30,57,19,38,0,0,0
2019-11-16 23:45,56,33,23,0,0,0
2019-11-17 00:00,38,21,17,0,0,0
2019-11-17 00:15,39,15,24,0,0,0
2019-11-17 00:30,48,22,26,0,0,0
2019-11-17 00:45,42,22,20,0,0,0
2019-11-17 01:00,41,20,21,0,0,0
2019-11-17 01:15,28,19,9,0,0,0
2019-11-17 01:30,40,17,23,0,0,0
2019-11-17 01:45,27,15,12,0,0,0
2019-11-17 02:00,21,11,10,0,0,0
2019-11-17 02:15,20,10,10,0,0,0
2019-11-17 02:30,24,9,15,0,0,0
2019-11-17 02:45,19,10,9,0,0,0
2019-11-17 03:00,17,6,11,0,0,0
2019-11-17 03:15,13,4,9,0,0,0
2019-11-17 03:30,21,8,13,0,0,0
2019-11-17 03:45,26,13,13,0,0,0
2019-11-17 04:00,11,5,6,0,0,0
2019-11-17 04:15,13,5,8,0,0,0
2019-11-17 04:30,8,3,5,0,0,0
2019-11-17 04:45,9,2,7,0,0,0
2019-11-17 05:00,3,1,2,0,0,0
2019-11-17 05:15,5,4,1,0,0,0
2019-11-17 05:30,17,12,5,0,0,0
2019-11-17 05:45,4,3,1,0,0,0
2019-11-17 06:00,7,2,5,0,0,0
2019-11-17 06:15,3,1,2,0,0,0
2019-11-17 06:30,11,4,7,0,0,0
2019-11-17 06:45,4,2,2,0,0,0
2019-11-17 07:00,2,2,0,0,0,0
2019-11-17 07:15,3,2,1,0,0,0
2019-11-17 07:30,3,3,0,0,0,0
2019-11-17 07:45,10,9,1,0,0,0
2019-11-17 08:00,7,4,3,0,0,0
2019-11-17 08:15,7,3,4,0,0,0
2019-11-17 08:30,7,3,4,0,0,0
2019-11-17 08:45,12,8,4,0,0,0
2019-11-17 09:00,19,10,9,0,0,0
2019-11-17 09:15,22,13,9,0,0,0
2019-11-17 09:30,29,16,13,0,0,0
2019-11-17 09:45,51,34,17,0,0,0
2019-11-17 10:00,47,33,14,0,0,0
2019-11-17 10:15,33,20,13,0,0,0
2019-11-17 10:30,38,29,9,0,0,0
2019-11-17 10:45,38,19,19,0,0,0
2019-11-17 11:00,17,6,11,0,0,0
2019-11-17 11:15,36,20,16,0,0,0
2019-11-17 11:30,34,22,12,0,0,0
2019-11-17 11:45,53,34,19,0,0,0
2019-11-17 12:00,56,31,25,0,0,0
2019-11-17 12:15,41,22,19,0,0,0
2019-11-17 12:30,61,30,31,0,0,0
2019-11-17 12:45,59,30,29,0,0,0
2019-11-17 13:00,52,32,20,0,0,0
2019-11-17 13:15,61,32,29,0,0,0
2019-11-17 13:30,51,21,30,0,0,0
2019-11-17 13:45,69,36,33,0,0,0
2019-11-17 14:00,79,33,46,0,0,0
2019-11-17 14:15,40,23,17,0,0,0
2019-11-17 14:30,68,34,34,0,0,0
2019-11-17 14:45,82,47,35,0,0,0
2019-11-17 15:00,67,35,32,0,0,0
2019-11-17 15:15,48,22,26,0,0,0
2019-11-17 15:30,36,13,23,0,0,0
2019-11-17 15:45,66,28,38,0,0,0
2019-11-17 16:00,60,23,37,0,0,0
2019-11-17 16:15,62,27,35,0,0,0
2019-11-17 16:30,67,27,40,0,0,0
2019-11-17 16:45,47,25,22,0,0,0
2019-11-17 17:00,57,25,32,0,0,0
2019-11-17 17:15,53,20,33,0,0,0
2019-11-17 17:30,39,17,22,0,0,0
2019-11-17 17:45,60,34,26,0,0,0
2019-11-17 18:00,42,15,27,0,0,0
2019-11-17 18:15,46,25,21,0,0,0
2019-11-17 18:30,35,16,19,0,0,0
2019-11-17 18:45,44,18,26,0,0,0
2019-11-17 19:00,45,14,31,0,0,0
2019-11-17 19:15,34,18,16,0,0,0
2019-11-17 19:30,30,10,20,0,0,0
2019-11-17 19:45,28,12,16,0,0,0
2019-11-17 20:00,19,7,12,0,0,0
2019-11-17 20:15,29,8,21,0,0,0
2019-11-17 20:30,25,6,19,0,0,0
2019-11-17 20:45,19,7,12,0,0,0
2019-11-17 21:00,19,8,11,0,0,0
2019-11-17 21:15,19,9,10,0,0,0
2019-11-17 21:30,12,4,8,0,0,0
2019-11-17 21:45,10,0,10,0,0,0
2019-11-17 22:00,23,7,16,0,0,0
2019-11-17 22:15,18,7,11,0,0,0
2019-11-17 22:30,16,1,15,0,0,0
2019-11-17 22:45,13,1,12,0,0,0
2019-11-17 23:00,6,2,4,0,0,0
2019-11-17 23:15,8,2,6,0,0,0
2019-11-17 23:30,7,2,5,0,0,0
2019-11-17 23:45,8,4,4,0,0,0
2019-11-18 00:00,4,0,4,0,0,0
2019-11-18 00:15,7,3,4,0,0,0
2019-11-18 00:30,3,1,2,0,0,0
2019-11-18 00:45,1,1,0,0,0,0
2019-11-18 01:00,4,4,0,0,0,0
2019-11-18 01:15,1,0,1,0,0,0
2019-11-18 01:30,1,0,1,0,0,0
2019-11-18 01:45,1,0,1,0,0,0
2019-11-18 02:00,0,0,0,0,0,0
2019-11-18 02:15,0,0,0,0,0,0
2019-11-18 02:30,0,0,0,0,0,0
2019-11-18 02:45,1,1,0,0,0,0
2019-11-18 03:00,0,0,0,0,0,0
2019-11-18 03:15,0,0,0,0,0,0
2019-11-18 03:30,1,0,1,0,0,0
2019-11-18 03:45,0,0,0,0,0,0
2019-11-18 04:00,0,0,0,0,0,0
2019-11-18 04:15,2,2,0,0,0,0
2019-11-18 04:30,0,0,0,0,0,0
2019-11-18 04:45,6,2,4,0,0,0
2019-11-18 05:00,3,3,0,0,0,0
2019-11-18 05:15,6,5,1,0,0,0
2019-11-18 05:30,11,9,2,0,0,0
2019-11-18 05:45,15,12,3,0,0,0
2019-11-18 06:00,19,11,8,0,0,0
2019-11-18 06:15,27,21,6,0,0,0
2019-11-18 06:30,38,23,15,0,0,0
2019-11-18 06:45,60,41,19,0,0,0
2019-11-18 07:00,61,43,18,0,0,0
2019-11-18 07:15,99,69,30,0,0,0
2019-11-18 07:30,134,92,42,0,0,0
2019-11-18 07:45,147,97,50,0,0,0
2019-11-18 08:00,139,107,32,0,0,0
2019-11-18 08:15,160,104,56,0,0,0
2019-11-18 08:30,129,90,39,0,0,0
2019-11-18 08:45,138,106,32,0,0,0
2019-11-18 09:00,95,62,33,0,0,0
2019-11-18 09:15,79,58,21,0,0,0
2019-11-18 09:30,90,73,17,0,0,0
2019-11-18 09:45,118,85,33,0,0,0
2019-11-18 10:00,127,92,35,0,0,0
2019-11-18 10:15,70,41,29,0,0,0
2019-11-18 10:30,74,38,36,0,0,0
2019-11-18 10:45,98,55,43,0,0,0
2019-11-18 11:00,73,39,34,0,0,0
2019-11-18 11:15,88,51,37,0,0,0
2019-11-18 11:30,97,34,63,0,0,0
2019-11-18 11:45,94,48,46,0,0,0
2019-11-18 12:00,122,57,65,0,0,0
2019-11-18 12:15,112,55,57,0,0,0
2019-11-18 12:30,107,43,64,0,0,0
2019-11-18 12:45,127,53,74,0,0,0
2019-11-18 13:00,111,42,69,0,0,0
2019-11-18 13:15,107,47,60,0,0,0
2019-11-18 13:30,97,33,64,0,0,0
2019-11-18 13:45,129,58,71,0,0,0
2019-11-18 14:00,105,42,63,0,0,0
2019-11-18 14:15,103,39,64,0,0,0
2019-11-18 14:30,88,33,55,0,0,0
2019-11-18 14:45,98,34,64,0,0,0
2019-11-18 15:00,94,36,58,0,0,0
2019-11-18 15:15,101,33,68,0,0,0
2019-11-18 15:30,90,37,53,0,0,0
2019-11-18 15:45,143,49,94,0,0,0
2019-11-18 16:00,139,53,86,0,0,0
2019-11-18 16:15,125,46,79,0,0,0
2019-11-18 16:30,102,25,77,0,0,0
2019-11-18 16:45,119,35,84,0,0,0
2019-11-18 17:00,130,40,90,0,0,0
2019-11-18 17:15,130,41,89,0,0,0
2019-11-18 17:30,119,41,78,0,0,0
2019-11-18 17:45,126,42,84,0,0,0
2019-11-18 18:00,134,38,96,0,0,0
2019-11-18 18:15,103,35,68,0,0,0
2019-11-18 18:30,99,30,69,0,0,0
2019-11-18 18:45,92,33,59,0,0,0
2019-11-18 19:00,76,23,53,0,0,0
2019-11-18 19:15,87,33,54,0,0,0
2019-11-18 19:30,63,23,40,0,0,0
2019-11-18 19:45,78,31,47,0,0,0
2019-11-18 20:00,54,16,38,0,0,0
2019-11-18 20:15,39,14,25,0,0,0
2019-11-18 20:30,32,9,23,0,0,0
2019-11-18 20:45,24,8,16,0,0,0
2019-11-18 21:00,35,17,18,0,0,0
2019-11-18 21:15,31,11,20,0,0,0
2019-11-18 21:30,32,11,21,0,0,0
2019-11-18 21:45,37,6,31,0,0,0
2019-11-18 22:00,18,6,12,0,0,0
2019-11-18 22:15,28,9,19,0,0,0
2019-11-18 22:30,24,3,21,0,0,0
2019-11-18 22:45,21,4,17,0,0,0
2019-11-18 23:00,21,4,17,0,0,0
2019-11-18 23:15,11,2,9,0,0,0
2019-11-18 23:30,8,3,5,0,0,0
2019-11-18 23:45,7,4,3,0,0,0
2019-11-19 00:00,7,2,5,0,0,0
2019-11-19 00:15,5,3,2,0,0,0
2019-11-19 00:30,4,0,4,0,0,0
2019-11-19 00:45,2,0,2,0,0,0
2019-11-19 01:00,7,3,4,0,0,0
2019-11-19 01:15,1,0,1,0,0,0
2019-11-19 01:30,3,2,1,0,0,0
2019-11-19 01:45,1,1,0,0,0,0
2019-11-19 02:00,0,0,0,0,0,0
2019-11-19 02:15,2,0,2,0,0,0
2019-11-19 02:30,0,0,0,0,0,0
2019-11-19 02:45,1,1,0,0,0,0
2019-11-19 03:00,0,0,0,0,0,0
2019-11-19 03:15,1,0,1,0,0,0
2019-11-19 03:30,2,0,2,0,0,0
2019-11-19 03:45,0,0,0,0,0,0
2019-11-19 04:00,1,0,1,0,0,0
2019-11-19 04:15,3,2,1,0,0,0
2019-11-19 04:30,1,1,0,0,0,0
2019-11-19 04:45,6,3,3,0,0,0
2019-11-19 05:00,2,2,0,0,0,0
2019-11-19 05:15,9,6,3,0,0,0
2019-11-19 05:30,13,11,2,0,0,0
2019-11-19 05:45,21,18,3,0,0,0
2019-11-19 06:00,14,10,4,0,0,0
2019-11-19 06:15,29,23,6,0,0,0
2019-11-19 06:30,27,19,8,0,0,0
2019-11-19 06:45,44,35,9,0,0,0
2019-11-19 07:00,69,47,22,0,0,0
2019-11-19 07:15,91,70,21,0,0,0
2019-11-19 07:30,110,71,39,0,0,0
2019-11-19 07:45,143,99,44,0,0,0
2019-11-19 08:00,129,99,30,0,0,0
2019-11-19 08:15,138,90,48,0,0,0
2019-11-19 08:30,92,65,27,0,0,0
2019-11-19 08:45,131,93,38,0,0,0
2019-11-19 09:00,93,60,33,0,0,0
2019-11-19 09:15,83,57,26,0,0,0
2019-11-19 09:30,63,37,26,0,0,0
2019-11-19 09:45,90,61,29,0,0,0
2019-11-19 10:00,105,82,23,0,0,0
2019-11-19 10:15,62,35,27,0,0,0
2019-11-19 10:30,47,27,20,0,0,0
2019-11-19 10:45,60,37,23,0,0,0
2019-11-19 11:00,54,29,25,0,0,0
2019-11-19 11:15,84,42,42,0,0,0
2019-11-19 11:30,90,54,36,0,0,0
2019-11-19 11:45,93,45,48,0,0,0
2019-11-19 12:00,117,47,70,0,0,0
2019-11-19 12:15,94,56,38,0,0,0
2019-11-19 12:30,119,52,67,0,0,0
2019-11-19 12:45,121,50,71,0,0,0
2019-11-19 13:00,125,52,73,0,0,0
2019-11-19 13:15,112,40,72,0,0,0
2019-11-19 13:30,92,44,48,0,0,0
2019-11-19 13:45,134,53,81,0,0,0
2019-11-19 14:00,125,42,83,0,0,0
2019-11-19 14:15,114,41,73,0,0,0
2019-11-19 14:30,123,45,78,0,0,0
2019-11-19 14:45,138,71,67,0,0,0
2019-11-19 15:00,161,54,107,0,0,0
2019-11-19 15:15,149,63,86,0,0,0
2019-11-19 15:30,160,67,93,0,0,0
2019-11-19 15:45,163,71,92,0,0,0
2019-11-19 16:00,188,81,107,0,0,0
2019-11-19 16:15,173,68,105,0,0,0
2019-11-19 16:30,194,84,110,0,0,0
2019-11-19 16:45,161,78,83,0,0,0
2019-11-19 17:00,179,74,105,0,0,0
2019-11-19 17:15,168,57,111,0,0,0
2019-11-19 17:30,195,68,127,0,0,0
2019-11-19 17:45,180,67,113,0,0,0
2019-11-19 18:00,166,50,116,0,0,0
2019-11-19 18:15,146,52,94,0,0,0
2019-11-19 18:30,129,44,85,0,0,0
2019-11-19 18:45,140,59,81,0,0,0
2019-11-19 19:00,124,55,69,0,0,0
2019-11-19 19:15,109,43,66,0,0,0
2019-11-19 19:30,100,36,64,0,0,0
2019-11-19 19:45,137,57,80,0,0,0
2019-11-19 20:00,89,19,70,0,0,0
2019-11-19 20:15,67,27,40,0,0,0
2019-11-19 20:30,61,25,36,0,0,0
2019-11-19 20:45,57,15,42,0,0,0
2019-11-19 21:00,52,18,34,0,0,0
2019-11-19 21:15,51,17,34,0,0,0
2019-11-19 21:30,55,17,38,0,0,0
2019-11-19 21:45,52,13,39,0,0,0
2019-11-19 22:00,45,11,34,0,0,0
2019-11-19 22:15,50,17,33,0,0,0
2019-11-19 22:30,45,9,36,0,0,0
2019-11-19 22:45,41,12,29,0,0,0
2019-11-19 23:00,33,12,21,0,0,0
2019-11-19 23:15,20,8,12,0,0,0
2019-11-19 23:30,12,2,10,0,0,0
2019-11-19 23:45,23,5,18,0,0,0
2019-11-20 00:00,23,7,16,0,0,0
2019-11-20 00:15,14,3,11,0,0,0
2019-11-20 00:30,16,2,14,0,0,0
2019-11-20 00:45,12,6,6,0,0,0
2019-11-20 01:00,7,0,7,0,0,0
2019-11-20 01:15,7,1,6,0,0,0
2019-11-20 01:30,2,0,2,0,0,0
2019-11-20 01:45,1,0,1,0,0,0
2019-11-20 02:00,2,2,0,0,0,0
2019-11-20 02:15,0,0,0,0,0,0
2019-11-20 02:30,0,0,0,0,0,0
2019-11-20 02:45,3,1,2,0,0,0
2019-11-20 03:00,0,0,0,0,0,0
2019-11-20 03:15,3,0,3,0,0,0
2019-11-20 03:30,0,0,0,0,0,0
2019-11-20 03:45,1,0,1,0,0,0
2019-11-20 04:00,0,0,0,0,0,0
2019-11-20 04:15,2,1,1,0,0,0
2019-11-20 04:30,1,1,0,0,0,0
2019-11-20 04:45,5,4,1,0,0,0
2019-11-20 05:00,1,1,0,0,0,0
2019-11-20 05:15,7,4,3,0,0,0
2019-11-20 05:30,16,10,6,0,0,0
2019-11-20 05:45,18,15,3,0,0,0
2019-11-20 06:00,29,21,8,0,0,0
2019-11-20 06:15,40,33,7,0,0,0
2019-11-20 06:30,36,25,11,0,0,0
2019-11-20 06:45,58,39,19,0,0,0
2019-11-20 07:00,79,49,30,0,0,0
2019-11-20 07:15,114,82,32,0,0,0
2019-11-20 07:30,149,89,60,0,0,0
2019-11-20 07:45,186,122,64,0,0,0
2019-11-20 08:00,143,99,44,0,0,0
2019-11-20 08:15,154,106,48,0,0,0
2019-11-20 08:30,135,96,39,0,0,0
2019-11-20 08:45,155,104,51,0,0,0
2019-11-20 09:00,96,69,27,0,0,0
2019-11-20 09:15,110,75,35,0,0,0
2019-11-20 09:30,104,72,32,0,0,0
2019-11-20 09:45,119,93,26,0,0,0
2019-11-20 10:00,116,78,38,0,0,0
2019-11-20 10:15,87,50,37,0,0,0
2019-11-20 10:30,81,45,36,0,0,0
2019-11-20 10:45,120,68,52,0,0,0
2019-11-20 11:00,94,61,33,0,0,0
2019-11-20 11:15,106,56,50,0,0,0
2019-11-20 11:30,110,59,51,0,0,0
2019-11-20 11:45,143,66,77,0,0,0
2019-11-20 12:00,161,64,97,0,0,0
2019-11-20 12:15,126,56,70,0,0,0
2019-11-20 12:30,118,48,70,0,0,0
2019-11-20 12:45,147,57,90,0,0,0
2019-11-20 13:00,127,37,90,0,0,0
2019-11-20 13:15,132,63,69,0,0,0
2019-11-20 13:30,136,57,79,0,0,0
2019-11-20 13:45,171,76,95,0,0,0
2019-11-20 14:00,166,54,112,0,0,0
2019-11-20 14:15,115,45,70,0,0,0
2019-11-20 14:30,131,56,75,0,0,0
2019-11-20 14:45,132,49,83,0,0,0
2019-11-20 15:00,134,55,79,0,0,0
2019-11-20 15:15,146,62,84,0,0,0
2019-11-20 15:30,141,62,79,0,0,0
2019-11-20 15:45,183,68,115,0,0,0
2019-11-20 16:00,191,70,121,0,0,0
2019-11-20 16:15,179,62,117,0,0,0
2019-11-20 16:30,175,70,105,0,0,0
2019-11-20 16:45,211,88,123,0,0,0
2019-11-20 17:00,192,76,116,0,0,0
2019-11-20 17:15,172,53,119,0,0,0
2019-11-20 17:30,196,70,126,0,0,0
2019-11-20 17:45,209,69,140,0,0,0
2019-11-20 18:00,192,65,127,0,0,0
2019-11-20 18:15,136,46,90,0,0,0
2019-11-20 18:30,157,47,110,0,0,0
2019-11-20 18:45,166,65,101,0,0,0
2019-11-20 19:00,163,50,113,0,0,0
2019-11-20 19:15,134,36,98,0,0,0
2019-11-20 19:30,117,41,76,0,0,0
2019-11-20 19:45,91,35,56,0,0,0
2019-11-20 20:00,109,37,72,0,0,0
2019-11-20 20:15,81,33,48,0,0,0
2019-11-20 20:30,75,21,54,0,0,0
2019-11-20 20:45,66,16,50,0,0,0
2019-11-20 21:00,67,34,33,0,0,0
2019-11-20 21:15,42,14,28,0,0,0
2019-11-20 21:30,50,8,42,0,0,0
2019-11-20 21:45,61,14,47,0,0,0
2019-11-20 22:00,70,23,47,0,0,0
2019-11-20 22:15,90,17,73,0,0,0
2019-11-20 22:30,61,14,47,0,0,0
2019-11-20 22:45,36,11,25,0,0,0
2019-11-20 23:00,36,7,29,0,0,0
2019-11-20 23:15,30,11,19,0,0,0
2019-11-20 23:30,35,18,17,0,0,0
2019-11-20 23:45,21,10,11,0,0,0
2019-11-21 00:00,14,5,9,0,0,0
2019-11-21 00:15,35,17,18,0,0,0
2019-11-21 00:30,25,11,14,0,0,0
2019-11-21 00:45,18,3,15,0,0,0
2019-11-21 01:00,9,6,3,0,0,0
2019-11-21 01:15,9,1,8,0,0,0
2019-11-21 01:30,9,2,7,0,0,0
2019-11-21 01:45,5,1,4,0,0,0
2019-11-21 02:00,4,0,4,0,0,0
2019-11-21 02:15,3,2,1,0,0,0
2019-11-21 02:30,3,1,2,0,0,0
2019-11-21 02:45,6,2,4,0,0,0
2019-11-21 03:00,2,1,1,0,0,0
2019-11-21 03:15,2,0,2,0,0,0
2019-11-21 03:30,1,0,1,0,0,0
2019-11-21 03:45,1,1,0,0,0,0
2019-11-21 04:00,5,3,2,0,0,0
2019-11-21 04:15,2,1,1,0,0,0
2019-11-21 04:30,6,3,3,0,0,0
2019-11-21 04:45,5,4,1,0,0,0
2019-11-21 05:00,4,3,1,0,0,0
2019-11-21 05:15,8,7,1,0,0,0
2019-11-21 05:30,14,11,3,0,0,0
2019-11-21 05:45,18,12,6,0,0,0
2019-11-21 06:00,26,19,7,0,0,0
2019-11-21 06:15,38,31,7,0,0,0
2019-11-21 06:30,35,20,15,0,0,0
2019-11-21 06:45,66,52,14,0,0,0
2019-11-21 07:00,72,48,24,0,0,0
2019-11-21 07:15,109,71,38,0,0,0
2019-11-21 07:30,167,118,49,0,0,0
2019-11-21 07:45,177,119,58,0,0,0
2019-11-21 08:00,146,112,34,0,0,0
2019-11-21 08:15,171,106,65,0,0,0
2019-11-21 08:30,110,86,24,0,0,0
2019-11-21 08:45,133,94,39,0,0,0
2019-11-21 09:00,113,78,35,0,0,0
2019-11-21 09:15,99,77,22,0,0,0
2019-11-21 09:30,113,81,32,0,0,0
2019-11-21 09:45,137,106,31,0,0,0
2019-11-21 10:00,126,89,37,0,0,0
2019-11-21 10:15,103,54,49,0,0,0
2019-11-21 10:30,94,57,37,0,0,0
2019-11-21 10:45,104,65,39,0,0,0
2019-11-21 11:00,89,51,38,0,0,0
2019-11-21 11:15,110,61,49,0,0,0
2019-11-21 11:30,124,58,66,0,0,0
2019-11-21 11:45,128,67,61,0,0,0
2019-11-21 12:00,129,61,68,0,0,0
2019-11-21 12:15,139,63,76,0,0,0
2019-11-21 12:30,149,66,83,0,0,0
2019-11-21 12:45,121,52,69,0,0,0
2019-11-21 13:00,120,55,65,0,0,0
2019-11-21 13:15,122,48,74,0,0,0
2019-11-21 13:30,117,50,67,0,0,0
2019-11-21 13:45,168,89,79,0,0,0
2019-11-21 14:00,156,62,94,0,0,0
2019-11-21 14:15,136,58,78,0,0,0
2019-11-21 14:30,132,56,76,0,0,0
2019-11-21 14:45,170,80,90,0,0,0
2019-11-21 15:00,140,59,81,0,0,0
2019-11-21 15:15,174,72,102,0,0,0
2019-11-21 15:30,189,93,96,0,0,0
2019-11-21 15:45,223,99,124,0,0,0
2019-11-21 16:00,196,61,135,0,0,0
2019-11-21 16:15,173,53,120,0,0,0
2019-11-21 16:30,174,71,103,0,0,0
2019-11-21 16:45,175,76,99,0,0,0
2019-11-21 17:00,187,60,127,0,0,0
2019-11-21 17:15,172,69,103,0,0,0
2019-11-21 17:30,162,52,110,0,0,0
2019-11-21 17:45,218,95,123,0,0,0
2019-11-21 18:00,175,57,118,0,0,0
2019-11-21 18:15,179,78,101,0,0,0
2019-11-21 18:30,155,50,105,0,0,0
2019-11-21 18:45,124,46,78,0,0,0
2019-11-21 19:00,141,59,82,0,0,0
2019-11-21 19:15,128,49,79,0,0,0
2019-11-21 19:30,118,30,88,0,0,0
2019-11-21 19:45,133,59,74,0,0,0
2019-11-21 20:00,96,20,76,0,0,0
2019-11-21 20:15,95,25,70,0,0,0
2019-11-21 20:30,62,18,44,0,0,0
2019-11-21 20:45,46,15,31,0,0,0
2019-11-21 21:00,59,16,43,0,0,0
2019-11-21 21:15,53,17,36,0,0,0
2019-11-21 21:30,64,15,49,0,0,0
2019-11-21 21:45,65,25,40,0,0,0
2019-11-21 22:00,74,20,54,0,0,0
2019-11-21 22:15,65,17,48,0,0,0
2019-11-21 22:30,52,16,36,0,0,0
2019-11-21 22:45,49,9,40,0,0,0
2019-11-21 23:00,43,13,30,0,0,0
2019-11-21 23:15,47,14,33,0,0,0
2019-11-21 23:30,21,8,13,0,0,0
2019-11-21 23:45,23,6,17,0,0,0
2019-11-22 00:00,15,7,8,0,0,0
2019-11-22 00:15,13,6,7,0,0,0
2019-11-22 00:30,12,3,9,0,0,0
2019-11-22 00:45,12,1,11,0,0,0
2019-11-22 01:00,17,10,7,0,0,0
2019-11-22 01:15,6,2,4,0,0,0
2019-11-22 01:30,4,1,3,0,0,0
2019-11-22 01:45,1,1,0,0,0,0
2019-11-22 02:00,3,1,2,0,0,0
2019-11-22 02:15,1,0,1,0,0,0
2019-11-22 02:30,5,4,1,0,0,0
2019-11-22 02:45,3,1,2,0,0,0
2019-11-22 03:00,2,0,2,0,0,0
2019-11-22 03:15,2,0,2,0,0,0
2019-11-22 03:30,3,0,3,0,0,0
2019-11-22 03:45,3,1,2,0,0,0
2019-11-22 04:00,5,1,4,0,0,0
2019-11-22 04:15,3,1,2,0,0,0
2019-11-22 04:30,4,2,2,0,0,0
2019-11-22 04:45,5,3,2,0,0,0
2019-11-22 05:00,2,2,0,0,0,0
2019-11-22 05:15,4,3,1,0,0,0
2019-11-22 05:30,17,15,2,0,0,0
2019-11-22 05:45,13,10,3,0,0,0
2019-11-22 06:00,22,17,5,0,0,0
2019-11-22 06:15,43,34,9,0,0,0
2019-11-22 06:30,36,25,11,0,0,0
2019-11-22 06:45,54,37,17,0,0,0
2019-11-22 07:00,77,54,23,0,0,0
2019-11-22 07:15,112,74,38,0,0,0
2019-11-22 07:30,147,102,45,0,0,0
2019-11-22 07:45,153,105,48,0,0,0
2019-11-22 08:00,92,68,24,0,0,0
2019-11-22 08:15,139,94,45,0,0,0
2019-11-22 08:30,99,71,28,0,0,0
2019-11-22 08:45,115,92,23,0,0,0
2019-11-22 09:00,81,54,27,0,0,0
2019-11-22 09:15,88,58,30,0,0,0
2019-11-22 09:30,73,48,25,0,0,0
2019-11-22 09:45,111,79,32,0,0,0
2019-11-22 10:00,82,55,27,0,0,0
2019-11-22 10:15,49,31,18,0,0,0
2019-11-22 10:30,68,40,28,0,0,0
2019-11-22 10:45,69,42,27,0,0,0
2019-11-22 11:00,82,38,44,0,0,0
2019-11-22 11:15,90,38,52,0,0,0
2019-11-22 11:30,76,39,37,0,0,0
2019-11-22 11:45,109,59,50,0,0,0
2019-11-22 12:00,93,42,51,0,0,0
2019-11-22 12:15,134,52,82,0,0,0
2019-11-22 12:30,124,44,80,0,0,0
2019-11-22 12:45,148,44,104,0,0,0
2019-11-22 13:00,153,77,76,0,0,0
2019-11-22 13:15,170,68,102,0,0,0
2019-11-22 13:30,151,67,84,0,0,0
2019-11-22 13:45,188,88,100,0,0,0
2019-11-22 14:00,201,86,115,0,0,0
2019-11-22 14:15,166,72,94,0,0,0
2019-11-22 14:30,159,65,94,0,0,0
2019-11-22 14:45,187,91,96,0,0,0
2019-11-22 15:00,158,66,92,0,0,0
2019-11-22 15:15,189,88,101,0,0,0
2019-11-22 15:30,192,91,101,0,0,0
2019-11-22 15:45,190,74,116,0,0,0
2019-11-22 16:00,178,77,101,0,0,0
2019-11-22 16:15,170,65,105,0,0,0
2019-11-22 16:30,170,69,101,0,0,0
2019-11-22 16:45,180,81,99,0,0,0
2019-11-22 17:00,160,48,112,0,0,0
2019-11-22 17:15,132,50,82,0,0,0
2019-11-22 17:30,161,57,104,0,0,0
2019-11-22 17:45,163,75,88,0,0,0
2019-11-22 18:00,143,47,96,0,0,0
2019-11-22 18:15,125,44,81,0,0,0
2019-11-22 18:30,135,34,101,0,0,0
2019-11-22 18:45,127,65,62,0,0,0
2019-11-22 19:00,117,44,73,0,0,0
2019-11-22 19:15,152,53,99,0,0,0
2019-11-22 19:30,123,60,63,0,0,0
2019-11-22 19:45,116,52,64,0,0,0
2019-11-22 20:00,91,36,55,0,0,0
2019-11-22 20:15,86,37,49,0,0,0
2019-11-22 20:30,87,28,59,0,0,0
2019-11-22 20:45,44,22,22,0,0,0
2019-11-22 21:00,70,21,49,0,0,0
2019-11-22 21:15,58,17,41,0,0,0
2019-11-22 21:30,49,19,30,0,0,0
2019-11-22 21:45,48,23,25,0,0,0
2019-11-22 22:00,46,20,26,0,0,0
2019-11-22 22:15,56,17,39,0,0,0
2019-11-22 22:30,76,14,62,0,0,0
2019-11-22 22:45,71,28,43,0,0,0
2019-11-22 23:00,44,10,34,0,0,0
2019-11-22 23:15,52,24,28,0,0,0
2019-11-22 23:30,47,17,30,0,0,0
2019-11-22 23:45,40,10,30,0,0,0
2019-11-23 00:00,52,13,39,0,0,0
2019-11-23 00:15,38,20,18,0,0,0
2019-11-23 00:30,38,15,23,0,0,0
2019-11-23 00:45,37,19,18,0,0,0
2019-11-23 01:00,32,11,21,0,0,0
2019-11-23 01:15,9,1,8,0,0,0
2019-11-23 01:30,25,10,15,0,0,0
2019-11-23 01:45,29,10,19,0,0,0
2019-11-23 02:00,21,7,14,0,0,0
2019-11-23 02:15,19,4,15,0,0,0
2019-11-23 02:30,15,6,9,0,0,0
2019-11-23 02:45,18,5,13,0,0,0
2019-11-23 03:00,20,4,16,0,0,0
2019-11-23 03:15,9,1,8,0,0,0
2019-11-23 03:30,12,4,8,0,0,0
2019-11-23 03:45,11,2,9,0,0,0
2019-11-23 04:00,8,1,7,0,0,0
2019-11-23 04:15,4,0,4,0,0,0
2019-11-23 04:30,2,0,2,0,0,0
2019-11-23 04:45,10,2,8,0,0,0
2019-11-23 05:00,7,2,5,0,0,0
2019-11-23 05:15,1,1,0,0,0,0
2019-11-23 05:30,10,8,2,0,0,0
2019-11-23 05:45,7,6,1,0,0,0
2019-11-23 06:00,6,5,1,0,0,0
2019-11-23 06:15,8,5,3,0,0,0
2019-11-23 06:30,8,3,5,0,0,0
2019-11-23 06:45,10,7,3,0,0,0
2019-11-23 07:00,10,8,2,0,0,0
2019-11-23 07:15,21,16,5,0,0,0
2019-11-23 07:30,10,4,6,0,0,0
2019-11-23 07:45,34,20,14,0,0,0
2019-11-23 08:00,25,15,10,0,0,0
2019-11-23 08:15,38,22,16,0,0,0
2019-11-23 08:30,36,24,12,0,0,0
2019-11-23 08:45,60,37,23,0,0,0
2019-11-23 09:00,52,33,19,0,0,0
2019-11-23 09:15,58,43,15,0,0,0
2019-11-23 09:30,78,52,26,0,0,0
2019-11-23 09:45,133,96,37,0,0,0
2019-11-23 10:00,96,75,21,0,0,0
2019-11-23 10:15,97,71,26,0,0,0
2019-11-23 10:30,145,100,45,0,0,0
2019-11-23 10:45,148,95,53,0,0,0
2019-11-23 11:00,156,89,67,0,0,0
2019-11-23 11:15,132,84,48,0,0,0
2019-11-23 11:30,148,91,57,0,0,0
2019-11-23 11:45,172,110,62,0,0,0
2019-11-23 12:00,183,113,70,0,0,0
2019-11-23 12:15,167,75,92,0,0,0
2019-11-23 12:30,172,89,83,0,0,0
2019-11-23 12:45,165,73,92,0,0,0
2019-11-23 13:00,187,90,97,0,0,0
2019-11-23 13:15,137,68,69,0,0,0
2019-11-23 13:30,164,77,87,0,0,0
2019-11-23 13:45,150,83,67,0,0,0
2019-11-23 14:00,134,66,68,0,0,0
2019-11-23 14:15,149,59,90,0,0,0
2019-11-23 14:30,162,56,106,0,0,0
2019-11-23 14:45,148,56,92,0,0,0
2019-11-23 15:00,161,67,94,0,0,0
2019-11-23 15:15,138,66,72,0,0,0
2019-11-23 15:30,172,62,110,0,0,0
2019-11-23 15:45,151,63,88,0,0,0
2019-11-23 16:00,111,52,59,0,0,0
2019-11-23 16:15,130,56,74,0,0,0
2019-11-23 16:30,137,48,89,0,0,0
2019-11-23 16:45,114,51,63,0,0,0
2019-11-23 17:00,100,35,65,0,0,0
2019-11-23 17:15,108,32,76,0,0,0
2019-11-23 17:30,124,39,85,0,0,0
2019-11-23 17:45,123,39,84,0,0,0
2019-11-23 18:00,111,42,69,0,0,0
2019-11-23 18:15,111,36,75,0,0,0
2019-11-23 18:30,72,23,49,0,0,0
2019-11-23 18:45,76,29,47,0,0,0
2019-11-23 19:00,85,34,51,0,0,0
2019-11-23 19:15,73,31,42,0,0,0
2019-11-23 19:30,77,29,48,0,0,0
2019-11-23 19:45,64,32,32,0,0,0
2019-11-23 20:00,95,43,52,0,0,0
2019-11-23 20:15,75,36,39,0,0,0
2019-11-23 20:30,43,15,28,0,0,0
2019-11-23 20:45,65,33,32,0,0,0
2019-11-23 21:00,77,30,47,0,0,0
2019-11-23 21:15,55,17,38,0,0,0
2019-11-23 21:30,39,14,25,0,0,0
2019-11-23 21:45,28,15,13,0,0,0
2019-11-23 22:00,29,9,20,0,0,0
2019-11-23 22:15,40,13,27,0,0,0
2019-11-23 22:30,50,21,29,0,0,0
2019-11-23 22:45,41,18,23,0,0,0
2019-11-23 23:00,43,16,27,0,0,0
2019-11-23 23:15,37,10,27,0,0,0
2019-11-23 23:30,35,7,28,0,0,0
2019-11-23 23:45,31,14,17,0,0,0
2019-11-24 00:00,41,15,26,0,0,0
2019-11-24 00:15,38,14,24,0,0,0
2019-11-24 00:30,23,7,16,0,0,0
2019-11-24 00:45,43,15,28,0,0,0
2019-11-24 01:00,25,6,19,0,0,0
2019-11-24 01:15,32,12,20,0,0,0
2019-11-24 01:30,27,8,19,0,0,0
2019-11-24 01:45,25,15,10,0,0,0
2019-11-24 02:00,19,10,9,0,0,0
2019-11-24 02:15,10,3,7,0,0,0
2019-11-24 02:30,10,1,9,0,0,0
2019-11-24 02:45,12,3,9,0,0,0
2019-11-24 03:00,11,1,10,0,0,0
2019-11-24 03:15,13,1,12,0,0,0
2019-11-24 03:30,11,3,8,0,0,0
2019-11-24 03:45,13,5,8,0,0,0
2019-11-24 04:00,14,1,13,0,0,0
2019-11-24 04:15,9,0,9,0,0,0
2019-11-24 04:30,8,3,5,0,0,0
2019-11-24 04:45,1,0,1,0,0,0
2019-11-24 05:00,1,0,1,0,0,0
2019-11-24 05:15,3,0,3,0,0,0
2019-11-24 05:30,8,6,2,0,0,0
2019-11-24 05:45,4,3,1,0,0,0
2019-11-24 06:00,7,4,3,0,0,0
2019-11-24 06:15,2,0,2,0,0,0
2019-11-24 06:30,4,0,4,0,0,0
2019-11-24 06:45,2,1,1,0,0,0
2019-11-24 07:00,1,0,1,0,0,0
2019-11-24 07:15,3,2,1,0,0,0
2019-11-24 07:30,6,5,1,0,0,0
2019-11-24 07:45,5,3,2,0,0,0
2019-11-24 08:00,8,3,5,0,0,0
2019-11-24 08:15,6,4,2,0,0,0
2019-11-24 08:30,8,4,4,0,0,0
2019-11-24 08:45,11,6,5,0,0,0
2019-11-24 09:00,15,11,4,0,0,0
2019-11-24 09:15,27,17,10,0,0,0
2019-11-24 09:30,21,10,11,0,0,0
2019-11-24 09:45,56,34,22,0,0,0
2019-11-24 10:00,45,28,17,0,0,0
2019-11-24 10:15,45,37,8,0,0,0
2019-11-24 10:30,33,22,11,0,0,0
2019-11-24 10:45,27,12,15,0,0,0
2019-11-24 11:00,37,18,19,0,0,0
2019-11-24 11:15,41,19,22,0,0,0
2019-11-24 11:30,37,22,15,0,0,0
2019-11-24 11:45,61,28,33,0,0,0
2019-11-24 12:00,48,23,25,0,0,0
2019-11-24 12:15,44,20,24,0,0,0
2019-11-24 12:30,48,25,23,0,0,0
2019-11-24 12:45,56,37,19,0,0,0
2019-11-24 13:00,49,16,33,0,0,0
2019-11-24 13:15,54,24,30,0,0,0
2019-11-24 13:30,64,28,36,0,0,0
2019-11-24 13:45,77,43,34,0,0,0
2019-11-24 14:00,78,44,34,0,0,0
2019-11-24 14:15,89,46,43,0,0,0
2019-11-24 14:30,72,29,43,0,0,0
2019-11-24 14:45,99,41,58,0,0,0
2019-11-24 15:00,87,43,44,0,0,0
2019-11-24 15:15,58,40,18,0,0,0
2019-11-24 15:30,76,39,37,0,0,0
2019-11-24 15:45,74,30,44,0,0,0
2019-11-24 16:00,67,26,41,0,0,0
2019-11-24 16:15,81,44,37,0,0,0
2019-11-24 16:30,85,41,44,0,0,0
2019-11-24 16:45,70,30,40,0,0,0
2019-11-24 17:00,81,45,36,0,0,0
2019-11-24 17:15,63,16,47,0,0,0
2019-11-24 17:30,59,20,39,0,0,0
2019-11-24 17:45,65,34,31,0,0,0
2019-11-24 18:00,79,32,47,0,0,0
2019-11-24 18:15,44,19,25,0,0,0
2019-11-24 18:30,66,29,37,0,0,0
2019-11-24 18:45,37,15,22,0,0,0
2019-11-24 19:00,52,20,32,0,0,0
2019-11-24 19:15,38,18,20,0,0,0
2019-11-24 19:30,31,8,23,0,0,0
2019-11-24 19:45,44,19,25,0,0,0
2019-11-24 20:00,35,13,22,0,0,0
2019-11-24 20:15,45,21,24,0,0,0
2019-11-24 20:30,34,16,18,0,0,0
2019-11-24 20:45,23,9,14,0,0,0
2019-11-24 21:00,19,13,6,0,0,0
2019-11-24 21:15,33,11,22,0,0,0
2019-11-24 21:30,28,8,20,0,0,0
2019-11-24 21:45,20,7,13,0,0,0
2019-11-24 22:00,24,8,16,0,0,0
2019-11-24 22:15,22,11,11,0,0,0
2019-11-24 22:30,20,5,15,0,0,0
2019-11-24 22:45,13,4,9,0,0,0
2019-11-24 23:00,11,1,10,0,0,0
2019-11-24 23:15,9,6,3,0,0,0
2019-11-24 23:30,6,0,6,0,0,0
2019-11-24 23:45,11,4,7,0,0,0
2019-11-25 00:00,11,2,9,0,0,0
2019-11-25 00:15,7,3,4,0,0,0
2019-11-25 00:30,5,1,4,0,0,0
2019-11-25 00:45,3,0,3,0,0,0
2019-11-25 01:00,3,1,2,0,0,0
2019-11-25 01:15,1,1,0,0,0,0
2019-11-25 01:30,1,0,1,0,0,0
2019-11-25 01:45,3,0,3,0,0,0
2019-11-25 02:00,1,1,0,0,0,0
2019-11-25 02:15,0,0,0,0,0,0
2019-11-25 02:30,4,0,4,0,0,0
2019-11-25 02:45,1,1,0,0,0,0
2019-11-25 03:00,2,1,1,0,0,0
2019-11-25 03:15,0,0,0,0,0,0
2019-11-25 03:30,0,0,0,0,0,0
2019-11-25 03:45,2,2,0,0,0,0
2019-11-25 04:00,1,0,1,0,0,0
2019-11-25 04:15,2,2,0,0,0,0
2019-11-25 04:30,0,0,0,0,0,0
2019-11-25 04:45,3,3,0,0,0,0
2019-11-25 05:00,4,3,1,0,0,0
2019-11-25 05:15,6,4,2,0,0,0
2019-11-25 05:30,8,6,2,0,0,0
2019-11-25 05:45,14,11,3,0,0,0
2019-11-25 06:00,23,17,6,0,0,0
2019-11-25 06:15,37,29,8,0,0,0
2019-11-25 06:30,45,30,15,0,0,0
2019-11-25 06:45,60,49,11,0,0,0
2019-11-25 07:00,70,45,25,0,0,0
2019-11-25 07:15,119,81,38,0,0,0
2019-11-25 07:30,158,102,56,0,0,0
2019-11-25 07:45,164,108,56,0,0,0
2019-11-25 08:00,130,90,40,0,0,0
2019-11-25 08:15,162,115,47,0,0,0
2019-11-25 08:30,149,96,53,0,0,0
2019-11-25 08:45,143,100,43,0,0,0
2019-11-25 09:00,99,73,26,0,0,0
2019-11-25 09:15,98,65,33,0,0,0
2019-11-25 09:30,100,71,29,0,0,0
2019-11-25 09:45,152,113,39,0,0,0
2019-11-25 10:00,124,78,46,0,0,0
2019-11-25 10:15,98,62,36,0,0,0
2019-11-25 10:30,91,56,35,0,0,0
2019-11-25 10:45,106,66,40,0,0,0
2019-11-25 11:00,82,40,42,0,0,0
2019-11-25 11:15,104,60,44,0,0,0
2019-11-25 11:30,124,57,67,0,0,0
2019-11-25 11:45,154,77,77,0,0,0
2019-11-25 12:00,122,48,74,0,0,0
2019-11-25 12:15,116,47,69,0,0,0
2019-11-25 12:30,124,51,73,0,0,0
2019-11-25 12:45,116,51,65,0,0,0
2019-11-25 13:00,125,47,78,0,0,0
2019-11-25 13:15,137,57,80,0,0,0
2019-11-25 13:30,130,52,78,0,0,0
2019-11-25 13:45,160,79,81,0,0,0
2019-11-25 14:00,174,61,113,0,0,0
2019-11-25 14:15,120,52,68,0,0,0
2019-11-25 14:30,160,70,90,0,0,0
2019-11-25 14:45,144,73,71,0,0,0
2019-11-25 15:00,121,42,79,0,0,0
2019-11-25 15:15,149,53,96,0,0,0
2019-11-25 15:30,195,73,122,0,0,0
2019-11-25 15:45,226,95,131,0,0,0
2019-11-25 16:00,176,71,105,0,0,0
2019-11-25 16:15,195,79,116,0,0,0
2019-11-25 16:30,198,72,126,0,0,0
2019-11-25 16:45,203,94,109,0,0,0
2019-11-25 17:00,228,90,138,0,0,0
2019-11-25 17:15,200,64,136,0,0,0
2019-11-25 17:30,212,71,141,0,0,0
2019-11-25 17:45,243,93,150,0,0,0
2019-11-25 18:00,213,80,133,0,0,0
2019-11-25 18:15,209,89,120,0,0,0
2019-11-25 18:30,160,62,98,0,0,0
2019-11-25 18:45,162,58,104,0,0,0
2019-11-25 19:00,160,43,117,0,0,0
2019-11-25 19:15,156,64,92,0,0,0
2019-11-25 19:30,142,32,110,0,0,0
2019-11-25 19:45,129,36,93,0,0,0
2019-11-25 20:00,117,25,92,0,0,0
2019-11-25 20:15,98,27,71,0,0,0
2019-11-25 20:30,87,13,74,0,0,0
2019-11-25 20:45,68,21,47,0,0,0
2019-11-25 21:00,50,15,35,0,0,0
2019-11-25 21:15,66,11,55,0,0,0
2019-11-25 21:30,56,18,38,0,0,0
2019-11-25 21:45,62,16,46,0,0,0
2019-11-25 22:00,44,11,33,0,0,0
2019-11-25 22:15,63,19,44,0,0,0
2019-11-25 22:30,44,8,36,0,0,0
2019-11-25 22:45,42,17,25,0,0,0
2019-11-25 23:00,36,7,29,0,0,0
2019-11-25 23:15,24,7,17,0,0,0
2019-11-25 23:30,18,7,11,0,0,0
2019-11-25 23:45,12,2,10,0,0,0
2019-11-26 00:00,19,4,15,0,0,0
2019-11-26 00:15,8,3,5,0,0,0
2019-11-26 00:30,3,1,2,0,0,0
2019-11-26 00:45,10,2,8,0,0,0
2019-11-26 01:00,5,2,3,0,0,0
2019-11-26 01:15,9,5,4,0,0,0
2019-11-26 01:30,2,1,1,0,0,0
2019-11-26 01:45,2,1,1,0,0,0
2019-11-26 02:00,1,0,1,0,0,0
2019-11-26 02:15,0,0,0,0,0,0
2019-11-26 02:30,2,1,1,0,0,0
2019-11-26 02:45,0,0,0,0,0,0
2019-11-26 03:00,0,0,0,0,0,0
2019-11-26 03:15,0,0,0,0,0,0
2019-11-26 03:30,1,0,1,0,0,0
2019-11-26 03:45,1,0,1,0,0,0
2019-11-26 04:00,0,0,0,0,0,0
2019-11-26 04:15,2,1,1,0,0,0
2019-11-26 04:30,1,1,0,0,0,0
2019-11-26 04:45,4,4,0,0,0,0
2019-11-26 05:00,4,3,1,0,0,0
2019-11-26 05:15,4,4,0,0,0,0
2019-11-26 05:30,13,9,4,0,0,0
2019-11-26 05:45,17,15,2,0,0,0
2019-11-26 06:00,28,22,6,0,0,0
2019-11-26 06:15,42,31,11,0,0,0
2019-11-26 06:30,44,26,18,0,0,0
2019-11-26 06:45,52,42,10,0,0,0
2019-11-26 07:00,84,52,32,0,0,0
2019-11-26 07:15,112,83,29,0,0,0
2019-11-26 07:30,176,113,63,0,0,0
2019-11-26 07:45,198,132,66,0,0,0
2019-11-26 08:00,145,108,37,0,0,0
2019-11-26 08:15,151,101,50,0,0,0
2019-11-26 08:30,116,79,37,0,0,0
2019-11-26 08:45,156,112,44,0,0,0
2019-11-26 09:00,110,72,38,0,0,0
2019-11-26 09:15,92,62,30,0,0,0
2019-11-26 09:30,114,77,37,0,0,0
2019-11-26 09:45,138,94,44,0,0,0
2019-11-26 10:00,131,88,43,0,0,0
2019-11-26 10:15,87,46,41,0,0,0
2019-11-26 10:30,97,54,43,0,0,0
2019-11-26 10:45,113,70,43,0,0,0
2019-11-26 11:00,97,43,54,0,0,0
2019-11-26 11:15,120,62,58,0,0,0
2019-11-26 11:30,114,59,55,0,0,0
2019-11-26 11:45,148,77,71,0,0,0
2019-11-26 12:00,135,70,65,0,0,0
2019-11-26 12:15,125,48,77,0,0,0
2019-11-26 12:30,144,52,92,0,0,0
2019-11-26 12:45,130,49,81,0,0,0
2019-11-26 13:00,123,49,74,0,0,0
2019-11-26 13:15,136,37,99,0,0,0
2019-11-26 13:30,129,54,75,0,0,0
2019-11-26 13:45,171,77,94,0,0,0
2019-11-26 14:00,164,78,86,0,0,0
2019-11-26 14:15,137,55,82,0,0,0
2019-11-26 14:30,149,58,91,0,0,0
2019-11-26 14:45,166,80,86,0,0,0
2019-11-26 15:00,157,73,84,0,0,0
2019-11-26 15:15,169,65,104,0,0,0
2019-11-26 15:30,186,68,118,0,0,0
2019-11-26 15:45,176,73,103,0,0,0
2019-11-26 16:00,203,79,124,0,0,0
2019-11-26 16:15,202,80,122,0,0,0
2019-11-26 16:30,209,82,127,0,0,0
2019-11-26 16:45,218,87,131,0,0,0
2019-11-26 17:00,201,82,119,0,0,0
2019-11-26 17:15,204,94,110,0,0,0
2019-11-26 17:30,208,93,115,0,0,0
2019-11-26 17:45,208,80,128,0,0,0
2019-11-26 18:00,225,92,133,0,0,0
2019-11-26 18:15,186,81,105,0,0,0
2019-11-26 18:30,174,78,96,0,0,0
2019-11-26 18:45,178,82,96,0,0,0
2019-11-26 19:00,144,61,83,0,0,0
2019-11-26 19:15,143,58,85,0,0,0
2019-11-26 19:30,122,39,83,0,0,0
2019-11-26 19:45,140,37,103,0,0,0
2019-11-26 20:00,128,22,106,0,0,0
2019-11-26 20:15,72,14,58,0,0,0
2019-11-26 20:30,90,25,65,0,0,0
2019-11-26 20:45,62,17,45,0,0,0
2019-11-26 21:00,63,21,42,0,0,0
2019-11-26 21:15,60,14,46,0,0,0
2019-11-26 21:30,57,14,43,0,0,0
2019-11-26 21:45,93,24,69,0,0,0
2019-11-26 22:00,81,12,69,0,0,0
2019-11-26 22:15,56,18,38,0,0,0
2019-11-26 22:30,72,14,58,0,0,0
2019-11-26 22:45,41,8,33,0,0,0
2019-11-26 23:00,62,26,36,0,0,0
2019-11-26 23:15,29,13,16,0,0,0
2019-11-26 23:30,21,3,18,0,0,0
2019-11-26 23:45,20,8,12,0,0,0
2019-11-27 00:00,22,12,10,0,0,0
2019-11-27 00:15,18,3,15,0,0,0
2019-11-27 00:30,4,0,4,0,0,0
2019-11-27 00:45,1,0,1,0,0,0
2019-11-27 01:00,5,0,5,0,0,0
2019-11-27 01:15,4,2,2,0,0,0
2019-11-27 01:30,3,0,3,0,0,0
2019-11-27 01:45,6,1,5,0,0,0
2019-11-27 02:00,2,1,1,0,0,0
2019-11-27 02:15,0,0,0,0,0,0
2019-11-27 02:30,1,0,1,0,0,0
2019-11-27 02:45,2,2,0,0,0,0
2019-11-27 03:00,0,0,0,0,0,0
2019-11-27 03:15,1,1,0,0,0,0
2019-11-27 03:30,0,0,0,0,0,0
2019-11-27 03:45,2,0,2,0,0,0
2019-11-27 04:00,2,0,2,0,0,0
2019-11-27 04:15,4,4,0,0,0,0
2019-11-27 04:30,1,1,0,0,0,0
2019-11-27 04:45,6,4,2,0,0,0
2019-11-27 05:00,4,4,0,0,0,0
2019-11-27 05:15,7,5,2,0,0,0
2019-11-27 05:30,11,7,4,0,0,0
2019-11-27 05:45,21,18,3,0,0,0
2019-11-27 06:00,24,18,6,0,0,0
2019-11-27 06:15,40,36,4,0,0,0
2019-11-27 06:30,43,28,15,0,0,0
2019-11-27 06:45,74,54,20,0,0,0
2019-11-27 07:00,77,55,22,0,0,0
2019-11-27 07:15,113,79,34,0,0,0
2019-11-27 07:30,153,102,51,0,0,0
2019-11-27 07:45,181,128,53,0,0,0
2019-11-27 08:00,176,120,56,0,0,0
2019-11-27 08:15,192,140,52,0,0,0
2019-11-27 08:30,126,93,33,0,0,0
2019-11-27 08:45,154,105,49,0,0,0
2019-11-27 09:00,96,76,20,0,0,0
2019-11-27 09:15,86,63,23,0,0,0
2019-11-27 09:30,126,85,41,0,0,0
2019-11-27 09:45,106,71,35,0,0,0
2019-11-27 10:00,112,87,25,0,0,0
2019-11-27 10:15,98,62,36,0,0,0
2019-11-27 10:30,99,68,31,0,0,0
2019-11-27 10:45,117,68,49,0,0,0
2019-11-27 11:00,134,82,52,0,0,0
2019-11-27 11:15,117,67,50,0,0,0
2019-11-27 11:30,112,63,49,0,0,0
2019-11-27 11:45,143,92,51,0,0,0
2019-11-27 12:00,154,74,80,0,0,0
2019-11-27 12:15,175,83,92,0,0,0
2019-11-27 12:30,138,72,66,0,0,0
2019-11-27 12:45,144,60,84,0,0,0
2019-11-27 13:00,136,51,85,0,0,0
2019-11-27 13:15,150,59,91,0,0,0
2019-11-27 13:30,147,58,89,0,0,0
2019-11-27 13:45,147,65,82,0,0,0
2019-11-27 14:00,185,59,126,0,0,0
2019-11-27 14:15,154,52,102,0,0,0
2019-11-27 14:30,142,55,87,0,0,0
2019-11-27 14:45,124,51,73,0,0,0
2019-11-27 15:00,146,54,92,0,0,0
2019-11-27 15:15,141,56,85,0,0,0
2019-11-27 15:30,142,59,83,0,0,0
2019-11-27 15:45,146,51,95,0,0,0
2019-11-27 16:00,143,61,82,0,0,0
2019-11-27 16:15,155,49,106,0,0,0
2019-11-27 16:30,160,61,99,0,0,0
2019-11-27 16:45,177,69,108,0,0,0
2019-11-27 17:00,162,59,103,0,0,0
2019-11-27 17:15,180,67,113,0,0,0
2019-11-27 17:30,156,50,106,0,0,0
2019-11-27 17:45,218,87,131,0,0,0
2019-11-27 18:00,192,64,128,0,0,0
2019-11-27 18:15,138,59,79,0,0,0
2019-11-27 18:30,132,54,78,0,0,0
2019-11-27 18:45,97,35,62,0,0,0
2019-11-27 19:00,112,40,72,0,0,0
2019-11-27 19:15,120,44,76,0,0,0
2019-11-27 19:30,94,21,73,0,0,0
2019-11-27 19:45,109,32,77,0,0,0
2019-11-27 20:00,130,39,91,0,0,0
2019-11-27 20:15,84,38,46,0,0,0
2019-11-27 20:30,92,38,54,0,0,0
2019-11-27 20:45,67,20,47,0,0,0
2019-11-27 21:00,59,21,38,0,0,0
2019-11-27 21:15,40,12,28,0,0,0
2019-11-27 21:30,64,15,49,0,0,0
2019-11-27 21:45,56,15,41,0,0,0
2019-11-27 22:00,60,11,49,0,0,0
2019-11-27 22:15,48,13,35,0,0,0
2019-11-27 22:30,34,6,28,0,0,0
2019-11-27 22:45,34,8,26,0,0,0
2019-11-27 23:00,52,17,35,0,0,0
2019-11-27 23:15,43,11,32,0,0,0
2019-11-27 23:30,31,10,21,0,0,0
2019-11-27 23:45,23,3,20,0,0,0
2019-11-28 00:00,15,7,8,0,0,0
2019-11-28 00:15,20,6,14,0,0,0
2019-11-28 00:30,15,3,12,0,0,0
2019-11-28 00:45,8,1,7,0,0,0
2019-11-28 01:00,13,1,12,0,0,0
2019-11-28 01:15,8,2,6,0,0,0
2019-11-28 01:30,6,0,6,0,0,0
2019-11-28 01:45,5,2,3,0,0,0
2019-11-28 02:00,5,2,3,0,0,0
2019-11-28 02:15,2,2,0,0,0,0
2019-11-28 02:30,2,1,1,0,0,0
2019-11-28 02:45,7,0,7,0,0,0
2019-11-28 03:00,0,0,0,0,0,0
2019-11-28 03:15,1,0,1,0,0,0
2019-11-28 03:30,2,0,2,0,0,0
2019-11-28 03:45,7,1,6,0,0,0
2019-11-28 04:00,5,1,4,0,0,0
2019-11-28 04:15,1,0,1,0,0,0
2019-11-28 04:30,5,2,3,0,0,0
2019-11-28 04:45,6,4,2,0,0,0
2019-11-28 05:00,3,3,0,0,0,0
2019-11-28 05:15,4,2,2,0,0,0
2019-11-28 05:30,12,7,5,0,0,0
2019-11-28 05:45,17,14,3,0,0,0
2019-11-28 06:00,24,16,8,0,0,0
2019-11-28 06:15,44,35,9,0,0,0
2019-11-28 06:30,32,22,10,0,0,0
2019-11-28 06:45,53,37,16,0,0,0
2019-11-28 07:00,59,40,19,0,0,0
2019-11-28 07:15,110,72,38,0,0,0
2019-11-28 07:30,128,86,42,0,0,0
2019-11-28 07:45,178,110,68,0,0,0
2019-11-28 08:00,130,95,35,0,0,0
2019-11-28 08:15,158,96,62,0,0,0
2019-11-28 08:30,130,82,48,0,0,0
2019-11-28 08:45,126,89,37,0,0,0
2019-11-28 09:00,80,64,16,0,0,0
2019-11-28 09:15,80,41,39,0,0,0
2019-11-28 09:30,90,65,25,0,0,0
2019-11-28 09:45,121,87,34,0,0,0
2019-11-28 10:00,96,73,23,0,0,0
2019-11-28 10:15,78,46,32,0,0,0
2019-11-28 10:30,77,48,29,0,0,0
2019-11-28 10:45,91,57,34,0,0,0
2019-11-28 11:00,85,39,46,0,0,0
2019-11-28 11:15,66,35,31,0,0,0
2019-11-28 11:30,76,36,40,0,0,0
2019-11-28 11:45,110,51,59,0,0,0
2019-11-28 12:00,91,36,55,0,0,0
2019-11-28 12:15,73,25,48,0,0,0
2019-11-28 12:30,108,33,75,0,0,0
2019-11-28 12:45,84,27,57,0,0,0
2019-11-28 13:00,74,22,52,0,0,0
2019-11-28 13:15,108,42,66,0,0,0
2019-11-28 13:30,77,36,41,0,0,0
2019-11-28 13:45,123,51,72,0,0,0
2019-11-28 14:00,128,47,81,0,0,0
2019-11-28 14:15,90,34,56,0,0,0
2019-11-28 14:30,96,48,48,0,0,0
2019-11-28 14:45,134,62,72,0,0,0
2019-11-28 15:00,122,44,78,0,0,0
2019-11-28 15:15,132,39,93,0,0,0
2019-11-28 15:30,136,46,90,0,0,0
2019-11-28 15:45,150,62,88,0,0,0
2019-11-28 16:00,135,37,98,0,0,0
2019-11-28 16:15,148,48,100,0,0,0
2019-11-28 16:30,141,57,84,0,0,0
2019-11-28 16:45,148,63,85,0,0,0
2019-11-28 17:00,128,46,82,0,0,0
2019-11-28 17:15,162,50,112,0,0,0
2019-11-28 17:30,155,55,100,0,0,0
2019-11-28 17:45,163,68,95,0,0,0
2019-11-28 18:00,151,60,91,0,0,0
2019-11-28 18:15,159,49,110,0,0,0
2019-11-28 18:30,157,51,106,0,0,0
2019-11-28 18:45,149,60,89,0,0,0
2019-11-28 19:00,107,39,68,0,0,0
2019-11-28 19:15,117,46,71,0,0,0
2019-11-28 19:30,101,26,75,0,0,0
2019-11-28 19:45,115,42,73,0,0,0
2019-11-28 20:00,89,29,60,0,0,0
2019-11-28 20:15,94,21,73,0,0,0
2019-11-28 20:30,50,12,38,0,0,0
2019-11-28 20:45,49,9,40,0,0,0
2019-11-28 21:00,61,12,49,0,0,0
2019-11-28 21:15,50,10,40,0,0,0
2019-11-28 21:30,61,14,47,0,0,0
2019-11-28 21:45,63,13,50,0,0,0
2019-11-28 22:00,62,17,45,0,0,0
2019-11-28 22:15,72,25,47,0,0,0
2019-11-28 22:30,73,26,47,0,0,0
2019-11-28 22:45,35,13,22,0,0,0
2019-11-28 23:00,28,5,23,0,0,0
2019-11-28 23:15,32,11,21,0,0,0
2019-11-28 23:30,30,8,22,0,0,0
2019-11-28 23:45,29,11,18,0,0,0
2019-11-29 00:00,19,8,11,0,0,0
2019-11-29 00:15,13,6,7,0,0,0
2019-11-29 00:30,21,5,16,0,0,0
2019-11-29 00:45,12,3,9,0,0,0
2019-11-29 01:00,16,2,14,0,0,0
2019-11-29 01:15,11,4,7,0,0,0
2019-11-29 01:30,4,2,2,0,0,0
2019-11-29 01:45,6,0,6,0,0,0
2019-11-29 02:00,8,2,6,0,0,0
2019-11-29 02:15,5,3,2,0,0,0
2019-11-29 02:30,9,1,8,0,0,0
2019-11-29 02:45,6,6,0,0,0,0
2019-11-29 03:00,7,4,3,0,0,0
2019-11-29 03:15,1,0,1,0,0,0
2019-11-29 03:30,1,0,1,0,0,0
2019-11-29 03:45,3,2,1,0,0,0
2019-11-29 04:00,1,0,1,0,0,0
2019-11-29 04:15,2,2,0,0,0,0
2019-11-29 04:30,2,1,1,0,0,0
2019-11-29 04:45,7,5,2,0,0,0
2019-11-29 05:00,5,4,1,0,0,0
2019-11-29 05:15,7,3,4,0,0,0
2019-11-29 05:30,13,8,5,0,0,0
2019-11-29 05:45,23,17,6,0,0,0
2019-11-29 06:00,23,17,6,0,0,0
2019-11-29 06:15,34,27,7,0,0,0
2019-11-29 06:30,40,23,17,0,0,0
2019-11-29 06:45,61,44,17,0,0,0
2019-11-29 07:00,62,41,21,0,0,0
2019-11-29 07:15,96,62,34,0,0,0
2019-11-29 07:30,157,104,53,0,0,0
2019-11-29 07:45,178,124,54,0,0,0
2019-11-29 08:00,120,88,32,0,0,0
2019-11-29 08:15,134,93,41,0,0,0
2019-11-29 08:30,114,84,30,0,0,0
2019-11-29 08:45,173,117,56,0,0,0
2019-11-29 09:00,104,70,34,0,0,0
2019-11-29 09:15,110,78,32,0,0,0
2019-11-29 09:30,89,57,32,0,0,0
2019-11-29 09:45,145,115,30,0,0,0
2019-11-29 10:00,138,98,40,0,0,0
2019-11-29 10:15,123,63,60,0,0,0
2019-11-29 10:30,103,70,33,0,0,0
2019-11-29 10:45,146,104,42,0,0,0
2019-11-29 11:00,124,69,55,0,0,0
2019-11-29 11:15,157,95,62,0,0,0
2019-11-29 11:30,166,102,64,0,0,0
2019-11-29 11:45,188,115,73,0,0,0
2019-11-29 12:00,131,75,56,0,0,0
2019-11-29 12:15,190,87,103,0,0,0
2019-11-29 12:30,202,92,110,0,0,0
2019-11-29 12:45,203,86,117,0,0,0
2019-11-29 13:00,189,82,107,0,0,0
2019-11-29 13:15,176,63,113,0,0,0
2019-11-29 13:30,193,67,126,0,0,0
2019-11-29 13:45,212,104,108,0,0,0
2019-11-29 14:00,190,86,104,0,0,0
2019-11-29 14:15,221,75,146,0,0,0
2019-11-29 14:30,217,97,120,0,0,0
2019-11-29 14:45,213,80,133,0,0,0
2019-11-29 15:00,223,89,134,0,0,0
2019-11-29 15:15,232,105,127,0,0,0
2019-11-29 15:30,191,79,112,0,0,0
2019-11-29 15:45,205,88,117,0,0,0
2019-11-29 16:00,227,105,122,0,0,0
2019-11-29 16:15,207,99,108,0,0,0
2019-11-29 16:30,185,74,111,0,0,0
2019-11-29 16:45,212,82,130,0,0,0
2019-11-29 17:00,185,81,104,0,0,0
2019-11-29 17:15,199,71,128,0,0,0
2019-11-29 17:30,181,70,111,0,0,0
2019-11-29 17:45,209,108,101,0,0,0
2019-11-29 18:00,173,67,106,0,0,0
2019-11-29 18:15,166,67,99,0,0,0
2019-11-29 18:30,123,50,73,0,0,0
2019-11-29 18:45,202,106,96,0,0,0
2019-11-29 19:00,141,66,75,0,0,0
2019-11-29 19:15,147,69,78,0,0,0
2019-11-29 19:30,121,47,74,0,0,0
2019-11-29 19:45,116,43,73,0,0,0
2019-11-29 20:00,113,39,74,0,0,0
2019-11-29 20:15,98,39,59,0,0,0
2019-11-29 20:30,51,14,37,0,0,0
2019-11-29 20:45,95,30,65,0,0,0
2019-11-29 21:00,82,22,60,0,0,0
2019-11-29 21:15,85,8,77,0,0,0
2019-11-29 21:30,77,21,56,0,0,0
2019-11-29 21:45,65,15,50,0,0,0
2019-11-29 22:00,91,17,74,0,0,0
2019-11-29 22:15,84,17,67,0,0,0
2019-11-29 22:30,56,7,49,0,0,0
2019-11-29 22:45,55,15,40,0,0,0
2019-11-29 23:00,48,16,32,0,0,0
2019-11-29 23:15,51,12,39,0,0,0
2019-11-29 23:30,51,11,40,0,0,0
2019-11-29 23:45,65,22,43,0,0,0
2019-11-30 00:00,46,12,34,0,0,0
2019-11-30 00:15,29,11,18,0,0,0
2019-11-30 00:30,45,13,32,0,0,0
2019-11-30 00:45,51,19,32,0,0,0
2019-11-30 01:00,41,16,25,0,0,0
2019-11-30 01:15,32,15,17,0,0,0
2019-11-30 01:30,27,3,24,0,0,0
2019-11-30 01:45,32,7,25,0,0,0
2019-11-30 02:00,17,5,12,0,0,0
2019-11-30 02:15,7,2,5,0,0,0
2019-11-30 02:30,7,4,3,0,0,0
2019-11-30 02:45,27,11,16,0,0,0
2019-11-30 03:00,16,5,11,0,0,0
2019-11-30 03:15,20,7,13,0,0,0
2019-11-30 03:30,10,1,9,0,0,0
2019-11-30 03:45,7,0,7,0,0,0
2019-11-30 04:00,10,3,7,0,0,0
2019-11-30 04:15,9,1,8,0,0,0
2019-11-30 04:30,12,4,8,0,0,0
2019-11-30 04:45,6,0,6,0,0,0
2019-11-30 05:00,7,2,5,0,0,0
2019-11-30 05:15,9,2,7,0,0,0
2019-11-30 05:30,16,7,9,0,0,0
2019-11-30 05:45,8,5,3,0,0,0
2019-11-30 06:00,4,3,1,0,0,0
2019-11-30 06:15,9,7,2,0,0,0
2019-11-30 06:30,2,0,2,0,0,0
2019-11-30 06:45,8,8,0,0,0,0
2019-11-30 07:00,9,6,3,0,0,0
2019-11-30 07:15,18,9,9,0,0,0
2019-11-30 07:30,25,18,7,0,0,0
2019-11-30 07:45,32,18,14,0,0,0
2019-11-30 08:00,25,13,12,0,0,0
2019-11-30 08:15,37,25,12,0,0,0
2019-11-30 08:30,46,33,13,0,0,0
2019-11-30 08:45,70,51,19,0,0,0
2019-11-30 09:00,55,33,22,0,0,0
2019-11-30 09:15,72,52,20,0,0,0
2019-11-30 09:30,82,65,17,0,0,0
2019-11-30 09:45,118,84,34,0,0,0
2019-11-30 10:00,115,78,37,0,0,0
2019-11-30 10:15,147,112,35,0,0,0
2019-11-30 10:30,133,98,35,0,0,0
2019-11-30 10:45,161,103,58,0,0,0
2019-11-30 11:00,148,91,57,0,0,0
2019-11-30 11:15,128,67,61,0,0,0
2019-11-30 11:30,161,93,68,0,0,0
2019-11-30 11:45,160,81,79,0,0,0
2019-11-30 12:00,186,107,79,0,0,0
2019-11-30 12:15,175,83,92,0,0,0
2019-11-30 12:30,194,96,98,0,0,0
2019-11-30 12:45,179,92,87,0,0,0
2019-11-30 13:00,212,86,126,0,0,0
2019-11-30 13:15,202,74,128,0,0,0
2019-11-30 13:30,209,99,110,0,0,0
2019-11-30 13:45,184,87,97,0,0,0
2019-11-30 14:00,164,68,96,0,0,0
2019-11-30 14:15,174,83,91,0,0,0
2019-11-30 14:30,166,77,89,0,0,0
2019-11-30 14:45,156,69,87,0,0,0
2019-11-30 15:00,159,61,98,0,0,0
2019-11-30 15:15,163,53,110,0,0,0
2019-11-30 15:30,132,64,68,0,0,0
2019-11-30 15:45,154,84,70,0,0,0
2019-11-30 16:00,216,125,91,0,0,0
2019-11-30 16:15,148,69,79,0,0,0
2019-11-30 16:30,153,73,80,0,0,0
2019-11-30 16:45,109,58,51,0,0,0
2019-11-30 17:00,108,53,55,0,0,0
2019-11-30 17:15,114,53,61,0,0,0
2019-11-30 17:30,107,57,50,0,0,0
2019-11-30 17:45,135,64,71,0,0,0
2019-11-30 18:00,114,54,60,0,0,0
2019-11-30 18:15,125,43,82,0,0,0
2019-11-30 18:30,86,40,46,0,0,0
2019-11-30 18:45,111,52,59,0,0,0
2019-11-30 19:00,120,54,66,0,0,0
2019-11-30 19:15,109,40,69,0,0,0
2019-11-30 19:30,110,31,79,0,0,0
2019-11-30 19:45,119,50,69,0,0,0
2019-11-30 20:00,70,18,52,0,0,0
2019-11-30 20:15,88,28,60,0,0,0
2019-11-30 20:30,69,23,46,0,0,0
2019-11-30 20:45,61,18,43,0,0,0
2019-11-30 21:00,62,20,42,0,0,0
2019-11-30 21:15,63,15,48,0,0,0
2019-11-30 21:30,38,15,23,0,0,0
2019-11-30 21:45,39,6,33,0,0,0
2019-11-30 22:00,38,9,29,0,0,0
2019-11-30 22:15,57,23,34,0,0,0
2019-11-30 22:30,42,14,28,0,0,0
2019-11-30 22:45,51,20,31,0,0,0
2019-11-30 23:00,27,6,21,0,0,0
2019-11-30 23:15,34,13,21,0,0,0
2019-11-30 23:30,51,21,30,0,0,0
2019-11-30 23:45,41,7,34,0,0,0
