Datetime,100034980 (Hammer Straße),101034980 (Hammer Straße stadteinwärts),102034980 (Hammer Straße stadtauswärts),100034980-status,101034980-status,102034980-status
2020-12-01 00:00,2,1,1,0,0,0
2020-12-01 00:15,3,0,3,0,0,0
2020-12-01 00:30,2,2,0,0,0,0
2020-12-01 00:45,4,4,0,0,0,0
2020-12-01 01:00,1,0,1,0,0,0
2020-12-01 01:15,2,1,1,0,0,0
2020-12-01 01:30,0,0,0,0,0,0
2020-12-01 01:45,2,2,0,0,0,0
2020-12-01 02:00,0,0,0,0,0,0
2020-12-01 02:15,0,0,0,0,0,0
2020-12-01 02:30,0,0,0,0,0,0
2020-12-01 02:45,2,0,2,0,0,0
2020-12-01 03:00,0,0,0,0,0,0
2020-12-01 03:15,0,0,0,0,0,0
2020-12-01 03:30,1,0,1,0,0,0
2020-12-01 03:45,0,0,0,0,0,0
2020-12-01 04:00,1,0,1,0,0,0
2020-12-01 04:15,1,0,1,0,0,0
2020-12-01 04:30,1,1,0,0,0,0
2020-12-01 04:45,6,6,0,0,0,0
2020-12-01 05:00,0,0,0,0,0,0
2020-12-01 05:15,4,2,2,0,0,0
2020-12-01 05:30,17,13,4,0,0,0
2020-12-01 05:45,16,15,1,0,0,0
2020-12-01 06:00,18,11,7,0,0,0
2020-12-01 06:15,33,21,12,0,0,0
2020-12-01 06:30,35,24,11,0,0,0
2020-12-01 06:45,61,40,21,0,0,0
2020-12-01 07:00,76,48,28,0,0,0
2020-12-01 07:15,83,51,32,0,0,0
2020-12-01 07:30,113,69,44,0,0,0
2020-12-01 07:45,162,113,49,0,0,0
2020-12-01 08:00,130,81,49,0,0,0
2020-12-01 08:15,133,98,35,0,0,0
2020-12-01 08:30,103,69,34,0,0,0
2020-12-01 08:45,117,83,34,0,0,0
2020-12-01 09:00,96,68,28,0,0,0
2020-12-01 09:15,54,29,25,0,0,0
2020-12-01 09:30,68,48,20,0,0,0
2020-12-01 09:45,71,44,27,0,0,0
2020-12-01 10:00,93,61,32,0,0,0
2020-12-01 10:15,74,43,31,0,0,0
2020-12-01 10:30,73,37,36,0,0,0
2020-12-01 10:45,76,42,34,0,0,0
2020-12-01 11:00,71,30,41,0,0,0
2020-12-01 11:15,54,24,30,0,0,0
2020-12-01 11:30,70,19,51,0,0,0
2020-12-01 11:45,65,29,36,0,0,0
2020-12-01 12:00,75,28,47,0,0,0
2020-12-01 12:15,88,34,54,0,0,0
2020-12-01 12:30,90,34,56,0,0,0
2020-12-01 12:45,93,42,51,0,0,0
2020-12-01 13:00,82,29,53,0,0,0
2020-12-01 13:15,90,43,47,0,0,0
2020-12-01 13:30,81,34,47,0,0,0
2020-12-01 13:45,107,49,58,0,0,0
2020-12-01 14:00,119,51,68,0,0,0
2020-12-01 14:15,147,58,89,0,0,0
2020-12-01 14:30,114,46,68,0,0,0
2020-12-01 14:45,97,46,51,0,0,0
2020-12-01 15:00,98,37,61,0,0,0
2020-12-01 15:15,117,44,73,0,0,0
2020-12-01 15:30,112,35,77,0,0,0
2020-12-01 15:45,127,36,91,0,0,0
2020-12-01 16:00,127,32,95,0,0,0
2020-12-01 16:15,153,39,114,0,0,0
2020-12-01 16:30,113,41,72,0,0,0
2020-12-01 16:45,121,46,75,0,0,0
2020-12-01 17:00,137,47,90,0,0,0
2020-12-01 17:15,135,39,96,0,0,0
2020-12-01 17:30,121,38,83,0,0,0
2020-12-01 17:45,119,37,82,0,0,0
2020-12-01 18:00,117,29,88,0,0,0
2020-12-01 18:15,77,23,54,0,0,0
2020-12-01 18:30,105,30,75,0,0,0
2020-12-01 18:45,98,33,65,0,0,0
2020-12-01 19:00,84,25,59,0,0,0
2020-12-01 19:15,64,20,44,0,0,0
2020-12-01 19:30,53,13,40,0,0,0
2020-12-01 19:45,55,29,26,0,0,0
2020-12-01 20:00,59,19,40,0,0,0
2020-12-01 20:15,36,11,25,0,0,0
2020-12-01 20:30,27,10,17,0,0,0
2020-12-01 20:45,16,4,12,0,0,0
2020-12-01 21:00,21,8,13,0,0,0
2020-12-01 21:15,22,14,8,0,0,0
2020-12-01 21:30,25,7,18,0,0,0
2020-12-01 21:45,16,5,11,0,0,0
2020-12-01 22:00,19,5,14,0,0,0
2020-12-01 22:15,13,7,6,0,0,0
2020-12-01 22:30,16,5,11,0,0,0
2020-12-01 22:45,14,8,6,0,0,0
2020-12-01 23:00,17,7,10,0,0,0
2020-12-01 23:15,5,1,4,0,0,0
2020-12-01 23:30,6,3,3,0,0,0
2020-12-01 23:45,4,2,2,0,0,0
2020-12-02 00:00,7,6,1,0,0,0
2020-12-02 00:15,4,2,2,0,0,0
2020-12-02 00:30,5,2,3,0,0,0
2020-12-02 00:45,2,0,2,0,0,0
2020-12-02 01:00,3,0,3,0,0,0
2020-12-02 01:15,1,1,0,0,0,0
2020-12-02 01:30,3,2,1,0,0,0
2020-12-02 01:45,3,2,1,0,0,0
2020-12-02 02:00,1,1,0,0,0,0
2020-12-02 02:15,0,0,0,0,0,0
2020-12-02 02:30,2,2,0,0,0,0
2020-12-02 02:45,1,1,0,0,0,0
2020-12-02 03:00,1,0,1,0,0,0
2020-12-02 03:15,1,1,0,0,0,0
2020-12-02 03:30,0,0,0,0,0,0
2020-12-02 03:45,1,1,0,0,0,0
2020-12-02 04:00,1,0,1,0,0,0
2020-12-02 04:15,1,1,0,0,0,0
2020-12-02 04:30,1,1,0,0,0,0
2020-12-02 04:45,3,2,1,0,0,0
2020-12-02 05:00,3,2,1,0,0,0
2020-12-02 05:15,8,5,3,0,0,0
2020-12-02 05:30,19,10,9,0,0,0
2020-12-02 05:45,19,17,2,0,0,0
2020-12-02 06:00,18,13,5,0,0,0
2020-12-02 06:15,35,30,5,0,0,0
2020-12-02 06:30,33,22,11,0,0,0
2020-12-02 06:45,57,43,14,0,0,0
2020-12-02 07:00,59,33,26,0,0,0
2020-12-02 07:15,103,59,44,0,0,0
2020-12-02 07:30,140,95,45,0,0,0
2020-12-02 07:45,175,107,68,0,0,0
2020-12-02 08:00,144,98,46,0,0,0
2020-12-02 08:15,129,84,45,0,0,0
2020-12-02 08:30,152,104,48,0,0,0
2020-12-02 08:45,127,80,47,0,0,0
2020-12-02 09:00,107,71,36,0,0,0
2020-12-02 09:15,79,51,28,0,0,0
2020-12-02 09:30,103,70,33,0,0,0
2020-12-02 09:45,121,67,54,0,0,0
2020-12-02 10:00,91,66,25,0,0,0
2020-12-02 10:15,122,77,45,0,0,0
2020-12-02 10:30,113,60,53,0,0,0
2020-12-02 10:45,129,77,52,0,0,0
2020-12-02 11:00,116,60,56,0,0,0
2020-12-02 11:15,119,54,65,0,0,0
2020-12-02 11:30,133,71,62,0,0,0
2020-12-02 11:45,150,65,85,0,0,0
2020-12-02 12:00,159,59,100,0,0,0
2020-12-02 12:15,156,77,79,0,0,0
2020-12-02 12:30,128,48,80,0,0,0
2020-12-02 12:45,175,85,90,0,0,0
2020-12-02 13:00,138,56,82,0,0,0
2020-12-02 13:15,118,56,62,0,0,0
2020-12-02 13:30,161,53,108,0,0,0
2020-12-02 13:45,151,52,99,0,0,0
2020-12-02 14:00,160,60,100,0,0,0
2020-12-02 14:15,160,73,87,0,0,0
2020-12-02 14:30,124,58,66,0,0,0
2020-12-02 14:45,147,49,98,0,0,0
2020-12-02 15:00,152,55,97,0,0,0
2020-12-02 15:15,170,79,91,0,0,0
2020-12-02 15:30,151,58,93,0,0,0
2020-12-02 15:45,156,54,102,0,0,0
2020-12-02 16:00,176,68,108,0,0,0
2020-12-02 16:15,154,69,85,0,0,0
2020-12-02 16:30,163,60,103,0,0,0
2020-12-02 16:45,170,72,98,0,0,0
2020-12-02 17:00,188,65,123,0,0,0
2020-12-02 17:15,147,50,97,0,0,0
2020-12-02 17:30,138,46,92,0,0,0
2020-12-02 17:45,135,37,98,0,0,0
2020-12-02 18:00,135,41,94,0,0,0
2020-12-02 18:15,117,37,80,0,0,0
2020-12-02 18:30,97,27,70,0,0,0
2020-12-02 18:45,101,36,65,0,0,0
2020-12-02 19:00,84,17,67,0,0,0
2020-12-02 19:15,84,22,62,0,0,0
2020-12-02 19:30,59,19,40,0,0,0
2020-12-02 19:45,48,22,26,0,0,0
2020-12-02 20:00,68,21,47,0,0,0
2020-12-02 20:15,48,12,36,0,0,0
2020-12-02 20:30,28,9,19,0,0,0
2020-12-02 20:45,31,10,21,0,0,0
2020-12-02 21:00,33,12,21,0,0,0
2020-12-02 21:15,35,14,21,0,0,0
2020-12-02 21:30,22,4,18,0,0,0
2020-12-02 21:45,15,2,13,0,0,0
2020-12-02 22:00,22,6,16,0,0,0
2020-12-02 22:15,20,7,13,0,0,0
2020-12-02 22:30,24,7,17,0,0,0
2020-12-02 22:45,15,8,7,0,0,0
2020-12-02 23:00,26,12,14,0,0,0
2020-12-02 23:15,6,4,2,0,0,0
2020-12-02 23:30,13,8,5,0,0,0
2020-12-02 23:45,4,2,2,0,0,0
2020-12-03 00:00,9,5,4,0,0,0
2020-12-03 00:15,11,6,5,0,0,0
2020-12-03 00:30,13,2,11,0,0,0
2020-12-03 00:45,2,2,0,0,0,0
2020-12-03 01:00,6,1,5,0,0,0
2020-12-03 01:15,7,4,3,0,0,0
2020-12-03 01:30,2,0,2,0,0,0
2020-12-03 01:45,6,3,3,0,0,0
2020-12-03 02:00,0,0,0,0,0,0
2020-12-03 02:15,0,0,0,0,0,0
2020-12-03 02:30,1,1,0,0,0,0
2020-12-03 02:45,2,1,1,0,0,0
2020-12-03 03:00,3,2,1,0,0,0
2020-12-03 03:15,0,0,0,0,0,0
2020-12-03 03:30,1,0,1,0,0,0
2020-12-03 03:45,0,0,0,0,0,0
2020-12-03 04:00,2,0,2,0,0,0
2020-12-03 04:15,1,1,0,0,0,0
2020-12-03 04:30,3,2,1,0,0,0
2020-12-03 04:45,4,3,1,0,0,0
2020-12-03 05:00,4,2,2,0,0,0
2020-12-03 05:15,5,3,2,0,0,0
2020-12-03 05:30,16,9,7,0,0,0
2020-12-03 05:45,11,10,1,0,0,0
2020-12-03 06:00,21,16,5,0,0,0
2020-12-03 06:15,31,26,5,0,0,0
2020-12-03 06:30,34,21,13,0,0,0
2020-12-03 06:45,52,32,20,0,0,0
2020-12-03 07:00,66,40,26,0,0,0
2020-12-03 07:15,107,65,42,0,0,0
2020-12-03 07:30,118,71,47,0,0,0
2020-12-03 07:45,174,112,62,0,0,0
2020-12-03 08:00,162,100,62,0,0,0
2020-12-03 08:15,116,72,44,0,0,0
2020-12-03 08:30,102,66,36,0,0,0
2020-12-03 08:45,121,86,35,0,0,0
2020-12-03 09:00,57,36,21,0,0,0
2020-12-03 09:15,87,56,31,0,0,0
2020-12-03 09:30,77,45,32,0,0,0
2020-12-03 09:45,90,62,28,0,0,0
2020-12-03 10:00,74,42,32,0,0,0
2020-12-03 10:15,76,43,33,0,0,0
2020-12-03 10:30,70,41,29,0,0,0
2020-12-03 10:45,101,52,49,0,0,0
2020-12-03 11:00,106,52,54,0,0,0
2020-12-03 11:15,86,44,42,0,0,0
2020-12-03 11:30,68,43,25,0,0,0
2020-12-03 11:45,88,43,45,0,0,0
2020-12-03 12:00,102,39,63,0,0,0
2020-12-03 12:15,81,37,44,0,0,0
2020-12-03 12:30,93,41,52,0,0,0
2020-12-03 12:45,107,52,55,0,0,0
2020-12-03 13:00,163,50,113,0,0,0
2020-12-03 13:15,130,52,78,0,0,0
2020-12-03 13:30,102,50,52,0,0,0
2020-12-03 13:45,110,51,59,0,0,0
2020-12-03 14:00,105,51,54,0,0,0
2020-12-03 14:15,137,61,76,0,0,0
2020-12-03 14:30,132,52,80,0,0,0
2020-12-03 14:45,127,51,76,0,0,0
2020-12-03 15:00,133,44,89,0,0,0
2020-12-03 15:15,167,84,83,0,0,0
2020-12-03 15:30,158,67,91,0,0,0
2020-12-03 15:45,175,81,94,0,0,0
2020-12-03 16:00,195,68,127,0,0,0
2020-12-03 16:15,160,69,91,0,0,0
2020-12-03 16:30,146,57,89,0,0,0
2020-12-03 16:45,164,61,103,0,0,0
2020-12-03 17:00,180,55,125,0,0,0
2020-12-03 17:15,153,52,101,0,0,0
2020-12-03 17:30,162,53,109,0,0,0
2020-12-03 17:45,150,46,104,0,0,0
2020-12-03 18:00,126,33,93,0,0,0
2020-12-03 18:15,113,31,82,0,0,0
2020-12-03 18:30,110,42,68,0,0,0
2020-12-03 18:45,84,31,53,0,0,0
2020-12-03 19:00,85,25,60,0,0,0
2020-12-03 19:15,84,21,63,0,0,0
2020-12-03 19:30,53,10,43,0,0,0
2020-12-03 19:45,55,20,35,0,0,0
2020-12-03 20:00,44,10,34,0,0,0
2020-12-03 20:15,46,12,34,0,0,0
2020-12-03 20:30,37,14,23,0,0,0
2020-12-03 20:45,26,7,19,0,0,0
2020-12-03 21:00,18,9,9,0,0,0
2020-12-03 21:15,36,19,17,0,0,0
2020-12-03 21:30,11,1,10,0,0,0
2020-12-03 21:45,20,8,12,0,0,0
2020-12-03 22:00,16,6,10,0,0,0
2020-12-03 22:15,23,9,14,0,0,0
2020-12-03 22:30,15,5,10,0,0,0
2020-12-03 22:45,18,4,14,0,0,0
2020-12-03 23:00,19,11,8,0,0,0
2020-12-03 23:15,4,0,4,0,0,0
2020-12-03 23:30,14,7,7,0,0,0
2020-12-03 23:45,11,7,4,0,0,0
2020-12-04 00:00,3,2,1,0,0,0
2020-12-04 00:15,8,3,5,0,0,0
2020-12-04 00:30,9,3,6,0,0,0
2020-12-04 00:45,5,1,4,0,0,0
2020-12-04 01:00,3,1,2,0,0,0
2020-12-04 01:15,9,8,1,0,0,0
2020-12-04 01:30,7,4,3,0,0,0
2020-12-04 01:45,6,0,6,0,0,0
2020-12-04 02:00,1,1,0,0,0,0
2020-12-04 02:15,3,2,1,0,0,0
2020-12-04 02:30,2,1,1,0,0,0
2020-12-04 02:45,0,0,0,0,0,0
2020-12-04 03:00,0,0,0,0,0,0
2020-12-04 03:15,0,0,0,0,0,0
2020-12-04 03:30,1,0,1,0,0,0
2020-12-04 03:45,0,0,0,0,0,0
2020-12-04 04:00,0,0,0,0,0,0
2020-12-04 04:15,0,0,0,0,0,0
2020-12-04 04:30,2,1,1,0,0,0
2020-12-04 04:45,4,4,0,0,0,0
2020-12-04 05:00,6,2,4,0,0,0
2020-12-04 05:15,10,5,5,0,0,0
2020-12-04 05:30,12,7,5,0,0,0
2020-12-04 05:45,17,15,2,0,0,0
2020-12-04 06:00,22,16,6,0,0,0
2020-12-04 06:15,29,21,8,0,0,0
2020-12-04 06:30,33,27,6,0,0,0
2020-12-04 06:45,48,33,15,0,0,0
2020-12-04 07:00,58,34,24,0,0,0
2020-12-04 07:15,71,44,27,0,0,0
2020-12-04 07:30,105,69,36,0,0,0
2020-12-04 07:45,161,117,44,0,0,0
2020-12-04 08:00,122,90,32,0,0,0
2020-12-04 08:15,121,88,33,0,0,0
2020-12-04 08:30,105,72,33,0,0,0
2020-12-04 08:45,116,82,34,0,0,0
2020-12-04 09:00,81,49,32,0,0,0
2020-12-04 09:15,85,55,30,0,0,0
2020-12-04 09:30,71,47,24,0,0,0
2020-12-04 09:45,108,65,43,0,0,0
2020-12-04 10:00,100,69,31,0,0,0
2020-12-04 10:15,98,61,37,0,0,0
2020-12-04 10:30,95,64,31,0,0,0
2020-12-04 10:45,107,68,39,0,0,0
2020-12-04 11:00,99,50,49,0,0,0
2020-12-04 11:15,127,64,63,0,0,0
2020-12-04 11:30,111,57,54,0,0,0
2020-12-04 11:45,147,76,71,0,0,0
2020-12-04 12:00,118,46,72,0,0,0
2020-12-04 12:15,164,61,103,0,0,0
2020-12-04 12:30,154,59,95,0,0,0
2020-12-04 12:45,131,62,69,0,0,0
2020-12-04 13:00,160,59,101,0,0,0
2020-12-04 13:15,180,72,108,0,0,0
2020-12-04 13:30,131,51,80,0,0,0
2020-12-04 13:45,186,86,100,0,0,0
2020-12-04 14:00,172,77,95,0,0,0
2020-12-04 14:15,185,72,113,0,0,0
2020-12-04 14:30,187,64,123,0,0,0
2020-12-04 14:45,178,63,115,0,0,0
2020-12-04 15:00,151,66,85,0,0,0
2020-12-04 15:15,163,75,88,0,0,0
2020-12-04 15:30,160,67,93,0,0,0
2020-12-04 15:45,167,68,99,0,0,0
2020-12-04 16:00,170,82,88,0,0,0
2020-12-04 16:15,163,62,101,0,0,0
2020-12-04 16:30,142,49,93,0,0,0
2020-12-04 16:45,158,76,82,0,0,0
2020-12-04 17:00,147,59,88,0,0,0
2020-12-04 17:15,148,47,101,0,0,0
2020-12-04 17:30,125,46,79,0,0,0
2020-12-04 17:45,119,43,76,0,0,0
2020-12-04 18:00,123,38,85,0,0,0
2020-12-04 18:15,117,36,81,0,0,0
2020-12-04 18:30,103,30,73,0,0,0
2020-12-04 18:45,114,40,74,0,0,0
2020-12-04 19:00,110,37,73,0,0,0
2020-12-04 19:15,76,37,39,0,0,0
2020-12-04 19:30,74,17,57,0,0,0
2020-12-04 19:45,71,25,46,0,0,0
2020-12-04 20:00,68,20,48,0,0,0
2020-12-04 20:15,56,25,31,0,0,0
2020-12-04 20:30,35,15,20,0,0,0
2020-12-04 20:45,41,14,27,0,0,0
2020-12-04 21:00,26,9,17,0,0,0
2020-12-04 21:15,28,9,19,0,0,0
2020-12-04 21:30,38,18,20,0,0,0
2020-12-04 21:45,31,16,15,0,0,0
2020-12-04 22:00,15,2,13,0,0,0
2020-12-04 22:15,12,5,7,0,0,0
2020-12-04 22:30,14,7,7,0,0,0
2020-12-04 22:45,11,4,7,0,0,0
2020-12-04 23:00,18,2,16,0,0,0
2020-12-04 23:15,23,8,15,0,0,0
2020-12-04 23:30,18,6,12,0,0,0
2020-12-04 23:45,13,9,4,0,0,0
2020-12-05 00:00,11,4,7,0,0,0
2020-12-05 00:15,21,7,14,0,0,0
2020-12-05 00:30,11,5,6,0,0,0
2020-12-05 00:45,22,6,16,0,0,0
2020-12-05 01:00,12,3,9,0,0,0
2020-12-05 01:15,8,4,4,0,0,0
2020-12-05 01:30,9,5,4,0,0,0
2020-12-05 01:45,8,3,5,0,0,0
2020-12-05 02:00,7,7,0,0,0,0
2020-12-05 02:15,6,2,4,0,0,0
2020-12-05 02:30,6,3,3,0,0,0
2020-12-05 02:45,4,1,3,0,0,0
2020-12-05 03:00,5,4,1,0,0,0
2020-12-05 03:15,4,2,2,0,0,0
2020-12-05 03:30,6,1,5,0,0,0
2020-12-05 03:45,1,0,1,0,0,0
2020-12-05 04:00,1,0,1,0,0,0
2020-12-05 04:15,1,0,1,0,0,0
2020-12-05 04:30,1,1,0,0,0,0
2020-12-05 04:45,3,2,1,0,0,0
2020-12-05 05:00,2,1,1,0,0,0
2020-12-05 05:15,2,1,1,0,0,0
2020-12-05 05:30,5,3,2,0,0,0
2020-12-05 05:45,7,5,2,0,0,0
2020-12-05 06:00,8,4,4,0,0,0
2020-12-05 06:15,5,3,2,0,0,0
2020-12-05 06:30,6,4,2,0,0,0
2020-12-05 06:45,15,9,6,0,0,0
2020-12-05 07:00,11,5,6,0,0,0
2020-12-05 07:15,10,5,5,0,0,0
2020-12-05 07:30,15,7,8,0,0,0
2020-12-05 07:45,25,16,9,0,0,0
2020-12-05 08:00,22,8,14,0,0,0
2020-12-05 08:15,26,18,8,0,0,0
2020-12-05 08:30,24,19,5,0,0,0
2020-12-05 08:45,45,31,14,0,0,0
2020-12-05 09:00,38,23,15,0,0,0
2020-12-05 09:15,62,43,19,0,0,0
2020-12-05 09:30,66,43,23,0,0,0
2020-12-05 09:45,76,54,22,0,0,0
2020-12-05 10:00,78,50,28,0,0,0
2020-12-05 10:15,91,66,25,0,0,0
2020-12-05 10:30,107,73,34,0,0,0
2020-12-05 10:45,121,71,50,0,0,0
2020-12-05 11:00,131,74,57,0,0,0
2020-12-05 11:15,143,83,60,0,0,0
2020-12-05 11:30,144,94,50,0,0,0
2020-12-05 11:45,187,101,86,0,0,0
2020-12-05 12:00,146,74,72,0,0,0
2020-12-05 12:15,173,95,78,0,0,0
2020-12-05 12:30,144,63,81,0,0,0
2020-12-05 12:45,179,78,101,0,0,0
2020-12-05 13:00,143,67,76,0,0,0
2020-12-05 13:15,197,89,108,0,0,0
2020-12-05 13:30,169,65,104,0,0,0
2020-12-05 13:45,180,82,98,0,0,0
2020-12-05 14:00,155,69,86,0,0,0
2020-12-05 14:15,175,77,98,0,0,0
2020-12-05 14:30,142,53,89,0,0,0
2020-12-05 14:45,147,57,90,0,0,0
2020-12-05 15:00,117,42,75,0,0,0
2020-12-05 15:15,166,70,96,0,0,0
2020-12-05 15:30,133,54,79,0,0,0
2020-12-05 15:45,123,49,74,0,0,0
2020-12-05 16:00,112,45,67,0,0,0
2020-12-05 16:15,118,58,60,0,0,0
2020-12-05 16:30,122,50,72,0,0,0
2020-12-05 16:45,108,46,62,0,0,0
2020-12-05 17:00,96,44,52,0,0,0
2020-12-05 17:15,111,38,73,0,0,0
2020-12-05 17:30,116,49,67,0,0,0
2020-12-05 17:45,96,34,62,0,0,0
2020-12-05 18:00,83,35,48,0,0,0
2020-12-05 18:15,134,48,86,0,0,0
2020-12-05 18:30,68,24,44,0,0,0
2020-12-05 18:45,70,35,35,0,0,0
2020-12-05 19:00,65,19,46,0,0,0
2020-12-05 19:15,60,16,44,0,0,0
2020-12-05 19:30,73,23,50,0,0,0
2020-12-05 19:45,70,28,42,0,0,0
2020-12-05 20:00,35,12,23,0,0,0
2020-12-05 20:15,29,10,19,0,0,0
2020-12-05 20:30,32,10,22,0,0,0
2020-12-05 20:45,38,16,22,0,0,0
2020-12-05 21:00,28,11,17,0,0,0
2020-12-05 21:15,19,8,11,0,0,0
2020-12-05 21:30,12,2,10,0,0,0
2020-12-05 21:45,21,5,16,0,0,0
2020-12-05 22:00,15,4,11,0,0,0
2020-12-05 22:15,9,2,7,0,0,0
2020-12-05 22:30,14,7,7,0,0,0
2020-12-05 22:45,14,2,12,0,0,0
2020-12-05 23:00,10,3,7,0,0,0
2020-12-05 23:15,19,9,10,0,0,0
2020-12-05 23:30,19,10,9,0,0,0
2020-12-05 23:45,23,12,11,0,0,0
2020-12-06 00:00,15,7,8,0,0,0
2020-12-06 00:15,19,8,11,0,0,0
2020-12-06 00:30,10,4,6,0,0,0
2020-12-06 00:45,23,7,16,0,0,0
2020-12-06 01:00,17,9,8,0,0,0
2020-12-06 01:15,12,6,6,0,0,0
2020-12-06 01:30,6,2,4,0,0,0
2020-12-06 01:45,12,5,7,0,0,0
2020-12-06 02:00,13,5,8,0,0,0
2020-12-06 02:15,2,1,1,0,0,0
2020-12-06 02:30,9,3,6,0,0,0
2020-12-06 02:45,11,7,4,0,0,0
2020-12-06 03:00,1,1,0,0,0,0
2020-12-06 03:15,5,2,3,0,0,0
2020-12-06 03:30,3,1,2,0,0,0
2020-12-06 03:45,0,0,0,0,0,0
2020-12-06 04:00,5,3,2,0,0,0
2020-12-06 04:15,1,1,0,0,0,0
2020-12-06 04:30,3,0,3,0,0,0
2020-12-06 04:45,4,2,2,0,0,0
2020-12-06 05:00,1,0,1,0,0,0
2020-12-06 05:15,5,3,2,0,0,0
2020-12-06 05:30,2,2,0,0,0,0
2020-12-06 05:45,4,4,0,0,0,0
2020-12-06 06:00,3,3,0,0,0,0
2020-12-06 06:15,0,0,0,0,0,0
2020-12-06 06:30,3,2,1,0,0,0
2020-12-06 06:45,3,1,2,0,0,0
2020-12-06 07:00,3,2,1,0,0,0
2020-12-06 07:15,6,4,2,0,0,0
2020-12-06 07:30,9,7,2,0,0,0
2020-12-06 07:45,3,1,2,0,0,0
2020-12-06 08:00,4,3,1,0,0,0
2020-12-06 08:15,5,3,2,0,0,0
2020-12-06 08:30,5,4,1,0,0,0
2020-12-06 08:45,9,7,2,0,0,0
2020-12-06 09:00,12,7,5,0,0,0
2020-12-06 09:15,13,5,8,0,0,0
2020-12-06 09:30,19,12,7,0,0,0
2020-12-06 09:45,25,10,15,0,0,0
2020-12-06 10:00,27,16,11,0,0,0
2020-12-06 10:15,16,8,8,0,0,0
2020-12-06 10:30,18,5,13,0,0,0
2020-12-06 10:45,31,19,12,0,0,0
2020-12-06 11:00,31,19,12,0,0,0
2020-12-06 11:15,34,18,16,0,0,0
2020-12-06 11:30,15,7,8,0,0,0
2020-12-06 11:45,51,16,35,0,0,0
2020-12-06 12:00,40,21,19,0,0,0
2020-12-06 12:15,30,14,16,0,0,0
2020-12-06 12:30,32,17,15,0,0,0
2020-12-06 12:45,23,14,9,0,0,0
2020-12-06 13:00,28,16,12,0,0,0
2020-12-06 13:15,35,14,21,0,0,0
2020-12-06 13:30,24,13,11,0,0,0
2020-12-06 13:45,47,30,17,0,0,0
2020-12-06 14:00,45,21,24,0,0,0
2020-12-06 14:15,46,17,29,0,0,0
2020-12-06 14:30,54,18,36,0,0,0
2020-12-06 14:45,57,29,28,0,0,0
2020-12-06 15:00,52,22,30,0,0,0
2020-12-06 15:15,62,32,30,0,0,0
2020-12-06 15:30,43,24,19,0,0,0
2020-12-06 15:45,56,27,29,0,0,0
2020-12-06 16:00,39,12,27,0,0,0
2020-12-06 16:15,35,16,19,0,0,0
2020-12-06 16:30,33,22,11,0,0,0
2020-12-06 16:45,39,23,16,0,0,0
2020-12-06 17:00,50,22,28,0,0,0
2020-12-06 17:15,32,9,23,0,0,0
2020-12-06 17:30,35,12,23,0,0,0
2020-12-06 17:45,39,14,25,0,0,0
2020-12-06 18:00,33,15,18,0,0,0
2020-12-06 18:15,45,18,27,0,0,0
2020-12-06 18:30,30,17,13,0,0,0
2020-12-06 18:45,36,17,19,0,0,0
2020-12-06 19:00,23,12,11,0,0,0
2020-12-06 19:15,19,10,9,0,0,0
2020-12-06 19:30,27,9,18,0,0,0
2020-12-06 19:45,27,14,13,0,0,0
2020-12-06 20:00,23,9,14,0,0,0
2020-12-06 20:15,30,12,18,0,0,0
2020-12-06 20:30,17,6,11,0,0,0
2020-12-06 20:45,23,9,14,0,0,0
2020-12-06 21:00,18,8,10,0,0,0
2020-12-06 21:15,18,10,8,0,0,0
2020-12-06 21:30,14,4,10,0,0,0
2020-12-06 21:45,10,6,4,0,0,0
2020-12-06 22:00,7,2,5,0,0,0
2020-12-06 22:15,11,2,9,0,0,0
2020-12-06 22:30,10,4,6,0,0,0
2020-12-06 22:45,9,4,5,0,0,0
2020-12-06 23:00,8,3,5,0,0,0
2020-12-06 23:15,5,1,4,0,0,0
2020-12-06 23:30,6,2,4,0,0,0
2020-12-06 23:45,4,2,2,0,0,0
2020-12-07 00:00,8,3,5,0,0,0
2020-12-07 00:15,4,1,3,0,0,0
2020-12-07 00:30,3,3,0,0,0,0
2020-12-07 00:45,0,0,0,0,0,0
2020-12-07 01:00,4,1,3,0,0,0
2020-12-07 01:15,1,0,1,0,0,0
2020-12-07 01:30,0,0,0,0,0,0
2020-12-07 01:45,1,1,0,0,0,0
2020-12-07 02:00,0,0,0,0,0,0
2020-12-07 02:15,0,0,0,0,0,0
2020-12-07 02:30,0,0,0,0,0,0
2020-12-07 02:45,0,0,0,0,0,0
2020-12-07 03:00,0,0,0,0,0,0
2020-12-07 03:15,0,0,0,0,0,0
2020-12-07 03:30,1,0,1,0,0,0
2020-12-07 03:45,0,0,0,0,0,0
2020-12-07 04:00,0,0,0,0,0,0
2020-12-07 04:15,2,2,0,0,0,0
2020-12-07 04:30,3,3,0,0,0,0
2020-12-07 04:45,0,0,0,0,0,0
2020-12-07 05:00,5,3,2,0,0,0
2020-12-07 05:15,9,5,4,0,0,0
2020-12-07 05:30,11,9,2,0,0,0
2020-12-07 05:45,19,15,4,0,0,0
2020-12-07 06:00,8,6,2,0,0,0
2020-12-07 06:15,19,14,5,0,0,0
2020-12-07 06:30,26,17,9,0,0,0
2020-12-07 06:45,40,29,11,0,0,0
2020-12-07 07:00,55,36,19,0,0,0
2020-12-07 07:15,84,53,31,0,0,0
2020-12-07 07:30,121,80,41,0,0,0
2020-12-07 07:45,129,90,39,0,0,0
2020-12-07 08:00,120,85,35,0,0,0
2020-12-07 08:15,102,69,33,0,0,0
2020-12-07 08:30,95,70,25,0,0,0
2020-12-07 08:45,98,69,29,0,0,0
2020-12-07 09:00,93,61,32,0,0,0
2020-12-07 09:15,77,52,25,0,0,0
2020-12-07 09:30,83,53,30,0,0,0
2020-12-07 09:45,93,71,22,0,0,0
2020-12-07 10:00,82,46,36,0,0,0
2020-12-07 10:15,65,40,25,0,0,0
2020-12-07 10:30,93,51,42,0,0,0
2020-12-07 10:45,80,44,36,0,0,0
2020-12-07 11:00,86,46,40,0,0,0
2020-12-07 11:15,83,36,47,0,0,0
2020-12-07 11:30,64,29,35,0,0,0
2020-12-07 11:45,86,36,50,0,0,0
2020-12-07 12:00,84,33,51,0,0,0
2020-12-07 12:15,64,24,40,0,0,0
2020-12-07 12:30,92,41,51,0,0,0
2020-12-07 12:45,80,37,43,0,0,0
2020-12-07 13:00,101,42,59,0,0,0
2020-12-07 13:15,84,37,47,0,0,0
2020-12-07 13:30,76,26,50,0,0,0
2020-12-07 13:45,84,36,48,0,0,0
2020-12-07 14:00,95,33,62,0,0,0
2020-12-07 14:15,122,59,63,0,0,0
2020-12-07 14:30,67,25,42,0,0,0
2020-12-07 14:45,110,55,55,0,0,0
2020-12-07 15:00,94,41,53,0,0,0
2020-12-07 15:15,109,52,57,0,0,0
2020-12-07 15:30,125,56,69,0,0,0
2020-12-07 15:45,158,58,100,0,0,0
2020-12-07 16:00,131,58,73,0,0,0
2020-12-07 16:15,170,67,103,0,0,0
2020-12-07 16:30,161,64,97,0,0,0
2020-12-07 16:45,142,54,88,0,0,0
2020-12-07 17:00,141,43,98,0,0,0
2020-12-07 17:15,140,46,94,0,0,0
2020-12-07 17:30,138,39,99,0,0,0
2020-12-07 17:45,127,44,83,0,0,0
2020-12-07 18:00,136,34,102,0,0,0
2020-12-07 18:15,117,37,80,0,0,0
2020-12-07 18:30,99,31,68,0,0,0
2020-12-07 18:45,96,23,73,0,0,0
2020-12-07 19:00,94,21,73,0,0,0
2020-12-07 19:15,66,14,52,0,0,0
2020-12-07 19:30,61,18,43,0,0,0
2020-12-07 19:45,54,12,42,0,0,0
2020-12-07 20:00,44,15,29,0,0,0
2020-12-07 20:15,29,9,20,0,0,0
2020-12-07 20:30,22,9,13,0,0,0
2020-12-07 20:45,19,3,16,0,0,0
2020-12-07 21:00,19,3,16,0,0,0
2020-12-07 21:15,13,4,9,0,0,0
2020-12-07 21:30,14,3,11,0,0,0
2020-12-07 21:45,15,4,11,0,0,0
2020-12-07 22:00,13,7,6,0,0,0
2020-12-07 22:15,15,8,7,0,0,0
2020-12-07 22:30,6,3,3,0,0,0
2020-12-07 22:45,12,3,9,0,0,0
2020-12-07 23:00,8,6,2,0,0,0
2020-12-07 23:15,4,2,2,0,0,0
2020-12-07 23:30,3,1,2,0,0,0
2020-12-07 23:45,1,1,0,0,0,0
2020-12-08 00:00,3,0,3,0,0,0
2020-12-08 00:15,0,0,0,0,0,0
2020-12-08 00:30,3,2,1,0,0,0
2020-12-08 00:45,4,2,2,0,0,0
2020-12-08 01:00,0,0,0,0,0,0
2020-12-08 01:15,2,1,1,0,0,0
2020-12-08 01:30,0,0,0,0,0,0
2020-12-08 01:45,1,0,1,0,0,0
2020-12-08 02:00,0,0,0,0,0,0
2020-12-08 02:15,2,1,1,0,0,0
2020-12-08 02:30,0,0,0,0,0,0
2020-12-08 02:45,2,0,2,0,0,0
2020-12-08 03:00,2,0,2,0,0,0
2020-12-08 03:15,1,0,1,0,0,0
2020-12-08 03:30,1,0,1,0,0,0
2020-12-08 03:45,0,0,0,0,0,0
2020-12-08 04:00,0,0,0,0,0,0
2020-12-08 04:15,0,0,0,0,0,0
2020-12-08 04:30,4,4,0,0,0,0
2020-12-08 04:45,4,3,1,0,0,0
2020-12-08 05:00,6,4,2,0,0,0
2020-12-08 05:15,6,4,2,0,0,0
2020-12-08 05:30,17,14,3,0,0,0
2020-12-08 05:45,12,10,2,0,0,0
2020-12-08 06:00,22,18,4,0,0,0
2020-12-08 06:15,28,17,11,0,0,0
2020-12-08 06:30,42,22,20,0,0,0
2020-12-08 06:45,50,35,15,0,0,0
2020-12-08 07:00,81,43,38,0,0,0
2020-12-08 07:15,96,70,26,0,0,0
2020-12-08 07:30,125,79,46,0,0,0
2020-12-08 07:45,167,107,60,0,0,0
2020-12-08 08:00,129,82,47,0,0,0
2020-12-08 08:15,153,112,41,0,0,0
2020-12-08 08:30,120,79,41,0,0,0
2020-12-08 08:45,110,74,36,0,0,0
2020-12-08 09:00,80,53,27,0,0,0
2020-12-08 09:15,68,38,30,0,0,0
2020-12-08 09:30,68,45,23,0,0,0
2020-12-08 09:45,79,52,27,0,0,0
2020-12-08 10:00,83,55,28,0,0,0
2020-12-08 10:15,97,54,43,0,0,0
2020-12-08 10:30,116,69,47,0,0,0
2020-12-08 10:45,120,58,62,0,0,0
2020-12-08 11:00,97,48,49,0,0,0
2020-12-08 11:15,99,40,59,0,0,0
2020-12-08 11:30,118,52,66,0,0,0
2020-12-08 11:45,152,74,78,0,0,0
2020-12-08 12:00,127,56,71,0,0,0
2020-12-08 12:15,127,54,73,0,0,0
2020-12-08 12:30,125,48,77,0,0,0
2020-12-08 12:45,121,58,63,0,0,0
2020-12-08 13:00,136,53,83,0,0,0
2020-12-08 13:15,133,57,76,0,0,0
2020-12-08 13:30,128,43,85,0,0,0
2020-12-08 13:45,138,73,65,0,0,0
2020-12-08 14:00,132,52,80,0,0,0
2020-12-08 14:15,150,53,97,0,0,0
2020-12-08 14:30,135,56,79,0,0,0
2020-12-08 14:45,156,70,86,0,0,0
2020-12-08 15:00,140,64,76,0,0,0
2020-12-08 15:15,163,80,83,0,0,0
2020-12-08 15:30,170,78,92,0,0,0
2020-12-08 15:45,169,69,100,0,0,0
2020-12-08 16:00,172,61,111,0,0,0
2020-12-08 16:15,181,70,111,0,0,0
2020-12-08 16:30,164,63,101,0,0,0
2020-12-08 16:45,189,82,107,0,0,0
2020-12-08 17:00,178,68,110,0,0,0
2020-12-08 17:15,169,64,105,0,0,0
2020-12-08 17:30,146,51,95,0,0,0
2020-12-08 17:45,144,52,92,0,0,0
2020-12-08 18:00,162,43,119,0,0,0
2020-12-08 18:15,143,39,104,0,0,0
2020-12-08 18:30,131,38,93,0,0,0
2020-12-08 18:45,99,30,69,0,0,0
2020-12-08 19:00,95,17,78,0,0,0
2020-12-08 19:15,83,33,50,0,0,0
2020-12-08 19:30,80,21,59,0,0,0
2020-12-08 19:45,54,17,37,0,0,0
2020-12-08 20:00,61,17,44,0,0,0
2020-12-08 20:15,38,9,29,0,0,0
2020-12-08 20:30,30,13,17,0,0,0
2020-12-08 20:45,24,10,14,0,0,0
2020-12-08 21:00,25,5,20,0,0,0
2020-12-08 21:15,23,6,17,0,0,0
2020-12-08 21:30,12,2,10,0,0,0
2020-12-08 21:45,20,7,13,0,0,0
2020-12-08 22:00,23,6,17,0,0,0
2020-12-08 22:15,25,9,16,0,0,0
2020-12-08 22:30,17,6,11,0,0,0
2020-12-08 22:45,11,2,9,0,0,0
2020-12-08 23:00,11,2,9,0,0,0
2020-12-08 23:15,15,8,7,0,0,0
2020-12-08 23:30,9,4,5,0,0,0
2020-12-08 23:45,5,3,2,0,0,0
2020-12-09 00:00,9,4,5,0,0,0
2020-12-09 00:15,6,1,5,0,0,0
2020-12-09 00:30,8,5,3,0,0,0
2020-12-09 00:45,3,2,1,0,0,0
2020-12-09 01:00,3,1,2,0,0,0
2020-12-09 01:15,5,2,3,0,0,0
2020-12-09 01:30,5,3,2,0,0,0
2020-12-09 01:45,2,0,2,0,0,0
2020-12-09 02:00,2,2,0,0,0,0
2020-12-09 02:15,2,0,2,0,0,0
2020-12-09 02:30,0,0,0,0,0,0
2020-12-09 02:45,0,0,0,0,0,0
2020-12-09 03:00,0,0,0,0,0,0
2020-12-09 03:15,0,0,0,0,0,0
2020-12-09 03:30,1,0,1,0,0,0
2020-12-09 03:45,0,0,0,0,0,0
2020-12-09 04:00,0,0,0,0,0,0
2020-12-09 04:15,0,0,0,0,0,0
2020-12-09 04:30,3,3,0,0,0,0
2020-12-09 04:45,2,2,0,0,0,0
2020-12-09 05:00,6,5,1,0,0,0
2020-12-09 05:15,13,5,8,0,0,0
2020-12-09 05:30,10,9,1,0,0,0
2020-12-09 05:45,23,20,3,0,0,0
2020-12-09 06:00,27,19,8,0,0,0
2020-12-09 06:15,31,24,7,0,0,0
2020-12-09 06:30,47,37,10,0,0,0
2020-12-09 06:45,60,40,20,0,0,0
2020-12-09 07:00,77,50,27,0,0,0
2020-12-09 07:15,107,62,45,0,0,0
2020-12-09 07:30,144,96,48,0,0,0
2020-12-09 07:45,185,127,58,0,0,0
2020-12-09 08:00,135,87,48,0,0,0
2020-12-09 08:15,133,88,45,0,0,0
2020-12-09 08:30,116,88,28,0,0,0
2020-12-09 08:45,133,89,44,0,0,0
2020-12-09 09:00,100,72,28,0,0,0
2020-12-09 09:15,98,69,29,0,0,0
2020-12-09 09:30,119,84,35,0,0,0
2020-12-09 09:45,110,73,37,0,0,0
2020-12-09 10:00,110,71,39,0,0,0
2020-12-09 10:15,101,60,41,0,0,0
2020-12-09 10:30,113,71,42,0,0,0
2020-12-09 10:45,127,86,41,0,0,0
2020-12-09 11:00,91,42,49,0,0,0
2020-12-09 11:15,97,46,51,0,0,0
2020-12-09 11:30,133,58,75,0,0,0
2020-12-09 11:45,155,80,75,0,0,0
2020-12-09 12:00,143,59,84,0,0,0
2020-12-09 12:15,128,63,65,0,0,0
2020-12-09 12:30,154,61,93,0,0,0
2020-12-09 12:45,136,64,72,0,0,0
2020-12-09 13:00,166,80,86,0,0,0
2020-12-09 13:15,146,71,75,0,0,0
2020-12-09 13:30,124,61,63,0,0,0
2020-12-09 13:45,135,51,84,0,0,0
2020-12-09 14:00,145,53,92,0,0,0
2020-12-09 14:15,151,73,78,0,0,0
2020-12-09 14:30,123,57,66,0,0,0
2020-12-09 14:45,130,65,65,0,0,0
2020-12-09 15:00,139,59,80,0,0,0
2020-12-09 15:15,175,74,101,0,0,0
2020-12-09 15:30,121,40,81,0,0,0
2020-12-09 15:45,158,66,92,0,0,0
2020-12-09 16:00,174,63,111,0,0,0
2020-12-09 16:15,170,66,104,0,0,0
2020-12-09 16:30,159,64,95,0,0,0
2020-12-09 16:45,145,64,81,0,0,0
2020-12-09 17:00,167,62,105,0,0,0
2020-12-09 17:15,167,60,107,0,0,0
2020-12-09 17:30,133,50,83,0,0,0
2020-12-09 17:45,168,59,109,0,0,0
2020-12-09 18:00,146,48,98,0,0,0
2020-12-09 18:15,125,38,87,0,0,0
2020-12-09 18:30,95,31,64,0,0,0
2020-12-09 18:45,108,32,76,0,0,0
2020-12-09 19:00,88,39,49,0,0,0
2020-12-09 19:15,99,29,70,0,0,0
2020-12-09 19:30,76,28,48,0,0,0
2020-12-09 19:45,85,24,61,0,0,0
2020-12-09 20:00,76,27,49,0,0,0
2020-12-09 20:15,48,15,33,0,0,0
2020-12-09 20:30,39,13,26,0,0,0
2020-12-09 20:45,31,12,19,0,0,0
2020-12-09 21:00,35,14,21,0,0,0
2020-12-09 21:15,27,7,20,0,0,0
2020-12-09 21:30,22,4,18,0,0,0
2020-12-09 21:45,16,9,7,0,0,0
2020-12-09 22:00,18,4,14,0,0,0
2020-12-09 22:15,20,6,14,0,0,0
2020-12-09 22:30,17,6,11,0,0,0
2020-12-09 22:45,23,7,16,0,0,0
2020-12-09 23:00,18,5,13,0,0,0
2020-12-09 23:15,13,7,6,0,0,0
2020-12-09 23:30,16,2,14,0,0,0
2020-12-09 23:45,6,1,5,0,0,0
2020-12-10 00:00,7,4,3,0,0,0
2020-12-10 00:15,5,2,3,0,0,0
2020-12-10 00:30,6,1,5,0,0,0
2020-12-10 00:45,8,3,5,0,0,0
2020-12-10 01:00,9,6,3,0,0,0
2020-12-10 01:15,4,1,3,0,0,0
2020-12-10 01:30,5,2,3,0,0,0
2020-12-10 01:45,0,0,0,0,0,0
2020-12-10 02:00,1,0,1,0,0,0
2020-12-10 02:15,0,0,0,0,0,0
2020-12-10 02:30,0,0,0,0,0,0
2020-12-10 02:45,1,0,1,0,0,0
2020-12-10 03:00,1,0,1,0,0,0
2020-12-10 03:15,1,0,1,0,0,0
2020-12-10 03:30,0,0,0,0,0,0
2020-12-10 03:45,0,0,0,0,0,0
2020-12-10 04:00,1,0,1,0,0,0
2020-12-10 04:15,1,0,1,0,0,0
2020-12-10 04:30,2,2,0,0,0,0
2020-12-10 04:45,4,3,1,0,0,0
2020-12-10 05:00,4,3,1,0,0,0
2020-12-10 05:15,7,6,1,0,0,0
2020-12-10 05:30,15,11,4,0,0,0
2020-12-10 05:45,21,18,3,0,0,0
2020-12-10 06:00,20,15,5,0,0,0
2020-12-10 06:15,34,23,11,0,0,0
2020-12-10 06:30,30,18,12,0,0,0
2020-12-10 06:45,50,36,14,0,0,0
2020-12-10 07:00,77,47,30,0,0,0
2020-12-10 07:15,103,70,33,0,0,0
2020-12-10 07:30,142,92,50,0,0,0
2020-12-10 07:45,174,124,50,0,0,0
2020-12-10 08:00,130,92,38,0,0,0
2020-12-10 08:15,134,94,40,0,0,0
2020-12-10 08:30,109,79,30,0,0,0
2020-12-10 08:45,113,83,30,0,0,0
2020-12-10 09:00,83,53,30,0,0,0
2020-12-10 09:15,90,61,29,0,0,0
2020-12-10 09:30,88,61,27,0,0,0
2020-12-10 09:45,89,62,27,0,0,0
2020-12-10 10:00,86,56,30,0,0,0
2020-12-10 10:15,82,37,45,0,0,0
2020-12-10 10:30,86,53,33,0,0,0
2020-12-10 10:45,112,56,56,0,0,0
2020-12-10 11:00,119,67,52,0,0,0
2020-12-10 11:15,107,57,50,0,0,0
2020-12-10 11:30,96,54,42,0,0,0
2020-12-10 11:45,144,68,76,0,0,0
2020-12-10 12:00,125,59,66,0,0,0
2020-12-10 12:15,125,62,63,0,0,0
2020-12-10 12:30,147,61,86,0,0,0
2020-12-10 12:45,130,61,69,0,0,0
2020-12-10 13:00,193,61,132,0,0,0
2020-12-10 13:15,142,51,91,0,0,0
2020-12-10 13:30,121,63,58,0,0,0
2020-12-10 13:45,147,68,79,0,0,0
2020-12-10 14:00,117,46,71,0,0,0
2020-12-10 14:15,148,67,81,0,0,0
2020-12-10 14:30,141,65,76,0,0,0
2020-12-10 14:45,147,63,84,0,0,0
2020-12-10 15:00,137,66,71,0,0,0
2020-12-10 15:15,178,83,95,0,0,0
2020-12-10 15:30,160,72,88,0,0,0
2020-12-10 15:45,187,93,94,0,0,0
2020-12-10 16:00,167,66,101,0,0,0
2020-12-10 16:15,162,55,107,0,0,0
2020-12-10 16:30,180,60,120,0,0,0
2020-12-10 16:45,194,93,101,0,0,0
2020-12-10 17:00,171,68,103,0,0,0
2020-12-10 17:15,178,63,115,0,0,0
2020-12-10 17:30,178,66,112,0,0,0
2020-12-10 17:45,149,51,98,0,0,0
2020-12-10 18:00,166,54,112,0,0,0
2020-12-10 18:15,126,41,85,0,0,0
2020-12-10 18:30,116,38,78,0,0,0
2020-12-10 18:45,99,40,59,0,0,0
2020-12-10 19:00,91,27,64,0,0,0
2020-12-10 19:15,98,27,71,0,0,0
2020-12-10 19:30,72,17,55,0,0,0
2020-12-10 19:45,64,17,47,0,0,0
2020-12-10 20:00,55,14,41,0,0,0
2020-12-10 20:15,43,18,25,0,0,0
2020-12-10 20:30,39,22,17,0,0,0
2020-12-10 20:45,24,9,15,0,0,0
2020-12-10 21:00,23,11,12,0,0,0
2020-12-10 21:15,26,9,17,0,0,0
2020-12-10 21:30,21,3,18,0,0,0
2020-12-10 21:45,24,8,16,0,0,0
2020-12-10 22:00,17,3,14,0,0,0
2020-12-10 22:15,17,4,13,0,0,0
2020-12-10 22:30,10,4,6,0,0,0
2020-12-10 22:45,14,5,9,0,0,0
2020-12-10 23:00,10,5,5,0,0,0
2020-12-10 23:15,11,8,3,0,0,0
2020-12-10 23:30,6,3,3,0,0,0
2020-12-10 23:45,8,2,6,0,0,0
2020-12-11 00:00,4,2,2,0,0,0
2020-12-11 00:15,4,3,1,0,0,0
2020-12-11 00:30,12,6,6,0,0,0
2020-12-11 00:45,7,0,7,0,0,0
2020-12-11 01:00,4,2,2,0,0,0
2020-12-11 01:15,5,2,3,0,0,0
2020-12-11 01:30,0,0,0,0,0,0
2020-12-11 01:45,0,0,0,0,0,0
2020-12-11 02:00,0,0,0,0,0,0
2020-12-11 02:15,5,3,2,0,0,0
2020-12-11 02:30,0,0,0,0,0,0
2020-12-11 02:45,0,0,0,0,0,0
2020-12-11 03:00,0,0,0,0,0,0
2020-12-11 03:15,1,1,0,0,0,0
2020-12-11 03:30,2,0,2,0,0,0
2020-12-11 03:45,0,0,0,0,0,0
2020-12-11 04:00,0,0,0,0,0,0
2020-12-11 04:15,0,0,0,0,0,0
2020-12-11 04:30,4,4,0,0,0,0
2020-12-11 04:45,3,1,2,0,0,0
2020-12-11 05:00,4,2,2,0,0,0
2020-12-11 05:15,5,4,1,0,0,0
2020-12-11 05:30,13,9,4,0,0,0
2020-12-11 05:45,14,12,2,0,0,0
2020-12-11 06:00,17,13,4,0,0,0
2020-12-11 06:15,27,19,8,0,0,0
2020-12-11 06:30,29,16,13,0,0,0
2020-12-11 06:45,60,36,24,0,0,0
2020-12-11 07:00,54,38,16,0,0,0
2020-12-11 07:15,80,50,30,0,0,0
2020-12-11 07:30,134,86,48,0,0,0
2020-12-11 07:45,158,109,49,0,0,0
2020-12-11 08:00,94,71,23,0,0,0
2020-12-11 08:15,128,91,37,0,0,0
2020-12-11 08:30,113,79,34,0,0,0
2020-12-11 08:45,110,78,32,0,0,0
2020-12-11 09:00,71,45,26,0,0,0
2020-12-11 09:15,91,55,36,0,0,0
2020-12-11 09:30,113,77,36,0,0,0
2020-12-11 09:45,126,93,33,0,0,0
2020-12-11 10:00,98,64,34,0,0,0
2020-12-11 10:15,115,83,32,0,0,0
2020-12-11 10:30,101,56,45,0,0,0
2020-12-11 10:45,136,84,52,0,0,0
2020-12-11 11:00,108,64,44,0,0,0
2020-12-11 11:15,148,78,70,0,0,0
2020-12-11 11:30,134,60,74,0,0,0
2020-12-11 11:45,155,78,77,0,0,0
2020-12-11 12:00,163,77,86,0,0,0
2020-12-11 12:15,156,65,91,0,0,0
2020-12-11 12:30,150,66,84,0,0,0
2020-12-11 12:45,182,91,91,0,0,0
2020-12-11 13:00,171,77,94,0,0,0
2020-12-11 13:15,192,95,97,0,0,0
2020-12-11 13:30,177,74,103,0,0,0
2020-12-11 13:45,183,87,96,0,0,0
2020-12-11 14:00,174,64,110,0,0,0
2020-12-11 14:15,165,76,89,0,0,0
2020-12-11 14:30,151,75,76,0,0,0
2020-12-11 14:45,176,83,93,0,0,0
2020-12-11 15:00,180,81,99,0,0,0
2020-12-11 15:15,187,100,87,0,0,0
2020-12-11 15:30,189,79,110,0,0,0
2020-12-11 15:45,187,87,100,0,0,0
2020-12-11 16:00,183,79,104,0,0,0
2020-12-11 16:15,190,86,104,0,0,0
2020-12-11 16:30,178,76,102,0,0,0
2020-12-11 16:45,191,91,100,0,0,0
2020-12-11 17:00,151,71,80,0,0,0
2020-12-11 17:15,152,46,106,0,0,0
2020-12-11 17:30,146,58,88,0,0,0
2020-12-11 17:45,167,70,97,0,0,0
2020-12-11 18:00,130,46,84,0,0,0
2020-12-11 18:15,129,53,76,0,0,0
2020-12-11 18:30,104,43,61,0,0,0
2020-12-11 18:45,132,44,88,0,0,0
2020-12-11 19:00,105,35,70,0,0,0
2020-12-11 19:15,95,31,64,0,0,0
2020-12-11 19:30,77,22,55,0,0,0
2020-12-11 19:45,86,30,56,0,0,0
2020-12-11 20:00,88,29,59,0,0,0
2020-12-11 20:15,51,12,39,0,0,0
2020-12-11 20:30,32,9,23,0,0,0
2020-12-11 20:45,28,11,17,0,0,0
2020-12-11 21:00,36,13,23,0,0,0
2020-12-11 21:15,29,12,17,0,0,0
2020-12-11 21:30,28,12,16,0,0,0
2020-12-11 21:45,13,3,10,0,0,0
2020-12-11 22:00,13,3,10,0,0,0
2020-12-11 22:15,8,2,6,0,0,0
2020-12-11 22:30,7,2,5,0,0,0
2020-12-11 22:45,16,7,9,0,0,0
2020-12-11 23:00,24,8,16,0,0,0
2020-12-11 23:15,15,7,8,0,0,0
2020-12-11 23:30,13,5,8,0,0,0
2020-12-11 23:45,19,6,13,0,0,0
2020-12-12 00:00,26,7,19,0,0,0
2020-12-12 00:15,19,5,14,0,0,0
2020-12-12 00:30,10,5,5,0,0,0
2020-12-12 00:45,13,4,9,0,0,0
2020-12-12 01:00,8,4,4,0,0,0
2020-12-12 01:15,7,1,6,0,0,0
2020-12-12 01:30,4,1,3,0,0,0
2020-12-12 01:45,1,1,0,0,0,0
2020-12-12 02:00,5,5,0,0,0,0
2020-12-12 02:15,3,2,1,0,0,0
2020-12-12 02:30,6,5,1,0,0,0
2020-12-12 02:45,5,0,5,0,0,0
2020-12-12 03:00,2,1,1,0,0,0
2020-12-12 03:15,2,0,2,0,0,0
2020-12-12 03:30,6,2,4,0,0,0
2020-12-12 03:45,6,0,6,0,0,0
2020-12-12 04:00,0,0,0,0,0,0
2020-12-12 04:15,0,0,0,0,0,0
2020-12-12 04:30,3,1,2,0,0,0
2020-12-12 04:45,3,1,2,0,0,0
2020-12-12 05:00,4,4,0,0,0,0
2020-12-12 05:15,4,2,2,0,0,0
2020-12-12 05:30,8,5,3,0,0,0
2020-12-12 05:45,11,7,4,0,0,0
2020-12-12 06:00,5,4,1,0,0,0
2020-12-12 06:15,5,5,0,0,0,0
2020-12-12 06:30,8,7,1,0,0,0
2020-12-12 06:45,12,6,6,0,0,0
2020-12-12 07:00,14,10,4,0,0,0
2020-12-12 07:15,19,11,8,0,0,0
2020-12-12 07:30,24,15,9,0,0,0
2020-12-12 07:45,30,18,12,0,0,0
2020-12-12 08:00,23,13,10,0,0,0
2020-12-12 08:15,42,24,18,0,0,0
2020-12-12 08:30,24,13,11,0,0,0
2020-12-12 08:45,65,41,24,0,0,0
2020-12-12 09:00,44,36,8,0,0,0
2020-12-12 09:15,90,64,26,0,0,0
2020-12-12 09:30,106,82,24,0,0,0
2020-12-12 09:45,154,116,38,0,0,0
2020-12-12 10:00,142,103,39,0,0,0
2020-12-12 10:15,154,94,60,0,0,0
2020-12-12 10:30,160,79,81,0,0,0
2020-12-12 10:45,131,67,64,0,0,0
2020-12-12 11:00,134,51,83,0,0,0
2020-12-12 11:15,136,80,56,0,0,0
2020-12-12 11:30,143,76,67,0,0,0
2020-12-12 11:45,127,55,72,0,0,0
2020-12-12 12:00,143,60,83,0,0,0
2020-12-12 12:15,144,71,73,0,0,0
2020-12-12 12:30,177,85,92,0,0,0
2020-12-12 12:45,150,77,73,0,0,0
2020-12-12 13:00,150,70,80,0,0,0
2020-12-12 13:15,139,66,73,0,0,0
2020-12-12 13:30,139,59,80,0,0,0
2020-12-12 13:45,139,58,81,0,0,0
2020-12-12 14:00,149,68,81,0,0,0
2020-12-12 14:15,140,70,70,0,0,0
2020-12-12 14:30,140,69,71,0,0,0
2020-12-12 14:45,146,48,98,0,0,0
2020-12-12 15:00,140,54,86,0,0,0
2020-12-12 15:15,144,64,80,0,0,0
2020-12-12 15:30,103,43,60,0,0,0
2020-12-12 15:45,121,49,72,0,0,0
2020-12-12 16:00,116,48,68,0,0,0
2020-12-12 16:15,112,42,70,0,0,0
2020-12-12 16:30,104,41,63,0,0,0
2020-12-12 16:45,83,36,47,0,0,0
2020-12-12 17:00,98,33,65,0,0,0
2020-12-12 17:15,82,32,50,0,0,0
2020-12-12 17:30,101,30,71,0,0,0
2020-12-12 17:45,102,49,53,0,0,0
2020-12-12 18:00,89,37,52,0,0,0
2020-12-12 18:15,85,31,54,0,0,0
2020-12-12 18:30,81,28,53,0,0,0
2020-12-12 18:45,94,38,56,0,0,0
2020-12-12 19:00,65,16,49,0,0,0
2020-12-12 19:15,73,32,41,0,0,0
2020-12-12 19:30,49,20,29,0,0,0
2020-12-12 19:45,47,16,31,0,0,0
2020-12-12 20:00,71,17,54,0,0,0
2020-12-12 20:15,38,7,31,0,0,0
2020-12-12 20:30,20,3,17,0,0,0
2020-12-12 20:45,35,8,27,0,0,0
2020-12-12 21:00,19,11,8,0,0,0
2020-12-12 21:15,26,10,16,0,0,0
2020-12-12 21:30,23,6,17,0,0,0
2020-12-12 21:45,23,6,17,0,0,0
2020-12-12 22:00,22,8,14,0,0,0
2020-12-12 22:15,14,4,10,0,0,0
2020-12-12 22:30,13,3,10,0,0,0
2020-12-12 22:45,17,7,10,0,0,0
2020-12-12 23:00,14,6,8,0,0,0
2020-12-12 23:15,18,8,10,0,0,0
2020-12-12 23:30,14,6,8,0,0,0
2020-12-12 23:45,9,8,1,0,0,0
2020-12-13 00:00,19,9,10,0,0,0
2020-12-13 00:15,12,6,6,0,0,0
2020-12-13 00:30,6,3,3,0,0,0
2020-12-13 00:45,9,3,6,0,0,0
2020-12-13 01:00,4,1,3,0,0,0
2020-12-13 01:15,10,4,6,0,0,0
2020-12-13 01:30,6,3,3,0,0,0
2020-12-13 01:45,10,4,6,0,0,0
2020-12-13 02:00,7,1,6,0,0,0
2020-12-13 02:15,9,3,6,0,0,0
2020-12-13 02:30,10,6,4,0,0,0
2020-12-13 02:45,6,4,2,0,0,0
2020-12-13 03:00,1,0,1,0,0,0
2020-12-13 03:15,2,1,1,0,0,0
2020-12-13 03:30,3,2,1,0,0,0
2020-12-13 03:45,0,0,0,0,0,0
2020-12-13 04:00,5,3,2,0,0,0
2020-12-13 04:15,0,0,0,0,0,0
2020-12-13 04:30,0,0,0,0,0,0
2020-12-13 04:45,0,0,0,0,0,0
2020-12-13 05:00,0,0,0,0,0,0
2020-12-13 05:15,3,1,2,0,0,0
2020-12-13 05:30,8,5,3,0,0,0
2020-12-13 05:45,5,3,2,0,0,0
2020-12-13 06:00,1,1,0,0,0,0
2020-12-13 06:15,3,1,2,0,0,0
2020-12-13 06:30,2,2,0,0,0,0
2020-12-13 06:45,7,3,4,0,0,0
2020-12-13 07:00,2,0,2,0,0,0
2020-12-13 07:15,4,2,2,0,0,0
2020-12-13 07:30,5,2,3,0,0,0
2020-12-13 07:45,8,4,4,0,0,0
2020-12-13 08:00,6,4,2,0,0,0
2020-12-13 08:15,7,5,2,0,0,0
2020-12-13 08:30,8,5,3,0,0,0
2020-12-13 08:45,11,7,4,0,0,0
2020-12-13 09:00,9,9,0,0,0,0
2020-12-13 09:15,11,4,7,0,0,0
2020-12-13 09:30,12,7,5,0,0,0
2020-12-13 09:45,20,14,6,0,0,0
2020-12-13 10:00,23,13,10,0,0,0
2020-12-13 10:15,34,20,14,0,0,0
2020-12-13 10:30,27,10,17,0,0,0
2020-12-13 10:45,30,20,10,0,0,0
2020-12-13 11:00,18,6,12,0,0,0
2020-12-13 11:15,32,16,16,0,0,0
2020-12-13 11:30,21,8,13,0,0,0
2020-12-13 11:45,26,14,12,0,0,0
2020-12-13 12:00,40,15,25,0,0,0
2020-12-13 12:15,46,21,25,0,0,0
2020-12-13 12:30,39,24,15,0,0,0
2020-12-13 12:45,40,23,17,0,0,0
2020-12-13 13:00,41,17,24,0,0,0
2020-12-13 13:15,28,16,12,0,0,0
2020-12-13 13:30,39,15,24,0,0,0
2020-12-13 13:45,55,30,25,0,0,0
2020-12-13 14:00,50,30,20,0,0,0
2020-12-13 14:15,49,25,24,0,0,0
2020-12-13 14:30,43,28,15,0,0,0
2020-12-13 14:45,71,43,28,0,0,0
2020-12-13 15:00,53,36,17,0,0,0
2020-12-13 15:15,34,19,15,0,0,0
2020-12-13 15:30,60,23,37,0,0,0
2020-12-13 15:45,47,25,22,0,0,0
2020-12-13 16:00,65,34,31,0,0,0
2020-12-13 16:15,67,40,27,0,0,0
2020-12-13 16:30,59,19,40,0,0,0
2020-12-13 16:45,63,26,37,0,0,0
2020-12-13 17:00,51,22,29,0,0,0
2020-12-13 17:15,62,17,45,0,0,0
2020-12-13 17:30,31,8,23,0,0,0
2020-12-13 17:45,69,31,38,0,0,0
2020-12-13 18:00,58,33,25,0,0,0
2020-12-13 18:15,39,20,19,0,0,0
2020-12-13 18:30,24,8,16,0,0,0
2020-12-13 18:45,51,16,35,0,0,0
2020-12-13 19:00,37,13,24,0,0,0
2020-12-13 19:15,23,13,10,0,0,0
2020-12-13 19:30,28,8,20,0,0,0
2020-12-13 19:45,29,8,21,0,0,0
2020-12-13 20:00,20,11,9,0,0,0
2020-12-13 20:15,18,8,10,0,0,0
2020-12-13 20:30,16,11,5,0,0,0
2020-12-13 20:45,7,3,4,0,0,0
2020-12-13 21:00,9,2,7,0,0,0
2020-12-13 21:15,7,4,3,0,0,0
2020-12-13 21:30,14,6,8,0,0,0
2020-12-13 21:45,13,3,10,0,0,0
2020-12-13 22:00,10,4,6,0,0,0
2020-12-13 22:15,8,5,3,0,0,0
2020-12-13 22:30,11,7,4,0,0,0
2020-12-13 22:45,9,2,7,0,0,0
2020-12-13 23:00,7,4,3,0,0,0
2020-12-13 23:15,11,5,6,0,0,0
2020-12-13 23:30,7,3,4,0,0,0
2020-12-13 23:45,5,1,4,0,0,0
2020-12-14 00:00,8,1,7,0,0,0
2020-12-14 00:15,3,2,1,0,0,0
2020-12-14 00:30,8,3,5,0,0,0
2020-12-14 00:45,0,0,0,0,0,0
2020-12-14 01:00,2,1,1,0,0,0
2020-12-14 01:15,2,0,2,0,0,0
2020-12-14 01:30,2,1,1,0,0,0
2020-12-14 01:45,1,1,0,0,0,0
2020-12-14 02:00,1,1,0,0,0,0
2020-12-14 02:15,0,0,0,0,0,0
2020-12-14 02:30,0,0,0,0,0,0
2020-12-14 02:45,1,0,1,0,0,0
2020-12-14 03:00,0,0,0,0,0,0
2020-12-14 03:15,1,0,1,0,0,0
2020-12-14 03:30,1,0,1,0,0,0
2020-12-14 03:45,0,0,0,0,0,0
2020-12-14 04:00,0,0,0,0,0,0
2020-12-14 04:15,1,0,1,0,0,0
2020-12-14 04:30,3,3,0,0,0,0
2020-12-14 04:45,3,3,0,0,0,0
2020-12-14 05:00,2,1,1,0,0,0
2020-12-14 05:15,6,5,1,0,0,0
2020-12-14 05:30,9,8,1,0,0,0
2020-12-14 05:45,16,14,2,0,0,0
2020-12-14 06:00,19,12,7,0,0,0
2020-12-14 06:15,29,20,9,0,0,0
2020-12-14 06:30,35,24,11,0,0,0
2020-12-14 06:45,51,31,20,0,0,0
2020-12-14 07:00,52,34,18,0,0,0
2020-12-14 07:15,108,70,38,0,0,0
2020-12-14 07:30,113,73,40,0,0,0
2020-12-14 07:45,124,75,49,0,0,0
2020-12-14 08:00,113,69,44,0,0,0
2020-12-14 08:15,114,73,41,0,0,0
2020-12-14 08:30,102,76,26,0,0,0
2020-12-14 08:45,123,80,43,0,0,0
2020-12-14 09:00,104,71,33,0,0,0
2020-12-14 09:15,90,58,32,0,0,0
2020-12-14 09:30,140,86,54,0,0,0
2020-12-14 09:45,137,95,42,0,0,0
2020-12-14 10:00,128,77,51,0,0,0
2020-12-14 10:15,145,81,64,0,0,0
2020-12-14 10:30,157,74,83,0,0,0
2020-12-14 10:45,156,70,86,0,0,0
2020-12-14 11:00,132,67,65,0,0,0
2020-12-14 11:15,140,81,59,0,0,0
2020-12-14 11:30,107,54,53,0,0,0
2020-12-14 11:45,113,49,64,0,0,0
2020-12-14 12:00,110,55,55,0,0,0
2020-12-14 12:15,153,58,95,0,0,0
2020-12-14 12:30,141,46,95,0,0,0
2020-12-14 12:45,134,64,70,0,0,0
2020-12-14 13:00,140,64,76,0,0,0
2020-12-14 13:15,159,67,92,0,0,0
2020-12-14 13:30,151,78,73,0,0,0
2020-12-14 13:45,158,81,77,0,0,0
2020-12-14 14:00,153,65,88,0,0,0
2020-12-14 14:15,171,80,91,0,0,0
2020-12-14 14:30,150,74,76,0,0,0
2020-12-14 14:45,189,80,109,0,0,0
2020-12-14 15:00,184,95,89,0,0,0
2020-12-14 15:15,177,81,96,0,0,0
2020-12-14 15:30,201,89,112,0,0,0
2020-12-14 15:45,195,83,112,0,0,0
2020-12-14 16:00,217,88,129,0,0,0
2020-12-14 16:15,216,83,133,0,0,0
2020-12-14 16:30,228,94,134,0,0,0
2020-12-14 16:45,220,108,112,0,0,0
2020-12-14 17:00,238,95,143,0,0,0
2020-12-14 17:15,248,119,129,0,0,0
2020-12-14 17:30,230,97,133,0,0,0
2020-12-14 17:45,186,74,112,0,0,0
2020-12-14 18:00,160,66,94,0,0,0
2020-12-14 18:15,171,57,114,0,0,0
2020-12-14 18:30,138,51,87,0,0,0
2020-12-14 18:45,114,34,80,0,0,0
2020-12-14 19:00,120,32,88,0,0,0
2020-12-14 19:15,115,30,85,0,0,0
2020-12-14 19:30,88,29,59,0,0,0
2020-12-14 19:45,65,14,51,0,0,0
2020-12-14 20:00,67,10,57,0,0,0
2020-12-14 20:15,42,7,35,0,0,0
2020-12-14 20:30,55,15,40,0,0,0
2020-12-14 20:45,28,11,17,0,0,0
2020-12-14 21:00,36,8,28,0,0,0
2020-12-14 21:15,40,13,27,0,0,0
2020-12-14 21:30,15,2,13,0,0,0
2020-12-14 21:45,22,12,10,0,0,0
2020-12-14 22:00,21,10,11,0,0,0
2020-12-14 22:15,17,9,8,0,0,0
2020-12-14 22:30,12,5,7,0,0,0
2020-12-14 22:45,13,4,9,0,0,0
2020-12-14 23:00,15,3,12,0,0,0
2020-12-14 23:15,7,5,2,0,0,0
2020-12-14 23:30,6,1,5,0,0,0
2020-12-14 23:45,6,2,4,0,0,0
2020-12-15 00:00,4,2,2,0,0,0
2020-12-15 00:15,3,1,2,0,0,0
2020-12-15 00:30,7,1,6,0,0,0
2020-12-15 00:45,6,0,6,0,0,0
2020-12-15 01:00,1,0,1,0,0,0
2020-12-15 01:15,0,0,0,0,0,0
2020-12-15 01:30,2,0,2,0,0,0
2020-12-15 01:45,0,0,0,0,0,0
2020-12-15 02:00,0,0,0,0,0,0
2020-12-15 02:15,3,1,2,0,0,0
2020-12-15 02:30,1,1,0,0,0,0
2020-12-15 02:45,1,1,0,0,0,0
2020-12-15 03:00,1,1,0,0,0,0
2020-12-15 03:15,1,1,0,0,0,0
2020-12-15 03:30,1,0,1,0,0,0
2020-12-15 03:45,0,0,0,0,0,0
2020-12-15 04:00,0,0,0,0,0,0
2020-12-15 04:15,0,0,0,0,0,0
2020-12-15 04:30,4,4,0,0,0,0
2020-12-15 04:45,1,1,0,0,0,0
2020-12-15 05:00,5,4,1,0,0,0
2020-12-15 05:15,6,4,2,0,0,0
2020-12-15 05:30,18,13,5,0,0,0
2020-12-15 05:45,11,9,2,0,0,0
2020-12-15 06:00,33,19,14,0,0,0
2020-12-15 06:15,33,22,11,0,0,0
2020-12-15 06:30,33,19,14,0,0,0
2020-12-15 06:45,46,26,20,0,0,0
2020-12-15 07:00,65,42,23,0,0,0
2020-12-15 07:15,93,53,40,0,0,0
2020-12-15 07:30,106,72,34,0,0,0
2020-12-15 07:45,139,101,38,0,0,0
2020-12-15 08:00,133,88,45,0,0,0
2020-12-15 08:15,127,90,37,0,0,0
2020-12-15 08:30,140,103,37,0,0,0
2020-12-15 08:45,109,64,45,0,0,0
2020-12-15 09:00,109,70,39,0,0,0
2020-12-15 09:15,104,66,38,0,0,0
2020-12-15 09:30,97,73,24,0,0,0
2020-12-15 09:45,151,110,41,0,0,0
2020-12-15 10:00,129,85,44,0,0,0
2020-12-15 10:15,146,74,72,0,0,0
2020-12-15 10:30,127,69,58,0,0,0
2020-12-15 10:45,130,66,64,0,0,0
2020-12-15 11:00,142,70,72,0,0,0
2020-12-15 11:15,145,70,75,0,0,0
2020-12-15 11:30,130,68,62,0,0,0
2020-12-15 11:45,163,71,92,0,0,0
2020-12-15 12:00,152,49,103,0,0,0
2020-12-15 12:15,132,51,81,0,0,0
2020-12-15 12:30,128,44,84,0,0,0
2020-12-15 12:45,121,49,72,0,0,0
2020-12-15 13:00,144,60,84,0,0,0
2020-12-15 13:15,134,42,92,0,0,0
2020-12-15 13:30,126,51,75,0,0,0
2020-12-15 13:45,115,54,61,0,0,0
2020-12-15 14:00,136,59,77,0,0,0
2020-12-15 14:15,109,41,68,0,0,0
2020-12-15 14:30,126,59,67,0,0,0
2020-12-15 14:45,142,69,73,0,0,0
2020-12-15 15:00,144,61,83,0,0,0
2020-12-15 15:15,160,60,100,0,0,0
2020-12-15 15:30,156,56,100,0,0,0
2020-12-15 15:45,146,52,94,0,0,0
2020-12-15 16:00,148,69,79,0,0,0
2020-12-15 16:15,151,68,83,0,0,0
2020-12-15 16:30,187,77,110,0,0,0
2020-12-15 16:45,171,71,100,0,0,0
2020-12-15 17:00,215,84,131,0,0,0
2020-12-15 17:15,174,73,101,0,0,0
2020-12-15 17:30,179,57,122,0,0,0
2020-12-15 17:45,144,50,94,0,0,0
2020-12-15 18:00,174,67,107,0,0,0
2020-12-15 18:15,150,47,103,0,0,0
2020-12-15 18:30,118,36,82,0,0,0
2020-12-15 18:45,114,42,72,0,0,0
2020-12-15 19:00,102,26,76,0,0,0
2020-12-15 19:15,99,30,69,0,0,0
2020-12-15 19:30,74,20,54,0,0,0
2020-12-15 19:45,77,19,58,0,0,0
2020-12-15 20:00,64,8,56,0,0,0
2020-12-15 20:15,62,13,49,0,0,0
2020-12-15 20:30,30,7,23,0,0,0
2020-12-15 20:45,31,9,22,0,0,0
2020-12-15 21:00,42,13,29,0,0,0
2020-12-15 21:15,27,7,20,0,0,0
2020-12-15 21:30,29,11,18,0,0,0
2020-12-15 21:45,17,4,13,0,0,0
2020-12-15 22:00,16,5,11,0,0,0
2020-12-15 22:15,8,3,5,0,0,0
2020-12-15 22:30,17,8,9,0,0,0
2020-12-15 22:45,13,3,10,0,0,0
2020-12-15 23:00,14,8,6,0,0,0
2020-12-15 23:15,5,2,3,0,0,0
2020-12-15 23:30,10,3,7,0,0,0
2020-12-15 23:45,11,4,7,0,0,0
2020-12-16 00:00,6,3,3,0,0,0
2020-12-16 00:15,4,2,2,0,0,0
2020-12-16 00:30,6,2,4,0,0,0
2020-12-16 00:45,3,2,1,0,0,0
2020-12-16 01:00,0,0,0,0,0,0
2020-12-16 01:15,1,0,1,0,0,0
2020-12-16 01:30,2,2,0,0,0,0
2020-12-16 01:45,4,2,2,0,0,0
2020-12-16 02:00,3,0,3,0,0,0
2020-12-16 02:15,2,0,2,0,0,0
2020-12-16 02:30,1,0,1,0,0,0
2020-12-16 02:45,0,0,0,0,0,0
2020-12-16 03:00,0,0,0,0,0,0
2020-12-16 03:15,2,1,1,0,0,0
2020-12-16 03:30,0,0,0,0,0,0
2020-12-16 03:45,0,0,0,0,0,0
2020-12-16 04:00,1,0,1,0,0,0
2020-12-16 04:15,2,2,0,0,0,0
2020-12-16 04:30,2,2,0,0,0,0
2020-12-16 04:45,2,2,0,0,0,0
2020-12-16 05:00,5,4,1,0,0,0
2020-12-16 05:15,9,3,6,0,0,0
2020-12-16 05:30,14,10,4,0,0,0
2020-12-16 05:45,16,12,4,0,0,0
2020-12-16 06:00,20,12,8,0,0,0
2020-12-16 06:15,33,20,13,0,0,0
2020-12-16 06:30,30,24,6,0,0,0
2020-12-16 06:45,56,32,24,0,0,0
2020-12-16 07:00,59,34,25,0,0,0
2020-12-16 07:15,101,64,37,0,0,0
2020-12-16 07:30,103,66,37,0,0,0
2020-12-16 07:45,115,72,43,0,0,0
2020-12-16 08:00,97,60,37,0,0,0
2020-12-16 08:15,119,76,43,0,0,0
2020-12-16 08:30,92,54,38,0,0,0
2020-12-16 08:45,86,49,37,0,0,0
2020-12-16 09:00,94,69,25,0,0,0
2020-12-16 09:15,79,44,35,0,0,0
2020-12-16 09:30,89,50,39,0,0,0
2020-12-16 09:45,113,72,41,0,0,0
2020-12-16 10:00,107,56,51,0,0,0
2020-12-16 10:15,74,44,30,0,0,0
2020-12-16 10:30,98,50,48,0,0,0
2020-12-16 10:45,124,60,64,0,0,0
2020-12-16 11:00,95,50,45,0,0,0
2020-12-16 11:15,95,44,51,0,0,0
2020-12-16 11:30,124,52,72,0,0,0
2020-12-16 11:45,125,56,69,0,0,0
2020-12-16 12:00,138,53,85,0,0,0
2020-12-16 12:15,119,49,70,0,0,0
2020-12-16 12:30,114,41,73,0,0,0
2020-12-16 12:45,119,43,76,0,0,0
2020-12-16 13:00,101,42,59,0,0,0
2020-12-16 13:15,127,46,81,0,0,0
2020-12-16 13:30,112,38,74,0,0,0
2020-12-16 13:45,105,44,61,0,0,0
2020-12-16 14:00,110,48,62,0,0,0
2020-12-16 14:15,121,52,69,0,0,0
2020-12-16 14:30,118,47,71,0,0,0
2020-12-16 14:45,110,39,71,0,0,0
2020-12-16 15:00,91,35,56,0,0,0
2020-12-16 15:15,114,37,77,0,0,0
2020-12-16 15:30,104,34,70,0,0,0
2020-12-16 15:45,105,34,71,0,0,0
2020-12-16 16:00,121,38,83,0,0,0
2020-12-16 16:15,123,40,83,0,0,0
2020-12-16 16:30,128,47,81,0,0,0
2020-12-16 16:45,123,39,84,0,0,0
2020-12-16 17:00,128,43,85,0,0,0
2020-12-16 17:15,107,42,65,0,0,0
2020-12-16 17:30,94,39,55,0,0,0
2020-12-16 17:45,113,42,71,0,0,0
2020-12-16 18:00,119,30,89,0,0,0
2020-12-16 18:15,61,21,40,0,0,0
2020-12-16 18:30,78,22,56,0,0,0
2020-12-16 18:45,75,21,54,0,0,0
2020-12-16 19:00,61,19,42,0,0,0
2020-12-16 19:15,38,12,26,0,0,0
2020-12-16 19:30,45,18,27,0,0,0
2020-12-16 19:45,54,17,37,0,0,0
2020-12-16 20:00,42,17,25,0,0,0
2020-12-16 20:15,27,14,13,0,0,0
2020-12-16 20:30,23,10,13,0,0,0
2020-12-16 20:45,24,7,17,0,0,0
2020-12-16 21:00,19,5,14,0,0,0
2020-12-16 21:15,19,7,12,0,0,0
2020-12-16 21:30,13,4,9,0,0,0
2020-12-16 21:45,19,4,15,0,0,0
2020-12-16 22:00,9,3,6,0,0,0
2020-12-16 22:15,22,11,11,0,0,0
2020-12-16 22:30,14,5,9,0,0,0
2020-12-16 22:45,13,6,7,0,0,0
2020-12-16 23:00,7,4,3,0,0,0
2020-12-16 23:15,7,4,3,0,0,0
2020-12-16 23:30,9,2,7,0,0,0
2020-12-16 23:45,8,2,6,0,0,0
2020-12-17 00:00,3,1,2,0,0,0
2020-12-17 00:15,3,1,2,0,0,0
2020-12-17 00:30,7,2,5,0,0,0
2020-12-17 00:45,5,2,3,0,0,0
2020-12-17 01:00,2,0,2,0,0,0
2020-12-17 01:15,3,0,3,0,0,0
2020-12-17 01:30,1,0,1,0,0,0
2020-12-17 01:45,1,1,0,0,0,0
2020-12-17 02:00,1,1,0,0,0,0
2020-12-17 02:15,2,2,0,0,0,0
2020-12-17 02:30,0,0,0,0,0,0
2020-12-17 02:45,0,0,0,0,0,0
2020-12-17 03:00,1,0,1,0,0,0
2020-12-17 03:15,1,1,0,0,0,0
2020-12-17 03:30,2,0,2,0,0,0
2020-12-17 03:45,0,0,0,0,0,0
2020-12-17 04:00,0,0,0,0,0,0
2020-12-17 04:15,0,0,0,0,0,0
2020-12-17 04:30,4,3,1,0,0,0
2020-12-17 04:45,3,2,1,0,0,0
2020-12-17 05:00,4,3,1,0,0,0
2020-12-17 05:15,7,3,4,0,0,0
2020-12-17 05:30,12,8,4,0,0,0
2020-12-17 05:45,18,14,4,0,0,0
2020-12-17 06:00,14,10,4,0,0,0
2020-12-17 06:15,32,20,12,0,0,0
2020-12-17 06:30,26,18,8,0,0,0
2020-12-17 06:45,47,28,19,0,0,0
2020-12-17 07:00,47,31,16,0,0,0
2020-12-17 07:15,76,46,30,0,0,0
2020-12-17 07:30,83,56,27,0,0,0
2020-12-17 07:45,103,68,35,0,0,0
2020-12-17 08:00,73,49,24,0,0,0
2020-12-17 08:15,98,67,31,0,0,0
2020-12-17 08:30,72,50,22,0,0,0
2020-12-17 08:45,91,61,30,0,0,0
2020-12-17 09:00,50,32,18,0,0,0
2020-12-17 09:15,38,26,12,0,0,0
2020-12-17 09:30,53,33,20,0,0,0
2020-12-17 09:45,75,43,32,0,0,0
2020-12-17 10:00,52,29,23,0,0,0
2020-12-17 10:15,42,16,26,0,0,0
2020-12-17 10:30,70,39,31,0,0,0
2020-12-17 10:45,58,32,26,0,0,0
2020-12-17 11:00,77,37,40,0,0,0
2020-12-17 11:15,66,33,33,0,0,0
2020-12-17 11:30,78,40,38,0,0,0
2020-12-17 11:45,98,39,59,0,0,0
2020-12-17 12:00,70,30,40,0,0,0
2020-12-17 12:15,88,41,47,0,0,0
2020-12-17 12:30,83,31,52,0,0,0
2020-12-17 12:45,98,54,44,0,0,0
2020-12-17 13:00,85,33,52,0,0,0
2020-12-17 13:15,73,21,52,0,0,0
2020-12-17 13:30,85,39,46,0,0,0
2020-12-17 13:45,80,41,39,0,0,0
2020-12-17 14:00,92,35,57,0,0,0
2020-12-17 14:15,95,40,55,0,0,0
2020-12-17 14:30,119,54,65,0,0,0
2020-12-17 14:45,102,58,44,0,0,0
2020-12-17 15:00,109,43,66,0,0,0
2020-12-17 15:15,100,42,58,0,0,0
2020-12-17 15:30,123,48,75,0,0,0
2020-12-17 15:45,124,47,77,0,0,0
2020-12-17 16:00,131,49,82,0,0,0
2020-12-17 16:15,155,49,106,0,0,0
2020-12-17 16:30,128,50,78,0,0,0
2020-12-17 16:45,113,37,76,0,0,0
2020-12-17 17:00,138,44,94,0,0,0
2020-12-17 17:15,127,48,79,0,0,0
2020-12-17 17:30,81,31,50,0,0,0
2020-12-17 17:45,103,31,72,0,0,0
2020-12-17 18:00,80,31,49,0,0,0
2020-12-17 18:15,93,34,59,0,0,0
2020-12-17 18:30,68,20,48,0,0,0
2020-12-17 18:45,75,30,45,0,0,0
2020-12-17 19:00,75,22,53,0,0,0
2020-12-17 19:15,62,22,40,0,0,0
2020-12-17 19:30,52,27,25,0,0,0
2020-12-17 19:45,36,8,28,0,0,0
2020-12-17 20:00,30,10,20,0,0,0
2020-12-17 20:15,39,12,27,0,0,0
2020-12-17 20:30,16,9,7,0,0,0
2020-12-17 20:45,22,9,13,0,0,0
2020-12-17 21:00,20,8,12,0,0,0
2020-12-17 21:15,21,5,16,0,0,0
2020-12-17 21:30,17,3,14,0,0,0
2020-12-17 21:45,14,7,7,0,0,0
2020-12-17 22:00,19,6,13,0,0,0
2020-12-17 22:15,7,0,7,0,0,0
2020-12-17 22:30,20,4,16,0,0,0
2020-12-17 22:45,10,5,5,0,0,0
2020-12-17 23:00,8,6,2,0,0,0
2020-12-17 23:15,9,3,6,0,0,0
2020-12-17 23:30,5,2,3,0,0,0
2020-12-17 23:45,8,3,5,0,0,0
2020-12-18 00:00,3,0,3,0,0,0
2020-12-18 00:15,5,3,2,0,0,0
2020-12-18 00:30,5,2,3,0,0,0
2020-12-18 00:45,1,0,1,0,0,0
2020-12-18 01:00,0,0,0,0,0,0
2020-12-18 01:15,6,5,1,0,0,0
2020-12-18 01:30,5,2,3,0,0,0
2020-12-18 01:45,2,1,1,0,0,0
2020-12-18 02:00,2,0,2,0,0,0
2020-12-18 02:15,1,0,1,0,0,0
2020-12-18 02:30,0,0,0,0,0,0
2020-12-18 02:45,0,0,0,0,0,0
2020-12-18 03:00,1,0,1,0,0,0
2020-12-18 03:15,1,1,0,0,0,0
2020-12-18 03:30,2,0,2,0,0,0
2020-12-18 03:45,2,0,2,0,0,0
2020-12-18 04:00,1,0,1,0,0,0
2020-12-18 04:15,0,0,0,0,0,0
2020-12-18 04:30,3,2,1,0,0,0
2020-12-18 04:45,3,3,0,0,0,0
2020-12-18 05:00,4,3,1,0,0,0
2020-12-18 05:15,9,5,4,0,0,0
2020-12-18 05:30,6,4,2,0,0,0
2020-12-18 05:45,17,12,5,0,0,0
2020-12-18 06:00,21,13,8,0,0,0
2020-12-18 06:15,28,21,7,0,0,0
2020-12-18 06:30,32,21,11,0,0,0
2020-12-18 06:45,60,41,19,0,0,0
2020-12-18 07:00,51,30,21,0,0,0
2020-12-18 07:15,82,40,42,0,0,0
2020-12-18 07:30,81,56,25,0,0,0
2020-12-18 07:45,98,65,33,0,0,0
2020-12-18 08:00,79,54,25,0,0,0
2020-12-18 08:15,83,58,25,0,0,0
2020-12-18 08:30,83,50,33,0,0,0
2020-12-18 08:45,89,63,26,0,0,0
2020-12-18 09:00,65,39,26,0,0,0
2020-12-18 09:15,67,41,26,0,0,0
2020-12-18 09:30,74,45,29,0,0,0
2020-12-18 09:45,100,52,48,0,0,0
2020-12-18 10:00,80,41,39,0,0,0
2020-12-18 10:15,105,58,47,0,0,0
2020-12-18 10:30,91,47,44,0,0,0
2020-12-18 10:45,89,41,48,0,0,0
2020-12-18 11:00,80,38,42,0,0,0
2020-12-18 11:15,93,49,44,0,0,0
2020-12-18 11:30,92,48,44,0,0,0
2020-12-18 11:45,107,53,54,0,0,0
2020-12-18 12:00,115,41,74,0,0,0
2020-12-18 12:15,119,46,73,0,0,0
2020-12-18 12:30,114,56,58,0,0,0
2020-12-18 12:45,106,38,68,0,0,0
2020-12-18 13:00,103,48,55,0,0,0
2020-12-18 13:15,108,52,56,0,0,0
2020-12-18 13:30,130,52,78,0,0,0
2020-12-18 13:45,132,52,80,0,0,0
2020-12-18 14:00,135,59,76,0,0,0
2020-12-18 14:15,122,48,74,0,0,0
2020-12-18 14:30,130,59,71,0,0,0
2020-12-18 14:45,136,67,69,0,0,0
2020-12-18 15:00,129,56,73,0,0,0
2020-12-18 15:15,123,62,61,0,0,0
2020-12-18 15:30,132,61,71,0,0,0
2020-12-18 15:45,139,54,85,0,0,0
2020-12-18 16:00,126,53,73,0,0,0
2020-12-18 16:15,145,54,91,0,0,0
2020-12-18 16:30,113,47,66,0,0,0
2020-12-18 16:45,114,42,72,0,0,0
2020-12-18 17:00,103,35,68,0,0,0
2020-12-18 17:15,108,41,67,0,0,0
2020-12-18 17:30,86,27,59,0,0,0
2020-12-18 17:45,75,27,48,0,0,0
2020-12-18 18:00,92,32,60,0,0,0
2020-12-18 18:15,68,25,43,0,0,0
2020-12-18 18:30,63,22,41,0,0,0
2020-12-18 18:45,62,22,40,0,0,0
2020-12-18 19:00,66,21,45,0,0,0
2020-12-18 19:15,36,15,21,0,0,0
2020-12-18 19:30,38,15,23,0,0,0
2020-12-18 19:45,40,16,24,0,0,0
2020-12-18 20:00,29,12,17,0,0,0
2020-12-18 20:15,44,13,31,0,0,0
2020-12-18 20:30,34,11,23,0,0,0
2020-12-18 20:45,19,8,11,0,0,0
2020-12-18 21:00,23,8,15,0,0,0
2020-12-18 21:15,21,5,16,0,0,0
2020-12-18 21:30,10,4,6,0,0,0
2020-12-18 21:45,13,7,6,0,0,0
2020-12-18 22:00,14,5,9,0,0,0
2020-12-18 22:15,5,2,3,0,0,0
2020-12-18 22:30,16,6,10,0,0,0
2020-12-18 22:45,17,8,9,0,0,0
2020-12-18 23:00,13,6,7,0,0,0
2020-12-18 23:15,10,6,4,0,0,0
2020-12-18 23:30,11,5,6,0,0,0
2020-12-18 23:45,9,7,2,0,0,0
2020-12-19 00:00,3,0,3,0,0,0
2020-12-19 00:15,14,8,6,0,0,0
2020-12-19 00:30,1,1,0,0,0,0
2020-12-19 00:45,13,5,8,0,0,0
2020-12-19 01:00,6,2,4,0,0,0
2020-12-19 01:15,5,1,4,0,0,0
2020-12-19 01:30,2,1,1,0,0,0
2020-12-19 01:45,2,1,1,0,0,0
2020-12-19 02:00,2,1,1,0,0,0
2020-12-19 02:15,2,1,1,0,0,0
2020-12-19 02:30,6,1,5,0,0,0
2020-12-19 02:45,0,0,0,0,0,0
2020-12-19 03:00,0,0,0,0,0,0
2020-12-19 03:15,0,0,0,0,0,0
2020-12-19 03:30,4,4,0,0,0,0
2020-12-19 03:45,1,0,1,0,0,0
2020-12-19 04:00,7,3,4,0,0,0
2020-12-19 04:15,0,0,0,0,0,0
2020-12-19 04:30,3,0,3,0,0,0
2020-12-19 04:45,1,1,0,0,0,0
2020-12-19 05:00,4,0,4,0,0,0
2020-12-19 05:15,6,2,4,0,0,0
2020-12-19 05:30,5,4,1,0,0,0
2020-12-19 05:45,16,8,8,0,0,0
2020-12-19 06:00,3,3,0,0,0,0
2020-12-19 06:15,9,8,1,0,0,0
2020-12-19 06:30,13,7,6,0,0,0
2020-12-19 06:45,16,10,6,0,0,0
2020-12-19 07:00,14,10,4,0,0,0
2020-12-19 07:15,19,9,10,0,0,0
2020-12-19 07:30,30,20,10,0,0,0
2020-12-19 07:45,30,16,14,0,0,0
2020-12-19 08:00,32,18,14,0,0,0
2020-12-19 08:15,35,23,12,0,0,0
2020-12-19 08:30,41,19,22,0,0,0
2020-12-19 08:45,62,30,32,0,0,0
2020-12-19 09:00,42,22,20,0,0,0
2020-12-19 09:15,44,29,15,0,0,0
2020-12-19 09:30,77,39,38,0,0,0
2020-12-19 09:45,63,37,26,0,0,0
2020-12-19 10:00,53,26,27,0,0,0
2020-12-19 10:15,91,45,46,0,0,0
2020-12-19 10:30,60,36,24,0,0,0
2020-12-19 10:45,85,42,43,0,0,0
2020-12-19 11:00,85,45,40,0,0,0
2020-12-19 11:15,120,62,58,0,0,0
2020-12-19 11:30,94,37,57,0,0,0
2020-12-19 11:45,102,58,44,0,0,0
2020-12-19 12:00,130,73,57,0,0,0
2020-12-19 12:15,130,70,60,0,0,0
2020-12-19 12:30,108,62,46,0,0,0
2020-12-19 12:45,121,59,62,0,0,0
2020-12-19 13:00,125,56,69,0,0,0
2020-12-19 13:15,152,77,75,0,0,0
2020-12-19 13:30,138,64,74,0,0,0
2020-12-19 13:45,144,72,72,0,0,0
2020-12-19 14:00,146,66,80,0,0,0
2020-12-19 14:15,149,61,88,0,0,0
2020-12-19 14:30,127,48,79,0,0,0
2020-12-19 14:45,101,41,60,0,0,0
2020-12-19 15:00,108,37,71,0,0,0
2020-12-19 15:15,102,39,63,0,0,0
2020-12-19 15:30,86,39,47,0,0,0
2020-12-19 15:45,106,38,68,0,0,0
2020-12-19 16:00,77,30,47,0,0,0
2020-12-19 16:15,105,47,58,0,0,0
2020-12-19 16:30,77,28,49,0,0,0
2020-12-19 16:45,61,26,35,0,0,0
2020-12-19 17:00,45,17,28,0,0,0
2020-12-19 17:15,63,28,35,0,0,0
2020-12-19 17:30,54,16,38,0,0,0
2020-12-19 17:45,65,31,34,0,0,0
2020-12-19 18:00,70,24,46,0,0,0
2020-12-19 18:15,67,29,38,0,0,0
2020-12-19 18:30,47,19,28,0,0,0
2020-12-19 18:45,41,21,20,0,0,0
2020-12-19 19:00,41,16,25,0,0,0
2020-12-19 19:15,36,12,24,0,0,0
2020-12-19 19:30,23,11,12,0,0,0
2020-12-19 19:45,25,9,16,0,0,0
2020-12-19 20:00,28,13,15,0,0,0
2020-12-19 20:15,18,9,9,0,0,0
2020-12-19 20:30,25,9,16,0,0,0
2020-12-19 20:45,33,9,24,0,0,0
2020-12-19 21:00,28,12,16,0,0,0
2020-12-19 21:15,13,8,5,0,0,0
2020-12-19 21:30,19,13,6,0,0,0
2020-12-19 21:45,16,4,12,0,0,0
2020-12-19 22:00,15,7,8,0,0,0
2020-12-19 22:15,10,4,6,0,0,0
2020-12-19 22:30,14,8,6,0,0,0
2020-12-19 22:45,9,3,6,0,0,0
2020-12-19 23:00,9,5,4,0,0,0
2020-12-19 23:15,11,8,3,0,0,0
2020-12-19 23:30,11,4,7,0,0,0
2020-12-19 23:45,12,5,7,0,0,0
2020-12-20 00:00,7,2,5,0,0,0
2020-12-20 00:15,10,5,5,0,0,0
2020-12-20 00:30,16,12,4,0,0,0
2020-12-20 00:45,6,2,4,0,0,0
2020-12-20 01:00,12,7,5,0,0,0
2020-12-20 01:15,5,2,3,0,0,0
2020-12-20 01:30,7,2,5,0,0,0
2020-12-20 01:45,5,1,4,0,0,0
2020-12-20 02:00,12,5,7,0,0,0
2020-12-20 02:15,0,0,0,0,0,0
2020-12-20 02:30,2,2,0,0,0,0
2020-12-20 02:45,2,1,1,0,0,0
2020-12-20 03:00,3,3,0,0,0,0
2020-12-20 03:15,0,0,0,0,0,0
2020-12-20 03:30,2,2,0,0,0,0
2020-12-20 03:45,1,1,0,0,0,0
2020-12-20 04:00,1,1,0,0,0,0
2020-12-20 04:15,0,0,0,0,0,0
2020-12-20 04:30,2,1,1,0,0,0
2020-12-20 04:45,1,1,0,0,0,0
2020-12-20 05:00,2,1,1,0,0,0
2020-12-20 05:15,4,2,2,0,0,0
2020-12-20 05:30,9,5,4,0,0,0
2020-12-20 05:45,1,1,0,0,0,0
2020-12-20 06:00,3,2,1,0,0,0
2020-12-20 06:15,3,1,2,0,0,0
2020-12-20 06:30,8,3,5,0,0,0
2020-12-20 06:45,4,3,1,0,0,0
2020-12-20 07:00,1,0,1,0,0,0
2020-12-20 07:15,4,3,1,0,0,0
2020-12-20 07:30,6,4,2,0,0,0
2020-12-20 07:45,7,4,3,0,0,0
2020-12-20 08:00,9,2,7,0,0,0
2020-12-20 08:15,5,3,2,0,0,0
2020-12-20 08:30,11,5,6,0,0,0
2020-12-20 08:45,7,5,2,0,0,0
2020-12-20 09:00,5,3,2,0,0,0
2020-12-20 09:15,10,5,5,0,0,0
2020-12-20 09:30,20,13,7,0,0,0
2020-12-20 09:45,35,25,10,0,0,0
2020-12-20 10:00,25,15,10,0,0,0
2020-12-20 10:15,24,12,12,0,0,0
2020-12-20 10:30,36,21,15,0,0,0
2020-12-20 10:45,27,11,16,0,0,0
2020-12-20 11:00,32,16,16,0,0,0
2020-12-20 11:15,35,15,20,0,0,0
2020-12-20 11:30,19,9,10,0,0,0
2020-12-20 11:45,38,23,15,0,0,0
2020-12-20 12:00,48,25,23,0,0,0
2020-12-20 12:15,46,27,19,0,0,0
2020-12-20 12:30,47,21,26,0,0,0
2020-12-20 12:45,70,38,32,0,0,0
2020-12-20 13:00,40,24,16,0,0,0
2020-12-20 13:15,57,22,35,0,0,0
2020-12-20 13:30,58,28,30,0,0,0
2020-12-20 13:45,73,43,30,0,0,0
2020-12-20 14:00,73,35,38,0,0,0
2020-12-20 14:15,54,26,28,0,0,0
2020-12-20 14:30,75,35,40,0,0,0
2020-12-20 14:45,73,34,39,0,0,0
2020-12-20 15:00,53,26,27,0,0,0
2020-12-20 15:15,74,28,46,0,0,0
2020-12-20 15:30,59,26,33,0,0,0
2020-12-20 15:45,75,40,35,0,0,0
2020-12-20 16:00,51,20,31,0,0,0
2020-12-20 16:15,59,34,25,0,0,0
2020-12-20 16:30,52,29,23,0,0,0
2020-12-20 16:45,68,31,37,0,0,0
2020-12-20 17:00,53,16,37,0,0,0
2020-12-20 17:15,35,16,19,0,0,0
2020-12-20 17:30,43,22,21,0,0,0
2020-12-20 17:45,45,22,23,0,0,0
2020-12-20 18:00,35,18,17,0,0,0
2020-12-20 18:15,43,16,27,0,0,0
2020-12-20 18:30,28,13,15,0,0,0
2020-12-20 18:45,38,16,22,0,0,0
2020-12-20 19:00,43,12,31,0,0,0
2020-12-20 19:15,25,6,19,0,0,0
2020-12-20 19:30,19,7,12,0,0,0
2020-12-20 19:45,27,9,18,0,0,0
2020-12-20 20:00,27,8,19,0,0,0
2020-12-20 20:15,18,7,11,0,0,0
2020-12-20 20:30,10,2,8,0,0,0
2020-12-20 20:45,15,7,8,0,0,0
2020-12-20 21:00,17,12,5,0,0,0
2020-12-20 21:15,4,2,2,0,0,0
2020-12-20 21:30,12,3,9,0,0,0
2020-12-20 21:45,8,0,8,0,0,0
2020-12-20 22:00,4,2,2,0,0,0
2020-12-20 22:15,6,1,5,0,0,0
2020-12-20 22:30,9,2,7,0,0,0
2020-12-20 22:45,8,3,5,0,0,0
2020-12-20 23:00,2,2,0,0,0,0
2020-12-20 23:15,5,3,2,0,0,0
2020-12-20 23:30,3,1,2,0,0,0
2020-12-20 23:45,4,0,4,0,0,0
2020-12-21 00:00,2,1,1,0,0,0
2020-12-21 00:15,8,4,4,0,0,0
2020-12-21 00:30,3,3,0,0,0,0
2020-12-21 00:45,0,0,0,0,0,0
2020-12-21 01:00,5,4,1,0,0,0
2020-12-21 01:15,2,1,1,0,0,0
2020-12-21 01:30,3,3,0,0,0,0
2020-12-21 01:45,2,0,2,0,0,0
2020-12-21 02:00,2,2,0,0,0,0
2020-12-21 02:15,2,2,0,0,0,0
2020-12-21 02:30,0,0,0,0,0,0
2020-12-21 02:45,1,0,1,0,0,0
2020-12-21 03:00,0,0,0,0,0,0
2020-12-21 03:15,2,0,2,0,0,0
2020-12-21 03:30,0,0,0,0,0,0
2020-12-21 03:45,1,0,1,0,0,0
2020-12-21 04:00,0,0,0,0,0,0
2020-12-21 04:15,0,0,0,0,0,0
2020-12-21 04:30,3,3,0,0,0,0
2020-12-21 04:45,1,1,0,0,0,0
2020-12-21 05:00,4,1,3,0,0,0
2020-12-21 05:15,7,7,0,0,0,0
2020-12-21 05:30,9,8,1,0,0,0
2020-12-21 05:45,9,9,0,0,0,0
2020-12-21 06:00,20,13,7,0,0,0
2020-12-21 06:15,27,23,4,0,0,0
2020-12-21 06:30,27,16,11,0,0,0
2020-12-21 06:45,39,24,15,0,0,0
2020-12-21 07:00,49,27,22,0,0,0
2020-12-21 07:15,60,36,24,0,0,0
2020-12-21 07:30,73,46,27,0,0,0
2020-12-21 07:45,86,60,26,0,0,0
2020-12-21 08:00,61,46,15,0,0,0
2020-12-21 08:15,64,39,25,0,0,0
2020-12-21 08:30,58,36,22,0,0,0
2020-12-21 08:45,99,73,26,0,0,0
2020-12-21 09:00,60,34,26,0,0,0
2020-12-21 09:15,52,32,20,0,0,0
2020-12-21 09:30,77,42,35,0,0,0
2020-12-21 09:45,86,52,34,0,0,0
2020-12-21 10:00,58,31,27,0,0,0
2020-12-21 10:15,67,31,36,0,0,0
2020-12-21 10:30,77,38,39,0,0,0
2020-12-21 10:45,103,50,53,0,0,0
2020-12-21 11:00,93,40,53,0,0,0
2020-12-21 11:15,107,44,63,0,0,0
2020-12-21 11:30,87,33,54,0,0,0
2020-12-21 11:45,88,48,40,0,0,0
2020-12-21 12:00,89,37,52,0,0,0
2020-12-21 12:15,113,50,63,0,0,0
2020-12-21 12:30,91,33,58,0,0,0
2020-12-21 12:45,83,39,44,0,0,0
2020-12-21 13:00,83,32,51,0,0,0
2020-12-21 13:15,74,24,50,0,0,0
2020-12-21 13:30,66,25,41,0,0,0
2020-12-21 13:45,77,43,34,0,0,0
2020-12-21 14:00,73,30,43,0,0,0
2020-12-21 14:15,67,26,41,0,0,0
2020-12-21 14:30,72,30,42,0,0,0
2020-12-21 14:45,78,34,44,0,0,0
2020-12-21 15:00,76,32,44,0,0,0
2020-12-21 15:15,80,34,46,0,0,0
2020-12-21 15:30,70,36,34,0,0,0
2020-12-21 15:45,79,33,46,0,0,0
2020-12-21 16:00,100,41,59,0,0,0
2020-12-21 16:15,98,38,60,0,0,0
2020-12-21 16:30,83,41,42,0,0,0
2020-12-21 16:45,81,36,45,0,0,0
2020-12-21 17:00,79,32,47,0,0,0
2020-12-21 17:15,68,20,48,0,0,0
2020-12-21 17:30,81,28,53,0,0,0
2020-12-21 17:45,81,27,54,0,0,0
2020-12-21 18:00,71,17,54,0,0,0
2020-12-21 18:15,68,27,41,0,0,0
2020-12-21 18:30,58,21,37,0,0,0
2020-12-21 18:45,40,14,26,0,0,0
2020-12-21 19:00,33,13,20,0,0,0
2020-12-21 19:15,38,14,24,0,0,0
2020-12-21 19:30,28,8,20,0,0,0
2020-12-21 19:45,31,14,17,0,0,0
2020-12-21 20:00,30,16,14,0,0,0
2020-12-21 20:15,18,6,12,0,0,0
2020-12-21 20:30,21,13,8,0,0,0
2020-12-21 20:45,16,6,10,0,0,0
2020-12-21 21:00,9,4,5,0,0,0
2020-12-21 21:15,8,4,4,0,0,0
2020-12-21 21:30,11,8,3,0,0,0
2020-12-21 21:45,14,2,12,0,0,0
2020-12-21 22:00,7,1,6,0,0,0
2020-12-21 22:15,3,1,2,0,0,0
2020-12-21 22:30,3,2,1,0,0,0
2020-12-21 22:45,6,4,2,0,0,0
2020-12-21 23:00,5,2,3,0,0,0
2020-12-21 23:15,3,2,1,0,0,0
2020-12-21 23:30,3,2,1,0,0,0
2020-12-21 23:45,5,2,3,0,0,0
2020-12-22 00:00,1,0,1,0,0,0
2020-12-22 00:15,2,1,1,0,0,0
2020-12-22 00:30,2,1,1,0,0,0
2020-12-22 00:45,2,0,2,0,0,0
2020-12-22 01:00,4,1,3,0,0,0
2020-12-22 01:15,2,1,1,0,0,0
2020-12-22 01:30,1,0,1,0,0,0
2020-12-22 01:45,0,0,0,0,0,0
2020-12-22 02:00,4,1,3,0,0,0
2020-12-22 02:15,2,0,2,0,0,0
2020-12-22 02:30,0,0,0,0,0,0
2020-12-22 02:45,0,0,0,0,0,0
2020-12-22 03:00,1,0,1,0,0,0
2020-12-22 03:15,2,0,2,0,0,0
2020-12-22 03:30,1,1,0,0,0,0
2020-12-22 03:45,0,0,0,0,0,0
2020-12-22 04:00,0,0,0,0,0,0
2020-12-22 04:15,1,1,0,0,0,0
2020-12-22 04:30,3,3,0,0,0,0
2020-12-22 04:45,2,2,0,0,0,0
2020-12-22 05:00,3,2,1,0,0,0
2020-12-22 05:15,5,4,1,0,0,0
2020-12-22 05:30,6,5,1,0,0,0
2020-12-22 05:45,13,12,1,0,0,0
2020-12-22 06:00,11,8,3,0,0,0
2020-12-22 06:15,21,16,5,0,0,0
2020-12-22 06:30,20,15,5,0,0,0
2020-12-22 06:45,32,22,10,0,0,0
2020-12-22 07:00,29,14,15,0,0,0
2020-12-22 07:15,36,24,12,0,0,0
2020-12-22 07:30,47,27,20,0,0,0
2020-12-22 07:45,57,35,22,0,0,0
2020-12-22 08:00,48,33,15,0,0,0
2020-12-22 08:15,42,30,12,0,0,0
2020-12-22 08:30,59,44,15,0,0,0
2020-12-22 08:45,44,27,17,0,0,0
2020-12-22 09:00,29,22,7,0,0,0
2020-12-22 09:15,26,14,12,0,0,0
2020-12-22 09:30,48,22,26,0,0,0
2020-12-22 09:45,42,31,11,0,0,0
2020-12-22 10:00,32,13,19,0,0,0
2020-12-22 10:15,49,16,33,0,0,0
2020-12-22 10:30,59,26,33,0,0,0
2020-12-22 10:45,77,36,41,0,0,0
2020-12-22 11:00,76,36,40,0,0,0
2020-12-22 11:15,82,37,45,0,0,0
2020-12-22 11:30,76,31,45,0,0,0
2020-12-22 11:45,69,27,42,0,0,0
2020-12-22 12:00,64,27,37,0,0,0
2020-12-22 12:15,65,29,36,0,0,0
2020-12-22 12:30,73,30,43,0,0,0
2020-12-22 12:45,70,29,41,0,0,0
2020-12-22 13:00,51,20,31,0,0,0
2020-12-22 13:15,83,37,46,0,0,0
2020-12-22 13:30,87,35,52,0,0,0
2020-12-22 13:45,83,45,38,0,0,0
2020-12-22 14:00,81,41,40,0,0,0
2020-12-22 14:15,84,35,49,0,0,0
2020-12-22 14:30,96,43,53,0,0,0
2020-12-22 14:45,97,47,50,0,0,0
2020-12-22 15:00,105,39,66,0,0,0
2020-12-22 15:15,110,38,72,0,0,0
2020-12-22 15:30,85,33,52,0,0,0
2020-12-22 15:45,98,44,54,0,0,0
2020-12-22 16:00,99,37,62,0,0,0
2020-12-22 16:15,97,40,57,0,0,0
2020-12-22 16:30,105,39,66,0,0,0
2020-12-22 16:45,109,32,77,0,0,0
2020-12-22 17:00,75,27,48,0,0,0
2020-12-22 17:15,103,44,59,0,0,0
2020-12-22 17:30,80,22,58,0,0,0
2020-12-22 17:45,71,35,36,0,0,0
2020-12-22 18:00,78,17,61,0,0,0
2020-12-22 18:15,67,25,42,0,0,0
2020-12-22 18:30,53,17,36,0,0,0
2020-12-22 18:45,51,22,29,0,0,0
2020-12-22 19:00,57,22,35,0,0,0
2020-12-22 19:15,38,14,24,0,0,0
2020-12-22 19:30,36,22,14,0,0,0
2020-12-22 19:45,45,11,34,0,0,0
2020-12-22 20:00,28,12,16,0,0,0
2020-12-22 20:15,23,7,16,0,0,0
2020-12-22 20:30,17,8,9,0,0,0
2020-12-22 20:45,18,4,14,0,0,0
2020-12-22 21:00,12,3,9,0,0,0
2020-12-22 21:15,15,4,11,0,0,0
2020-12-22 21:30,13,5,8,0,0,0
2020-12-22 21:45,12,7,5,0,0,0
2020-12-22 22:00,9,4,5,0,0,0
2020-12-22 22:15,9,4,5,0,0,0
2020-12-22 22:30,7,3,4,0,0,0
2020-12-22 22:45,6,1,5,0,0,0
2020-12-22 23:00,6,1,5,0,0,0
2020-12-22 23:15,8,1,7,0,0,0
2020-12-22 23:30,1,1,0,0,0,0
2020-12-22 23:45,5,2,3,0,0,0
2020-12-23 00:00,9,4,5,0,0,0
2020-12-23 00:15,3,3,0,0,0,0
2020-12-23 00:30,4,0,4,0,0,0
2020-12-23 00:45,6,1,5,0,0,0
2020-12-23 01:00,7,2,5,0,0,0
2020-12-23 01:15,5,0,5,0,0,0
2020-12-23 01:30,3,3,0,0,0,0
2020-12-23 01:45,5,3,2,0,0,0
2020-12-23 02:00,0,0,0,0,0,0
2020-12-23 02:15,1,0,1,0,0,0
2020-12-23 02:30,2,2,0,0,0,0
2020-12-23 02:45,0,0,0,0,0,0
2020-12-23 03:00,0,0,0,0,0,0
2020-12-23 03:15,2,0,2,0,0,0
2020-12-23 03:30,4,3,1,0,0,0
2020-12-23 03:45,0,0,0,0,0,0
2020-12-23 04:00,3,0,3,0,0,0
2020-12-23 04:15,1,1,0,0,0,0
2020-12-23 04:30,1,1,0,0,0,0
2020-12-23 04:45,4,3,1,0,0,0
2020-12-23 05:00,5,3,2,0,0,0
2020-12-23 05:15,3,2,1,0,0,0
2020-12-23 05:30,6,5,1,0,0,0
2020-12-23 05:45,7,5,2,0,0,0
2020-12-23 06:00,15,9,6,0,0,0
2020-12-23 06:15,23,16,7,0,0,0
2020-12-23 06:30,27,18,9,0,0,0
2020-12-23 06:45,30,20,10,0,0,0
2020-12-23 07:00,44,24,20,0,0,0
2020-12-23 07:15,51,31,20,0,0,0
2020-12-23 07:30,56,36,20,0,0,0
2020-12-23 07:45,69,36,33,0,0,0
2020-12-23 08:00,48,31,17,0,0,0
2020-12-23 08:15,60,39,21,0,0,0
2020-12-23 08:30,71,36,35,0,0,0
2020-12-23 08:45,64,39,25,0,0,0
2020-12-23 09:00,56,33,23,0,0,0
2020-12-23 09:15,49,32,17,0,0,0
2020-12-23 09:30,62,46,16,0,0,0
2020-12-23 09:45,68,44,24,0,0,0
2020-12-23 10:00,76,36,40,0,0,0
2020-12-23 10:15,62,31,31,0,0,0
2020-12-23 10:30,85,41,44,0,0,0
2020-12-23 10:45,91,49,42,0,0,0
2020-12-23 11:00,82,42,40,0,0,0
2020-12-23 11:15,80,37,43,0,0,0
2020-12-23 11:30,115,66,49,0,0,0
2020-12-23 11:45,103,51,52,0,0,0
2020-12-23 12:00,105,47,58,0,0,0
2020-12-23 12:15,99,44,55,0,0,0
2020-12-23 12:30,102,48,54,0,0,0
2020-12-23 12:45,110,51,59,0,0,0
2020-12-23 13:00,96,37,59,0,0,0
2020-12-23 13:15,86,39,47,0,0,0
2020-12-23 13:30,95,39,56,0,0,0
2020-12-23 13:45,101,44,57,0,0,0
2020-12-23 14:00,69,22,47,0,0,0
2020-12-23 14:15,87,24,63,0,0,0
2020-12-23 14:30,64,28,36,0,0,0
2020-12-23 14:45,61,23,38,0,0,0
2020-12-23 15:00,68,23,45,0,0,0
2020-12-23 15:15,56,21,35,0,0,0
2020-12-23 15:30,59,15,44,0,0,0
2020-12-23 15:45,52,20,32,0,0,0
2020-12-23 16:00,91,37,54,0,0,0
2020-12-23 16:15,69,23,46,0,0,0
2020-12-23 16:30,70,37,33,0,0,0
2020-12-23 16:45,75,30,45,0,0,0
2020-12-23 17:00,78,41,37,0,0,0
2020-12-23 17:15,64,25,39,0,0,0
2020-12-23 17:30,62,21,41,0,0,0
2020-12-23 17:45,45,20,25,0,0,0
2020-12-23 18:00,38,14,24,0,0,0
2020-12-23 18:15,49,17,32,0,0,0
2020-12-23 18:30,45,21,24,0,0,0
2020-12-23 18:45,30,9,21,0,0,0
2020-12-23 19:00,36,8,28,0,0,0
2020-12-23 19:15,23,11,12,0,0,0
2020-12-23 19:30,20,5,15,0,0,0
2020-12-23 19:45,25,10,15,0,0,0
2020-12-23 20:00,24,9,15,0,0,0
2020-12-23 20:15,18,10,8,0,0,0
2020-12-23 20:30,19,10,9,0,0,0
2020-12-23 20:45,16,3,13,0,0,0
2020-12-23 21:00,14,4,10,0,0,0
2020-12-23 21:15,15,6,9,0,0,0
2020-12-23 21:30,11,5,6,0,0,0
2020-12-23 21:45,4,3,1,0,0,0
2020-12-23 22:00,12,4,8,0,0,0
2020-12-23 22:15,6,2,4,0,0,0
2020-12-23 22:30,13,5,8,0,0,0
2020-12-23 22:45,6,5,1,0,0,0
2020-12-23 23:00,8,3,5,0,0,0
2020-12-23 23:15,8,3,5,0,0,0
2020-12-23 23:30,2,0,2,0,0,0
2020-12-23 23:45,2,1,1,0,0,0
2020-12-24 00:00,4,3,1,0,0,0
2020-12-24 00:15,3,2,1,0,0,0
2020-12-24 00:30,3,0,3,0,0,0
2020-12-24 00:45,0,0,0,0,0,0
2020-12-24 01:00,1,0,1,0,0,0
2020-12-24 01:15,3,2,1,0,0,0
2020-12-24 01:30,1,1,0,0,0,0
2020-12-24 01:45,1,0,1,0,0,0
2020-12-24 02:00,0,0,0,0,0,0
2020-12-24 02:15,0,0,0,0,0,0
2020-12-24 02:30,0,0,0,0,0,0
2020-12-24 02:45,2,1,1,0,0,0
2020-12-24 03:00,0,0,0,0,0,0
2020-12-24 03:15,2,1,1,0,0,0
2020-12-24 03:30,1,0,1,0,0,0
2020-12-24 03:45,1,0,1,0,0,0
2020-12-24 04:00,2,0,2,0,0,0
2020-12-24 04:15,2,2,0,0,0,0
2020-12-24 04:30,2,1,1,0,0,0
2020-12-24 04:45,4,3,1,0,0,0
2020-12-24 05:00,1,1,0,0,0,0
2020-12-24 05:15,2,0,2,0,0,0
2020-12-24 05:30,13,10,3,0,0,0
2020-12-24 05:45,7,3,4,0,0,0
2020-12-24 06:00,3,2,1,0,0,0
2020-12-24 06:15,6,6,0,0,0,0
2020-12-24 06:30,10,9,1,0,0,0
2020-12-24 06:45,9,8,1,0,0,0
2020-12-24 07:00,11,6,5,0,0,0
2020-12-24 07:15,18,9,9,0,0,0
2020-12-24 07:30,13,6,7,0,0,0
2020-12-24 07:45,11,7,4,0,0,0
2020-12-24 08:00,15,8,7,0,0,0
2020-12-24 08:15,22,10,12,0,0,0
2020-12-24 08:30,23,12,11,0,0,0
2020-12-24 08:45,27,13,14,0,0,0
2020-12-24 09:00,30,13,17,0,0,0
2020-12-24 09:15,19,14,5,0,0,0
2020-12-24 09:30,23,14,9,0,0,0
2020-12-24 09:45,31,12,19,0,0,0
2020-12-24 10:00,33,18,15,0,0,0
2020-12-24 10:15,51,22,29,0,0,0
2020-12-24 10:30,50,26,24,0,0,0
2020-12-24 10:45,63,32,31,0,0,0
2020-12-24 11:00,56,36,20,0,0,0
2020-12-24 11:15,62,27,35,0,0,0
2020-12-24 11:30,59,26,33,0,0,0
2020-12-24 11:45,57,29,28,0,0,0
2020-12-24 12:00,55,17,38,0,0,0
2020-12-24 12:15,56,22,34,0,0,0
2020-12-24 12:30,49,13,36,0,0,0
2020-12-24 12:45,33,16,17,0,0,0
2020-12-24 13:00,46,18,28,0,0,0
2020-12-24 13:15,45,19,26,0,0,0
2020-12-24 13:30,31,12,19,0,0,0
2020-12-24 13:45,37,17,20,0,0,0
2020-12-24 14:00,38,16,22,0,0,0
2020-12-24 14:15,27,11,16,0,0,0
2020-12-24 14:30,22,9,13,0,0,0
2020-12-24 14:45,35,15,20,0,0,0
2020-12-24 15:00,22,15,7,0,0,0
2020-12-24 15:15,17,6,11,0,0,0
2020-12-24 15:30,18,8,10,0,0,0
2020-12-24 15:45,17,7,10,0,0,0
2020-12-24 16:00,25,14,11,0,0,0
2020-12-24 16:15,22,4,18,0,0,0
2020-12-24 16:30,28,11,17,0,0,0
2020-12-24 16:45,22,12,10,0,0,0
2020-12-24 17:00,24,4,20,0,0,0
2020-12-24 17:15,17,10,7,0,0,0
2020-12-24 17:30,17,12,5,0,0,0
2020-12-24 17:45,14,9,5,0,0,0
2020-12-24 18:00,11,4,7,0,0,0
2020-12-24 18:15,15,4,11,0,0,0
2020-12-24 18:30,6,3,3,0,0,0
2020-12-24 18:45,12,3,9,0,0,0
2020-12-24 19:00,10,4,6,0,0,0
2020-12-24 19:15,5,1,4,0,0,0
2020-12-24 19:30,4,1,3,0,0,0
2020-12-24 19:45,4,2,2,0,0,0
2020-12-24 20:00,9,5,4,0,0,0
2020-12-24 20:15,2,0,2,0,0,0
2020-12-24 20:30,9,3,6,0,0,0
2020-12-24 20:45,2,0,2,0,0,0
2020-12-24 21:00,3,2,1,0,0,0
2020-12-24 21:15,5,2,3,0,0,0
2020-12-24 21:30,15,6,9,0,0,0
2020-12-24 21:45,7,4,3,0,0,0
2020-12-24 22:00,6,2,4,0,0,0
2020-12-24 22:15,6,4,2,0,0,0
2020-12-24 22:30,8,3,5,0,0,0
2020-12-24 22:45,7,5,2,0,0,0
2020-12-24 23:00,7,2,5,0,0,0
2020-12-24 23:15,7,5,2,0,0,0
2020-12-24 23:30,10,4,6,0,0,0
2020-12-24 23:45,6,5,1,0,0,0
2020-12-25 00:00,9,4,5,0,0,0
2020-12-25 00:15,2,1,1,0,0,0
2020-12-25 00:30,1,0,1,0,0,0
2020-12-25 00:45,8,4,4,0,0,0
2020-12-25 01:00,5,2,3,0,0,0
2020-12-25 01:15,8,0,8,0,0,0
2020-12-25 01:30,3,0,3,0,0,0
2020-12-25 01:45,4,0,4,0,0,0
2020-12-25 02:00,4,2,2,0,0,0
2020-12-25 02:15,0,0,0,0,0,0
2020-12-25 02:30,2,0,2,0,0,0
2020-12-25 02:45,5,4,1,0,0,0
2020-12-25 03:00,1,0,1,0,0,0
2020-12-25 03:15,0,0,0,0,0,0
2020-12-25 03:30,2,0,2,0,0,0
2020-12-25 03:45,1,1,0,0,0,0
2020-12-25 04:00,4,0,4,0,0,0
2020-12-25 04:15,1,1,0,0,0,0
2020-12-25 04:30,1,1,0,0,0,0
2020-12-25 04:45,1,0,1,0,0,0
2020-12-25 05:00,0,0,0,0,0,0
2020-12-25 05:15,1,0,1,0,0,0
2020-12-25 05:30,8,4,4,0,0,0
2020-12-25 05:45,4,2,2,0,0,0
2020-12-25 06:00,3,2,1,0,0,0
2020-12-25 06:15,3,0,3,0,0,0
2020-12-25 06:30,3,1,2,0,0,0
2020-12-25 06:45,1,1,0,0,0,0
2020-12-25 07:00,0,0,0,0,0,0
2020-12-25 07:15,2,1,1,0,0,0
2020-12-25 07:30,3,1,2,0,0,0
2020-12-25 07:45,2,1,1,0,0,0
2020-12-25 08:00,1,1,0,0,0,0
2020-12-25 08:15,2,1,1,0,0,0
2020-12-25 08:30,6,5,1,0,0,0
2020-12-25 08:45,3,3,0,0,0,0
2020-12-25 09:00,5,3,2,0,0,0
2020-12-25 09:15,7,2,5,0,0,0
2020-12-25 09:30,8,6,2,0,0,0
2020-12-25 09:45,6,4,2,0,0,0
2020-12-25 10:00,4,3,1,0,0,0
2020-12-25 10:15,13,6,7,0,0,0
2020-12-25 10:30,5,2,3,0,0,0
2020-12-25 10:45,12,6,6,0,0,0
2020-12-25 11:00,18,10,8,0,0,0
2020-12-25 11:15,14,11,3,0,0,0
2020-12-25 11:30,19,8,11,0,0,0
2020-12-25 11:45,18,10,8,0,0,0
2020-12-25 12:00,21,12,9,0,0,0
2020-12-25 12:15,23,7,16,0,0,0
2020-12-25 12:30,27,13,14,0,0,0
2020-12-25 12:45,13,9,4,0,0,0
2020-12-25 13:00,17,10,7,0,0,0
2020-12-25 13:15,20,12,8,0,0,0
2020-12-25 13:30,21,12,9,0,0,0
2020-12-25 13:45,21,9,12,0,0,0
2020-12-25 14:00,38,10,28,0,0,0
2020-12-25 14:15,22,8,14,0,0,0
2020-12-25 14:30,30,9,21,0,0,0
2020-12-25 14:45,20,7,13,0,0,0
2020-12-25 15:00,25,9,16,0,0,0
2020-12-25 15:15,12,5,7,0,0,0
2020-12-25 15:30,19,13,6,0,0,0
2020-12-25 15:45,28,11,17,0,0,0
2020-12-25 16:00,12,6,6,0,0,0
2020-12-25 16:15,29,7,22,0,0,0
2020-12-25 16:30,20,8,12,0,0,0
2020-12-25 16:45,21,6,15,0,0,0
2020-12-25 17:00,17,9,8,0,0,0
2020-12-25 17:15,28,14,14,0,0,0
2020-12-25 17:30,20,11,9,0,0,0
2020-12-25 17:45,15,8,7,0,0,0
2020-12-25 18:00,17,11,6,0,0,0
2020-12-25 18:15,10,5,5,0,0,0
2020-12-25 18:30,12,5,7,0,0,0
2020-12-25 18:45,13,3,10,0,0,0
2020-12-25 19:00,12,2,10,0,0,0
2020-12-25 19:15,7,3,4,0,0,0
2020-12-25 19:30,9,5,4,0,0,0
2020-12-25 19:45,16,12,4,0,0,0
2020-12-25 20:00,22,13,9,0,0,0
2020-12-25 20:15,9,3,6,0,0,0
2020-12-25 20:30,8,4,4,0,0,0
2020-12-25 20:45,5,2,3,0,0,0
2020-12-25 21:00,12,5,7,0,0,0
2020-12-25 21:15,4,1,3,0,0,0
2020-12-25 21:30,13,5,8,0,0,0
2020-12-25 21:45,8,4,4,0,0,0
2020-12-25 22:00,7,1,6,0,0,0
2020-12-25 22:15,10,4,6,0,0,0
2020-12-25 22:30,2,1,1,0,0,0
2020-12-25 22:45,16,4,12,0,0,0
2020-12-25 23:00,4,2,2,0,0,0
2020-12-25 23:15,4,4,0,0,0,0
2020-12-25 23:30,4,3,1,0,0,0
2020-12-25 23:45,4,0,4,0,0,0
2020-12-26 00:00,4,2,2,0,0,0
2020-12-26 00:15,2,1,1,0,0,0
2020-12-26 00:30,1,1,0,0,0,0
2020-12-26 00:45,1,0,1,0,0,0
2020-12-26 01:00,2,1,1,0,0,0
2020-12-26 01:15,0,0,0,0,0,0
2020-12-26 01:30,7,3,4,0,0,0
2020-12-26 01:45,3,3,0,0,0,0
2020-12-26 02:00,1,0,1,0,0,0
2020-12-26 02:15,1,1,0,0,0,0
2020-12-26 02:30,2,0,2,0,0,0
2020-12-26 02:45,0,0,0,0,0,0
2020-12-26 03:00,1,1,0,0,0,0
2020-12-26 03:15,0,0,0,0,0,0
2020-12-26 03:30,1,0,1,0,0,0
2020-12-26 03:45,0,0,0,0,0,0
2020-12-26 04:00,0,0,0,0,0,0
2020-12-26 04:15,1,1,0,0,0,0
2020-12-26 04:30,0,0,0,0,0,0
2020-12-26 04:45,0,0,0,0,0,0
2020-12-26 05:00,0,0,0,0,0,0
2020-12-26 05:15,0,0,0,0,0,0
2020-12-26 05:30,4,4,0,0,0,0
2020-12-26 05:45,3,3,0,0,0,0
2020-12-26 06:00,2,0,2,0,0,0
2020-12-26 06:15,2,2,0,0,0,0
2020-12-26 06:30,2,1,1,0,0,0
2020-12-26 06:45,2,2,0,0,0,0
2020-12-26 07:00,1,1,0,0,0,0
2020-12-26 07:15,1,0,1,0,0,0
2020-12-26 07:30,5,0,5,0,0,0
2020-12-26 07:45,3,1,2,0,0,0
2020-12-26 08:00,3,1,2,0,0,0
2020-12-26 08:15,2,1,1,0,0,0
2020-12-26 08:30,2,1,1,0,0,0
2020-12-26 08:45,1,0,1,0,0,0
2020-12-26 09:00,5,3,2,0,0,0
2020-12-26 09:15,3,1,2,0,0,0
2020-12-26 09:30,2,2,0,0,0,0
2020-12-26 09:45,8,4,4,0,0,0
2020-12-26 10:00,7,4,3,0,0,0
2020-12-26 10:15,15,8,7,0,0,0
2020-12-26 10:30,10,6,4,0,0,0
2020-12-26 10:45,16,9,7,0,0,0
2020-12-26 11:00,18,11,7,0,0,0
2020-12-26 11:15,22,15,7,0,0,0
2020-12-26 11:30,15,6,9,0,0,0
2020-12-26 11:45,17,10,7,0,0,0
2020-12-26 12:00,24,8,16,0,0,0
2020-12-26 12:15,22,9,13,0,0,0
2020-12-26 12:30,31,11,20,0,0,0
2020-12-26 12:45,27,10,17,0,0,0
2020-12-26 13:00,30,12,18,0,0,0
2020-12-26 13:15,18,8,10,0,0,0
2020-12-26 13:30,34,14,20,0,0,0
2020-12-26 13:45,33,20,13,0,0,0
2020-12-26 14:00,28,7,21,0,0,0
2020-12-26 14:15,32,14,18,0,0,0
2020-12-26 14:30,26,10,16,0,0,0
2020-12-26 14:45,29,11,18,0,0,0
2020-12-26 15:00,35,21,14,0,0,0
2020-12-26 15:15,31,24,7,0,0,0
2020-12-26 15:30,28,8,20,0,0,0
2020-12-26 15:45,41,19,22,0,0,0
2020-12-26 16:00,29,8,21,0,0,0
2020-12-26 16:15,30,18,12,0,0,0
2020-12-26 16:30,37,12,25,0,0,0
2020-12-26 16:45,34,8,26,0,0,0
2020-12-26 17:00,35,5,30,0,0,0
2020-12-26 17:15,22,10,12,0,0,0
2020-12-26 17:30,16,6,10,0,0,0
2020-12-26 17:45,14,6,8,0,0,0
2020-12-26 18:00,20,7,13,0,0,0
2020-12-26 18:15,16,6,10,0,0,0
2020-12-26 18:30,9,8,1,0,0,0
2020-12-26 18:45,22,6,16,0,0,0
2020-12-26 19:00,14,5,9,0,0,0
2020-12-26 19:15,10,4,6,0,0,0
2020-12-26 19:30,11,6,5,0,0,0
2020-12-26 19:45,15,5,10,0,0,0
2020-12-26 20:00,17,9,8,0,0,0
2020-12-26 20:15,5,0,5,0,0,0
2020-12-26 20:30,11,5,6,0,0,0
2020-12-26 20:45,10,6,4,0,0,0
2020-12-26 21:00,5,5,0,0,0,0
2020-12-26 21:15,10,2,8,0,0,0
2020-12-26 21:30,9,3,6,0,0,0
2020-12-26 21:45,4,2,2,0,0,0
2020-12-26 22:00,4,0,4,0,0,0
2020-12-26 22:15,4,1,3,0,0,0
2020-12-26 22:30,12,8,4,0,0,0
2020-12-26 22:45,4,4,0,0,0,0
2020-12-26 23:00,4,0,4,0,0,0
2020-12-26 23:15,3,2,1,0,0,0
2020-12-26 23:30,6,3,3,0,0,0
2020-12-26 23:45,2,1,1,0,0,0
2020-12-27 00:00,3,1,2,0,0,0
2020-12-27 00:15,3,3,0,0,0,0
2020-12-27 00:30,3,2,1,0,0,0
2020-12-27 00:45,2,2,0,0,0,0
2020-12-27 01:00,2,0,2,0,0,0
2020-12-27 01:15,2,1,1,0,0,0
2020-12-27 01:30,4,1,3,0,0,0
2020-12-27 01:45,4,3,1,0,0,0
2020-12-27 02:00,1,0,1,0,0,0
2020-12-27 02:15,3,2,1,0,0,0
2020-12-27 02:30,4,2,2,0,0,0
2020-12-27 02:45,2,2,0,0,0,0
2020-12-27 03:00,3,2,1,0,0,0
2020-12-27 03:15,2,0,2,0,0,0
2020-12-27 03:30,2,0,2,0,0,0
2020-12-27 03:45,1,0,1,0,0,0
2020-12-27 04:00,3,3,0,0,0,0
2020-12-27 04:15,1,1,0,0,0,0
2020-12-27 04:30,0,0,0,0,0,0
2020-12-27 04:45,2,2,0,0,0,0
2020-12-27 05:00,0,0,0,0,0,0
2020-12-27 05:15,3,0,3,0,0,0
2020-12-27 05:30,2,2,0,0,0,0
2020-12-27 05:45,7,7,0,0,0,0
2020-12-27 06:00,3,1,2,0,0,0
2020-12-27 06:15,1,1,0,0,0,0
2020-12-27 06:30,1,0,1,0,0,0
2020-12-27 06:45,0,0,0,0,0,0
2020-12-27 07:00,4,2,2,0,0,0
2020-12-27 07:15,0,0,0,0,0,0
2020-12-27 07:30,3,2,1,0,0,0
2020-12-27 07:45,8,2,6,0,0,0
2020-12-27 08:00,3,2,1,0,0,0
2020-12-27 08:15,9,5,4,0,0,0
2020-12-27 08:30,10,7,3,0,0,0
2020-12-27 08:45,4,4,0,0,0,0
2020-12-27 09:00,1,1,0,0,0,0
2020-12-27 09:15,5,1,4,0,0,0
2020-12-27 09:30,4,1,3,0,0,0
2020-12-27 09:45,4,3,1,0,0,0
2020-12-27 10:00,10,6,4,0,0,0
2020-12-27 10:15,5,3,2,0,0,0
2020-12-27 10:30,8,4,4,0,0,0
2020-12-27 10:45,10,7,3,0,0,0
2020-12-27 11:00,8,4,4,0,0,0
2020-12-27 11:15,7,3,4,0,0,0
2020-12-27 11:30,6,2,4,0,0,0
2020-12-27 11:45,11,6,5,0,0,0
2020-12-27 12:00,10,3,7,0,0,0
2020-12-27 12:15,11,6,5,0,0,0
2020-12-27 12:30,14,8,6,0,0,0
2020-12-27 12:45,13,7,6,0,0,0
2020-12-27 13:00,11,6,5,0,0,0
2020-12-27 13:15,10,5,5,0,0,0
2020-12-27 13:30,12,8,4,0,0,0
2020-12-27 13:45,11,7,4,0,0,0
2020-12-27 14:00,11,3,8,0,0,0
2020-12-27 14:15,8,6,2,0,0,0
2020-12-27 14:30,6,0,6,0,0,0
2020-12-27 14:45,10,7,3,0,0,0
2020-12-27 15:00,8,2,6,0,0,0
2020-12-27 15:15,11,6,5,0,0,0
2020-12-27 15:30,6,4,2,0,0,0
2020-12-27 15:45,10,5,5,0,0,0
2020-12-27 16:00,9,6,3,0,0,0
2020-12-27 16:15,14,4,10,0,0,0
2020-12-27 16:30,14,2,12,0,0,0
2020-12-27 16:45,19,7,12,0,0,0
2020-12-27 17:00,12,4,8,0,0,0
2020-12-27 17:15,13,7,6,0,0,0
2020-12-27 17:30,10,3,7,0,0,0
2020-12-27 17:45,13,7,6,0,0,0
2020-12-27 18:00,26,14,12,0,0,0
2020-12-27 18:15,14,8,6,0,0,0
2020-12-27 18:30,14,5,9,0,0,0
2020-12-27 18:45,14,6,8,0,0,0
2020-12-27 19:00,12,6,6,0,0,0
2020-12-27 19:15,19,6,13,0,0,0
2020-12-27 19:30,11,5,6,0,0,0
2020-12-27 19:45,9,3,6,0,0,0
2020-12-27 20:00,9,5,4,0,0,0
2020-12-27 20:15,7,4,3,0,0,0
2020-12-27 20:30,6,4,2,0,0,0
2020-12-27 20:45,6,1,5,0,0,0
2020-12-27 21:00,3,2,1,0,0,0
2020-12-27 21:15,12,3,9,0,0,0
2020-12-27 21:30,5,1,4,0,0,0
2020-12-27 21:45,2,1,1,0,0,0
2020-12-27 22:00,8,4,4,0,0,0
2020-12-27 22:15,1,0,1,0,0,0
2020-12-27 22:30,2,0,2,0,0,0
2020-12-27 22:45,2,0,2,0,0,0
2020-12-27 23:00,3,3,0,0,0,0
2020-12-27 23:15,2,1,1,0,0,0
2020-12-27 23:30,6,1,5,0,0,0
2020-12-27 23:45,5,0,5,0,0,0
2020-12-28 00:00,1,1,0,0,0,0
2020-12-28 00:15,5,0,5,0,0,0
2020-12-28 00:30,2,1,1,0,0,0
2020-12-28 00:45,0,0,0,0,0,0
2020-12-28 01:00,3,1,2,0,0,0
2020-12-28 01:15,0,0,0,0,0,0
2020-12-28 01:30,1,0,1,0,0,0
2020-12-28 01:45,6,1,5,0,0,0
2020-12-28 02:00,3,3,0,0,0,0
2020-12-28 02:15,0,0,0,0,0,0
2020-12-28 02:30,0,0,0,0,0,0
2020-12-28 02:45,2,1,1,0,0,0
2020-12-28 03:00,3,0,3,0,0,0
2020-12-28 03:15,3,2,1,0,0,0
2020-12-28 03:30,1,1,0,0,0,0
2020-12-28 03:45,0,0,0,0,0,0
2020-12-28 04:00,0,0,0,0,0,0
2020-12-28 04:15,2,1,1,0,0,0
2020-12-28 04:30,1,1,0,0,0,0
2020-12-28 04:45,1,1,0,0,0,0
2020-12-28 05:00,1,1,0,0,0,0
2020-12-28 05:15,6,3,3,0,0,0
2020-12-28 05:30,3,2,1,0,0,0
2020-12-28 05:45,5,5,0,0,0,0
2020-12-28 06:00,13,8,5,0,0,0
2020-12-28 06:15,9,6,3,0,0,0
2020-12-28 06:30,12,5,7,0,0,0
2020-12-28 06:45,12,10,2,0,0,0
2020-12-28 07:00,23,13,10,0,0,0
2020-12-28 07:15,21,10,11,0,0,0
2020-12-28 07:30,25,18,7,0,0,0
2020-12-28 07:45,38,23,15,0,0,0
2020-12-28 08:00,21,14,7,0,0,0
2020-12-28 08:15,24,13,11,0,0,0
2020-12-28 08:30,36,24,12,0,0,0
2020-12-28 08:45,32,21,11,0,0,0
2020-12-28 09:00,17,11,6,0,0,0
2020-12-28 09:15,29,22,7,0,0,0
2020-12-28 09:30,30,16,14,0,0,0
2020-12-28 09:45,47,27,20,0,0,0
2020-12-28 10:00,41,25,16,0,0,0
2020-12-28 10:15,45,22,23,0,0,0
2020-12-28 10:30,50,28,22,0,0,0
2020-12-28 10:45,75,39,36,0,0,0
2020-12-28 11:00,61,28,33,0,0,0
2020-12-28 11:15,55,27,28,0,0,0
2020-12-28 11:30,65,28,37,0,0,0
2020-12-28 11:45,71,22,49,0,0,0
2020-12-28 12:00,54,29,25,0,0,0
2020-12-28 12:15,55,24,31,0,0,0
2020-12-28 12:30,75,35,40,0,0,0
2020-12-28 12:45,68,30,38,0,0,0
2020-12-28 13:00,60,35,25,0,0,0
2020-12-28 13:15,58,21,37,0,0,0
2020-12-28 13:30,62,32,30,0,0,0
2020-12-28 13:45,79,32,47,0,0,0
2020-12-28 14:00,64,34,30,0,0,0
2020-12-28 14:15,94,30,64,0,0,0
2020-12-28 14:30,100,47,53,0,0,0
2020-12-28 14:45,88,43,45,0,0,0
2020-12-28 15:00,94,43,51,0,0,0
2020-12-28 15:15,79,38,41,0,0,0
2020-12-28 15:30,90,33,57,0,0,0
2020-12-28 15:45,72,34,38,0,0,0
2020-12-28 16:00,79,32,47,0,0,0
2020-12-28 16:15,95,33,62,0,0,0
2020-12-28 16:30,67,23,44,0,0,0
2020-12-28 16:45,79,27,52,0,0,0
2020-12-28 17:00,85,31,54,0,0,0
2020-12-28 17:15,59,23,36,0,0,0
2020-12-28 17:30,58,16,42,0,0,0
2020-12-28 17:45,52,16,36,0,0,0
2020-12-28 18:00,41,13,28,0,0,0
2020-12-28 18:15,42,16,26,0,0,0
2020-12-28 18:30,38,14,24,0,0,0
2020-12-28 18:45,36,15,21,0,0,0
2020-12-28 19:00,30,12,18,0,0,0
2020-12-28 19:15,25,9,16,0,0,0
2020-12-28 19:30,14,5,9,0,0,0
2020-12-28 19:45,22,9,13,0,0,0
2020-12-28 20:00,24,12,12,0,0,0
2020-12-28 20:15,12,6,6,0,0,0
2020-12-28 20:30,23,6,17,0,0,0
2020-12-28 20:45,14,8,6,0,0,0
2020-12-28 21:00,16,11,5,0,0,0
2020-12-28 21:15,9,5,4,0,0,0
2020-12-28 21:30,6,3,3,0,0,0
2020-12-28 21:45,7,3,4,0,0,0
2020-12-28 22:00,13,3,10,0,0,0
2020-12-28 22:15,3,0,3,0,0,0
2020-12-28 22:30,4,0,4,0,0,0
2020-12-28 22:45,6,0,6,0,0,0
2020-12-28 23:00,7,2,5,0,0,0
2020-12-28 23:15,8,0,8,0,0,0
2020-12-28 23:30,7,2,5,0,0,0
2020-12-28 23:45,5,1,4,0,0,0
2020-12-29 00:00,2,2,0,0,0,0
2020-12-29 00:15,1,1,0,0,0,0
2020-12-29 00:30,5,0,5,0,0,0
2020-12-29 00:45,5,3,2,0,0,0
2020-12-29 01:00,4,2,2,0,0,0
2020-12-29 01:15,1,1,0,0,0,0
2020-12-29 01:30,5,1,4,0,0,0
2020-12-29 01:45,4,3,1,0,0,0
2020-12-29 02:00,0,0,0,0,0,0
2020-12-29 02:15,3,1,2,0,0,0
2020-12-29 02:30,2,0,2,0,0,0
2020-12-29 02:45,1,1,0,0,0,0
2020-12-29 03:00,1,1,0,0,0,0
2020-12-29 03:15,1,0,1,0,0,0
2020-12-29 03:30,2,0,2,0,0,0
2020-12-29 03:45,0,0,0,0,0,0
2020-12-29 04:00,4,2,2,0,0,0
2020-12-29 04:15,1,1,0,0,0,0
2020-12-29 04:30,1,1,0,0,0,0
2020-12-29 04:45,2,1,1,0,0,0
2020-12-29 05:00,3,2,1,0,0,0
2020-12-29 05:15,2,2,0,0,0,0
2020-12-29 05:30,6,2,4,0,0,0
2020-12-29 05:45,9,7,2,0,0,0
2020-12-29 06:00,11,4,7,0,0,0
2020-12-29 06:15,12,8,4,0,0,0
2020-12-29 06:30,18,8,10,0,0,0
2020-12-29 06:45,19,13,6,0,0,0
2020-12-29 07:00,28,17,11,0,0,0
2020-12-29 07:15,19,9,10,0,0,0
2020-12-29 07:30,38,23,15,0,0,0
2020-12-29 07:45,36,25,11,0,0,0
2020-12-29 08:00,29,17,12,0,0,0
2020-12-29 08:15,34,15,19,0,0,0
2020-12-29 08:30,28,19,9,0,0,0
2020-12-29 08:45,51,39,12,0,0,0
2020-12-29 09:00,26,16,10,0,0,0
2020-12-29 09:15,31,18,13,0,0,0
2020-12-29 09:30,32,16,16,0,0,0
2020-12-29 09:45,41,25,16,0,0,0
2020-12-29 10:00,51,21,30,0,0,0
2020-12-29 10:15,40,16,24,0,0,0
2020-12-29 10:30,35,14,21,0,0,0
2020-12-29 10:45,33,11,22,0,0,0
2020-12-29 11:00,32,13,19,0,0,0
2020-12-29 11:15,24,6,18,0,0,0
2020-12-29 11:30,23,14,9,0,0,0
2020-12-29 11:45,57,34,23,0,0,0
2020-12-29 12:00,41,13,28,0,0,0
2020-12-29 12:15,46,24,22,0,0,0
2020-12-29 12:30,53,26,27,0,0,0
2020-12-29 12:45,56,20,36,0,0,0
2020-12-29 13:00,41,16,25,0,0,0
2020-12-29 13:15,46,20,26,0,0,0
2020-12-29 13:30,51,22,29,0,0,0
2020-12-29 13:45,62,29,33,0,0,0
2020-12-29 14:00,59,23,36,0,0,0
2020-12-29 14:15,54,23,31,0,0,0
2020-12-29 14:30,64,25,39,0,0,0
2020-12-29 14:45,46,15,31,0,0,0
2020-12-29 15:00,63,26,37,0,0,0
2020-12-29 15:15,52,21,31,0,0,0
2020-12-29 15:30,67,23,44,0,0,0
2020-12-29 15:45,63,32,31,0,0,0
2020-12-29 16:00,66,21,45,0,0,0
2020-12-29 16:15,70,34,36,0,0,0
2020-12-29 16:30,55,22,33,0,0,0
2020-12-29 16:45,65,27,38,0,0,0
2020-12-29 17:00,57,21,36,0,0,0
2020-12-29 17:15,42,14,28,0,0,0
2020-12-29 17:30,50,15,35,0,0,0
2020-12-29 17:45,44,14,30,0,0,0
2020-12-29 18:00,39,11,28,0,0,0
2020-12-29 18:15,49,21,28,0,0,0
2020-12-29 18:30,36,19,17,0,0,0
2020-12-29 18:45,42,28,14,0,0,0
2020-12-29 19:00,31,12,19,0,0,0
2020-12-29 19:15,16,8,8,0,0,0
2020-12-29 19:30,16,5,11,0,0,0
2020-12-29 19:45,27,11,16,0,0,0
2020-12-29 20:00,13,7,6,0,0,0
2020-12-29 20:15,23,10,13,0,0,0
2020-12-29 20:30,20,9,11,0,0,0
2020-12-29 20:45,16,4,12,0,0,0
2020-12-29 21:00,13,6,7,0,0,0
2020-12-29 21:15,13,4,9,0,0,0
2020-12-29 21:30,14,5,9,0,0,0
2020-12-29 21:45,9,4,5,0,0,0
2020-12-29 22:00,5,2,3,0,0,0
2020-12-29 22:15,1,1,0,0,0,0
2020-12-29 22:30,3,0,3,0,0,0
2020-12-29 22:45,8,1,7,0,0,0
2020-12-29 23:00,3,2,1,0,0,0
2020-12-29 23:15,5,3,2,0,0,0
2020-12-29 23:30,5,1,4,0,0,0
2020-12-29 23:45,7,4,3,0,0,0
2020-12-30 00:00,7,3,4,0,0,0
2020-12-30 00:15,8,2,6,0,0,0
2020-12-30 00:30,7,4,3,0,0,0
2020-12-30 00:45,5,1,4,0,0,0
2020-12-30 01:00,5,2,3,0,0,0
2020-12-30 01:15,3,1,2,0,0,0
2020-12-30 01:30,1,0,1,0,0,0
2020-12-30 01:45,2,1,1,0,0,0
2020-12-30 02:00,2,0,2,0,0,0
2020-12-30 02:15,4,1,3,0,0,0
2020-12-30 02:30,0,0,0,0,0,0
2020-12-30 02:45,0,0,0,0,0,0
2020-12-30 03:00,3,2,1,0,0,0
2020-12-30 03:15,1,1,0,0,0,0
2020-12-30 03:30,2,0,2,0,0,0
2020-12-30 03:45,0,0,0,0,0,0
2020-12-30 04:00,0,0,0,0,0,0
2020-12-30 04:15,1,1,0,0,0,0
2020-12-30 04:30,1,0,1,0,0,0
2020-12-30 04:45,0,0,0,0,0,0
2020-12-30 05:00,1,1,0,0,0,0
2020-12-30 05:15,7,3,4,0,0,0
2020-12-30 05:30,1,1,0,0,0,0
2020-12-30 05:45,9,9,0,0,0,0
2020-12-30 06:00,8,4,4,0,0,0
2020-12-30 06:15,10,8,2,0,0,0
2020-12-30 06:30,20,12,8,0,0,0
2020-12-30 06:45,17,12,5,0,0,0
2020-12-30 07:00,24,14,10,0,0,0
2020-12-30 07:15,39,25,14,0,0,0
2020-12-30 07:30,42,25,17,0,0,0
2020-12-30 07:45,43,29,14,0,0,0
2020-12-30 08:00,37,26,11,0,0,0
2020-12-30 08:15,46,26,20,0,0,0
2020-12-30 08:30,41,22,19,0,0,0
2020-12-30 08:45,49,37,12,0,0,0
2020-12-30 09:00,50,34,16,0,0,0
2020-12-30 09:15,60,40,20,0,0,0
2020-12-30 09:30,54,37,17,0,0,0
2020-12-30 09:45,59,31,28,0,0,0
2020-12-30 10:00,73,52,21,0,0,0
2020-12-30 10:15,62,32,30,0,0,0
2020-12-30 10:30,77,46,31,0,0,0
2020-12-30 10:45,62,37,25,0,0,0
2020-12-30 11:00,116,51,65,0,0,0
2020-12-30 11:15,106,53,53,0,0,0
2020-12-30 11:30,105,50,55,0,0,0
2020-12-30 11:45,95,27,68,0,0,0
2020-12-30 12:00,84,32,52,0,0,0
2020-12-30 12:15,99,34,65,0,0,0
2020-12-30 12:30,81,37,44,0,0,0
2020-12-30 12:45,93,37,56,0,0,0
2020-12-30 13:00,92,40,52,0,0,0
2020-12-30 13:15,65,29,36,0,0,0
2020-12-30 13:30,58,31,27,0,0,0
2020-12-30 13:45,83,43,40,0,0,0
2020-12-30 14:00,72,30,42,0,0,0
2020-12-30 14:15,78,30,48,0,0,0
2020-12-30 14:30,77,25,52,0,0,0
2020-12-30 14:45,93,46,47,0,0,0
2020-12-30 15:00,73,28,45,0,0,0
2020-12-30 15:15,75,24,51,0,0,0
2020-12-30 15:30,47,16,31,0,0,0
2020-12-30 15:45,76,24,52,0,0,0
2020-12-30 16:00,69,25,44,0,0,0
2020-12-30 16:15,74,35,39,0,0,0
2020-12-30 16:30,58,25,33,0,0,0
2020-12-30 16:45,67,26,41,0,0,0
2020-12-30 17:00,61,23,38,0,0,0
2020-12-30 17:15,52,17,35,0,0,0
2020-12-30 17:30,60,28,32,0,0,0
2020-12-30 17:45,56,25,31,0,0,0
2020-12-30 18:00,61,19,42,0,0,0
2020-12-30 18:15,38,14,24,0,0,0
2020-12-30 18:30,28,12,16,0,0,0
2020-12-30 18:45,35,11,24,0,0,0
2020-12-30 19:00,39,17,22,0,0,0
2020-12-30 19:15,25,11,14,0,0,0
2020-12-30 19:30,27,13,14,0,0,0
2020-12-30 19:45,24,11,13,0,0,0
2020-12-30 20:00,23,10,13,0,0,0
2020-12-30 20:15,21,8,13,0,0,0
2020-12-30 20:30,16,7,9,0,0,0
2020-12-30 20:45,12,6,6,0,0,0
2020-12-30 21:00,16,5,11,0,0,0
2020-12-30 21:15,11,6,5,0,0,0
2020-12-30 21:30,9,5,4,0,0,0
2020-12-30 21:45,14,4,10,0,0,0
2020-12-30 22:00,13,5,8,0,0,0
2020-12-30 22:15,8,3,5,0,0,0
2020-12-30 22:30,9,2,7,0,0,0
2020-12-30 22:45,6,3,3,0,0,0
2020-12-30 23:00,6,2,4,0,0,0
2020-12-30 23:15,11,3,8,0,0,0
2020-12-30 23:30,13,3,10,0,0,0
2020-12-30 23:45,2,2,0,0,0,0
2020-12-31 00:00,6,2,4,0,0,0
2020-12-31 00:15,11,4,7,0,0,0
2020-12-31 00:30,13,4,9,0,0,0
2020-12-31 00:45,4,1,3,0,0,0
2020-12-31 01:00,2,2,0,0,0,0
2020-12-31 01:15,6,2,4,0,0,0
2020-12-31 01:30,3,0,3,0,0,0
2020-12-31 01:45,2,0,2,0,0,0
2020-12-31 02:00,3,1,2,0,0,0
2020-12-31 02:15,1,1,0,0,0,0
2020-12-31 02:30,1,0,1,0,0,0
2020-12-31 02:45,2,1,1,0,0,0
2020-12-31 03:00,1,0,1,0,0,0
2020-12-31 03:15,0,0,0,0,0,0
2020-12-31 03:30,2,0,2,0,0,0
2020-12-31 03:45,1,0,1,0,0,0
2020-12-31 04:00,0,0,0,0,0,0
2020-12-31 04:15,1,1,0,0,0,0
2020-12-31 04:30,0,0,0,0,0,0
2020-12-31 04:45,3,1,2,0,0,0
2020-12-31 05:00,3,3,0,0,0,0
2020-12-31 05:15,3,2,1,0,0,0
2020-12-31 05:30,4,2,2,0,0,0
2020-12-31 05:45,3,2,1,0,0,0
2020-12-31 06:00,2,2,0,0,0,0
2020-12-31 06:15,3,3,0,0,0,0
2020-12-31 06:30,9,6,3,0,0,0
2020-12-31 06:45,6,3,3,0,0,0
2020-12-31 07:00,4,2,2,0,0,0
2020-12-31 07:15,8,3,5,0,0,0
2020-12-31 07:30,5,3,2,0,0,0
2020-12-31 07:45,13,6,7,0,0,0
2020-12-31 08:00,11,7,4,0,0,0
2020-12-31 08:15,15,11,4,0,0,0
2020-12-31 08:30,12,8,4,0,0,0
2020-12-31 08:45,23,10,13,0,0,0
2020-12-31 09:00,12,7,5,0,0,0
2020-12-31 09:15,24,15,9,0,0,0
2020-12-31 09:30,19,8,11,0,0,0
2020-12-31 09:45,34,18,16,0,0,0
2020-12-31 10:00,32,17,15,0,0,0
2020-12-31 10:15,34,17,17,0,0,0
2020-12-31 10:30,36,18,18,0,0,0
2020-12-31 10:45,54,32,22,0,0,0
2020-12-31 11:00,47,24,23,0,0,0
2020-12-31 11:15,50,24,26,0,0,0
2020-12-31 11:30,51,26,25,0,0,0
2020-12-31 11:45,49,28,21,0,0,0
2020-12-31 12:00,78,31,47,0,0,0
2020-12-31 12:15,72,34,38,0,0,0
2020-12-31 12:30,45,20,25,0,0,0
2020-12-31 12:45,62,23,39,0,0,0
2020-12-31 13:00,47,19,28,0,0,0
2020-12-31 13:15,60,21,39,0,0,0
2020-12-31 13:30,31,10,21,0,0,0
2020-12-31 13:45,47,16,31,0,0,0
2020-12-31 14:00,32,19,13,0,0,0
2020-12-31 14:15,37,9,28,0,0,0
2020-12-31 14:30,38,13,25,0,0,0
2020-12-31 14:45,28,13,15,0,0,0
2020-12-31 15:00,36,15,21,0,0,0
2020-12-31 15:15,29,11,18,0,0,0
2020-12-31 15:30,23,8,15,0,0,0
2020-12-31 15:45,40,15,25,0,0,0
2020-12-31 16:00,35,12,23,0,0,0
2020-12-31 16:15,29,14,15,0,0,0
2020-12-31 16:30,25,17,8,0,0,0
2020-12-31 16:45,21,7,14,0,0,0
2020-12-31 17:00,31,14,17,0,0,0
2020-12-31 17:15,27,8,19,0,0,0
2020-12-31 17:30,28,12,16,0,0,0
2020-12-31 17:45,35,13,22,0,0,0
2020-12-31 18:00,40,10,30,0,0,0
2020-12-31 18:15,29,19,10,0,0,0
2020-12-31 18:30,42,22,20,0,0,0
2020-12-31 18:45,55,20,35,0,0,0
2020-12-31 19:00,56,22,34,0,0,0
2020-12-31 19:15,24,12,12,0,0,0
2020-12-31 19:30,33,17,16,0,0,0
2020-12-31 19:45,29,9,20,0,0,0
2020-12-31 20:00,23,8,15,0,0,0
2020-12-31 20:15,19,7,12,0,0,0
2020-12-31 20:30,4,3,1,0,0,0
2020-12-31 20:45,12,6,6,0,0,0
2020-12-31 21:00,13,6,7,0,0,0
2020-12-31 21:15,5,4,1,0,0,0
2020-12-31 21:30,3,1,2,0,0,0
2020-12-31 21:45,7,4,3,0,0,0
2020-12-31 22:00,2,1,1,0,0,0
2020-12-31 22:15,3,1,2,0,0,0
2020-12-31 22:30,6,2,4,0,0,0
2020-12-31 22:45,5,0,5,0,0,0
2020-12-31 23:00,3,1,2,0,0,0
2020-12-31 23:15,7,0,7,0,0,0
2020-12-31 23:30,8,0,8,0,0,0
2020-12-31 23:45,4,0,4,0,0,0
