Datetime,100034980 (Hammer Straße),101034980 (Hammer Straße stadteinwärts),102034980 (Hammer Straße stadtauswärts),100034980-status,101034980-status,102034980-status
2020-04-01 00:00,4,2,2,0,0,0
2020-04-01 00:15,4,1,3,0,0,0
2020-04-01 00:30,1,0,1,0,0,0
2020-04-01 00:45,2,2,0,0,0,0
2020-04-01 01:00,2,1,1,0,0,0
2020-04-01 01:15,3,2,1,0,0,0
2020-04-01 01:30,4,2,2,0,0,0
2020-04-01 01:45,2,1,1,0,0,0
2020-04-01 02:00,0,0,0,0,0,0
2020-04-01 02:15,1,1,0,0,0,0
2020-04-01 02:30,1,1,0,0,0,0
2020-04-01 02:45,0,0,0,0,0,0
2020-04-01 03:00,0,0,0,0,0,0
2020-04-01 03:15,0,0,0,0,0,0
2020-04-01 03:30,0,0,0,0,0,0
2020-04-01 03:45,1,0,1,0,0,0
2020-04-01 04:00,0,0,0,0,0,0
2020-04-01 04:15,0,0,0,0,0,0
2020-04-01 04:30,3,3,0,0,0,0
2020-04-01 04:45,4,2,2,0,0,0
2020-04-01 05:00,2,0,2,0,0,0
2020-04-01 05:15,3,2,1,0,0,0
2020-04-01 05:30,10,5,5,0,0,0
2020-04-01 05:45,23,17,6,0,0,0
2020-04-01 06:00,18,14,4,0,0,0
2020-04-01 06:15,21,19,2,0,0,0
2020-04-01 06:30,27,20,7,0,0,0
2020-04-01 06:45,38,28,10,0,0,0
2020-04-01 07:00,52,32,20,0,0,0
2020-04-01 07:15,59,37,22,0,0,0
2020-04-01 07:30,76,55,21,0,0,0
2020-04-01 07:45,98,71,27,0,0,0
2020-04-01 08:00,61,41,20,0,0,0
2020-04-01 08:15,90,54,36,0,0,0
2020-04-01 08:30,70,48,22,0,0,0
2020-04-01 08:45,79,60,19,0,0,0
2020-04-01 09:00,52,34,18,0,0,0
2020-04-01 09:15,53,32,21,0,0,0
2020-04-01 09:30,63,36,27,0,0,0
2020-04-01 09:45,57,38,19,0,0,0
2020-04-01 10:00,76,42,34,0,0,0
2020-04-01 10:15,84,50,34,0,0,0
2020-04-01 10:30,89,53,36,0,0,0
2020-04-01 10:45,72,40,32,0,0,0
2020-04-01 11:00,82,40,42,0,0,0
2020-04-01 11:15,85,37,48,0,0,0
2020-04-01 11:30,79,38,41,0,0,0
2020-04-01 11:45,86,46,40,0,0,0
2020-04-01 12:00,109,49,60,0,0,0
2020-04-01 12:15,103,51,52,0,0,0
2020-04-01 12:30,105,48,57,0,0,0
2020-04-01 12:45,112,45,67,0,0,0
2020-04-01 13:00,95,35,60,0,0,0
2020-04-01 13:15,91,34,57,0,0,0
2020-04-01 13:30,97,41,56,0,0,0
2020-04-01 13:45,78,29,49,0,0,0
2020-04-01 14:00,85,38,47,0,0,0
2020-04-01 14:15,75,32,43,0,0,0
2020-04-01 14:30,89,28,61,0,0,0
2020-04-01 14:45,81,37,44,0,0,0
2020-04-01 15:00,99,40,59,0,0,0
2020-04-01 15:15,86,27,59,0,0,0
2020-04-01 15:30,100,31,69,0,0,0
2020-04-01 15:45,77,19,58,0,0,0
2020-04-01 16:00,104,43,61,0,0,0
2020-04-01 16:15,92,35,57,0,0,0
2020-04-01 16:30,108,36,72,0,0,0
2020-04-01 16:45,86,32,54,0,0,0
2020-04-01 17:00,91,31,60,0,0,0
2020-04-01 17:15,86,29,57,0,0,0
2020-04-01 17:30,70,26,44,0,0,0
2020-04-01 17:45,70,28,42,0,0,0
2020-04-01 18:00,63,22,41,0,0,0
2020-04-01 18:15,61,19,42,0,0,0
2020-04-01 18:30,54,23,31,0,0,0
2020-04-01 18:45,50,13,37,0,0,0
2020-04-01 19:00,43,15,28,0,0,0
2020-04-01 19:15,50,26,24,0,0,0
2020-04-01 19:30,38,11,27,0,0,0
2020-04-01 19:45,37,16,21,0,0,0
2020-04-01 20:00,38,17,21,0,0,0
2020-04-01 20:15,24,15,9,0,0,0
2020-04-01 20:30,17,5,12,0,0,0
2020-04-01 20:45,17,5,12,0,0,0
2020-04-01 21:00,11,5,6,0,0,0
2020-04-01 21:15,21,6,15,0,0,0
2020-04-01 21:30,9,3,6,0,0,0
2020-04-01 21:45,15,4,11,0,0,0
2020-04-01 22:00,6,0,6,0,0,0
2020-04-01 22:15,7,2,5,0,0,0
2020-04-01 22:30,12,9,3,0,0,0
2020-04-01 22:45,4,2,2,0,0,0
2020-04-01 23:00,11,5,6,0,0,0
2020-04-01 23:15,4,3,1,0,0,0
2020-04-01 23:30,9,5,4,0,0,0
2020-04-01 23:45,9,7,2,0,0,0
2020-04-02 00:00,2,1,1,0,0,0
2020-04-02 00:15,5,3,2,0,0,0
2020-04-02 00:30,2,0,2,0,0,0
2020-04-02 00:45,1,0,1,0,0,0
2020-04-02 01:00,2,0,2,0,0,0
2020-04-02 01:15,2,1,1,0,0,0
2020-04-02 01:30,1,0,1,0,0,0
2020-04-02 01:45,2,1,1,0,0,0
2020-04-02 02:00,0,0,0,0,0,0
2020-04-02 02:15,3,2,1,0,0,0
2020-04-02 02:30,2,2,0,0,0,0
2020-04-02 02:45,1,1,0,0,0,0
2020-04-02 03:00,1,0,1,0,0,0
2020-04-02 03:15,0,0,0,0,0,0
2020-04-02 03:30,1,0,1,0,0,0
2020-04-02 03:45,0,0,0,0,0,0
2020-04-02 04:00,0,0,0,0,0,0
2020-04-02 04:15,2,2,0,0,0,0
2020-04-02 04:30,4,3,1,0,0,0
2020-04-02 04:45,3,3,0,0,0,0
2020-04-02 05:00,1,1,0,0,0,0
2020-04-02 05:15,6,3,3,0,0,0
2020-04-02 05:30,11,10,1,0,0,0
2020-04-02 05:45,23,19,4,0,0,0
2020-04-02 06:00,15,12,3,0,0,0
2020-04-02 06:15,21,17,4,0,0,0
2020-04-02 06:30,25,19,6,0,0,0
2020-04-02 06:45,44,34,10,0,0,0
2020-04-02 07:00,55,32,23,0,0,0
2020-04-02 07:15,66,43,23,0,0,0
2020-04-02 07:30,54,39,15,0,0,0
2020-04-02 07:45,83,63,20,0,0,0
2020-04-02 08:00,57,40,17,0,0,0
2020-04-02 08:15,70,52,18,0,0,0
2020-04-02 08:30,84,52,32,0,0,0
2020-04-02 08:45,81,49,32,0,0,0
2020-04-02 09:00,50,33,17,0,0,0
2020-04-02 09:15,49,34,15,0,0,0
2020-04-02 09:30,39,22,17,0,0,0
2020-04-02 09:45,54,30,24,0,0,0
2020-04-02 10:00,44,25,19,0,0,0
2020-04-02 10:15,38,23,15,0,0,0
2020-04-02 10:30,53,34,19,0,0,0
2020-04-02 10:45,59,26,33,0,0,0
2020-04-02 11:00,53,29,24,0,0,0
2020-04-02 11:15,58,22,36,0,0,0
2020-04-02 11:30,56,32,24,0,0,0
2020-04-02 11:45,57,33,24,0,0,0
2020-04-02 12:00,64,25,39,0,0,0
2020-04-02 12:15,75,33,42,0,0,0
2020-04-02 12:30,80,35,45,0,0,0
2020-04-02 12:45,90,44,46,0,0,0
2020-04-02 13:00,75,36,39,0,0,0
2020-04-02 13:15,94,43,51,0,0,0
2020-04-02 13:30,61,22,39,0,0,0
2020-04-02 13:45,75,38,37,0,0,0
2020-04-02 14:00,68,35,33,0,0,0
2020-04-02 14:15,98,48,50,0,0,0
2020-04-02 14:30,80,40,40,0,0,0
2020-04-02 14:45,96,52,44,0,0,0
2020-04-02 15:00,63,25,38,0,0,0
2020-04-02 15:15,94,38,56,0,0,0
2020-04-02 15:30,85,39,46,0,0,0
2020-04-02 15:45,95,47,48,0,0,0
2020-04-02 16:00,85,34,51,0,0,0
2020-04-02 16:15,104,45,59,0,0,0
2020-04-02 16:30,103,39,64,0,0,0
2020-04-02 16:45,102,45,57,0,0,0
2020-04-02 17:00,118,51,67,0,0,0
2020-04-02 17:15,89,30,59,0,0,0
2020-04-02 17:30,91,31,60,0,0,0
2020-04-02 17:45,81,29,52,0,0,0
2020-04-02 18:00,73,21,52,0,0,0
2020-04-02 18:15,67,20,47,0,0,0
2020-04-02 18:30,50,25,25,0,0,0
2020-04-02 18:45,52,18,34,0,0,0
2020-04-02 19:00,51,23,28,0,0,0
2020-04-02 19:15,46,13,33,0,0,0
2020-04-02 19:30,38,12,26,0,0,0
2020-04-02 19:45,29,14,15,0,0,0
2020-04-02 20:00,25,9,16,0,0,0
2020-04-02 20:15,32,10,22,0,0,0
2020-04-02 20:30,18,11,7,0,0,0
2020-04-02 20:45,18,3,15,0,0,0
2020-04-02 21:00,21,12,9,0,0,0
2020-04-02 21:15,21,9,12,0,0,0
2020-04-02 21:30,5,3,2,0,0,0
2020-04-02 21:45,14,5,9,0,0,0
2020-04-02 22:00,7,1,6,0,0,0
2020-04-02 22:15,5,3,2,0,0,0
2020-04-02 22:30,5,3,2,0,0,0
2020-04-02 22:45,7,2,5,0,0,0
2020-04-02 23:00,11,7,4,0,0,0
2020-04-02 23:15,8,1,7,0,0,0
2020-04-02 23:30,9,4,5,0,0,0
2020-04-02 23:45,5,2,3,0,0,0
2020-04-03 00:00,5,4,1,0,0,0
2020-04-03 00:15,13,7,6,0,0,0
2020-04-03 00:30,4,1,3,0,0,0
2020-04-03 00:45,3,2,1,0,0,0
2020-04-03 01:00,0,0,0,0,0,0
2020-04-03 01:15,0,0,0,0,0,0
2020-04-03 01:30,0,0,0,0,0,0
2020-04-03 01:45,1,0,1,0,0,0
2020-04-03 02:00,0,0,0,0,0,0
2020-04-03 02:15,1,0,1,0,0,0
2020-04-03 02:30,1,1,0,0,0,0
2020-04-03 02:45,2,0,2,0,0,0
2020-04-03 03:00,0,0,0,0,0,0
2020-04-03 03:15,0,0,0,0,0,0
2020-04-03 03:30,1,0,1,0,0,0
2020-04-03 03:45,1,0,1,0,0,0
2020-04-03 04:00,0,0,0,0,0,0
2020-04-03 04:15,2,2,0,0,0,0
2020-04-03 04:30,4,2,2,0,0,0
2020-04-03 04:45,2,1,1,0,0,0
2020-04-03 05:00,4,2,2,0,0,0
2020-04-03 05:15,4,2,2,0,0,0
2020-04-03 05:30,11,8,3,0,0,0
2020-04-03 05:45,23,18,5,0,0,0
2020-04-03 06:00,12,10,2,0,0,0
2020-04-03 06:15,20,17,3,0,0,0
2020-04-03 06:30,31,23,8,0,0,0
2020-04-03 06:45,31,21,10,0,0,0
2020-04-03 07:00,44,25,19,0,0,0
2020-04-03 07:15,63,44,19,0,0,0
2020-04-03 07:30,46,33,13,0,0,0
2020-04-03 07:45,76,50,26,0,0,0
2020-04-03 08:00,43,29,14,0,0,0
2020-04-03 08:15,66,42,24,0,0,0
2020-04-03 08:30,63,38,25,0,0,0
2020-04-03 08:45,56,38,18,0,0,0
2020-04-03 09:00,37,20,17,0,0,0
2020-04-03 09:15,46,24,22,0,0,0
2020-04-03 09:30,41,23,18,0,0,0
2020-04-03 09:45,64,33,31,0,0,0
2020-04-03 10:00,63,28,35,0,0,0
2020-04-03 10:15,42,23,19,0,0,0
2020-04-03 10:30,45,26,19,0,0,0
2020-04-03 10:45,85,45,40,0,0,0
2020-04-03 11:00,65,29,36,0,0,0
2020-04-03 11:15,59,30,29,0,0,0
2020-04-03 11:30,54,23,31,0,0,0
2020-04-03 11:45,72,32,40,0,0,0
2020-04-03 12:00,72,32,40,0,0,0
2020-04-03 12:15,75,31,44,0,0,0
2020-04-03 12:30,86,33,53,0,0,0
2020-04-03 12:45,77,37,40,0,0,0
2020-04-03 13:00,79,22,57,0,0,0
2020-04-03 13:15,78,21,57,0,0,0
2020-04-03 13:30,78,27,51,0,0,0
2020-04-03 13:45,79,40,39,0,0,0
2020-04-03 14:00,87,40,47,0,0,0
2020-04-03 14:15,96,30,66,0,0,0
2020-04-03 14:30,83,25,58,0,0,0
2020-04-03 14:45,83,41,42,0,0,0
2020-04-03 15:00,86,30,56,0,0,0
2020-04-03 15:15,76,30,46,0,0,0
2020-04-03 15:30,90,35,55,0,0,0
2020-04-03 15:45,108,43,65,0,0,0
2020-04-03 16:00,102,49,53,0,0,0
2020-04-03 16:15,69,28,41,0,0,0
2020-04-03 16:30,79,41,38,0,0,0
2020-04-03 16:45,69,38,31,0,0,0
2020-04-03 17:00,100,40,60,0,0,0
2020-04-03 17:15,70,31,39,0,0,0
2020-04-03 17:30,76,32,44,0,0,0
2020-04-03 17:45,64,25,39,0,0,0
2020-04-03 18:00,46,20,26,0,0,0
2020-04-03 18:15,54,29,25,0,0,0
2020-04-03 18:30,46,23,23,0,0,0
2020-04-03 18:45,43,21,22,0,0,0
2020-04-03 19:00,47,23,24,0,0,0
2020-04-03 19:15,34,15,19,0,0,0
2020-04-03 19:30,34,10,24,0,0,0
2020-04-03 19:45,37,17,20,0,0,0
2020-04-03 20:00,32,14,18,0,0,0
2020-04-03 20:15,39,13,26,0,0,0
2020-04-03 20:30,26,13,13,0,0,0
2020-04-03 20:45,10,6,4,0,0,0
2020-04-03 21:00,17,7,10,0,0,0
2020-04-03 21:15,14,1,13,0,0,0
2020-04-03 21:30,9,1,8,0,0,0
2020-04-03 21:45,11,2,9,0,0,0
2020-04-03 22:00,7,4,3,0,0,0
2020-04-03 22:15,7,1,6,0,0,0
2020-04-03 22:30,3,1,2,0,0,0
2020-04-03 22:45,6,2,4,0,0,0
2020-04-03 23:00,6,3,3,0,0,0
2020-04-03 23:15,5,0,5,0,0,0
2020-04-03 23:30,9,3,6,0,0,0
2020-04-03 23:45,10,5,5,0,0,0
2020-04-04 00:00,3,2,1,0,0,0
2020-04-04 00:15,5,3,2,0,0,0
2020-04-04 00:30,0,0,0,0,0,0
2020-04-04 00:45,5,3,2,0,0,0
2020-04-04 01:00,6,1,5,0,0,0
2020-04-04 01:15,2,0,2,0,0,0
2020-04-04 01:30,2,2,0,0,0,0
2020-04-04 01:45,1,0,1,0,0,0
2020-04-04 02:00,1,1,0,0,0,0
2020-04-04 02:15,0,0,0,0,0,0
2020-04-04 02:30,2,0,2,0,0,0
2020-04-04 02:45,3,2,1,0,0,0
2020-04-04 03:00,1,1,0,0,0,0
2020-04-04 03:15,2,0,2,0,0,0
2020-04-04 03:30,0,0,0,0,0,0
2020-04-04 03:45,0,0,0,0,0,0
2020-04-04 04:00,1,1,0,0,0,0
2020-04-04 04:15,0,0,0,0,0,0
2020-04-04 04:30,1,1,0,0,0,0
2020-04-04 04:45,1,1,0,0,0,0
2020-04-04 05:00,0,0,0,0,0,0
2020-04-04 05:15,5,3,2,0,0,0
2020-04-04 05:30,7,6,1,0,0,0
2020-04-04 05:45,6,5,1,0,0,0
2020-04-04 06:00,4,3,1,0,0,0
2020-04-04 06:15,7,5,2,0,0,0
2020-04-04 06:30,9,4,5,0,0,0
2020-04-04 06:45,8,3,5,0,0,0
2020-04-04 07:00,17,11,6,0,0,0
2020-04-04 07:15,14,9,5,0,0,0
2020-04-04 07:30,22,9,13,0,0,0
2020-04-04 07:45,24,11,13,0,0,0
2020-04-04 08:00,19,9,10,0,0,0
2020-04-04 08:15,22,14,8,0,0,0
2020-04-04 08:30,27,18,9,0,0,0
2020-04-04 08:45,41,29,12,0,0,0
2020-04-04 09:00,39,26,13,0,0,0
2020-04-04 09:15,47,21,26,0,0,0
2020-04-04 09:30,61,37,24,0,0,0
2020-04-04 09:45,69,36,33,0,0,0
2020-04-04 10:00,91,55,36,0,0,0
2020-04-04 10:15,74,38,36,0,0,0
2020-04-04 10:30,60,31,29,0,0,0
2020-04-04 10:45,108,65,43,0,0,0
2020-04-04 11:00,79,41,38,0,0,0
2020-04-04 11:15,115,61,54,0,0,0
2020-04-04 11:30,106,61,45,0,0,0
2020-04-04 11:45,115,60,55,0,0,0
2020-04-04 12:00,90,44,46,0,0,0
2020-04-04 12:15,118,64,54,0,0,0
2020-04-04 12:30,123,64,59,0,0,0
2020-04-04 12:45,98,49,49,0,0,0
2020-04-04 13:00,118,53,65,0,0,0
2020-04-04 13:15,130,57,73,0,0,0
2020-04-04 13:30,122,44,78,0,0,0
2020-04-04 13:45,93,35,58,0,0,0
2020-04-04 14:00,93,36,57,0,0,0
2020-04-04 14:15,83,34,49,0,0,0
2020-04-04 14:30,92,37,55,0,0,0
2020-04-04 14:45,108,40,68,0,0,0
2020-04-04 15:00,93,37,56,0,0,0
2020-04-04 15:15,97,35,62,0,0,0
2020-04-04 15:30,79,26,53,0,0,0
2020-04-04 15:45,98,43,55,0,0,0
2020-04-04 16:00,94,49,45,0,0,0
2020-04-04 16:15,85,35,50,0,0,0
2020-04-04 16:30,70,29,41,0,0,0
2020-04-04 16:45,84,38,46,0,0,0
2020-04-04 17:00,85,30,55,0,0,0
2020-04-04 17:15,73,41,32,0,0,0
2020-04-04 17:30,66,23,43,0,0,0
2020-04-04 17:45,52,19,33,0,0,0
2020-04-04 18:00,60,20,40,0,0,0
2020-04-04 18:15,64,22,42,0,0,0
2020-04-04 18:30,48,12,36,0,0,0
2020-04-04 18:45,49,20,29,0,0,0
2020-04-04 19:00,55,15,40,0,0,0
2020-04-04 19:15,36,14,22,0,0,0
2020-04-04 19:30,40,17,23,0,0,0
2020-04-04 19:45,44,18,26,0,0,0
2020-04-04 20:00,30,7,23,0,0,0
2020-04-04 20:15,29,10,19,0,0,0
2020-04-04 20:30,19,9,10,0,0,0
2020-04-04 20:45,10,2,8,0,0,0
2020-04-04 21:00,15,8,7,0,0,0
2020-04-04 21:15,17,4,13,0,0,0
2020-04-04 21:30,11,4,7,0,0,0
2020-04-04 21:45,10,2,8,0,0,0
2020-04-04 22:00,12,5,7,0,0,0
2020-04-04 22:15,5,2,3,0,0,0
2020-04-04 22:30,3,3,0,0,0,0
2020-04-04 22:45,10,4,6,0,0,0
2020-04-04 23:00,8,3,5,0,0,0
2020-04-04 23:15,6,2,4,0,0,0
2020-04-04 23:30,4,3,1,0,0,0
2020-04-04 23:45,6,6,0,0,0,0
2020-04-05 00:00,9,3,6,0,0,0
2020-04-05 00:15,3,1,2,0,0,0
2020-04-05 00:30,9,4,5,0,0,0
2020-04-05 00:45,9,3,6,0,0,0
2020-04-05 01:00,4,1,3,0,0,0
2020-04-05 01:15,3,1,2,0,0,0
2020-04-05 01:30,2,0,2,0,0,0
2020-04-05 01:45,0,0,0,0,0,0
2020-04-05 02:00,2,1,1,0,0,0
2020-04-05 02:15,2,2,0,0,0,0
2020-04-05 02:30,2,1,1,0,0,0
2020-04-05 02:45,0,0,0,0,0,0
2020-04-05 03:00,1,1,0,0,0,0
2020-04-05 03:15,1,0,1,0,0,0
2020-04-05 03:30,0,0,0,0,0,0
2020-04-05 03:45,0,0,0,0,0,0
2020-04-05 04:00,0,0,0,0,0,0
2020-04-05 04:15,0,0,0,0,0,0
2020-04-05 04:30,0,0,0,0,0,0
2020-04-05 04:45,2,1,1,0,0,0
2020-04-05 05:00,0,0,0,0,0,0
2020-04-05 05:15,3,1,2,0,0,0
2020-04-05 05:30,5,3,2,0,0,0
2020-04-05 05:45,2,2,0,0,0,0
2020-04-05 06:00,0,0,0,0,0,0
2020-04-05 06:15,1,0,1,0,0,0
2020-04-05 06:30,5,2,3,0,0,0
2020-04-05 06:45,6,3,3,0,0,0
2020-04-05 07:00,4,3,1,0,0,0
2020-04-05 07:15,4,1,3,0,0,0
2020-04-05 07:30,7,5,2,0,0,0
2020-04-05 07:45,6,2,4,0,0,0
2020-04-05 08:00,7,2,5,0,0,0
2020-04-05 08:15,8,4,4,0,0,0
2020-04-05 08:30,8,6,2,0,0,0
2020-04-05 08:45,12,11,1,0,0,0
2020-04-05 09:00,13,10,3,0,0,0
2020-04-05 09:15,13,10,3,0,0,0
2020-04-05 09:30,20,9,11,0,0,0
2020-04-05 09:45,21,8,13,0,0,0
2020-04-05 10:00,22,15,7,0,0,0
2020-04-05 10:15,31,12,19,0,0,0
2020-04-05 10:30,27,16,11,0,0,0
2020-04-05 10:45,39,23,16,0,0,0
2020-04-05 11:00,34,17,17,0,0,0
2020-04-05 11:15,33,25,8,0,0,0
2020-04-05 11:30,40,20,20,0,0,0
2020-04-05 11:45,44,24,20,0,0,0
2020-04-05 12:00,43,19,24,0,0,0
2020-04-05 12:15,62,37,25,0,0,0
2020-04-05 12:30,54,30,24,0,0,0
2020-04-05 12:45,69,34,35,0,0,0
2020-04-05 13:00,62,30,32,0,0,0
2020-04-05 13:15,50,30,20,0,0,0
2020-04-05 13:30,95,45,50,0,0,0
2020-04-05 13:45,96,44,52,0,0,0
2020-04-05 14:00,99,45,54,0,0,0
2020-04-05 14:15,77,41,36,0,0,0
2020-04-05 14:30,75,20,55,0,0,0
2020-04-05 14:45,100,51,49,0,0,0
2020-04-05 15:00,92,36,56,0,0,0
2020-04-05 15:15,73,37,36,0,0,0
2020-04-05 15:30,78,34,44,0,0,0
2020-04-05 15:45,111,34,77,0,0,0
2020-04-05 16:00,82,31,51,0,0,0
2020-04-05 16:15,83,25,58,0,0,0
2020-04-05 16:30,88,21,67,0,0,0
2020-04-05 16:45,85,28,57,0,0,0
2020-04-05 17:00,86,35,51,0,0,0
2020-04-05 17:15,94,32,62,0,0,0
2020-04-05 17:30,83,33,50,0,0,0
2020-04-05 17:45,57,29,28,0,0,0
2020-04-05 18:00,80,34,46,0,0,0
2020-04-05 18:15,52,17,35,0,0,0
2020-04-05 18:30,56,15,41,0,0,0
2020-04-05 18:45,33,23,10,0,0,0
2020-04-05 19:00,28,14,14,0,0,0
2020-04-05 19:15,31,10,21,0,0,0
2020-04-05 19:30,32,8,24,0,0,0
2020-04-05 19:45,44,13,31,0,0,0
2020-04-05 20:00,29,17,12,0,0,0
2020-04-05 20:15,25,10,15,0,0,0
2020-04-05 20:30,25,12,13,0,0,0
2020-04-05 20:45,17,7,10,0,0,0
2020-04-05 21:00,20,5,15,0,0,0
2020-04-05 21:15,15,4,11,0,0,0
2020-04-05 21:30,20,9,11,0,0,0
2020-04-05 21:45,12,3,9,0,0,0
2020-04-05 22:00,5,2,3,0,0,0
2020-04-05 22:15,8,5,3,0,0,0
2020-04-05 22:30,8,2,6,0,0,0
2020-04-05 22:45,5,1,4,0,0,0
2020-04-05 23:00,7,3,4,0,0,0
2020-04-05 23:15,3,0,3,0,0,0
2020-04-05 23:30,5,0,5,0,0,0
2020-04-05 23:45,5,2,3,0,0,0
2020-04-06 00:00,3,1,2,0,0,0
2020-04-06 00:15,2,0,2,0,0,0
2020-04-06 00:30,2,2,0,0,0,0
2020-04-06 00:45,3,3,0,0,0,0
2020-04-06 01:00,2,1,1,0,0,0
2020-04-06 01:15,0,0,0,0,0,0
2020-04-06 01:30,3,1,2,0,0,0
2020-04-06 01:45,2,0,2,0,0,0
2020-04-06 02:00,1,0,1,0,0,0
2020-04-06 02:15,0,0,0,0,0,0
2020-04-06 02:30,0,0,0,0,0,0
2020-04-06 02:45,0,0,0,0,0,0
2020-04-06 03:00,0,0,0,0,0,0
2020-04-06 03:15,0,0,0,0,0,0
2020-04-06 03:30,4,0,4,0,0,0
2020-04-06 03:45,1,0,1,0,0,0
2020-04-06 04:00,0,0,0,0,0,0
2020-04-06 04:15,2,1,1,0,0,0
2020-04-06 04:30,2,2,0,0,0,0
2020-04-06 04:45,2,1,1,0,0,0
2020-04-06 05:00,7,5,2,0,0,0
2020-04-06 05:15,6,4,2,0,0,0
2020-04-06 05:30,8,5,3,0,0,0
2020-04-06 05:45,21,17,4,0,0,0
2020-04-06 06:00,11,9,2,0,0,0
2020-04-06 06:15,29,20,9,0,0,0
2020-04-06 06:30,30,25,5,0,0,0
2020-04-06 06:45,51,39,12,0,0,0
2020-04-06 07:00,65,42,23,0,0,0
2020-04-06 07:15,51,33,18,0,0,0
2020-04-06 07:30,69,43,26,0,0,0
2020-04-06 07:45,76,54,22,0,0,0
2020-04-06 08:00,71,50,21,0,0,0
2020-04-06 08:15,69,44,25,0,0,0
2020-04-06 08:30,51,36,15,0,0,0
2020-04-06 08:45,58,37,21,0,0,0
2020-04-06 09:00,52,36,16,0,0,0
2020-04-06 09:15,55,29,26,0,0,0
2020-04-06 09:30,55,35,20,0,0,0
2020-04-06 09:45,51,35,16,0,0,0
2020-04-06 10:00,59,22,37,0,0,0
2020-04-06 10:15,68,39,29,0,0,0
2020-04-06 10:30,56,30,26,0,0,0
2020-04-06 10:45,79,41,38,0,0,0
2020-04-06 11:00,59,29,30,0,0,0
2020-04-06 11:15,75,42,33,0,0,0
2020-04-06 11:30,76,40,36,0,0,0
2020-04-06 11:45,80,30,50,0,0,0
2020-04-06 12:00,80,29,51,0,0,0
2020-04-06 12:15,89,33,56,0,0,0
2020-04-06 12:30,95,47,48,0,0,0
2020-04-06 12:45,87,43,44,0,0,0
2020-04-06 13:00,85,32,53,0,0,0
2020-04-06 13:15,80,37,43,0,0,0
2020-04-06 13:30,87,36,51,0,0,0
2020-04-06 13:45,76,39,37,0,0,0
2020-04-06 14:00,91,46,45,0,0,0
2020-04-06 14:15,83,40,43,0,0,0
2020-04-06 14:30,105,40,65,0,0,0
2020-04-06 14:45,97,48,49,0,0,0
2020-04-06 15:00,93,42,51,0,0,0
2020-04-06 15:15,91,35,56,0,0,0
2020-04-06 15:30,106,51,55,0,0,0
2020-04-06 15:45,108,50,58,0,0,0
2020-04-06 16:00,131,51,80,0,0,0
2020-04-06 16:15,124,46,78,0,0,0
2020-04-06 16:30,125,42,83,0,0,0
2020-04-06 16:45,119,50,69,0,0,0
2020-04-06 17:00,155,61,94,0,0,0
2020-04-06 17:15,104,51,53,0,0,0
2020-04-06 17:30,109,44,65,0,0,0
2020-04-06 17:45,96,43,53,0,0,0
2020-04-06 18:00,101,37,64,0,0,0
2020-04-06 18:15,109,39,70,0,0,0
2020-04-06 18:30,89,38,51,0,0,0
2020-04-06 18:45,68,24,44,0,0,0
2020-04-06 19:00,60,25,35,0,0,0
2020-04-06 19:15,50,10,40,0,0,0
2020-04-06 19:30,50,28,22,0,0,0
2020-04-06 19:45,42,16,26,0,0,0
2020-04-06 20:00,32,8,24,0,0,0
2020-04-06 20:15,41,13,28,0,0,0
2020-04-06 20:30,25,10,15,0,0,0
2020-04-06 20:45,25,12,13,0,0,0
2020-04-06 21:00,20,11,9,0,0,0
2020-04-06 21:15,13,7,6,0,0,0
2020-04-06 21:30,22,8,14,0,0,0
2020-04-06 21:45,5,2,3,0,0,0
2020-04-06 22:00,16,4,12,0,0,0
2020-04-06 22:15,13,6,7,0,0,0
2020-04-06 22:30,12,2,10,0,0,0
2020-04-06 22:45,6,2,4,0,0,0
2020-04-06 23:00,4,1,3,0,0,0
2020-04-06 23:15,9,7,2,0,0,0
2020-04-06 23:30,5,1,4,0,0,0
2020-04-06 23:45,5,5,0,0,0,0
2020-04-07 00:00,5,3,2,0,0,0
2020-04-07 00:15,4,3,1,0,0,0
2020-04-07 00:30,3,1,2,0,0,0
2020-04-07 00:45,4,2,2,0,0,0
2020-04-07 01:00,0,0,0,0,0,0
2020-04-07 01:15,4,2,2,0,0,0
2020-04-07 01:30,3,2,1,0,0,0
2020-04-07 01:45,0,0,0,0,0,0
2020-04-07 02:00,0,0,0,0,0,0
2020-04-07 02:15,2,0,2,0,0,0
2020-04-07 02:30,1,1,0,0,0,0
2020-04-07 02:45,0,0,0,0,0,0
2020-04-07 03:00,2,0,2,0,0,0
2020-04-07 03:15,1,1,0,0,0,0
2020-04-07 03:30,1,1,0,0,0,0
2020-04-07 03:45,0,0,0,0,0,0
2020-04-07 04:00,1,0,1,0,0,0
2020-04-07 04:15,1,0,1,0,0,0
2020-04-07 04:30,2,2,0,0,0,0
2020-04-07 04:45,1,1,0,0,0,0
2020-04-07 05:00,7,6,1,0,0,0
2020-04-07 05:15,4,3,1,0,0,0
2020-04-07 05:30,13,9,4,0,0,0
2020-04-07 05:45,23,16,7,0,0,0
2020-04-07 06:00,16,12,4,0,0,0
2020-04-07 06:15,29,14,15,0,0,0
2020-04-07 06:30,41,26,15,0,0,0
2020-04-07 06:45,42,32,10,0,0,0
2020-04-07 07:00,58,42,16,0,0,0
2020-04-07 07:15,61,38,23,0,0,0
2020-04-07 07:30,62,43,19,0,0,0
2020-04-07 07:45,90,66,24,0,0,0
2020-04-07 08:00,70,41,29,0,0,0
2020-04-07 08:15,87,58,29,0,0,0
2020-04-07 08:30,61,30,31,0,0,0
2020-04-07 08:45,72,56,16,0,0,0
2020-04-07 09:00,51,34,17,0,0,0
2020-04-07 09:15,47,31,16,0,0,0
2020-04-07 09:30,56,32,24,0,0,0
2020-04-07 09:45,61,40,21,0,0,0
2020-04-07 10:00,68,33,35,0,0,0
2020-04-07 10:15,65,27,38,0,0,0
2020-04-07 10:30,70,41,29,0,0,0
2020-04-07 10:45,95,50,45,0,0,0
2020-04-07 11:00,69,29,40,0,0,0
2020-04-07 11:15,79,40,39,0,0,0
2020-04-07 11:30,91,39,52,0,0,0
2020-04-07 11:45,86,41,45,0,0,0
2020-04-07 12:00,95,35,60,0,0,0
2020-04-07 12:15,93,34,59,0,0,0
2020-04-07 12:30,88,31,57,0,0,0
2020-04-07 12:45,92,51,41,0,0,0
2020-04-07 13:00,111,44,67,0,0,0
2020-04-07 13:15,110,50,60,0,0,0
2020-04-07 13:30,81,32,49,0,0,0
2020-04-07 13:45,95,43,52,0,0,0
2020-04-07 14:00,93,40,53,0,0,0
2020-04-07 14:15,95,32,63,0,0,0
2020-04-07 14:30,109,46,63,0,0,0
2020-04-07 14:45,101,40,61,0,0,0
2020-04-07 15:00,113,40,73,0,0,0
2020-04-07 15:15,86,29,57,0,0,0
2020-04-07 15:30,117,58,59,0,0,0
2020-04-07 15:45,118,55,63,0,0,0
2020-04-07 16:00,122,41,81,0,0,0
2020-04-07 16:15,137,54,83,0,0,0
2020-04-07 16:30,135,46,89,0,0,0
2020-04-07 16:45,109,43,66,0,0,0
2020-04-07 17:00,138,55,83,0,0,0
2020-04-07 17:15,115,48,67,0,0,0
2020-04-07 17:30,112,47,65,0,0,0
2020-04-07 17:45,115,45,70,0,0,0
2020-04-07 18:00,110,43,67,0,0,0
2020-04-07 18:15,91,28,63,0,0,0
2020-04-07 18:30,67,21,46,0,0,0
2020-04-07 18:45,67,28,39,0,0,0
2020-04-07 19:00,70,26,44,0,0,0
2020-04-07 19:15,53,22,31,0,0,0
2020-04-07 19:30,45,18,27,0,0,0
2020-04-07 19:45,48,25,23,0,0,0
2020-04-07 20:00,54,14,40,0,0,0
2020-04-07 20:15,34,12,22,0,0,0
2020-04-07 20:30,34,15,19,0,0,0
2020-04-07 20:45,24,11,13,0,0,0
2020-04-07 21:00,39,16,23,0,0,0
2020-04-07 21:15,17,8,9,0,0,0
2020-04-07 21:30,15,4,11,0,0,0
2020-04-07 21:45,12,3,9,0,0,0
2020-04-07 22:00,16,6,10,0,0,0
2020-04-07 22:15,11,2,9,0,0,0
2020-04-07 22:30,10,3,7,0,0,0
2020-04-07 22:45,0,0,0,0,0,0
2020-04-07 23:00,10,3,7,0,0,0
2020-04-07 23:15,5,3,2,0,0,0
2020-04-07 23:30,2,2,0,0,0,0
2020-04-07 23:45,3,1,2,0,0,0
2020-04-08 00:00,5,0,5,0,0,0
2020-04-08 00:15,3,2,1,0,0,0
2020-04-08 00:30,4,0,4,0,0,0
2020-04-08 00:45,1,0,1,0,0,0
2020-04-08 01:00,2,2,0,0,0,0
2020-04-08 01:15,1,1,0,0,0,0
2020-04-08 01:30,2,1,1,0,0,0
2020-04-08 01:45,2,1,1,0,0,0
2020-04-08 02:00,1,0,1,0,0,0
2020-04-08 02:15,0,0,0,0,0,0
2020-04-08 02:30,0,0,0,0,0,0
2020-04-08 02:45,2,1,1,0,0,0
2020-04-08 03:00,2,0,2,0,0,0
2020-04-08 03:15,4,0,4,0,0,0
2020-04-08 03:30,0,0,0,0,0,0
2020-04-08 03:45,0,0,0,0,0,0
2020-04-08 04:00,0,0,0,0,0,0
2020-04-08 04:15,2,1,1,0,0,0
2020-04-08 04:30,1,1,0,0,0,0
2020-04-08 04:45,2,1,1,0,0,0
2020-04-08 05:00,4,3,1,0,0,0
2020-04-08 05:15,11,6,5,0,0,0
2020-04-08 05:30,9,6,3,0,0,0
2020-04-08 05:45,22,17,5,0,0,0
2020-04-08 06:00,12,10,2,0,0,0
2020-04-08 06:15,28,16,12,0,0,0
2020-04-08 06:30,29,22,7,0,0,0
2020-04-08 06:45,69,51,18,0,0,0
2020-04-08 07:00,58,41,17,0,0,0
2020-04-08 07:15,67,42,25,0,0,0
2020-04-08 07:30,79,58,21,0,0,0
2020-04-08 07:45,108,72,36,0,0,0
2020-04-08 08:00,82,53,29,0,0,0
2020-04-08 08:15,90,60,30,0,0,0
2020-04-08 08:30,66,39,27,0,0,0
2020-04-08 08:45,95,66,29,0,0,0
2020-04-08 09:00,84,48,36,0,0,0
2020-04-08 09:15,69,33,36,0,0,0
2020-04-08 09:30,68,32,36,0,0,0
2020-04-08 09:45,92,64,28,0,0,0
2020-04-08 10:00,81,49,32,0,0,0
2020-04-08 10:15,93,56,37,0,0,0
2020-04-08 10:30,96,46,50,0,0,0
2020-04-08 10:45,121,58,63,0,0,0
2020-04-08 11:00,108,45,63,0,0,0
2020-04-08 11:15,111,51,60,0,0,0
2020-04-08 11:30,101,46,55,0,0,0
2020-04-08 11:45,125,63,62,0,0,0
2020-04-08 12:00,119,60,59,0,0,0
2020-04-08 12:15,113,51,62,0,0,0
2020-04-08 12:30,139,60,79,0,0,0
2020-04-08 12:45,121,51,70,0,0,0
2020-04-08 13:00,120,40,80,0,0,0
2020-04-08 13:15,124,59,65,0,0,0
2020-04-08 13:30,92,41,51,0,0,0
2020-04-08 13:45,102,52,50,0,0,0
2020-04-08 14:00,114,41,73,0,0,0
2020-04-08 14:15,82,37,45,0,0,0
2020-04-08 14:30,113,55,58,0,0,0
2020-04-08 14:45,101,34,67,0,0,0
2020-04-08 15:00,115,46,69,0,0,0
2020-04-08 15:15,103,43,60,0,0,0
2020-04-08 15:30,124,39,85,0,0,0
2020-04-08 15:45,111,54,57,0,0,0
2020-04-08 16:00,143,36,107,0,0,0
2020-04-08 16:15,118,47,71,0,0,0
2020-04-08 16:30,127,61,66,0,0,0
2020-04-08 16:45,107,46,61,0,0,0
2020-04-08 17:00,128,50,78,0,0,0
2020-04-08 17:15,87,31,56,0,0,0
2020-04-08 17:30,108,33,75,0,0,0
2020-04-08 17:45,92,31,61,0,0,0
2020-04-08 18:00,79,32,47,0,0,0
2020-04-08 18:15,86,40,46,0,0,0
2020-04-08 18:30,91,38,53,0,0,0
2020-04-08 18:45,72,32,40,0,0,0
2020-04-08 19:00,60,21,39,0,0,0
2020-04-08 19:15,45,15,30,0,0,0
2020-04-08 19:30,46,22,24,0,0,0
2020-04-08 19:45,60,27,33,0,0,0
2020-04-08 20:00,43,19,24,0,0,0
2020-04-08 20:15,31,7,24,0,0,0
2020-04-08 20:30,23,11,12,0,0,0
2020-04-08 20:45,54,23,31,0,0,0
2020-04-08 21:00,24,8,16,0,0,0
2020-04-08 21:15,29,11,18,0,0,0
2020-04-08 21:30,14,6,8,0,0,0
2020-04-08 21:45,16,5,11,0,0,0
2020-04-08 22:00,14,2,12,0,0,0
2020-04-08 22:15,12,6,6,0,0,0
2020-04-08 22:30,9,2,7,0,0,0
2020-04-08 22:45,17,4,13,0,0,0
2020-04-08 23:00,6,2,4,0,0,0
2020-04-08 23:15,14,7,7,0,0,0
2020-04-08 23:30,10,2,8,0,0,0
2020-04-08 23:45,4,2,2,0,0,0
2020-04-09 00:00,5,2,3,0,0,0
2020-04-09 00:15,3,2,1,0,0,0
2020-04-09 00:30,7,3,4,0,0,0
2020-04-09 00:45,2,1,1,0,0,0
2020-04-09 01:00,1,0,1,0,0,0
2020-04-09 01:15,1,1,0,0,0,0
2020-04-09 01:30,2,1,1,0,0,0
2020-04-09 01:45,4,1,3,0,0,0
2020-04-09 02:00,0,0,0,0,0,0
2020-04-09 02:15,2,1,1,0,0,0
2020-04-09 02:30,1,0,1,0,0,0
2020-04-09 02:45,0,0,0,0,0,0
2020-04-09 03:00,2,0,2,0,0,0
2020-04-09 03:15,1,0,1,0,0,0
2020-04-09 03:30,0,0,0,0,0,0
2020-04-09 03:45,1,0,1,0,0,0
2020-04-09 04:00,0,0,0,0,0,0
2020-04-09 04:15,3,3,0,0,0,0
2020-04-09 04:30,3,2,1,0,0,0
2020-04-09 04:45,1,0,1,0,0,0
2020-04-09 05:00,4,2,2,0,0,0
2020-04-09 05:15,6,5,1,0,0,0
2020-04-09 05:30,16,12,4,0,0,0
2020-04-09 05:45,22,14,8,0,0,0
2020-04-09 06:00,14,9,5,0,0,0
2020-04-09 06:15,20,10,10,0,0,0
2020-04-09 06:30,40,27,13,0,0,0
2020-04-09 06:45,45,33,12,0,0,0
2020-04-09 07:00,48,33,15,0,0,0
2020-04-09 07:15,66,46,20,0,0,0
2020-04-09 07:30,53,31,22,0,0,0
2020-04-09 07:45,94,61,33,0,0,0
2020-04-09 08:00,51,29,22,0,0,0
2020-04-09 08:15,75,42,33,0,0,0
2020-04-09 08:30,63,38,25,0,0,0
2020-04-09 08:45,68,44,24,0,0,0
2020-04-09 09:00,45,21,24,0,0,0
2020-04-09 09:15,57,37,20,0,0,0
2020-04-09 09:30,63,34,29,0,0,0
2020-04-09 09:45,67,39,28,0,0,0
2020-04-09 10:00,59,26,33,0,0,0
2020-04-09 10:15,72,49,23,0,0,0
2020-04-09 10:30,86,52,34,0,0,0
2020-04-09 10:45,95,45,50,0,0,0
2020-04-09 11:00,84,35,49,0,0,0
2020-04-09 11:15,91,56,35,0,0,0
2020-04-09 11:30,76,40,36,0,0,0
2020-04-09 11:45,95,48,47,0,0,0
2020-04-09 12:00,103,36,67,0,0,0
2020-04-09 12:15,79,40,39,0,0,0
2020-04-09 12:30,113,60,53,0,0,0
2020-04-09 12:45,87,31,56,0,0,0
2020-04-09 13:00,83,30,53,0,0,0
2020-04-09 13:15,93,40,53,0,0,0
2020-04-09 13:30,96,50,46,0,0,0
2020-04-09 13:45,109,49,60,0,0,0
2020-04-09 14:00,105,45,60,0,0,0
2020-04-09 14:15,109,54,55,0,0,0
2020-04-09 14:30,101,41,60,0,0,0
2020-04-09 14:45,129,59,70,0,0,0
2020-04-09 15:00,110,48,62,0,0,0
2020-04-09 15:15,129,50,79,0,0,0
2020-04-09 15:30,115,48,67,0,0,0
2020-04-09 15:45,121,50,71,0,0,0
2020-04-09 16:00,139,58,81,0,0,0
2020-04-09 16:15,125,53,72,0,0,0
2020-04-09 16:30,117,39,78,0,0,0
2020-04-09 16:45,114,35,79,0,0,0
2020-04-09 17:00,127,41,86,0,0,0
2020-04-09 17:15,79,30,49,0,0,0
2020-04-09 17:30,123,53,70,0,0,0
2020-04-09 17:45,93,44,49,0,0,0
2020-04-09 18:00,99,38,61,0,0,0
2020-04-09 18:15,80,32,48,0,0,0
2020-04-09 18:30,87,26,61,0,0,0
2020-04-09 18:45,80,23,57,0,0,0
2020-04-09 19:00,53,23,30,0,0,0
2020-04-09 19:15,40,16,24,0,0,0
2020-04-09 19:30,55,24,31,0,0,0
2020-04-09 19:45,42,18,24,0,0,0
2020-04-09 20:00,36,19,17,0,0,0
2020-04-09 20:15,29,19,10,0,0,0
2020-04-09 20:30,30,9,21,0,0,0
2020-04-09 20:45,32,15,17,0,0,0
2020-04-09 21:00,35,13,22,0,0,0
2020-04-09 21:15,22,4,18,0,0,0
2020-04-09 21:30,21,11,10,0,0,0
2020-04-09 21:45,10,5,5,0,0,0
2020-04-09 22:00,7,4,3,0,0,0
2020-04-09 22:15,19,6,13,0,0,0
2020-04-09 22:30,15,6,9,0,0,0
2020-04-09 22:45,9,4,5,0,0,0
2020-04-09 23:00,9,4,5,0,0,0
2020-04-09 23:15,8,3,5,0,0,0
2020-04-09 23:30,5,1,4,0,0,0
2020-04-09 23:45,5,3,2,0,0,0
2020-04-10 00:00,8,3,5,0,0,0
2020-04-10 00:15,2,1,1,0,0,0
2020-04-10 00:30,2,1,1,0,0,0
2020-04-10 00:45,5,1,4,0,0,0
2020-04-10 01:00,3,1,2,0,0,0
2020-04-10 01:15,4,3,1,0,0,0
2020-04-10 01:30,2,0,2,0,0,0
2020-04-10 01:45,1,1,0,0,0,0
2020-04-10 02:00,4,3,1,0,0,0
2020-04-10 02:15,2,1,1,0,0,0
2020-04-10 02:30,3,2,1,0,0,0
2020-04-10 02:45,2,2,0,0,0,0
2020-04-10 03:00,2,0,2,0,0,0
2020-04-10 03:15,1,0,1,0,0,0
2020-04-10 03:30,2,2,0,0,0,0
2020-04-10 03:45,1,1,0,0,0,0
2020-04-10 04:00,1,1,0,0,0,0
2020-04-10 04:15,1,1,0,0,0,0
2020-04-10 04:30,1,1,0,0,0,0
2020-04-10 04:45,0,0,0,0,0,0
2020-04-10 05:00,0,0,0,0,0,0
2020-04-10 05:15,2,2,0,0,0,0
2020-04-10 05:30,5,3,2,0,0,0
2020-04-10 05:45,2,2,0,0,0,0
2020-04-10 06:00,1,0,1,0,0,0
2020-04-10 06:15,2,0,2,0,0,0
2020-04-10 06:30,4,2,2,0,0,0
2020-04-10 06:45,2,1,1,0,0,0
2020-04-10 07:00,6,4,2,0,0,0
2020-04-10 07:15,5,3,2,0,0,0
2020-04-10 07:30,4,1,3,0,0,0
2020-04-10 07:45,6,3,3,0,0,0
2020-04-10 08:00,7,5,2,0,0,0
2020-04-10 08:15,8,5,3,0,0,0
2020-04-10 08:30,9,7,2,0,0,0
2020-04-10 08:45,12,8,4,0,0,0
2020-04-10 09:00,10,6,4,0,0,0
2020-04-10 09:15,13,8,5,0,0,0
2020-04-10 09:30,13,6,7,0,0,0
2020-04-10 09:45,29,18,11,0,0,0
2020-04-10 10:00,20,6,14,0,0,0
2020-04-10 10:15,20,18,2,0,0,0
2020-04-10 10:30,32,16,16,0,0,0
2020-04-10 10:45,28,19,9,0,0,0
2020-04-10 11:00,21,14,7,0,0,0
2020-04-10 11:15,48,31,17,0,0,0
2020-04-10 11:30,37,16,21,0,0,0
2020-04-10 11:45,46,24,22,0,0,0
2020-04-10 12:00,40,26,14,0,0,0
2020-04-10 12:15,58,26,32,0,0,0
2020-04-10 12:30,65,39,26,0,0,0
2020-04-10 12:45,72,39,33,0,0,0
2020-04-10 13:00,52,33,19,0,0,0
2020-04-10 13:15,74,43,31,0,0,0
2020-04-10 13:30,59,30,29,0,0,0
2020-04-10 13:45,65,35,30,0,0,0
2020-04-10 14:00,82,34,48,0,0,0
2020-04-10 14:15,83,52,31,0,0,0
2020-04-10 14:30,64,40,24,0,0,0
2020-04-10 14:45,77,45,32,0,0,0
2020-04-10 15:00,88,57,31,0,0,0
2020-04-10 15:15,103,36,67,0,0,0
2020-04-10 15:30,89,37,52,0,0,0
2020-04-10 15:45,94,30,64,0,0,0
2020-04-10 16:00,95,42,53,0,0,0
2020-04-10 16:15,67,38,29,0,0,0
2020-04-10 16:30,85,28,57,0,0,0
2020-04-10 16:45,97,52,45,0,0,0
2020-04-10 17:00,91,36,55,0,0,0
2020-04-10 17:15,80,35,45,0,0,0
2020-04-10 17:30,72,22,50,0,0,0
2020-04-10 17:45,79,19,60,0,0,0
2020-04-10 18:00,77,26,51,0,0,0
2020-04-10 18:15,82,41,41,0,0,0
2020-04-10 18:30,48,18,30,0,0,0
2020-04-10 18:45,58,26,32,0,0,0
2020-04-10 19:00,45,18,27,0,0,0
2020-04-10 19:15,33,11,22,0,0,0
2020-04-10 19:30,29,12,17,0,0,0
2020-04-10 19:45,33,10,23,0,0,0
2020-04-10 20:00,22,6,16,0,0,0
2020-04-10 20:15,26,10,16,0,0,0
2020-04-10 20:30,23,11,12,0,0,0
2020-04-10 20:45,22,9,13,0,0,0
2020-04-10 21:00,19,11,8,0,0,0
2020-04-10 21:15,20,9,11,0,0,0
2020-04-10 21:30,18,8,10,0,0,0
2020-04-10 21:45,6,2,4,0,0,0
2020-04-10 22:00,8,3,5,0,0,0
2020-04-10 22:15,7,2,5,0,0,0
2020-04-10 22:30,11,5,6,0,0,0
2020-04-10 22:45,5,1,4,0,0,0
2020-04-10 23:00,5,3,2,0,0,0
2020-04-10 23:15,2,2,0,0,0,0
2020-04-10 23:30,10,3,7,0,0,0
2020-04-10 23:45,5,1,4,0,0,0
2020-04-11 00:00,7,4,3,0,0,0
2020-04-11 00:15,2,1,1,0,0,0
2020-04-11 00:30,1,0,1,0,0,0
2020-04-11 00:45,2,1,1,0,0,0
2020-04-11 01:00,3,0,3,0,0,0
2020-04-11 01:15,2,2,0,0,0,0
2020-04-11 01:30,4,1,3,0,0,0
2020-04-11 01:45,2,0,2,0,0,0
2020-04-11 02:00,1,0,1,0,0,0
2020-04-11 02:15,0,0,0,0,0,0
2020-04-11 02:30,0,0,0,0,0,0
2020-04-11 02:45,2,2,0,0,0,0
2020-04-11 03:00,1,0,1,0,0,0
2020-04-11 03:15,0,0,0,0,0,0
2020-04-11 03:30,0,0,0,0,0,0
2020-04-11 03:45,6,1,5,0,0,0
2020-04-11 04:00,0,0,0,0,0,0
2020-04-11 04:15,0,0,0,0,0,0
2020-04-11 04:30,2,1,1,0,0,0
2020-04-11 04:45,2,2,0,0,0,0
2020-04-11 05:00,5,3,2,0,0,0
2020-04-11 05:15,3,2,1,0,0,0
2020-04-11 05:30,7,3,4,0,0,0
2020-04-11 05:45,7,6,1,0,0,0
2020-04-11 06:00,6,3,3,0,0,0
2020-04-11 06:15,6,5,1,0,0,0
2020-04-11 06:30,15,12,3,0,0,0
2020-04-11 06:45,18,14,4,0,0,0
2020-04-11 07:00,27,18,9,0,0,0
2020-04-11 07:15,35,18,17,0,0,0
2020-04-11 07:30,46,28,18,0,0,0
2020-04-11 07:45,39,19,20,0,0,0
2020-04-11 08:00,73,32,41,0,0,0
2020-04-11 08:15,54,38,16,0,0,0
2020-04-11 08:30,67,37,30,0,0,0
2020-04-11 08:45,62,35,27,0,0,0
2020-04-11 09:00,69,31,38,0,0,0
2020-04-11 09:15,57,24,33,0,0,0
2020-04-11 09:30,77,38,39,0,0,0
2020-04-11 09:45,88,43,45,0,0,0
2020-04-11 10:00,90,44,46,0,0,0
2020-04-11 10:15,81,43,38,0,0,0
2020-04-11 10:30,85,44,41,0,0,0
2020-04-11 10:45,96,60,36,0,0,0
2020-04-11 11:00,123,54,69,0,0,0
2020-04-11 11:15,130,60,70,0,0,0
2020-04-11 11:30,130,64,66,0,0,0
2020-04-11 11:45,126,59,67,0,0,0
2020-04-11 12:00,105,47,58,0,0,0
2020-04-11 12:15,138,64,74,0,0,0
2020-04-11 12:30,100,53,47,0,0,0
2020-04-11 12:45,116,58,58,0,0,0
2020-04-11 13:00,114,48,66,0,0,0
2020-04-11 13:15,86,33,53,0,0,0
2020-04-11 13:30,114,52,62,0,0,0
2020-04-11 13:45,134,67,67,0,0,0
2020-04-11 14:00,105,57,48,0,0,0
2020-04-11 14:15,103,44,59,0,0,0
2020-04-11 14:30,96,47,49,0,0,0
2020-04-11 14:45,113,42,71,0,0,0
2020-04-11 15:00,91,47,44,0,0,0
2020-04-11 15:15,71,23,48,0,0,0
2020-04-11 15:30,78,39,39,0,0,0
2020-04-11 15:45,76,34,42,0,0,0
2020-04-11 16:00,72,29,43,0,0,0
2020-04-11 16:15,85,34,51,0,0,0
2020-04-11 16:30,67,20,47,0,0,0
2020-04-11 16:45,78,30,48,0,0,0
2020-04-11 17:00,76,34,42,0,0,0
2020-04-11 17:15,75,28,47,0,0,0
2020-04-11 17:30,72,24,48,0,0,0
2020-04-11 17:45,85,35,50,0,0,0
2020-04-11 18:00,79,21,58,0,0,0
2020-04-11 18:15,59,34,25,0,0,0
2020-04-11 18:30,71,30,41,0,0,0
2020-04-11 18:45,60,35,25,0,0,0
2020-04-11 19:00,58,19,39,0,0,0
2020-04-11 19:15,41,13,28,0,0,0
2020-04-11 19:30,56,25,31,0,0,0
2020-04-11 19:45,39,16,23,0,0,0
2020-04-11 20:00,38,14,24,0,0,0
2020-04-11 20:15,38,21,17,0,0,0
2020-04-11 20:30,31,16,15,0,0,0
2020-04-11 20:45,28,14,14,0,0,0
2020-04-11 21:00,23,7,16,0,0,0
2020-04-11 21:15,23,13,10,0,0,0
2020-04-11 21:30,15,3,12,0,0,0
2020-04-11 21:45,11,3,8,0,0,0
2020-04-11 22:00,17,3,14,0,0,0
2020-04-11 22:15,18,8,10,0,0,0
2020-04-11 22:30,8,4,4,0,0,0
2020-04-11 22:45,12,7,5,0,0,0
2020-04-11 23:00,9,5,4,0,0,0
2020-04-11 23:15,8,1,7,0,0,0
2020-04-11 23:30,12,8,4,0,0,0
2020-04-11 23:45,7,5,2,0,0,0
2020-04-12 00:00,6,1,5,0,0,0
2020-04-12 00:15,4,2,2,0,0,0
2020-04-12 00:30,6,3,3,0,0,0
2020-04-12 00:45,5,3,2,0,0,0
2020-04-12 01:00,1,0,1,0,0,0
2020-04-12 01:15,1,0,1,0,0,0
2020-04-12 01:30,0,0,0,0,0,0
2020-04-12 01:45,3,1,2,0,0,0
2020-04-12 02:00,1,0,1,0,0,0
2020-04-12 02:15,1,0,1,0,0,0
2020-04-12 02:30,4,3,1,0,0,0
2020-04-12 02:45,0,0,0,0,0,0
2020-04-12 03:00,1,0,1,0,0,0
2020-04-12 03:15,1,1,0,0,0,0
2020-04-12 03:30,0,0,0,0,0,0
2020-04-12 03:45,3,2,1,0,0,0
2020-04-12 04:00,0,0,0,0,0,0
2020-04-12 04:15,0,0,0,0,0,0
2020-04-12 04:30,1,1,0,0,0,0
2020-04-12 04:45,1,0,1,0,0,0
2020-04-12 05:00,3,1,2,0,0,0
2020-04-12 05:15,4,3,1,0,0,0
2020-04-12 05:30,5,4,1,0,0,0
2020-04-12 05:45,4,4,0,0,0,0
2020-04-12 06:00,1,1,0,0,0,0
2020-04-12 06:15,6,4,2,0,0,0
2020-04-12 06:30,2,2,0,0,0,0
2020-04-12 06:45,4,2,2,0,0,0
2020-04-12 07:00,1,0,1,0,0,0
2020-04-12 07:15,2,2,0,0,0,0
2020-04-12 07:30,5,2,3,0,0,0
2020-04-12 07:45,7,2,5,0,0,0
2020-04-12 08:00,6,2,4,0,0,0
2020-04-12 08:15,11,5,6,0,0,0
2020-04-12 08:30,10,4,6,0,0,0
2020-04-12 08:45,10,8,2,0,0,0
2020-04-12 09:00,10,3,7,0,0,0
2020-04-12 09:15,25,13,12,0,0,0
2020-04-12 09:30,20,9,11,0,0,0
2020-04-12 09:45,27,17,10,0,0,0
2020-04-12 10:00,32,8,24,0,0,0
2020-04-12 10:15,20,12,8,0,0,0
2020-04-12 10:30,25,10,15,0,0,0
2020-04-12 10:45,38,23,15,0,0,0
2020-04-12 11:00,43,25,18,0,0,0
2020-04-12 11:15,35,22,13,0,0,0
2020-04-12 11:30,38,17,21,0,0,0
2020-04-12 11:45,65,36,29,0,0,0
2020-04-12 12:00,44,27,17,0,0,0
2020-04-12 12:15,46,20,26,0,0,0
2020-04-12 12:30,65,28,37,0,0,0
2020-04-12 12:45,57,32,25,0,0,0
2020-04-12 13:00,64,27,37,0,0,0
2020-04-12 13:15,51,23,28,0,0,0
2020-04-12 13:30,63,42,21,0,0,0
2020-04-12 13:45,80,41,39,0,0,0
2020-04-12 14:00,59,32,27,0,0,0
2020-04-12 14:15,73,32,41,0,0,0
2020-04-12 14:30,85,39,46,0,0,0
2020-04-12 14:45,80,31,49,0,0,0
2020-04-12 15:00,93,42,51,0,0,0
2020-04-12 15:15,71,32,39,0,0,0
2020-04-12 15:30,64,22,42,0,0,0
2020-04-12 15:45,63,28,35,0,0,0
2020-04-12 16:00,73,41,32,0,0,0
2020-04-12 16:15,85,34,51,0,0,0
2020-04-12 16:30,67,36,31,0,0,0
2020-04-12 16:45,84,50,34,0,0,0
2020-04-12 17:00,87,28,59,0,0,0
2020-04-12 17:15,88,42,46,0,0,0
2020-04-12 17:30,79,28,51,0,0,0
2020-04-12 17:45,61,22,39,0,0,0
2020-04-12 18:00,59,21,38,0,0,0
2020-04-12 18:15,62,22,40,0,0,0
2020-04-12 18:30,41,16,25,0,0,0
2020-04-12 18:45,54,21,33,0,0,0
2020-04-12 19:00,51,19,32,0,0,0
2020-04-12 19:15,29,14,15,0,0,0
2020-04-12 19:30,31,16,15,0,0,0
2020-04-12 19:45,42,15,27,0,0,0
2020-04-12 20:00,31,14,17,0,0,0
2020-04-12 20:15,27,7,20,0,0,0
2020-04-12 20:30,27,12,15,0,0,0
2020-04-12 20:45,25,14,11,0,0,0
2020-04-12 21:00,23,13,10,0,0,0
2020-04-12 21:15,17,4,13,0,0,0
2020-04-12 21:30,18,4,14,0,0,0
2020-04-12 21:45,16,6,10,0,0,0
2020-04-12 22:00,11,5,6,0,0,0
2020-04-12 22:15,6,3,3,0,0,0
2020-04-12 22:30,7,2,5,0,0,0
2020-04-12 22:45,9,5,4,0,0,0
2020-04-12 23:00,7,5,2,0,0,0
2020-04-12 23:15,7,1,6,0,0,0
2020-04-12 23:30,6,3,3,0,0,0
2020-04-12 23:45,11,7,4,0,0,0
2020-04-13 00:00,8,0,8,0,0,0
2020-04-13 00:15,1,0,1,0,0,0
2020-04-13 00:30,8,0,8,0,0,0
2020-04-13 00:45,0,0,0,0,0,0
2020-04-13 01:00,0,0,0,0,0,0
2020-04-13 01:15,5,1,4,0,0,0
2020-04-13 01:30,0,0,0,0,0,0
2020-04-13 01:45,2,2,0,0,0,0
2020-04-13 02:00,1,1,0,0,0,0
2020-04-13 02:15,0,0,0,0,0,0
2020-04-13 02:30,0,0,0,0,0,0
2020-04-13 02:45,0,0,0,0,0,0
2020-04-13 03:00,0,0,0,0,0,0
2020-04-13 03:15,1,0,1,0,0,0
2020-04-13 03:30,0,0,0,0,0,0
2020-04-13 03:45,0,0,0,0,0,0
2020-04-13 04:00,0,0,0,0,0,0
2020-04-13 04:15,0,0,0,0,0,0
2020-04-13 04:30,1,1,0,0,0,0
2020-04-13 04:45,3,0,3,0,0,0
2020-04-13 05:00,0,0,0,0,0,0
2020-04-13 05:15,4,1,3,0,0,0
2020-04-13 05:30,3,2,1,0,0,0
2020-04-13 05:45,1,1,0,0,0,0
2020-04-13 06:00,3,3,0,0,0,0
2020-04-13 06:15,1,0,1,0,0,0
2020-04-13 06:30,5,1,4,0,0,0
2020-04-13 06:45,4,0,4,0,0,0
2020-04-13 07:00,2,1,1,0,0,0
2020-04-13 07:15,5,5,0,0,0,0
2020-04-13 07:30,9,6,3,0,0,0
2020-04-13 07:45,4,3,1,0,0,0
2020-04-13 08:00,5,2,3,0,0,0
2020-04-13 08:15,6,4,2,0,0,0
2020-04-13 08:30,12,5,7,0,0,0
2020-04-13 08:45,8,5,3,0,0,0
2020-04-13 09:00,7,4,3,0,0,0
2020-04-13 09:15,13,7,6,0,0,0
2020-04-13 09:30,9,5,4,0,0,0
2020-04-13 09:45,17,7,10,0,0,0
2020-04-13 10:00,24,13,11,0,0,0
2020-04-13 10:15,21,13,8,0,0,0
2020-04-13 10:30,25,12,13,0,0,0
2020-04-13 10:45,26,11,15,0,0,0
2020-04-13 11:00,18,8,10,0,0,0
2020-04-13 11:15,28,16,12,0,0,0
2020-04-13 11:30,18,8,10,0,0,0
2020-04-13 11:45,28,16,12,0,0,0
2020-04-13 12:00,25,14,11,0,0,0
2020-04-13 12:15,35,18,17,0,0,0
2020-04-13 12:30,41,24,17,0,0,0
2020-04-13 12:45,26,5,21,0,0,0
2020-04-13 13:00,26,12,14,0,0,0
2020-04-13 13:15,40,12,28,0,0,0
2020-04-13 13:30,38,18,20,0,0,0
2020-04-13 13:45,41,22,19,0,0,0
2020-04-13 14:00,38,27,11,0,0,0
2020-04-13 14:15,54,24,30,0,0,0
2020-04-13 14:30,43,26,17,0,0,0
2020-04-13 14:45,76,35,41,0,0,0
2020-04-13 15:00,72,22,50,0,0,0
2020-04-13 15:15,65,27,38,0,0,0
2020-04-13 15:30,62,37,25,0,0,0
2020-04-13 15:45,50,32,18,0,0,0
2020-04-13 16:00,68,36,32,0,0,0
2020-04-13 16:15,57,24,33,0,0,0
2020-04-13 16:30,66,30,36,0,0,0
2020-04-13 16:45,55,21,34,0,0,0
2020-04-13 17:00,68,33,35,0,0,0
2020-04-13 17:15,55,24,31,0,0,0
2020-04-13 17:30,62,27,35,0,0,0
2020-04-13 17:45,43,21,22,0,0,0
2020-04-13 18:00,55,21,34,0,0,0
2020-04-13 18:15,35,18,17,0,0,0
2020-04-13 18:30,24,7,17,0,0,0
2020-04-13 18:45,35,19,16,0,0,0
2020-04-13 19:00,32,12,20,0,0,0
2020-04-13 19:15,29,9,20,0,0,0
2020-04-13 19:30,21,9,12,0,0,0
2020-04-13 19:45,18,11,7,0,0,0
2020-04-13 20:00,17,9,8,0,0,0
2020-04-13 20:15,24,13,11,0,0,0
2020-04-13 20:30,26,13,13,0,0,0
2020-04-13 20:45,10,7,3,0,0,0
2020-04-13 21:00,18,8,10,0,0,0
2020-04-13 21:15,7,2,5,0,0,0
2020-04-13 21:30,14,6,8,0,0,0
2020-04-13 21:45,11,6,5,0,0,0
2020-04-13 22:00,5,0,5,0,0,0
2020-04-13 22:15,5,2,3,0,0,0
2020-04-13 22:30,4,2,2,0,0,0
2020-04-13 22:45,7,3,4,0,0,0
2020-04-13 23:00,3,1,2,0,0,0
2020-04-13 23:15,4,1,3,0,0,0
2020-04-13 23:30,2,1,1,0,0,0
2020-04-13 23:45,2,2,0,0,0,0
2020-04-14 00:00,2,2,0,0,0,0
2020-04-14 00:15,2,0,2,0,0,0
2020-04-14 00:30,0,0,0,0,0,0
2020-04-14 00:45,1,0,1,0,0,0
2020-04-14 01:00,3,1,2,0,0,0
2020-04-14 01:15,1,1,0,0,0,0
2020-04-14 01:30,0,0,0,0,0,0
2020-04-14 01:45,1,1,0,0,0,0
2020-04-14 02:00,0,0,0,0,0,0
2020-04-14 02:15,0,0,0,0,0,0
2020-04-14 02:30,0,0,0,0,0,0
2020-04-14 02:45,0,0,0,0,0,0
2020-04-14 03:00,0,0,0,0,0,0
2020-04-14 03:15,0,0,0,0,0,0
2020-04-14 03:30,1,0,1,0,0,0
2020-04-14 03:45,2,0,2,0,0,0
2020-04-14 04:00,0,0,0,0,0,0
2020-04-14 04:15,4,4,0,0,0,0
2020-04-14 04:30,0,0,0,0,0,0
2020-04-14 04:45,5,2,3,0,0,0
2020-04-14 05:00,3,1,2,0,0,0
2020-04-14 05:15,5,3,2,0,0,0
2020-04-14 05:30,10,8,2,0,0,0
2020-04-14 05:45,17,13,4,0,0,0
2020-04-14 06:00,14,12,2,0,0,0
2020-04-14 06:15,19,16,3,0,0,0
2020-04-14 06:30,27,20,7,0,0,0
2020-04-14 06:45,51,32,19,0,0,0
2020-04-14 07:00,33,23,10,0,0,0
2020-04-14 07:15,54,39,15,0,0,0
2020-04-14 07:30,69,51,18,0,0,0
2020-04-14 07:45,71,51,20,0,0,0
2020-04-14 08:00,67,53,14,0,0,0
2020-04-14 08:15,71,38,33,0,0,0
2020-04-14 08:30,57,42,15,0,0,0
2020-04-14 08:45,63,47,16,0,0,0
2020-04-14 09:00,47,29,18,0,0,0
2020-04-14 09:15,32,12,20,0,0,0
2020-04-14 09:30,47,22,25,0,0,0
2020-04-14 09:45,26,11,15,0,0,0
2020-04-14 10:00,62,31,31,0,0,0
2020-04-14 10:15,48,25,23,0,0,0
2020-04-14 10:30,70,36,34,0,0,0
2020-04-14 10:45,60,32,28,0,0,0
2020-04-14 11:00,53,24,29,0,0,0
2020-04-14 11:15,69,24,45,0,0,0
2020-04-14 11:30,70,32,38,0,0,0
2020-04-14 11:45,65,27,38,0,0,0
2020-04-14 12:00,52,27,25,0,0,0
2020-04-14 12:15,83,38,45,0,0,0
2020-04-14 12:30,53,26,27,0,0,0
2020-04-14 12:45,54,19,35,0,0,0
2020-04-14 13:00,101,38,63,0,0,0
2020-04-14 13:15,71,31,40,0,0,0
2020-04-14 13:30,80,32,48,0,0,0
2020-04-14 13:45,71,29,42,0,0,0
2020-04-14 14:00,87,41,46,0,0,0
2020-04-14 14:15,80,33,47,0,0,0
2020-04-14 14:30,78,35,43,0,0,0
2020-04-14 14:45,87,43,44,0,0,0
2020-04-14 15:00,78,35,43,0,0,0
2020-04-14 15:15,96,47,49,0,0,0
2020-04-14 15:30,113,43,70,0,0,0
2020-04-14 15:45,92,39,53,0,0,0
2020-04-14 16:00,117,39,78,0,0,0
2020-04-14 16:15,108,43,65,0,0,0
2020-04-14 16:30,130,46,84,0,0,0
2020-04-14 16:45,99,38,61,0,0,0
2020-04-14 17:00,117,47,70,0,0,0
2020-04-14 17:15,99,28,71,0,0,0
2020-04-14 17:30,74,27,47,0,0,0
2020-04-14 17:45,101,42,59,0,0,0
2020-04-14 18:00,81,27,54,0,0,0
2020-04-14 18:15,60,21,39,0,0,0
2020-04-14 18:30,54,24,30,0,0,0
2020-04-14 18:45,46,20,26,0,0,0
2020-04-14 19:00,52,13,39,0,0,0
2020-04-14 19:15,53,18,35,0,0,0
2020-04-14 19:30,27,13,14,0,0,0
2020-04-14 19:45,30,12,18,0,0,0
2020-04-14 20:00,30,13,17,0,0,0
2020-04-14 20:15,38,13,25,0,0,0
2020-04-14 20:30,21,12,9,0,0,0
2020-04-14 20:45,18,11,7,0,0,0
2020-04-14 21:00,23,9,14,0,0,0
2020-04-14 21:15,14,6,8,0,0,0
2020-04-14 21:30,9,4,5,0,0,0
2020-04-14 21:45,12,5,7,0,0,0
2020-04-14 22:00,9,4,5,0,0,0
2020-04-14 22:15,9,0,9,0,0,0
2020-04-14 22:30,5,3,2,0,0,0
2020-04-14 22:45,10,5,5,0,0,0
2020-04-14 23:00,3,2,1,0,0,0
2020-04-14 23:15,8,5,3,0,0,0
2020-04-14 23:30,6,5,1,0,0,0
2020-04-14 23:45,4,1,3,0,0,0
2020-04-15 00:00,3,2,1,0,0,0
2020-04-15 00:15,5,4,1,0,0,0
2020-04-15 00:30,2,1,1,0,0,0
2020-04-15 00:45,2,0,2,0,0,0
2020-04-15 01:00,1,0,1,0,0,0
2020-04-15 01:15,2,0,2,0,0,0
2020-04-15 01:30,2,0,2,0,0,0
2020-04-15 01:45,0,0,0,0,0,0
2020-04-15 02:00,1,1,0,0,0,0
2020-04-15 02:15,1,0,1,0,0,0
2020-04-15 02:30,4,0,4,0,0,0
2020-04-15 02:45,0,0,0,0,0,0
2020-04-15 03:00,2,1,1,0,0,0
2020-04-15 03:15,0,0,0,0,0,0
2020-04-15 03:30,0,0,0,0,0,0
2020-04-15 03:45,2,1,1,0,0,0
2020-04-15 04:00,0,0,0,0,0,0
2020-04-15 04:15,0,0,0,0,0,0
2020-04-15 04:30,4,4,0,0,0,0
2020-04-15 04:45,3,1,2,0,0,0
2020-04-15 05:00,2,2,0,0,0,0
2020-04-15 05:15,3,2,1,0,0,0
2020-04-15 05:30,10,8,2,0,0,0
2020-04-15 05:45,21,16,5,0,0,0
2020-04-15 06:00,17,12,5,0,0,0
2020-04-15 06:15,25,18,7,0,0,0
2020-04-15 06:30,27,18,9,0,0,0
2020-04-15 06:45,56,39,17,0,0,0
2020-04-15 07:00,55,37,18,0,0,0
2020-04-15 07:15,56,34,22,0,0,0
2020-04-15 07:30,75,60,15,0,0,0
2020-04-15 07:45,72,52,20,0,0,0
2020-04-15 08:00,65,42,23,0,0,0
2020-04-15 08:15,76,47,29,0,0,0
2020-04-15 08:30,68,40,28,0,0,0
2020-04-15 08:45,67,46,21,0,0,0
2020-04-15 09:00,52,34,18,0,0,0
2020-04-15 09:15,65,39,26,0,0,0
2020-04-15 09:30,52,30,22,0,0,0
2020-04-15 09:45,72,50,22,0,0,0
2020-04-15 10:00,50,20,30,0,0,0
2020-04-15 10:15,74,44,30,0,0,0
2020-04-15 10:30,87,51,36,0,0,0
2020-04-15 10:45,97,56,41,0,0,0
2020-04-15 11:00,87,44,43,0,0,0
2020-04-15 11:15,107,43,64,0,0,0
2020-04-15 11:30,106,63,43,0,0,0
2020-04-15 11:45,116,64,52,0,0,0
2020-04-15 12:00,85,27,58,0,0,0
2020-04-15 12:15,95,44,51,0,0,0
2020-04-15 12:30,118,60,58,0,0,0
2020-04-15 12:45,117,52,65,0,0,0
2020-04-15 13:00,112,40,72,0,0,0
2020-04-15 13:15,136,53,83,0,0,0
2020-04-15 13:30,123,61,62,0,0,0
2020-04-15 13:45,106,53,53,0,0,0
2020-04-15 14:00,113,46,67,0,0,0
2020-04-15 14:15,98,44,54,0,0,0
2020-04-15 14:30,109,43,66,0,0,0
2020-04-15 14:45,94,43,51,0,0,0
2020-04-15 15:00,103,35,68,0,0,0
2020-04-15 15:15,102,33,69,0,0,0
2020-04-15 15:30,106,41,65,0,0,0
2020-04-15 15:45,115,39,76,0,0,0
2020-04-15 16:00,119,48,71,0,0,0
2020-04-15 16:15,129,53,76,0,0,0
2020-04-15 16:30,116,40,76,0,0,0
2020-04-15 16:45,140,51,89,0,0,0
2020-04-15 17:00,111,43,68,0,0,0
2020-04-15 17:15,124,47,77,0,0,0
2020-04-15 17:30,101,37,64,0,0,0
2020-04-15 17:45,111,47,64,0,0,0
2020-04-15 18:00,90,33,57,0,0,0
2020-04-15 18:15,98,36,62,0,0,0
2020-04-15 18:30,81,27,54,0,0,0
2020-04-15 18:45,62,20,42,0,0,0
2020-04-15 19:00,64,23,41,0,0,0
2020-04-15 19:15,66,24,42,0,0,0
2020-04-15 19:30,57,20,37,0,0,0
2020-04-15 19:45,53,25,28,0,0,0
2020-04-15 20:00,45,19,26,0,0,0
2020-04-15 20:15,50,18,32,0,0,0
2020-04-15 20:30,28,7,21,0,0,0
2020-04-15 20:45,30,13,17,0,0,0
2020-04-15 21:00,26,11,15,0,0,0
2020-04-15 21:15,19,6,13,0,0,0
2020-04-15 21:30,7,0,7,0,0,0
2020-04-15 21:45,8,5,3,0,0,0
2020-04-15 22:00,16,4,12,0,0,0
2020-04-15 22:15,21,13,8,0,0,0
2020-04-15 22:30,5,2,3,0,0,0
2020-04-15 22:45,9,3,6,0,0,0
2020-04-15 23:00,9,8,1,0,0,0
2020-04-15 23:15,8,5,3,0,0,0
2020-04-15 23:30,1,1,0,0,0,0
2020-04-15 23:45,6,2,4,0,0,0
2020-04-16 00:00,3,0,3,0,0,0
2020-04-16 00:15,6,3,3,0,0,0
2020-04-16 00:30,3,1,2,0,0,0
2020-04-16 00:45,1,1,0,0,0,0
2020-04-16 01:00,5,1,4,0,0,0
2020-04-16 01:15,1,0,1,0,0,0
2020-04-16 01:30,1,1,0,0,0,0
2020-04-16 01:45,0,0,0,0,0,0
2020-04-16 02:00,1,0,1,0,0,0
2020-04-16 02:15,1,0,1,0,0,0
2020-04-16 02:30,2,0,2,0,0,0
2020-04-16 02:45,0,0,0,0,0,0
2020-04-16 03:00,1,1,0,0,0,0
2020-04-16 03:15,0,0,0,0,0,0
2020-04-16 03:30,0,0,0,0,0,0
2020-04-16 03:45,1,1,0,0,0,0
2020-04-16 04:00,1,1,0,0,0,0
2020-04-16 04:15,2,1,1,0,0,0
2020-04-16 04:30,2,2,0,0,0,0
2020-04-16 04:45,3,1,2,0,0,0
2020-04-16 05:00,4,3,1,0,0,0
2020-04-16 05:15,7,5,2,0,0,0
2020-04-16 05:30,8,6,2,0,0,0
2020-04-16 05:45,20,16,4,0,0,0
2020-04-16 06:00,15,13,2,0,0,0
2020-04-16 06:15,29,22,7,0,0,0
2020-04-16 06:30,30,23,7,0,0,0
2020-04-16 06:45,45,32,13,0,0,0
2020-04-16 07:00,43,29,14,0,0,0
2020-04-16 07:15,70,48,22,0,0,0
2020-04-16 07:30,56,47,9,0,0,0
2020-04-16 07:45,68,52,16,0,0,0
2020-04-16 08:00,63,40,23,0,0,0
2020-04-16 08:15,84,55,29,0,0,0
2020-04-16 08:30,85,60,25,0,0,0
2020-04-16 08:45,75,46,29,0,0,0
2020-04-16 09:00,46,31,15,0,0,0
2020-04-16 09:15,49,28,21,0,0,0
2020-04-16 09:30,53,32,21,0,0,0
2020-04-16 09:45,56,46,10,0,0,0
2020-04-16 10:00,53,30,23,0,0,0
2020-04-16 10:15,61,41,20,0,0,0
2020-04-16 10:30,66,34,32,0,0,0
2020-04-16 10:45,77,37,40,0,0,0
2020-04-16 11:00,80,44,36,0,0,0
2020-04-16 11:15,78,40,38,0,0,0
2020-04-16 11:30,78,44,34,0,0,0
2020-04-16 11:45,108,51,57,0,0,0
2020-04-16 12:00,80,32,48,0,0,0
2020-04-16 12:15,81,31,50,0,0,0
2020-04-16 12:30,94,39,55,0,0,0
2020-04-16 12:45,111,48,63,0,0,0
2020-04-16 13:00,83,38,45,0,0,0
2020-04-16 13:15,76,25,51,0,0,0
2020-04-16 13:30,99,45,54,0,0,0
2020-04-16 13:45,105,51,54,0,0,0
2020-04-16 14:00,78,35,43,0,0,0
2020-04-16 14:15,105,52,53,0,0,0
2020-04-16 14:30,112,58,54,0,0,0
2020-04-16 14:45,111,61,50,0,0,0
2020-04-16 15:00,108,46,62,0,0,0
2020-04-16 15:15,126,60,66,0,0,0
2020-04-16 15:30,134,52,82,0,0,0
2020-04-16 15:45,132,59,73,0,0,0
2020-04-16 16:00,134,49,85,0,0,0
2020-04-16 16:15,144,50,94,0,0,0
2020-04-16 16:30,121,36,85,0,0,0
2020-04-16 16:45,131,54,77,0,0,0
2020-04-16 17:00,131,43,88,0,0,0
2020-04-16 17:15,123,34,89,0,0,0
2020-04-16 17:30,128,54,74,0,0,0
2020-04-16 17:45,117,50,67,0,0,0
2020-04-16 18:00,81,28,53,0,0,0
2020-04-16 18:15,74,29,45,0,0,0
2020-04-16 18:30,74,18,56,0,0,0
2020-04-16 18:45,84,22,62,0,0,0
2020-04-16 19:00,79,30,49,0,0,0
2020-04-16 19:15,66,14,52,0,0,0
2020-04-16 19:30,62,33,29,0,0,0
2020-04-16 19:45,69,23,46,0,0,0
2020-04-16 20:00,41,15,26,0,0,0
2020-04-16 20:15,32,19,13,0,0,0
2020-04-16 20:30,28,8,20,0,0,0
2020-04-16 20:45,36,14,22,0,0,0
2020-04-16 21:00,31,10,21,0,0,0
2020-04-16 21:15,13,9,4,0,0,0
2020-04-16 21:30,18,7,11,0,0,0
2020-04-16 21:45,19,4,15,0,0,0
2020-04-16 22:00,19,5,14,0,0,0
2020-04-16 22:15,7,6,1,0,0,0
2020-04-16 22:30,10,4,6,0,0,0
2020-04-16 22:45,18,6,12,0,0,0
2020-04-16 23:00,6,2,4,0,0,0
2020-04-16 23:15,7,5,2,0,0,0
2020-04-16 23:30,7,4,3,0,0,0
2020-04-16 23:45,6,4,2,0,0,0
2020-04-17 00:00,9,6,3,0,0,0
2020-04-17 00:15,3,1,2,0,0,0
2020-04-17 00:30,3,2,1,0,0,0
2020-04-17 00:45,4,3,1,0,0,0
2020-04-17 01:00,1,0,1,0,0,0
2020-04-17 01:15,2,0,2,0,0,0
2020-04-17 01:30,1,0,1,0,0,0
2020-04-17 01:45,3,1,2,0,0,0
2020-04-17 02:00,0,0,0,0,0,0
2020-04-17 02:15,2,0,2,0,0,0
2020-04-17 02:30,0,0,0,0,0,0
2020-04-17 02:45,0,0,0,0,0,0
2020-04-17 03:00,0,0,0,0,0,0
2020-04-17 03:15,0,0,0,0,0,0
2020-04-17 03:30,3,1,2,0,0,0
2020-04-17 03:45,0,0,0,0,0,0
2020-04-17 04:00,1,0,1,0,0,0
2020-04-17 04:15,1,1,0,0,0,0
2020-04-17 04:30,1,1,0,0,0,0
2020-04-17 04:45,2,1,1,0,0,0
2020-04-17 05:00,3,1,2,0,0,0
2020-04-17 05:15,3,3,0,0,0,0
2020-04-17 05:30,8,8,0,0,0,0
2020-04-17 05:45,30,19,11,0,0,0
2020-04-17 06:00,15,12,3,0,0,0
2020-04-17 06:15,39,25,14,0,0,0
2020-04-17 06:30,28,23,5,0,0,0
2020-04-17 06:45,42,29,13,0,0,0
2020-04-17 07:00,45,30,15,0,0,0
2020-04-17 07:15,56,40,16,0,0,0
2020-04-17 07:30,48,33,15,0,0,0
2020-04-17 07:45,53,40,13,0,0,0
2020-04-17 08:00,48,33,15,0,0,0
2020-04-17 08:15,73,51,22,0,0,0
2020-04-17 08:30,69,42,27,0,0,0
2020-04-17 08:45,71,51,20,0,0,0
2020-04-17 09:00,62,34,28,0,0,0
2020-04-17 09:15,67,40,27,0,0,0
2020-04-17 09:30,53,34,19,0,0,0
2020-04-17 09:45,77,55,22,0,0,0
2020-04-17 10:00,62,29,33,0,0,0
2020-04-17 10:15,60,38,22,0,0,0
2020-04-17 10:30,77,39,38,0,0,0
2020-04-17 10:45,90,51,39,0,0,0
2020-04-17 11:00,79,49,30,0,0,0
2020-04-17 11:15,62,32,30,0,0,0
2020-04-17 11:30,79,31,48,0,0,0
2020-04-17 11:45,108,51,57,0,0,0
2020-04-17 12:00,105,53,52,0,0,0
2020-04-17 12:15,103,37,66,0,0,0
2020-04-17 12:30,104,44,60,0,0,0
2020-04-17 12:45,93,35,58,0,0,0
2020-04-17 13:00,118,49,69,0,0,0
2020-04-17 13:15,112,42,70,0,0,0
2020-04-17 13:30,115,38,77,0,0,0
2020-04-17 13:45,95,40,55,0,0,0
2020-04-17 14:00,94,32,62,0,0,0
2020-04-17 14:15,105,42,63,0,0,0
2020-04-17 14:30,107,45,62,0,0,0
2020-04-17 14:45,98,44,54,0,0,0
2020-04-17 15:00,121,56,65,0,0,0
2020-04-17 15:15,110,46,64,0,0,0
2020-04-17 15:30,119,48,71,0,0,0
2020-04-17 15:45,130,59,71,0,0,0
2020-04-17 16:00,116,32,84,0,0,0
2020-04-17 16:15,116,48,68,0,0,0
2020-04-17 16:30,115,60,55,0,0,0
2020-04-17 16:45,140,47,93,0,0,0
2020-04-17 17:00,98,29,69,0,0,0
2020-04-17 17:15,146,62,84,0,0,0
2020-04-17 17:30,114,55,59,0,0,0
2020-04-17 17:45,96,40,56,0,0,0
2020-04-17 18:00,93,39,54,0,0,0
2020-04-17 18:15,80,28,52,0,0,0
2020-04-17 18:30,75,31,44,0,0,0
2020-04-17 18:45,63,22,41,0,0,0
2020-04-17 19:00,53,24,29,0,0,0
2020-04-17 19:15,73,26,47,0,0,0
2020-04-17 19:30,51,23,28,0,0,0
2020-04-17 19:45,54,23,31,0,0,0
2020-04-17 20:00,49,20,29,0,0,0
2020-04-17 20:15,38,18,20,0,0,0
2020-04-17 20:30,20,9,11,0,0,0
2020-04-17 20:45,28,10,18,0,0,0
2020-04-17 21:00,25,11,14,0,0,0
2020-04-17 21:15,34,17,17,0,0,0
2020-04-17 21:30,21,7,14,0,0,0
2020-04-17 21:45,18,4,14,0,0,0
2020-04-17 22:00,12,6,6,0,0,0
2020-04-17 22:15,3,1,2,0,0,0
2020-04-17 22:30,10,2,8,0,0,0
2020-04-17 22:45,19,6,13,0,0,0
2020-04-17 23:00,11,2,9,0,0,0
2020-04-17 23:15,2,2,0,0,0,0
2020-04-17 23:30,7,3,4,0,0,0
2020-04-17 23:45,5,1,4,0,0,0
2020-04-18 00:00,5,2,3,0,0,0
2020-04-18 00:15,6,4,2,0,0,0
2020-04-18 00:30,4,4,0,0,0,0
2020-04-18 00:45,2,2,0,0,0,0
2020-04-18 01:00,5,3,2,0,0,0
2020-04-18 01:15,6,2,4,0,0,0
2020-04-18 01:30,2,1,1,0,0,0
2020-04-18 01:45,8,6,2,0,0,0
2020-04-18 02:00,3,0,3,0,0,0
2020-04-18 02:15,0,0,0,0,0,0
2020-04-18 02:30,0,0,0,0,0,0
2020-04-18 02:45,4,4,0,0,0,0
2020-04-18 03:00,2,2,0,0,0,0
2020-04-18 03:15,1,1,0,0,0,0
2020-04-18 03:30,0,0,0,0,0,0
2020-04-18 03:45,3,1,2,0,0,0
2020-04-18 04:00,1,1,0,0,0,0
2020-04-18 04:15,0,0,0,0,0,0
2020-04-18 04:30,0,0,0,0,0,0
2020-04-18 04:45,2,1,1,0,0,0
2020-04-18 05:00,1,0,1,0,0,0
2020-04-18 05:15,3,1,2,0,0,0
2020-04-18 05:30,5,5,0,0,0,0
2020-04-18 05:45,2,1,1,0,0,0
2020-04-18 06:00,10,8,2,0,0,0
2020-04-18 06:15,6,3,3,0,0,0
2020-04-18 06:30,13,9,4,0,0,0
2020-04-18 06:45,6,3,3,0,0,0
2020-04-18 07:00,8,3,5,0,0,0
2020-04-18 07:15,20,10,10,0,0,0
2020-04-18 07:30,25,16,9,0,0,0
2020-04-18 07:45,24,14,10,0,0,0
2020-04-18 08:00,43,24,19,0,0,0
2020-04-18 08:15,31,19,12,0,0,0
2020-04-18 08:30,46,31,15,0,0,0
2020-04-18 08:45,59,38,21,0,0,0
2020-04-18 09:00,51,32,19,0,0,0
2020-04-18 09:15,65,33,32,0,0,0
2020-04-18 09:30,69,38,31,0,0,0
2020-04-18 09:45,77,45,32,0,0,0
2020-04-18 10:00,85,45,40,0,0,0
2020-04-18 10:15,83,47,36,0,0,0
2020-04-18 10:30,113,73,40,0,0,0
2020-04-18 10:45,99,54,45,0,0,0
2020-04-18 11:00,126,73,53,0,0,0
2020-04-18 11:15,125,67,58,0,0,0
2020-04-18 11:30,110,40,70,0,0,0
2020-04-18 11:45,115,49,66,0,0,0
2020-04-18 12:00,129,66,63,0,0,0
2020-04-18 12:15,154,75,79,0,0,0
2020-04-18 12:30,129,54,75,0,0,0
2020-04-18 12:45,116,63,53,0,0,0
2020-04-18 13:00,148,54,94,0,0,0
2020-04-18 13:15,120,61,59,0,0,0
2020-04-18 13:30,157,75,82,0,0,0
2020-04-18 13:45,112,45,67,0,0,0
2020-04-18 14:00,119,52,67,0,0,0
2020-04-18 14:15,125,43,82,0,0,0
2020-04-18 14:30,110,35,75,0,0,0
2020-04-18 14:45,104,49,55,0,0,0
2020-04-18 15:00,110,55,55,0,0,0
2020-04-18 15:15,90,41,49,0,0,0
2020-04-18 15:30,108,38,70,0,0,0
2020-04-18 15:45,84,47,37,0,0,0
2020-04-18 16:00,82,31,51,0,0,0
2020-04-18 16:15,103,43,60,0,0,0
2020-04-18 16:30,90,33,57,0,0,0
2020-04-18 16:45,100,43,57,0,0,0
2020-04-18 17:00,75,28,47,0,0,0
2020-04-18 17:15,63,28,35,0,0,0
2020-04-18 17:30,62,24,38,0,0,0
2020-04-18 17:45,50,21,29,0,0,0
2020-04-18 18:00,64,28,36,0,0,0
2020-04-18 18:15,44,16,28,0,0,0
2020-04-18 18:30,37,18,19,0,0,0
2020-04-18 18:45,44,20,24,0,0,0
2020-04-18 19:00,38,12,26,0,0,0
2020-04-18 19:15,31,14,17,0,0,0
2020-04-18 19:30,31,18,13,0,0,0
2020-04-18 19:45,42,21,21,0,0,0
2020-04-18 20:00,16,9,7,0,0,0
2020-04-18 20:15,18,6,12,0,0,0
2020-04-18 20:30,15,3,12,0,0,0
2020-04-18 20:45,22,11,11,0,0,0
2020-04-18 21:00,16,6,10,0,0,0
2020-04-18 21:15,17,6,11,0,0,0
2020-04-18 21:30,10,3,7,0,0,0
2020-04-18 21:45,15,7,8,0,0,0
2020-04-18 22:00,12,5,7,0,0,0
2020-04-18 22:15,13,5,8,0,0,0
2020-04-18 22:30,11,2,9,0,0,0
2020-04-18 22:45,7,4,3,0,0,0
2020-04-18 23:00,16,7,9,0,0,0
2020-04-18 23:15,5,2,3,0,0,0
2020-04-18 23:30,12,4,8,0,0,0
2020-04-18 23:45,7,5,2,0,0,0
2020-04-19 00:00,11,6,5,0,0,0
2020-04-19 00:15,5,2,3,0,0,0
2020-04-19 00:30,3,2,1,0,0,0
2020-04-19 00:45,8,2,6,0,0,0
2020-04-19 01:00,6,0,6,0,0,0
2020-04-19 01:15,5,3,2,0,0,0
2020-04-19 01:30,2,1,1,0,0,0
2020-04-19 01:45,1,1,0,0,0,0
2020-04-19 02:00,3,1,2,0,0,0
2020-04-19 02:15,6,3,3,0,0,0
2020-04-19 02:30,4,0,4,0,0,0
2020-04-19 02:45,1,0,1,0,0,0
2020-04-19 03:00,0,0,0,0,0,0
2020-04-19 03:15,0,0,0,0,0,0
2020-04-19 03:30,2,1,1,0,0,0
2020-04-19 03:45,0,0,0,0,0,0
2020-04-19 04:00,2,1,1,0,0,0
2020-04-19 04:15,2,0,2,0,0,0
2020-04-19 04:30,1,0,1,0,0,0
2020-04-19 04:45,0,0,0,0,0,0
2020-04-19 05:00,0,0,0,0,0,0
2020-04-19 05:15,2,0,2,0,0,0
2020-04-19 05:30,7,4,3,0,0,0
2020-04-19 05:45,2,2,0,0,0,0
2020-04-19 06:00,3,3,0,0,0,0
2020-04-19 06:15,3,3,0,0,0,0
2020-04-19 06:30,6,2,4,0,0,0
2020-04-19 06:45,3,2,1,0,0,0
2020-04-19 07:00,3,1,2,0,0,0
2020-04-19 07:15,6,3,3,0,0,0
2020-04-19 07:30,9,4,5,0,0,0
2020-04-19 07:45,8,5,3,0,0,0
2020-04-19 08:00,4,3,1,0,0,0
2020-04-19 08:15,5,4,1,0,0,0
2020-04-19 08:30,4,3,1,0,0,0
2020-04-19 08:45,9,4,5,0,0,0
2020-04-19 09:00,14,8,6,0,0,0
2020-04-19 09:15,13,9,4,0,0,0
2020-04-19 09:30,19,12,7,0,0,0
2020-04-19 09:45,20,14,6,0,0,0
2020-04-19 10:00,23,7,16,0,0,0
2020-04-19 10:15,21,9,12,0,0,0
2020-04-19 10:30,19,8,11,0,0,0
2020-04-19 10:45,36,21,15,0,0,0
2020-04-19 11:00,34,13,21,0,0,0
2020-04-19 11:15,41,17,24,0,0,0
2020-04-19 11:30,48,28,20,0,0,0
2020-04-19 11:45,39,22,17,0,0,0
2020-04-19 12:00,55,27,28,0,0,0
2020-04-19 12:15,64,41,23,0,0,0
2020-04-19 12:30,50,29,21,0,0,0
2020-04-19 12:45,61,32,29,0,0,0
2020-04-19 13:00,64,31,33,0,0,0
2020-04-19 13:15,68,25,43,0,0,0
2020-04-19 13:30,84,41,43,0,0,0
2020-04-19 13:45,94,40,54,0,0,0
2020-04-19 14:00,110,44,66,0,0,0
2020-04-19 14:15,97,47,50,0,0,0
2020-04-19 14:30,93,43,50,0,0,0
2020-04-19 14:45,102,40,62,0,0,0
2020-04-19 15:00,100,56,44,0,0,0
2020-04-19 15:15,79,35,44,0,0,0
2020-04-19 15:30,97,53,44,0,0,0
2020-04-19 15:45,118,46,72,0,0,0
2020-04-19 16:00,105,43,62,0,0,0
2020-04-19 16:15,95,33,62,0,0,0
2020-04-19 16:30,83,36,47,0,0,0
2020-04-19 16:45,98,38,60,0,0,0
2020-04-19 17:00,110,50,60,0,0,0
2020-04-19 17:15,85,33,52,0,0,0
2020-04-19 17:30,93,25,68,0,0,0
2020-04-19 17:45,79,33,46,0,0,0
2020-04-19 18:00,71,31,40,0,0,0
2020-04-19 18:15,72,31,41,0,0,0
2020-04-19 18:30,54,19,35,0,0,0
2020-04-19 18:45,49,15,34,0,0,0
2020-04-19 19:00,50,17,33,0,0,0
2020-04-19 19:15,63,29,34,0,0,0
2020-04-19 19:30,39,14,25,0,0,0
2020-04-19 19:45,53,18,35,0,0,0
2020-04-19 20:00,42,18,24,0,0,0
2020-04-19 20:15,25,5,20,0,0,0
2020-04-19 20:30,32,12,20,0,0,0
2020-04-19 20:45,26,14,12,0,0,0
2020-04-19 21:00,23,8,15,0,0,0
2020-04-19 21:15,16,5,11,0,0,0
2020-04-19 21:30,19,4,15,0,0,0
2020-04-19 21:45,13,5,8,0,0,0
2020-04-19 22:00,10,2,8,0,0,0
2020-04-19 22:15,11,6,5,0,0,0
2020-04-19 22:30,7,3,4,0,0,0
2020-04-19 22:45,11,5,6,0,0,0
2020-04-19 23:00,4,1,3,0,0,0
2020-04-19 23:15,8,3,5,0,0,0
2020-04-19 23:30,3,0,3,0,0,0
2020-04-19 23:45,4,1,3,0,0,0
2020-04-20 00:00,5,1,4,0,0,0
2020-04-20 00:15,1,1,0,0,0,0
2020-04-20 00:30,2,0,2,0,0,0
2020-04-20 00:45,1,1,0,0,0,0
2020-04-20 01:00,1,1,0,0,0,0
2020-04-20 01:15,1,1,0,0,0,0
2020-04-20 01:30,1,0,1,0,0,0
2020-04-20 01:45,0,0,0,0,0,0
2020-04-20 02:00,2,2,0,0,0,0
2020-04-20 02:15,0,0,0,0,0,0
2020-04-20 02:30,1,0,1,0,0,0
2020-04-20 02:45,0,0,0,0,0,0
2020-04-20 03:00,1,1,0,0,0,0
2020-04-20 03:15,1,0,1,0,0,0
2020-04-20 03:30,1,0,1,0,0,0
2020-04-20 03:45,0,0,0,0,0,0
2020-04-20 04:00,0,0,0,0,0,0
2020-04-20 04:15,1,0,1,0,0,0
2020-04-20 04:30,3,2,1,0,0,0
2020-04-20 04:45,4,3,1,0,0,0
2020-04-20 05:00,3,3,0,0,0,0
2020-04-20 05:15,10,7,3,0,0,0
2020-04-20 05:30,18,15,3,0,0,0
2020-04-20 05:45,20,16,4,0,0,0
2020-04-20 06:00,17,8,9,0,0,0
2020-04-20 06:15,29,19,10,0,0,0
2020-04-20 06:30,37,29,8,0,0,0
2020-04-20 06:45,57,43,14,0,0,0
2020-04-20 07:00,57,41,16,0,0,0
2020-04-20 07:15,67,46,21,0,0,0
2020-04-20 07:30,91,70,21,0,0,0
2020-04-20 07:45,89,67,22,0,0,0
2020-04-20 08:00,69,40,29,0,0,0
2020-04-20 08:15,110,67,43,0,0,0
2020-04-20 08:30,63,44,19,0,0,0
2020-04-20 08:45,98,62,36,0,0,0
2020-04-20 09:00,66,41,25,0,0,0
2020-04-20 09:15,88,46,42,0,0,0
2020-04-20 09:30,74,45,29,0,0,0
2020-04-20 09:45,94,64,30,0,0,0
2020-04-20 10:00,92,42,50,0,0,0
2020-04-20 10:15,79,39,40,0,0,0
2020-04-20 10:30,86,35,51,0,0,0
2020-04-20 10:45,102,56,46,0,0,0
2020-04-20 11:00,116,66,50,0,0,0
2020-04-20 11:15,130,60,70,0,0,0
2020-04-20 11:30,113,55,58,0,0,0
2020-04-20 11:45,133,51,82,0,0,0
2020-04-20 12:00,124,49,75,0,0,0
2020-04-20 12:15,129,52,77,0,0,0
2020-04-20 12:30,131,57,74,0,0,0
2020-04-20 12:45,121,56,65,0,0,0
2020-04-20 13:00,139,50,89,0,0,0
2020-04-20 13:15,150,62,88,0,0,0
2020-04-20 13:30,107,49,58,0,0,0
2020-04-20 13:45,126,63,63,0,0,0
2020-04-20 14:00,136,48,88,0,0,0
2020-04-20 14:15,130,50,80,0,0,0
2020-04-20 14:30,98,49,49,0,0,0
2020-04-20 14:45,141,69,72,0,0,0
2020-04-20 15:00,143,49,94,0,0,0
2020-04-20 15:15,156,75,81,0,0,0
2020-04-20 15:30,152,66,86,0,0,0
2020-04-20 15:45,143,57,86,0,0,0
2020-04-20 16:00,197,58,139,0,0,0
2020-04-20 16:15,175,67,108,0,0,0
2020-04-20 16:30,230,89,141,0,0,0
2020-04-20 16:45,162,53,109,0,0,0
2020-04-20 17:00,155,58,97,0,0,0
2020-04-20 17:15,167,75,92,0,0,0
2020-04-20 17:30,142,57,85,0,0,0
2020-04-20 17:45,148,52,96,0,0,0
2020-04-20 18:00,147,49,98,0,0,0
2020-04-20 18:15,110,47,63,0,0,0
2020-04-20 18:30,87,28,59,0,0,0
2020-04-20 18:45,80,21,59,0,0,0
2020-04-20 19:00,66,26,40,0,0,0
2020-04-20 19:15,82,23,59,0,0,0
2020-04-20 19:30,71,31,40,0,0,0
2020-04-20 19:45,53,21,32,0,0,0
2020-04-20 20:00,50,22,28,0,0,0
2020-04-20 20:15,39,11,28,0,0,0
2020-04-20 20:30,34,16,18,0,0,0
2020-04-20 20:45,25,6,19,0,0,0
2020-04-20 21:00,36,17,19,0,0,0
2020-04-20 21:15,20,9,11,0,0,0
2020-04-20 21:30,14,2,12,0,0,0
2020-04-20 21:45,15,6,9,0,0,0
2020-04-20 22:00,7,3,4,0,0,0
2020-04-20 22:15,19,7,12,0,0,0
2020-04-20 22:30,10,3,7,0,0,0
2020-04-20 22:45,7,1,6,0,0,0
2020-04-20 23:00,6,1,5,0,0,0
2020-04-20 23:15,5,4,1,0,0,0
2020-04-20 23:30,5,5,0,0,0,0
2020-04-20 23:45,6,2,4,0,0,0
2020-04-21 00:00,5,3,2,0,0,0
2020-04-21 00:15,3,1,2,0,0,0
2020-04-21 00:30,5,1,4,0,0,0
2020-04-21 00:45,2,1,1,0,0,0
2020-04-21 01:00,3,1,2,0,0,0
2020-04-21 01:15,0,0,0,0,0,0
2020-04-21 01:30,2,0,2,0,0,0
2020-04-21 01:45,2,0,2,0,0,0
2020-04-21 02:00,1,1,0,0,0,0
2020-04-21 02:15,0,0,0,0,0,0
2020-04-21 02:30,0,0,0,0,0,0
2020-04-21 02:45,1,0,1,0,0,0
2020-04-21 03:00,0,0,0,0,0,0
2020-04-21 03:15,1,0,1,0,0,0
2020-04-21 03:30,0,0,0,0,0,0
2020-04-21 03:45,0,0,0,0,0,0
2020-04-21 04:00,2,1,1,0,0,0
2020-04-21 04:15,5,2,3,0,0,0
2020-04-21 04:30,3,3,0,0,0,0
2020-04-21 04:45,1,0,1,0,0,0
2020-04-21 05:00,7,0,7,0,0,0
2020-04-21 05:15,8,7,1,0,0,0
2020-04-21 05:30,16,13,3,0,0,0
2020-04-21 05:45,23,18,5,0,0,0
2020-04-21 06:00,13,10,3,0,0,0
2020-04-21 06:15,30,24,6,0,0,0
2020-04-21 06:30,42,30,12,0,0,0
2020-04-21 06:45,50,35,15,0,0,0
2020-04-21 07:00,69,40,29,0,0,0
2020-04-21 07:15,82,59,23,0,0,0
2020-04-21 07:30,79,68,11,0,0,0
2020-04-21 07:45,113,80,33,0,0,0
2020-04-21 08:00,83,61,22,0,0,0
2020-04-21 08:15,101,62,39,0,0,0
2020-04-21 08:30,72,41,31,0,0,0
2020-04-21 08:45,103,69,34,0,0,0
2020-04-21 09:00,67,39,28,0,0,0
2020-04-21 09:15,56,33,23,0,0,0
2020-04-21 09:30,91,61,30,0,0,0
2020-04-21 09:45,97,68,29,0,0,0
2020-04-21 10:00,69,41,28,0,0,0
2020-04-21 10:15,86,45,41,0,0,0
2020-04-21 10:30,92,47,45,0,0,0
2020-04-21 10:45,92,51,41,0,0,0
2020-04-21 11:00,102,53,49,0,0,0
2020-04-21 11:15,118,55,63,0,0,0
2020-04-21 11:30,87,39,48,0,0,0
2020-04-21 11:45,108,48,60,0,0,0
2020-04-21 12:00,125,55,70,0,0,0
2020-04-21 12:15,117,48,69,0,0,0
2020-04-21 12:30,136,56,80,0,0,0
2020-04-21 12:45,119,43,76,0,0,0
2020-04-21 13:00,131,48,83,0,0,0
2020-04-21 13:15,104,48,56,0,0,0
2020-04-21 13:30,129,54,75,0,0,0
2020-04-21 13:45,117,67,50,0,0,0
2020-04-21 14:00,98,37,61,0,0,0
2020-04-21 14:15,132,56,76,0,0,0
2020-04-21 14:30,112,52,60,0,0,0
2020-04-21 14:45,157,68,89,0,0,0
2020-04-21 15:00,140,53,87,0,0,0
2020-04-21 15:15,135,51,84,0,0,0
2020-04-21 15:30,120,52,68,0,0,0
2020-04-21 15:45,159,68,91,0,0,0
2020-04-21 16:00,177,74,103,0,0,0
2020-04-21 16:15,166,71,95,0,0,0
2020-04-21 16:30,183,54,129,0,0,0
2020-04-21 16:45,221,82,139,0,0,0
2020-04-21 17:00,166,66,100,0,0,0
2020-04-21 17:15,161,61,100,0,0,0
2020-04-21 17:30,159,54,105,0,0,0
2020-04-21 17:45,143,37,106,0,0,0
2020-04-21 18:00,145,61,84,0,0,0
2020-04-21 18:15,114,49,65,0,0,0
2020-04-21 18:30,97,24,73,0,0,0
2020-04-21 18:45,93,40,53,0,0,0
2020-04-21 19:00,98,29,69,0,0,0
2020-04-21 19:15,82,21,61,0,0,0
2020-04-21 19:30,56,14,42,0,0,0
2020-04-21 19:45,60,24,36,0,0,0
2020-04-21 20:00,41,15,26,0,0,0
2020-04-21 20:15,44,7,37,0,0,0
2020-04-21 20:30,34,20,14,0,0,0
2020-04-21 20:45,33,13,20,0,0,0
2020-04-21 21:00,25,13,12,0,0,0
2020-04-21 21:15,18,8,10,0,0,0
2020-04-21 21:30,25,11,14,0,0,0
2020-04-21 21:45,18,3,15,0,0,0
2020-04-21 22:00,17,6,11,0,0,0
2020-04-21 22:15,27,10,17,0,0,0
2020-04-21 22:30,17,5,12,0,0,0
2020-04-21 22:45,11,2,9,0,0,0
2020-04-21 23:00,15,4,11,0,0,0
2020-04-21 23:15,5,1,4,0,0,0
2020-04-21 23:30,6,2,4,0,0,0
2020-04-21 23:45,2,2,0,0,0,0
2020-04-22 00:00,10,3,7,0,0,0
2020-04-22 00:15,8,4,4,0,0,0
2020-04-22 00:30,2,1,1,0,0,0
2020-04-22 00:45,4,2,2,0,0,0
2020-04-22 01:00,2,1,1,0,0,0
2020-04-22 01:15,2,0,2,0,0,0
2020-04-22 01:30,2,0,2,0,0,0
2020-04-22 01:45,3,1,2,0,0,0
2020-04-22 02:00,0,0,0,0,0,0
2020-04-22 02:15,1,1,0,0,0,0
2020-04-22 02:30,0,0,0,0,0,0
2020-04-22 02:45,0,0,0,0,0,0
2020-04-22 03:00,2,1,1,0,0,0
2020-04-22 03:15,1,0,1,0,0,0
2020-04-22 03:30,1,1,0,0,0,0
2020-04-22 03:45,0,0,0,0,0,0
2020-04-22 04:00,0,0,0,0,0,0
2020-04-22 04:15,2,1,1,0,0,0
2020-04-22 04:30,4,4,0,0,0,0
2020-04-22 04:45,3,2,1,0,0,0
2020-04-22 05:00,3,3,0,0,0,0
2020-04-22 05:15,8,5,3,0,0,0
2020-04-22 05:30,17,16,1,0,0,0
2020-04-22 05:45,23,16,7,0,0,0
2020-04-22 06:00,16,11,5,0,0,0
2020-04-22 06:15,32,23,9,0,0,0
2020-04-22 06:30,44,27,17,0,0,0
2020-04-22 06:45,58,43,15,0,0,0
2020-04-22 07:00,65,49,16,0,0,0
2020-04-22 07:15,89,58,31,0,0,0
2020-04-22 07:30,93,64,29,0,0,0
2020-04-22 07:45,103,67,36,0,0,0
2020-04-22 08:00,93,66,27,0,0,0
2020-04-22 08:15,110,62,48,0,0,0
2020-04-22 08:30,88,56,32,0,0,0
2020-04-22 08:45,91,60,31,0,0,0
2020-04-22 09:00,59,38,21,0,0,0
2020-04-22 09:15,77,50,27,0,0,0
2020-04-22 09:30,79,44,35,0,0,0
2020-04-22 09:45,103,66,37,0,0,0
2020-04-22 10:00,116,68,48,0,0,0
2020-04-22 10:15,119,67,52,0,0,0
2020-04-22 10:30,112,59,53,0,0,0
2020-04-22 10:45,118,70,48,0,0,0
2020-04-22 11:00,149,81,68,0,0,0
2020-04-22 11:15,113,58,55,0,0,0
2020-04-22 11:30,113,53,60,0,0,0
2020-04-22 11:45,117,56,61,0,0,0
2020-04-22 12:00,123,47,76,0,0,0
2020-04-22 12:15,142,54,88,0,0,0
2020-04-22 12:30,139,53,86,0,0,0
2020-04-22 12:45,132,59,73,0,0,0
2020-04-22 13:00,126,60,66,0,0,0
2020-04-22 13:15,142,52,90,0,0,0
2020-04-22 13:30,146,61,85,0,0,0
2020-04-22 13:45,151,75,76,0,0,0
2020-04-22 14:00,142,48,94,0,0,0
2020-04-22 14:15,151,74,77,0,0,0
2020-04-22 14:30,120,43,77,0,0,0
2020-04-22 14:45,125,61,64,0,0,0
2020-04-22 15:00,128,54,74,0,0,0
2020-04-22 15:15,128,49,79,0,0,0
2020-04-22 15:30,141,57,84,0,0,0
2020-04-22 15:45,146,62,84,0,0,0
2020-04-22 16:00,198,74,124,0,0,0
2020-04-22 16:15,195,72,123,0,0,0
2020-04-22 16:30,191,81,110,0,0,0
2020-04-22 16:45,172,74,98,0,0,0
2020-04-22 17:00,172,62,110,0,0,0
2020-04-22 17:15,202,73,129,0,0,0
2020-04-22 17:30,165,70,95,0,0,0
2020-04-22 17:45,136,49,87,0,0,0
2020-04-22 18:00,118,34,84,0,0,0
2020-04-22 18:15,146,49,97,0,0,0
2020-04-22 18:30,109,40,69,0,0,0
2020-04-22 18:45,106,42,64,0,0,0
2020-04-22 19:00,84,24,60,0,0,0
2020-04-22 19:15,82,23,59,0,0,0
2020-04-22 19:30,72,29,43,0,0,0
2020-04-22 19:45,68,20,48,0,0,0
2020-04-22 20:00,56,16,40,0,0,0
2020-04-22 20:15,44,15,29,0,0,0
2020-04-22 20:30,46,19,27,0,0,0
2020-04-22 20:45,28,12,16,0,0,0
2020-04-22 21:00,48,21,27,0,0,0
2020-04-22 21:15,22,11,11,0,0,0
2020-04-22 21:30,30,5,25,0,0,0
2020-04-22 21:45,25,10,15,0,0,0
2020-04-22 22:00,19,4,15,0,0,0
2020-04-22 22:15,13,4,9,0,0,0
2020-04-22 22:30,14,2,12,0,0,0
2020-04-22 22:45,13,4,9,0,0,0
2020-04-22 23:00,6,2,4,0,0,0
2020-04-22 23:15,7,4,3,0,0,0
2020-04-22 23:30,8,1,7,0,0,0
2020-04-22 23:45,6,4,2,0,0,0
2020-04-23 00:00,4,2,2,0,0,0
2020-04-23 00:15,10,3,7,0,0,0
2020-04-23 00:30,3,3,0,0,0,0
2020-04-23 00:45,5,3,2,0,0,0
2020-04-23 01:00,7,4,3,0,0,0
2020-04-23 01:15,4,0,4,0,0,0
2020-04-23 01:30,0,0,0,0,0,0
2020-04-23 01:45,0,0,0,0,0,0
2020-04-23 02:00,1,0,1,0,0,0
2020-04-23 02:15,2,0,2,0,0,0
2020-04-23 02:30,0,0,0,0,0,0
2020-04-23 02:45,0,0,0,0,0,0
2020-04-23 03:00,0,0,0,0,0,0
2020-04-23 03:15,0,0,0,0,0,0
2020-04-23 03:30,2,1,1,0,0,0
2020-04-23 03:45,0,0,0,0,0,0
2020-04-23 04:00,0,0,0,0,0,0
2020-04-23 04:15,2,1,1,0,0,0
2020-04-23 04:30,3,3,0,0,0,0
2020-04-23 04:45,1,0,1,0,0,0
2020-04-23 05:00,5,4,1,0,0,0
2020-04-23 05:15,5,4,1,0,0,0
2020-04-23 05:30,15,10,5,0,0,0
2020-04-23 05:45,17,12,5,0,0,0
2020-04-23 06:00,13,10,3,0,0,0
2020-04-23 06:15,31,21,10,0,0,0
2020-04-23 06:30,32,21,11,0,0,0
2020-04-23 06:45,56,36,20,0,0,0
2020-04-23 07:00,71,47,24,0,0,0
2020-04-23 07:15,80,45,35,0,0,0
2020-04-23 07:30,82,61,21,0,0,0
2020-04-23 07:45,100,73,27,0,0,0
2020-04-23 08:00,80,49,31,0,0,0
2020-04-23 08:15,116,74,42,0,0,0
2020-04-23 08:30,87,56,31,0,0,0
2020-04-23 08:45,100,77,23,0,0,0
2020-04-23 09:00,79,52,27,0,0,0
2020-04-23 09:15,68,40,28,0,0,0
2020-04-23 09:30,83,46,37,0,0,0
2020-04-23 09:45,88,59,29,0,0,0
2020-04-23 10:00,76,40,36,0,0,0
2020-04-23 10:15,77,45,32,0,0,0
2020-04-23 10:30,80,41,39,0,0,0
2020-04-23 10:45,103,48,55,0,0,0
2020-04-23 11:00,106,45,61,0,0,0
2020-04-23 11:15,125,63,62,0,0,0
2020-04-23 11:30,92,49,43,0,0,0
2020-04-23 11:45,116,58,58,0,0,0
2020-04-23 12:00,118,56,62,0,0,0
2020-04-23 12:15,122,49,73,0,0,0
2020-04-23 12:30,116,49,67,0,0,0
2020-04-23 12:45,106,60,46,0,0,0
2020-04-23 13:00,131,56,75,0,0,0
2020-04-23 13:15,146,79,67,0,0,0
2020-04-23 13:30,124,53,71,0,0,0
2020-04-23 13:45,113,56,57,0,0,0
2020-04-23 14:00,124,57,67,0,0,0
2020-04-23 14:15,145,60,85,0,0,0
2020-04-23 14:30,101,54,47,0,0,0
2020-04-23 14:45,136,67,69,0,0,0
2020-04-23 15:00,131,45,86,0,0,0
2020-04-23 15:15,142,54,88,0,0,0
2020-04-23 15:30,153,75,78,0,0,0
2020-04-23 15:45,156,68,88,0,0,0
2020-04-23 16:00,161,77,84,0,0,0
2020-04-23 16:15,181,78,103,0,0,0
2020-04-23 16:30,180,82,98,0,0,0
2020-04-23 16:45,180,62,118,0,0,0
2020-04-23 17:00,183,60,123,0,0,0
2020-04-23 17:15,156,68,88,0,0,0
2020-04-23 17:30,178,69,109,0,0,0
2020-04-23 17:45,175,72,103,0,0,0
2020-04-23 18:00,142,30,112,0,0,0
2020-04-23 18:15,125,27,98,0,0,0
2020-04-23 18:30,115,43,72,0,0,0
2020-04-23 18:45,89,34,55,0,0,0
2020-04-23 19:00,85,30,55,0,0,0
2020-04-23 19:15,68,28,40,0,0,0
2020-04-23 19:30,97,41,56,0,0,0
2020-04-23 19:45,70,23,47,0,0,0
2020-04-23 20:00,45,18,27,0,0,0
2020-04-23 20:15,42,15,27,0,0,0
2020-04-23 20:30,36,15,21,0,0,0
2020-04-23 20:45,56,23,33,0,0,0
2020-04-23 21:00,29,11,18,0,0,0
2020-04-23 21:15,38,13,25,0,0,0
2020-04-23 21:30,24,7,17,0,0,0
2020-04-23 21:45,18,6,12,0,0,0
2020-04-23 22:00,16,6,10,0,0,0
2020-04-23 22:15,7,4,3,0,0,0
2020-04-23 22:30,21,9,12,0,0,0
2020-04-23 22:45,19,9,10,0,0,0
2020-04-23 23:00,11,4,7,0,0,0
2020-04-23 23:15,8,0,8,0,0,0
2020-04-23 23:30,5,3,2,0,0,0
2020-04-23 23:45,10,4,6,0,0,0
2020-04-24 00:00,14,9,5,0,0,0
2020-04-24 00:15,4,3,1,0,0,0
2020-04-24 00:30,4,3,1,0,0,0
2020-04-24 00:45,3,1,2,0,0,0
2020-04-24 01:00,0,0,0,0,0,0
2020-04-24 01:15,0,0,0,0,0,0
2020-04-24 01:30,3,0,3,0,0,0
2020-04-24 01:45,2,0,2,0,0,0
2020-04-24 02:00,2,2,0,0,0,0
2020-04-24 02:15,1,1,0,0,0,0
2020-04-24 02:30,1,1,0,0,0,0
2020-04-24 02:45,2,1,1,0,0,0
2020-04-24 03:00,2,1,1,0,0,0
2020-04-24 03:15,0,0,0,0,0,0
2020-04-24 03:30,0,0,0,0,0,0
2020-04-24 03:45,0,0,0,0,0,0
2020-04-24 04:00,1,1,0,0,0,0
2020-04-24 04:15,2,0,2,0,0,0
2020-04-24 04:30,2,2,0,0,0,0
2020-04-24 04:45,1,0,1,0,0,0
2020-04-24 05:00,4,3,1,0,0,0
2020-04-24 05:15,6,3,3,0,0,0
2020-04-24 05:30,16,11,5,0,0,0
2020-04-24 05:45,16,12,4,0,0,0
2020-04-24 06:00,23,18,5,0,0,0
2020-04-24 06:15,32,23,9,0,0,0
2020-04-24 06:30,38,24,14,0,0,0
2020-04-24 06:45,54,36,18,0,0,0
2020-04-24 07:00,62,34,28,0,0,0
2020-04-24 07:15,67,49,18,0,0,0
2020-04-24 07:30,75,59,16,0,0,0
2020-04-24 07:45,89,56,33,0,0,0
2020-04-24 08:00,77,55,22,0,0,0
2020-04-24 08:15,80,54,26,0,0,0
2020-04-24 08:30,69,42,27,0,0,0
2020-04-24 08:45,93,63,30,0,0,0
2020-04-24 09:00,58,36,22,0,0,0
2020-04-24 09:15,84,51,33,0,0,0
2020-04-24 09:30,81,52,29,0,0,0
2020-04-24 09:45,112,59,53,0,0,0
2020-04-24 10:00,88,49,39,0,0,0
2020-04-24 10:15,77,41,36,0,0,0
2020-04-24 10:30,114,50,64,0,0,0
2020-04-24 10:45,99,48,51,0,0,0
2020-04-24 11:00,95,55,40,0,0,0
2020-04-24 11:15,127,60,67,0,0,0
2020-04-24 11:30,109,49,60,0,0,0
2020-04-24 11:45,133,66,67,0,0,0
2020-04-24 12:00,134,56,78,0,0,0
2020-04-24 12:15,137,55,82,0,0,0
2020-04-24 12:30,144,64,80,0,0,0
2020-04-24 12:45,130,51,79,0,0,0
2020-04-24 13:00,148,56,92,0,0,0
2020-04-24 13:15,145,65,80,0,0,0
2020-04-24 13:30,162,64,98,0,0,0
2020-04-24 13:45,145,60,85,0,0,0
2020-04-24 14:00,159,66,93,0,0,0
2020-04-24 14:15,138,57,81,0,0,0
2020-04-24 14:30,121,54,67,0,0,0
2020-04-24 14:45,148,59,89,0,0,0
2020-04-24 15:00,166,72,94,0,0,0
2020-04-24 15:15,138,49,89,0,0,0
2020-04-24 15:30,120,41,79,0,0,0
2020-04-24 15:45,153,63,90,0,0,0
2020-04-24 16:00,150,63,87,0,0,0
2020-04-24 16:15,163,81,82,0,0,0
2020-04-24 16:30,152,61,91,0,0,0
2020-04-24 16:45,145,47,98,0,0,0
2020-04-24 17:00,140,56,84,0,0,0
2020-04-24 17:15,142,57,85,0,0,0
2020-04-24 17:30,135,55,80,0,0,0
2020-04-24 17:45,144,47,97,0,0,0
2020-04-24 18:00,113,38,75,0,0,0
2020-04-24 18:15,100,44,56,0,0,0
2020-04-24 18:30,102,46,56,0,0,0
2020-04-24 18:45,102,50,52,0,0,0
2020-04-24 19:00,72,18,54,0,0,0
2020-04-24 19:15,62,26,36,0,0,0
2020-04-24 19:30,70,23,47,0,0,0
2020-04-24 19:45,65,23,42,0,0,0
2020-04-24 20:00,72,32,40,0,0,0
2020-04-24 20:15,40,22,18,0,0,0
2020-04-24 20:30,52,22,30,0,0,0
2020-04-24 20:45,43,21,22,0,0,0
2020-04-24 21:00,35,12,23,0,0,0
2020-04-24 21:15,27,12,15,0,0,0
2020-04-24 21:30,34,8,26,0,0,0
2020-04-24 21:45,16,11,5,0,0,0
2020-04-24 22:00,18,6,12,0,0,0
2020-04-24 22:15,24,8,16,0,0,0
2020-04-24 22:30,18,7,11,0,0,0
2020-04-24 22:45,17,8,9,0,0,0
2020-04-24 23:00,14,8,6,0,0,0
2020-04-24 23:15,15,4,11,0,0,0
2020-04-24 23:30,6,3,3,0,0,0
2020-04-24 23:45,20,7,13,0,0,0
2020-04-25 00:00,4,3,1,0,0,0
2020-04-25 00:15,18,6,12,0,0,0
2020-04-25 00:30,8,3,5,0,0,0
2020-04-25 00:45,6,2,4,0,0,0
2020-04-25 01:00,11,3,8,0,0,0
2020-04-25 01:15,7,4,3,0,0,0
2020-04-25 01:30,3,2,1,0,0,0
2020-04-25 01:45,4,1,3,0,0,0
2020-04-25 02:00,3,2,1,0,0,0
2020-04-25 02:15,2,1,1,0,0,0
2020-04-25 02:30,3,1,2,0,0,0
2020-04-25 02:45,1,0,1,0,0,0
2020-04-25 03:00,1,1,0,0,0,0
2020-04-25 03:15,1,0,1,0,0,0
2020-04-25 03:30,0,0,0,0,0,0
2020-04-25 03:45,4,4,0,0,0,0
2020-04-25 04:00,1,1,0,0,0,0
2020-04-25 04:15,0,0,0,0,0,0
2020-04-25 04:30,1,0,1,0,0,0
2020-04-25 04:45,3,3,0,0,0,0
2020-04-25 05:00,3,2,1,0,0,0
2020-04-25 05:15,4,2,2,0,0,0
2020-04-25 05:30,6,6,0,0,0,0
2020-04-25 05:45,7,6,1,0,0,0
2020-04-25 06:00,7,4,3,0,0,0
2020-04-25 06:15,4,4,0,0,0,0
2020-04-25 06:30,9,7,2,0,0,0
2020-04-25 06:45,8,4,4,0,0,0
2020-04-25 07:00,13,8,5,0,0,0
2020-04-25 07:15,19,15,4,0,0,0
2020-04-25 07:30,23,14,9,0,0,0
2020-04-25 07:45,28,19,9,0,0,0
2020-04-25 08:00,18,10,8,0,0,0
2020-04-25 08:15,32,9,23,0,0,0
2020-04-25 08:30,39,28,11,0,0,0
2020-04-25 08:45,31,23,8,0,0,0
2020-04-25 09:00,47,32,15,0,0,0
2020-04-25 09:15,64,40,24,0,0,0
2020-04-25 09:30,70,45,25,0,0,0
2020-04-25 09:45,98,52,46,0,0,0
2020-04-25 10:00,91,62,29,0,0,0
2020-04-25 10:15,94,57,37,0,0,0
2020-04-25 10:30,94,50,44,0,0,0
2020-04-25 10:45,117,75,42,0,0,0
2020-04-25 11:00,105,56,49,0,0,0
2020-04-25 11:15,148,79,69,0,0,0
2020-04-25 11:30,131,68,63,0,0,0
2020-04-25 11:45,145,75,70,0,0,0
2020-04-25 12:00,121,67,54,0,0,0
2020-04-25 12:15,149,75,74,0,0,0
2020-04-25 12:30,137,80,57,0,0,0
2020-04-25 12:45,138,72,66,0,0,0
2020-04-25 13:00,152,74,78,0,0,0
2020-04-25 13:15,177,94,83,0,0,0
2020-04-25 13:30,179,89,90,0,0,0
2020-04-25 13:45,162,80,82,0,0,0
2020-04-25 14:00,156,63,93,0,0,0
2020-04-25 14:15,137,57,80,0,0,0
2020-04-25 14:30,145,58,87,0,0,0
2020-04-25 14:45,110,52,58,0,0,0
2020-04-25 15:00,142,62,80,0,0,0
2020-04-25 15:15,143,63,80,0,0,0
2020-04-25 15:30,126,46,80,0,0,0
2020-04-25 15:45,125,60,65,0,0,0
2020-04-25 16:00,105,53,52,0,0,0
2020-04-25 16:15,100,33,67,0,0,0
2020-04-25 16:30,117,46,71,0,0,0
2020-04-25 16:45,104,37,67,0,0,0
2020-04-25 17:00,100,29,71,0,0,0
2020-04-25 17:15,103,39,64,0,0,0
2020-04-25 17:30,106,41,65,0,0,0
2020-04-25 17:45,77,29,48,0,0,0
2020-04-25 18:00,102,37,65,0,0,0
2020-04-25 18:15,72,24,48,0,0,0
2020-04-25 18:30,67,23,44,0,0,0
2020-04-25 18:45,62,25,37,0,0,0
2020-04-25 19:00,75,25,50,0,0,0
2020-04-25 19:15,60,29,31,0,0,0
2020-04-25 19:30,62,33,29,0,0,0
2020-04-25 19:45,37,12,25,0,0,0
2020-04-25 20:00,45,24,21,0,0,0
2020-04-25 20:15,27,8,19,0,0,0
2020-04-25 20:30,37,16,21,0,0,0
2020-04-25 20:45,26,11,15,0,0,0
2020-04-25 21:00,22,8,14,0,0,0
2020-04-25 21:15,26,9,17,0,0,0
2020-04-25 21:30,14,6,8,0,0,0
2020-04-25 21:45,19,12,7,0,0,0
2020-04-25 22:00,19,10,9,0,0,0
2020-04-25 22:15,15,5,10,0,0,0
2020-04-25 22:30,24,14,10,0,0,0
2020-04-25 22:45,16,5,11,0,0,0
2020-04-25 23:00,17,7,10,0,0,0
2020-04-25 23:15,19,11,8,0,0,0
2020-04-25 23:30,8,3,5,0,0,0
2020-04-25 23:45,12,4,8,0,0,0
2020-04-26 00:00,10,5,5,0,0,0
2020-04-26 00:15,7,4,3,0,0,0
2020-04-26 00:30,6,1,5,0,0,0
2020-04-26 00:45,10,6,4,0,0,0
2020-04-26 01:00,10,3,7,0,0,0
2020-04-26 01:15,8,7,1,0,0,0
2020-04-26 01:30,8,3,5,0,0,0
2020-04-26 01:45,1,0,1,0,0,0
2020-04-26 02:00,8,3,5,0,0,0
2020-04-26 02:15,3,2,1,0,0,0
2020-04-26 02:30,6,2,4,0,0,0
2020-04-26 02:45,3,1,2,0,0,0
2020-04-26 03:00,3,3,0,0,0,0
2020-04-26 03:15,3,1,2,0,0,0
2020-04-26 03:30,4,2,2,0,0,0
2020-04-26 03:45,3,2,1,0,0,0
2020-04-26 04:00,1,0,1,0,0,0
2020-04-26 04:15,1,1,0,0,0,0
2020-04-26 04:30,0,0,0,0,0,0
2020-04-26 04:45,1,1,0,0,0,0
2020-04-26 05:00,0,0,0,0,0,0
2020-04-26 05:15,2,1,1,0,0,0
2020-04-26 05:30,3,2,1,0,0,0
2020-04-26 05:45,0,0,0,0,0,0
2020-04-26 06:00,2,2,0,0,0,0
2020-04-26 06:15,4,2,2,0,0,0
2020-04-26 06:30,3,2,1,0,0,0
2020-04-26 06:45,1,0,1,0,0,0
2020-04-26 07:00,2,0,2,0,0,0
2020-04-26 07:15,7,5,2,0,0,0
2020-04-26 07:30,6,2,4,0,0,0
2020-04-26 07:45,5,2,3,0,0,0
2020-04-26 08:00,4,3,1,0,0,0
2020-04-26 08:15,8,4,4,0,0,0
2020-04-26 08:30,12,8,4,0,0,0
2020-04-26 08:45,5,2,3,0,0,0
2020-04-26 09:00,11,5,6,0,0,0
2020-04-26 09:15,12,7,5,0,0,0
2020-04-26 09:30,12,9,3,0,0,0
2020-04-26 09:45,19,13,6,0,0,0
2020-04-26 10:00,22,9,13,0,0,0
2020-04-26 10:15,32,22,10,0,0,0
2020-04-26 10:30,42,21,21,0,0,0
2020-04-26 10:45,50,38,12,0,0,0
2020-04-26 11:00,49,28,21,0,0,0
2020-04-26 11:15,28,18,10,0,0,0
2020-04-26 11:30,39,22,17,0,0,0
2020-04-26 11:45,51,29,22,0,0,0
2020-04-26 12:00,65,35,30,0,0,0
2020-04-26 12:15,72,36,36,0,0,0
2020-04-26 12:30,42,24,18,0,0,0
2020-04-26 12:45,68,38,30,0,0,0
2020-04-26 13:00,67,43,24,0,0,0
2020-04-26 13:15,91,51,40,0,0,0
2020-04-26 13:30,71,35,36,0,0,0
2020-04-26 13:45,95,50,45,0,0,0
2020-04-26 14:00,103,49,54,0,0,0
2020-04-26 14:15,98,48,50,0,0,0
2020-04-26 14:30,103,47,56,0,0,0
2020-04-26 14:45,109,51,58,0,0,0
2020-04-26 15:00,106,46,60,0,0,0
2020-04-26 15:15,104,48,56,0,0,0
2020-04-26 15:30,132,56,76,0,0,0
2020-04-26 15:45,118,53,65,0,0,0
2020-04-26 16:00,135,55,80,0,0,0
2020-04-26 16:15,91,32,59,0,0,0
2020-04-26 16:30,89,39,50,0,0,0
2020-04-26 16:45,113,57,56,0,0,0
2020-04-26 17:00,97,39,58,0,0,0
2020-04-26 17:15,118,30,88,0,0,0
2020-04-26 17:30,95,38,57,0,0,0
2020-04-26 17:45,81,27,54,0,0,0
2020-04-26 18:00,67,19,48,0,0,0
2020-04-26 18:15,65,22,43,0,0,0
2020-04-26 18:30,62,23,39,0,0,0
2020-04-26 18:45,59,19,40,0,0,0
2020-04-26 19:00,53,21,32,0,0,0
2020-04-26 19:15,39,17,22,0,0,0
2020-04-26 19:30,55,23,32,0,0,0
2020-04-26 19:45,56,30,26,0,0,0
2020-04-26 20:00,35,11,24,0,0,0
2020-04-26 20:15,34,16,18,0,0,0
2020-04-26 20:30,40,12,28,0,0,0
2020-04-26 20:45,26,13,13,0,0,0
2020-04-26 21:00,23,7,16,0,0,0
2020-04-26 21:15,23,10,13,0,0,0
2020-04-26 21:30,17,4,13,0,0,0
2020-04-26 21:45,19,8,11,0,0,0
2020-04-26 22:00,20,8,12,0,0,0
2020-04-26 22:15,16,6,10,0,0,0
2020-04-26 22:30,10,5,5,0,0,0
2020-04-26 22:45,14,7,7,0,0,0
2020-04-26 23:00,12,5,7,0,0,0
2020-04-26 23:15,3,1,2,0,0,0
2020-04-26 23:30,2,0,2,0,0,0
2020-04-26 23:45,4,3,1,0,0,0
2020-04-27 00:00,5,0,5,0,0,0
2020-04-27 00:15,3,0,3,0,0,0
2020-04-27 00:30,1,1,0,0,0,0
2020-04-27 00:45,2,0,2,0,0,0
2020-04-27 01:00,2,0,2,0,0,0
2020-04-27 01:15,2,1,1,0,0,0
2020-04-27 01:30,1,1,0,0,0,0
2020-04-27 01:45,2,2,0,0,0,0
2020-04-27 02:00,1,0,1,0,0,0
2020-04-27 02:15,0,0,0,0,0,0
2020-04-27 02:30,1,0,1,0,0,0
2020-04-27 02:45,0,0,0,0,0,0
2020-04-27 03:00,0,0,0,0,0,0
2020-04-27 03:15,1,0,1,0,0,0
2020-04-27 03:30,0,0,0,0,0,0
2020-04-27 03:45,0,0,0,0,0,0
2020-04-27 04:00,0,0,0,0,0,0
2020-04-27 04:15,0,0,0,0,0,0
2020-04-27 04:30,2,2,0,0,0,0
2020-04-27 04:45,6,1,5,0,0,0
2020-04-27 05:00,5,5,0,0,0,0
2020-04-27 05:15,7,6,1,0,0,0
2020-04-27 05:30,13,10,3,0,0,0
2020-04-27 05:45,23,17,6,0,0,0
2020-04-27 06:00,21,18,3,0,0,0
2020-04-27 06:15,32,24,8,0,0,0
2020-04-27 06:30,38,28,10,0,0,0
2020-04-27 06:45,60,43,17,0,0,0
2020-04-27 07:00,56,34,22,0,0,0
2020-04-27 07:15,81,58,23,0,0,0
2020-04-27 07:30,105,78,27,0,0,0
2020-04-27 07:45,102,73,29,0,0,0
2020-04-27 08:00,84,58,26,0,0,0
2020-04-27 08:15,90,61,29,0,0,0
2020-04-27 08:30,97,58,39,0,0,0
2020-04-27 08:45,100,76,24,0,0,0
2020-04-27 09:00,82,51,31,0,0,0
2020-04-27 09:15,82,47,35,0,0,0
2020-04-27 09:30,99,59,40,0,0,0
2020-04-27 09:45,98,68,30,0,0,0
2020-04-27 10:00,86,50,36,0,0,0
2020-04-27 10:15,99,46,53,0,0,0
2020-04-27 10:30,111,71,40,0,0,0
2020-04-27 10:45,135,70,65,0,0,0
2020-04-27 11:00,94,46,48,0,0,0
2020-04-27 11:15,114,49,65,0,0,0
2020-04-27 11:30,128,64,64,0,0,0
2020-04-27 11:45,129,58,71,0,0,0
2020-04-27 12:00,126,54,72,0,0,0
2020-04-27 12:15,136,64,72,0,0,0
2020-04-27 12:30,111,32,79,0,0,0
2020-04-27 12:45,142,72,70,0,0,0
2020-04-27 13:00,147,51,96,0,0,0
2020-04-27 13:15,137,49,88,0,0,0
2020-04-27 13:30,121,48,73,0,0,0
2020-04-27 13:45,145,78,67,0,0,0
2020-04-27 14:00,128,53,75,0,0,0
2020-04-27 14:15,125,54,71,0,0,0
2020-04-27 14:30,133,76,57,0,0,0
2020-04-27 14:45,159,77,82,0,0,0
2020-04-27 15:00,168,77,91,0,0,0
2020-04-27 15:15,153,80,73,0,0,0
2020-04-27 15:30,169,67,102,0,0,0
2020-04-27 15:45,163,78,85,0,0,0
2020-04-27 16:00,158,51,107,0,0,0
2020-04-27 16:15,186,67,119,0,0,0
2020-04-27 16:30,170,66,104,0,0,0
2020-04-27 16:45,173,60,113,0,0,0
2020-04-27 17:00,191,65,126,0,0,0
2020-04-27 17:15,189,66,123,0,0,0
2020-04-27 17:30,181,63,118,0,0,0
2020-04-27 17:45,164,47,117,0,0,0
2020-04-27 18:00,136,46,90,0,0,0
2020-04-27 18:15,136,45,91,0,0,0
2020-04-27 18:30,95,27,68,0,0,0
2020-04-27 18:45,107,42,65,0,0,0
2020-04-27 19:00,86,25,61,0,0,0
2020-04-27 19:15,84,23,61,0,0,0
2020-04-27 19:30,75,29,46,0,0,0
2020-04-27 19:45,69,33,36,0,0,0
2020-04-27 20:00,66,27,39,0,0,0
2020-04-27 20:15,56,18,38,0,0,0
2020-04-27 20:30,22,1,21,0,0,0
2020-04-27 20:45,44,19,25,0,0,0
2020-04-27 21:00,35,14,21,0,0,0
2020-04-27 21:15,18,5,13,0,0,0
2020-04-27 21:30,30,17,13,0,0,0
2020-04-27 21:45,36,12,24,0,0,0
2020-04-27 22:00,25,8,17,0,0,0
2020-04-27 22:15,18,5,13,0,0,0
2020-04-27 22:30,20,4,16,0,0,0
2020-04-27 22:45,11,4,7,0,0,0
2020-04-27 23:00,12,3,9,0,0,0
2020-04-27 23:15,8,0,8,0,0,0
2020-04-27 23:30,0,0,0,0,0,0
2020-04-27 23:45,6,3,3,0,0,0
2020-04-28 00:00,13,8,5,0,0,0
2020-04-28 00:15,9,5,4,0,0,0
2020-04-28 00:30,4,0,4,0,0,0
2020-04-28 00:45,5,3,2,0,0,0
2020-04-28 01:00,2,0,2,0,0,0
2020-04-28 01:15,4,2,2,0,0,0
2020-04-28 01:30,1,0,1,0,0,0
2020-04-28 01:45,0,0,0,0,0,0
2020-04-28 02:00,2,0,2,0,0,0
2020-04-28 02:15,1,0,1,0,0,0
2020-04-28 02:30,0,0,0,0,0,0
2020-04-28 02:45,1,1,0,0,0,0
2020-04-28 03:00,0,0,0,0,0,0
2020-04-28 03:15,1,0,1,0,0,0
2020-04-28 03:30,1,0,1,0,0,0
2020-04-28 03:45,0,0,0,0,0,0
2020-04-28 04:00,0,0,0,0,0,0
2020-04-28 04:15,0,0,0,0,0,0
2020-04-28 04:30,1,1,0,0,0,0
2020-04-28 04:45,5,2,3,0,0,0
2020-04-28 05:00,4,4,0,0,0,0
2020-04-28 05:15,12,8,4,0,0,0
2020-04-28 05:30,15,14,1,0,0,0
2020-04-28 05:45,27,23,4,0,0,0
2020-04-28 06:00,21,17,4,0,0,0
2020-04-28 06:15,36,28,8,0,0,0
2020-04-28 06:30,37,21,16,0,0,0
2020-04-28 06:45,63,42,21,0,0,0
2020-04-28 07:00,66,53,13,0,0,0
2020-04-28 07:15,77,49,28,0,0,0
2020-04-28 07:30,102,70,32,0,0,0
2020-04-28 07:45,111,68,43,0,0,0
2020-04-28 08:00,76,45,31,0,0,0
2020-04-28 08:15,107,71,36,0,0,0
2020-04-28 08:30,101,63,38,0,0,0
2020-04-28 08:45,105,81,24,0,0,0
2020-04-28 09:00,63,42,21,0,0,0
2020-04-28 09:15,78,50,28,0,0,0
2020-04-28 09:30,65,46,19,0,0,0
2020-04-28 09:45,107,65,42,0,0,0
2020-04-28 10:00,98,56,42,0,0,0
2020-04-28 10:15,95,62,33,0,0,0
2020-04-28 10:30,97,57,40,0,0,0
2020-04-28 10:45,110,59,51,0,0,0
2020-04-28 11:00,114,59,55,0,0,0
2020-04-28 11:15,100,60,40,0,0,0
2020-04-28 11:30,137,73,64,0,0,0
2020-04-28 11:45,116,53,63,0,0,0
2020-04-28 12:00,140,67,73,0,0,0
2020-04-28 12:15,133,60,73,0,0,0
2020-04-28 12:30,123,43,80,0,0,0
2020-04-28 12:45,111,57,54,0,0,0
2020-04-28 13:00,119,48,71,0,0,0
2020-04-28 13:15,113,50,63,0,0,0
2020-04-28 13:30,104,41,63,0,0,0
2020-04-28 13:45,119,65,54,0,0,0
2020-04-28 14:00,115,52,63,0,0,0
2020-04-28 14:15,109,52,57,0,0,0
2020-04-28 14:30,131,55,76,0,0,0
2020-04-28 14:45,131,61,70,0,0,0
2020-04-28 15:00,126,45,81,0,0,0
2020-04-28 15:15,118,46,72,0,0,0
2020-04-28 15:30,128,41,87,0,0,0
2020-04-28 15:45,121,49,72,0,0,0
2020-04-28 16:00,145,45,100,0,0,0
2020-04-28 16:15,158,60,98,0,0,0
2020-04-28 16:30,114,33,81,0,0,0
2020-04-28 16:45,122,44,78,0,0,0
2020-04-28 17:00,157,60,97,0,0,0
2020-04-28 17:15,124,57,67,0,0,0
2020-04-28 17:30,116,43,73,0,0,0
2020-04-28 17:45,104,31,73,0,0,0
2020-04-28 18:00,112,30,82,0,0,0
2020-04-28 18:15,71,18,53,0,0,0
2020-04-28 18:30,57,11,46,0,0,0
2020-04-28 18:45,55,21,34,0,0,0
2020-04-28 19:00,69,18,51,0,0,0
2020-04-28 19:15,40,14,26,0,0,0
2020-04-28 19:30,42,13,29,0,0,0
2020-04-28 19:45,32,6,26,0,0,0
2020-04-28 20:00,33,12,21,0,0,0
2020-04-28 20:15,25,6,19,0,0,0
2020-04-28 20:30,22,4,18,0,0,0
2020-04-28 20:45,19,6,13,0,0,0
2020-04-28 21:00,12,1,11,0,0,0
2020-04-28 21:15,17,8,9,0,0,0
2020-04-28 21:30,11,8,3,0,0,0
2020-04-28 21:45,10,2,8,0,0,0
2020-04-28 22:00,18,3,15,0,0,0
2020-04-28 22:15,11,3,8,0,0,0
2020-04-28 22:30,5,0,5,0,0,0
2020-04-28 22:45,10,3,7,0,0,0
2020-04-28 23:00,11,6,5,0,0,0
2020-04-28 23:15,5,3,2,0,0,0
2020-04-28 23:30,6,4,2,0,0,0
2020-04-28 23:45,9,5,4,0,0,0
2020-04-29 00:00,4,3,1,0,0,0
2020-04-29 00:15,4,2,2,0,0,0
2020-04-29 00:30,2,0,2,0,0,0
2020-04-29 00:45,1,1,0,0,0,0
2020-04-29 01:00,2,2,0,0,0,0
2020-04-29 01:15,1,0,1,0,0,0
2020-04-29 01:30,4,2,2,0,0,0
2020-04-29 01:45,2,0,2,0,0,0
2020-04-29 02:00,1,0,1,0,0,0
2020-04-29 02:15,1,0,1,0,0,0
2020-04-29 02:30,2,0,2,0,0,0
2020-04-29 02:45,0,0,0,0,0,0
2020-04-29 03:00,0,0,0,0,0,0
2020-04-29 03:15,2,1,1,0,0,0
2020-04-29 03:30,0,0,0,0,0,0
2020-04-29 03:45,0,0,0,0,0,0
2020-04-29 04:00,0,0,0,0,0,0
2020-04-29 04:15,1,0,1,0,0,0
2020-04-29 04:30,1,1,0,0,0,0
2020-04-29 04:45,2,1,1,0,0,0
2020-04-29 05:00,5,5,0,0,0,0
2020-04-29 05:15,7,2,5,0,0,0
2020-04-29 05:30,13,11,2,0,0,0
2020-04-29 05:45,19,15,4,0,0,0
2020-04-29 06:00,27,23,4,0,0,0
2020-04-29 06:15,37,27,10,0,0,0
2020-04-29 06:30,25,15,10,0,0,0
2020-04-29 06:45,59,41,18,0,0,0
2020-04-29 07:00,59,42,17,0,0,0
2020-04-29 07:15,78,54,24,0,0,0
2020-04-29 07:30,92,66,26,0,0,0
2020-04-29 07:45,96,68,28,0,0,0
2020-04-29 08:00,96,65,31,0,0,0
2020-04-29 08:15,112,69,43,0,0,0
2020-04-29 08:30,99,59,40,0,0,0
2020-04-29 08:45,110,74,36,0,0,0
2020-04-29 09:00,74,51,23,0,0,0
2020-04-29 09:15,101,50,51,0,0,0
2020-04-29 09:30,82,43,39,0,0,0
2020-04-29 09:45,86,55,31,0,0,0
2020-04-29 10:00,84,48,36,0,0,0
2020-04-29 10:15,92,51,41,0,0,0
2020-04-29 10:30,86,46,40,0,0,0
2020-04-29 10:45,84,48,36,0,0,0
2020-04-29 11:00,91,41,50,0,0,0
2020-04-29 11:15,110,48,62,0,0,0
2020-04-29 11:30,94,51,43,0,0,0
2020-04-29 11:45,110,59,51,0,0,0
2020-04-29 12:00,109,41,68,0,0,0
2020-04-29 12:15,123,56,67,0,0,0
2020-04-29 12:30,133,48,85,0,0,0
2020-04-29 12:45,106,49,57,0,0,0
2020-04-29 13:00,117,49,68,0,0,0
2020-04-29 13:15,133,53,80,0,0,0
2020-04-29 13:30,117,52,65,0,0,0
2020-04-29 13:45,122,53,69,0,0,0
2020-04-29 14:00,99,37,62,0,0,0
2020-04-29 14:15,91,27,64,0,0,0
2020-04-29 14:30,88,30,58,0,0,0
2020-04-29 14:45,121,60,61,0,0,0
2020-04-29 15:00,123,38,85,0,0,0
2020-04-29 15:15,132,46,86,0,0,0
2020-04-29 15:30,94,41,53,0,0,0
2020-04-29 15:45,136,50,86,0,0,0
2020-04-29 16:00,139,58,81,0,0,0
2020-04-29 16:15,155,61,94,0,0,0
2020-04-29 16:30,138,57,81,0,0,0
2020-04-29 16:45,144,59,85,0,0,0
2020-04-29 17:00,167,66,101,0,0,0
2020-04-29 17:15,138,58,80,0,0,0
2020-04-29 17:30,139,43,96,0,0,0
2020-04-29 17:45,130,44,86,0,0,0
2020-04-29 18:00,106,37,69,0,0,0
2020-04-29 18:15,123,37,86,0,0,0
2020-04-29 18:30,113,45,68,0,0,0
2020-04-29 18:45,107,38,69,0,0,0
2020-04-29 19:00,81,28,53,0,0,0
2020-04-29 19:15,81,24,57,0,0,0
2020-04-29 19:30,46,16,30,0,0,0
2020-04-29 19:45,54,15,39,0,0,0
2020-04-29 20:00,57,23,34,0,0,0
2020-04-29 20:15,34,8,26,0,0,0
2020-04-29 20:30,33,15,18,0,0,0
2020-04-29 20:45,22,14,8,0,0,0
2020-04-29 21:00,14,5,9,0,0,0
2020-04-29 21:15,25,8,17,0,0,0
2020-04-29 21:30,14,2,12,0,0,0
2020-04-29 21:45,15,7,8,0,0,0
2020-04-29 22:00,17,6,11,0,0,0
2020-04-29 22:15,9,2,7,0,0,0
2020-04-29 22:30,20,3,17,0,0,0
2020-04-29 22:45,11,4,7,0,0,0
2020-04-29 23:00,12,4,8,0,0,0
2020-04-29 23:15,10,3,7,0,0,0
2020-04-29 23:30,12,4,8,0,0,0
2020-04-29 23:45,16,8,8,0,0,0
2020-04-30 00:00,11,2,9,0,0,0
2020-04-30 00:15,7,3,4,0,0,0
2020-04-30 00:30,3,0,3,0,0,0
2020-04-30 00:45,5,1,4,0,0,0
2020-04-30 01:00,1,0,1,0,0,0
2020-04-30 01:15,3,0,3,0,0,0
2020-04-30 01:30,3,2,1,0,0,0
2020-04-30 01:45,1,0,1,0,0,0
2020-04-30 02:00,3,3,0,0,0,0
2020-04-30 02:15,2,0,2,0,0,0
2020-04-30 02:30,2,1,1,0,0,0
2020-04-30 02:45,0,0,0,0,0,0
2020-04-30 03:00,0,0,0,0,0,0
2020-04-30 03:15,1,0,1,0,0,0
2020-04-30 03:30,0,0,0,0,0,0
2020-04-30 03:45,1,0,1,0,0,0
2020-04-30 04:00,0,0,0,0,0,0
2020-04-30 04:15,1,1,0,0,0,0
2020-04-30 04:30,2,1,1,0,0,0
2020-04-30 04:45,1,0,1,0,0,0
2020-04-30 05:00,5,4,1,0,0,0
2020-04-30 05:15,7,4,3,0,0,0
2020-04-30 05:30,8,7,1,0,0,0
2020-04-30 05:45,13,9,4,0,0,0
2020-04-30 06:00,17,14,3,0,0,0
2020-04-30 06:15,23,14,9,0,0,0
2020-04-30 06:30,25,16,9,0,0,0
2020-04-30 06:45,53,34,19,0,0,0
2020-04-30 07:00,58,39,19,0,0,0
2020-04-30 07:15,65,34,31,0,0,0
2020-04-30 07:30,68,41,27,0,0,0
2020-04-30 07:45,82,59,23,0,0,0
2020-04-30 08:00,81,55,26,0,0,0
2020-04-30 08:15,83,54,29,0,0,0
2020-04-30 08:30,79,60,19,0,0,0
2020-04-30 08:45,97,61,36,0,0,0
2020-04-30 09:00,52,36,16,0,0,0
2020-04-30 09:15,70,44,26,0,0,0
2020-04-30 09:30,67,44,23,0,0,0
2020-04-30 09:45,69,42,27,0,0,0
2020-04-30 10:00,74,46,28,0,0,0
2020-04-30 10:15,68,34,34,0,0,0
2020-04-30 10:30,67,40,27,0,0,0
2020-04-30 10:45,91,41,50,0,0,0
2020-04-30 11:00,98,55,43,0,0,0
2020-04-30 11:15,78,36,42,0,0,0
2020-04-30 11:30,51,21,30,0,0,0
2020-04-30 11:45,96,39,57,0,0,0
2020-04-30 12:00,86,37,49,0,0,0
2020-04-30 12:15,94,35,59,0,0,0
2020-04-30 12:30,104,41,63,0,0,0
2020-04-30 12:45,123,58,65,0,0,0
2020-04-30 13:00,112,44,68,0,0,0
2020-04-30 13:15,119,49,70,0,0,0
2020-04-30 13:30,91,36,55,0,0,0
2020-04-30 13:45,115,61,54,0,0,0
2020-04-30 14:00,127,55,72,0,0,0
2020-04-30 14:15,122,55,67,0,0,0
2020-04-30 14:30,121,65,56,0,0,0
2020-04-30 14:45,151,75,76,0,0,0
2020-04-30 15:00,144,66,78,0,0,0
2020-04-30 15:15,153,64,89,0,0,0
2020-04-30 15:30,169,88,81,0,0,0
2020-04-30 15:45,171,85,86,0,0,0
2020-04-30 16:00,151,48,103,0,0,0
2020-04-30 16:15,170,74,96,0,0,0
2020-04-30 16:30,161,65,96,0,0,0
2020-04-30 16:45,152,64,88,0,0,0
2020-04-30 17:00,151,51,100,0,0,0
2020-04-30 17:15,126,53,73,0,0,0
2020-04-30 17:30,145,67,78,0,0,0
2020-04-30 17:45,128,39,89,0,0,0
2020-04-30 18:00,133,45,88,0,0,0
2020-04-30 18:15,102,34,68,0,0,0
2020-04-30 18:30,104,28,76,0,0,0
2020-04-30 18:45,92,32,60,0,0,0
2020-04-30 19:00,101,27,74,0,0,0
2020-04-30 19:15,62,17,45,0,0,0
2020-04-30 19:30,40,14,26,0,0,0
2020-04-30 19:45,42,12,30,0,0,0
2020-04-30 20:00,43,17,26,0,0,0
2020-04-30 20:15,49,16,33,0,0,0
2020-04-30 20:30,24,15,9,0,0,0
2020-04-30 20:45,16,8,8,0,0,0
2020-04-30 21:00,29,14,15,0,0,0
2020-04-30 21:15,20,7,13,0,0,0
2020-04-30 21:30,13,5,8,0,0,0
2020-04-30 21:45,21,5,16,0,0,0
2020-04-30 22:00,21,5,16,0,0,0
2020-04-30 22:15,22,9,13,0,0,0
2020-04-30 22:30,13,2,11,0,0,0
2020-04-30 22:45,10,3,7,0,0,0
2020-04-30 23:00,7,4,3,0,0,0
2020-04-30 23:15,8,3,5,0,0,0
2020-04-30 23:30,4,1,3,0,0,0
2020-04-30 23:45,7,4,3,0,0,0
